Equipe,GP,W,D,L,GF,GA,GD,Pts_Away,Liga,PIA,PIA_HA,GD_Away,Odd_Justa_MO,Odd_Justa_HA
MC Alger,5,3,2,0,5,2,3,11,algeria,0.6,0.4,3,1.67,2.5
CR Belouizdad,6,2,3,1,5,2,3,9,algeria,0.33,0.67,3,3.03,1.49
JS Kabylie,4,2,1,1,5,3,2,7,algeria,0.5,0.5,2,2.0,2.0
ES Setif,6,2,1,3,7,8,-1,7,algeria,0.33,0.67,-1,3.03,1.49
USM Alger,5,1,3,1,1,1,0,6,algeria,0.2,0.8,0,5.0,1.25
CS Constantine,5,1,2,2,4,5,-1,5,algeria,0.2,0.8,-1,5.0,1.25
Biskra,6,1,2,3,4,6,-2,5,algeria,0.17,0.83,-2,5.88,1.2
ASO Chlef,6,1,2,3,2,6,-4,5,algeria,0.17,0.83,-4,5.88,1.2
Mostaganem,7,1,2,4,3,8,-5,5,algeria,0.14,0.86,-5,7.14,1.16
O. Akbou,5,1,1,3,5,6,-1,4,algeria,0.2,0.8,-1,5.0,1.25
El Bayadh,5,1,0,4,3,7,-4,3,algeria,0.2,0.8,-4,5.0,1.25
Khenchela,5,0,3,2,2,7,-5,3,algeria,0.0,1.0,-5,0.0,1.0
Paradou AC,3,0,2,1,3,4,-1,2,algeria,0.0,1.0,-1,0.0,1.0
NC Magra,7,0,2,5,3,11,-8,2,algeria,0.0,1.0,-8,0.0,1.0
MC Oran,5,0,1,4,5,10,-5,1,algeria,0.0,1.0,-5,0.0,1.0
JS Saoura,5,0,1,4,3,9,-6,1,algeria,0.0,1.0,-6,0.0,1.0
T. de Cordoba,8,4,2,2,8,9,-1,14,argentina,0.5,0.5,-1,2.0,2.0
Central Cordoba,8,3,4,1,10,7,3,13,argentina,0.38,0.62,3,2.63,1.61
River Plate,8,3,4,1,8,6,2,13,argentina,0.38,0.62,2,2.63,1.61
Tigre,8,3,3,2,6,4,2,12,argentina,0.38,0.62,2,2.63,1.61
Belgrano,8,2,5,1,9,6,3,11,argentina,0.25,0.75,3,4.0,1.33
Velez Sarsfield,8,2,4,2,9,7,2,10,argentina,0.25,0.75,2,4.0,1.33
Independiente,8,2,4,2,7,5,2,10,argentina,0.25,0.75,2,4.0,1.33
Platense,8,2,4,2,5,4,1,10,argentina,0.25,0.75,1,4.0,1.33
Gimnasia,8,2,4,2,4,4,0,10,argentina,0.25,0.75,0,4.0,1.33
Estudiantes,8,2,4,2,12,13,-1,10,argentina,0.25,0.75,-1,4.0,1.33
Barracas C.,8,3,1,4,4,7,-3,10,argentina,0.38,0.62,-3,2.63,1.61
Huracan,8,2,3,3,9,10,-1,9,argentina,0.25,0.75,-1,4.0,1.33
Racing Club,8,3,0,5,8,10,-2,9,argentina,0.38,0.62,-2,2.63,1.61
San Lorenzo,8,2,3,3,4,6,-2,9,argentina,0.25,0.75,-2,4.0,1.33
Defensa y J.,8,2,2,4,11,12,-1,8,argentina,0.25,0.75,-1,4.0,1.33
Godoy Cruz,8,2,2,4,8,12,-4,8,argentina,0.25,0.75,-4,4.0,1.33
Boca Juniors,8,2,2,4,5,9,-4,8,argentina,0.25,0.75,-4,4.0,1.33
I. Rivadavia,8,2,2,4,7,12,-5,8,argentina,0.25,0.75,-5,4.0,1.33
Lanus,8,2,2,4,5,10,-5,8,argentina,0.25,0.75,-5,4.0,1.33
Rosario Central,8,1,3,4,5,11,-6,6,argentina,0.12,0.88,-6,8.33,1.14
Banfield,8,1,3,4,5,12,-7,6,argentina,0.12,0.88,-7,8.33,1.14
D. Riestra,8,0,5,3,5,11,-6,5,argentina,0.0,1.0,-6,0.0,1.0
Instituto,8,1,2,5,7,14,-7,5,argentina,0.12,0.88,-7,8.33,1.14
Union Santa Fe,8,1,2,5,6,15,-9,5,argentina,0.12,0.88,-9,8.33,1.14
Sarmiento,8,0,3,5,4,11,-7,3,argentina,0.0,1.0,-7,0.0,1.0
Newells,8,0,3,5,3,12,-9,3,argentina,0.0,1.0,-9,0.0,1.0
A. Tucuman,8,0,2,6,3,12,-9,2,argentina,0.0,1.0,-9,0.0,1.0
Argentinos Jrs,8,0,1,7,3,12,-9,1,argentina,0.0,1.0,-9,0.0,1.0
SM Tucuman,8,7,1,0,12,3,9,22,argentina3,0.88,0.12,9,1.14,8.33
Quilmes,8,4,4,0,11,2,9,16,argentina3,0.5,0.5,9,2.0,2.0
Nueva Chicago,8,4,2,2,11,6,5,14,argentina3,0.5,0.5,5,2.0,2.0
D. Madryn,8,3,5,0,6,3,3,14,argentina3,0.38,0.62,3,2.63,1.61
All Boys,8,4,2,2,9,7,2,14,argentina3,0.5,0.5,2,2.0,2.0
Atletico Mitre,8,2,6,0,7,5,2,12,argentina3,0.25,0.75,2,4.0,1.33
G. Mendoza,8,3,3,2,5,3,2,12,argentina3,0.38,0.62,2,2.63,1.61
SM San Juan,8,3,3,2,6,5,1,12,argentina3,0.38,0.62,1,2.63,1.61
Tristan Suarez,8,3,2,3,11,10,1,11,argentina3,0.38,0.62,1,2.63,1.61
Almagro,8,3,2,3,11,11,0,11,argentina3,0.38,0.62,0,2.63,1.61
Gimnasia y Tiro,8,3,2,3,7,7,0,11,argentina3,0.38,0.62,0,2.63,1.61
Temperley,8,2,4,2,4,5,-1,10,argentina3,0.25,0.75,-1,4.0,1.33
Almirante Brown,8,3,1,4,7,13,-6,10,argentina3,0.38,0.62,-6,2.63,1.61
Aldosivi,8,2,3,3,8,9,-1,9,argentina3,0.25,0.75,-1,4.0,1.33
Ferro Carril,8,2,3,3,6,8,-2,9,argentina3,0.25,0.75,-2,4.0,1.33
D. de Belgrano,8,2,3,3,3,5,-2,9,argentina3,0.25,0.75,-2,4.0,1.33
Gimnasia Jujuy,8,2,3,3,3,5,-2,9,argentina3,0.25,0.75,-2,4.0,1.33
San Telmo,8,2,2,4,5,7,-2,8,argentina3,0.25,0.75,-2,4.0,1.33
Atlanta,8,2,2,4,5,8,-3,8,argentina3,0.25,0.75,-3,4.0,1.33
Alvarado,8,2,1,5,8,10,-2,7,argentina3,0.25,0.75,-2,4.0,1.33
A. Rafaela,8,1,4,3,6,8,-2,7,argentina3,0.12,0.88,-2,8.33,1.14
Deportivo Moron,8,1,4,3,4,8,-4,7,argentina3,0.12,0.88,-4,8.33,1.14
Chaco For Ever,8,1,4,3,1,5,-4,7,argentina3,0.12,0.88,-4,8.33,1.14
E. Rio Cuarto,8,1,4,3,2,7,-5,7,argentina3,0.12,0.88,-5,8.33,1.14
Racing Cordoba,8,2,1,5,5,11,-6,7,argentina3,0.25,0.75,-6,4.0,1.33
Brown de A.,8,2,1,5,5,12,-7,7,argentina3,0.25,0.75,-7,4.0,1.33
Patronato,8,2,0,6,9,13,-4,6,argentina3,0.25,0.75,-4,4.0,1.33
CA Estudiantes,8,1,3,4,5,12,-7,6,argentina3,0.12,0.88,-7,8.33,1.14
Colon Santa Fe,8,1,2,5,2,5,-3,5,argentina3,0.12,0.88,-3,8.33,1.14
Pyunik,8,6,0,2,18,7,11,18,armenia,0.75,0.25,11,1.33,4.0
Noah,8,5,1,2,20,7,13,16,armenia,0.62,0.38,13,1.61,2.63
Ararat-Armenia,8,4,2,2,16,10,6,14,armenia,0.5,0.5,6,2.0,2.0
Urartu,8,4,1,3,15,9,6,13,armenia,0.5,0.5,6,2.0,2.0
Van,8,4,1,3,10,10,0,13,armenia,0.5,0.5,0,2.0,2.0
Shirak,8,4,1,3,9,11,-2,13,armenia,0.5,0.5,-2,2.0,2.0
West Armenia,8,4,0,4,8,17,-9,12,armenia,0.5,0.5,-9,2.0,2.0
BKMA,8,3,1,4,19,19,0,10,armenia,0.38,0.62,0,2.63,1.61
Alashkert,8,2,1,5,4,11,-7,7,armenia,0.25,0.75,-7,4.0,1.33
Ararat Yerevan,8,2,1,5,7,17,-10,7,armenia,0.25,0.75,-10,4.0,1.33
Gandzasar,8,0,2,6,3,19,-16,2,armenia,0.0,1.0,-16,0.0,1.0
Melbourne City,4,4,0,0,11,1,10,12,australia,1.0,0.0,10,1.0,0.0
Adelaide Utd,3,3,0,0,8,5,3,9,australia,1.0,0.0,3,1.0,0.0
Melbourne V.,4,2,1,1,6,3,3,7,australia,0.5,0.5,3,2.0,2.0
Wellington,3,2,0,1,6,2,4,6,australia,0.67,0.33,4,1.49,3.03
Auckland,2,2,0,0,3,0,3,6,australia,1.0,0.0,3,1.0,0.0
Sydney FC,4,2,0,2,6,6,0,6,australia,0.5,0.5,0,2.0,2.0
Western United,3,1,1,1,5,4,1,4,australia,0.33,0.67,1,3.03,1.49
Central Coast,2,1,1,0,3,2,1,4,australia,0.5,0.5,1,2.0,2.0
WS Wanderers,3,1,1,1,5,5,0,4,australia,0.33,0.67,0,3.03,1.49
Macarthur FC,3,1,1,1,3,3,0,4,australia,0.33,0.67,0,3.03,1.49
Newcastle Jets,3,1,0,2,3,7,-4,3,australia,0.33,0.67,-4,3.03,1.49
Perth Glory,4,0,2,2,3,10,-7,2,australia,0.0,1.0,-7,0.0,1.0
Brisbane Roar,3,0,1,2,4,8,-4,1,australia,0.0,1.0,-4,0.0,1.0
Sturm Graz,8,5,2,1,14,7,7,17,austria,0.62,0.38,7,1.61,2.63
LASK Linz,8,4,1,3,11,10,1,13,austria,0.5,0.5,1,2.0,2.0
Wolfsberger AC,7,4,0,3,15,11,4,12,austria,0.57,0.43,4,1.75,2.33
Austria Wien,8,3,2,3,8,8,0,11,austria,0.38,0.62,0,2.63,1.61
Rapid Wien,8,1,6,1,7,9,-2,9,austria,0.12,0.88,-2,8.33,1.14
Tirol,8,3,0,5,11,14,-3,9,austria,0.38,0.62,-3,2.63,1.61
Salzburg,8,2,3,3,7,13,-6,9,austria,0.25,0.75,-6,4.0,1.33
Hartberg,8,2,2,4,10,14,-4,8,austria,0.25,0.75,-4,4.0,1.33
BW Linz,8,2,2,4,9,15,-6,8,austria,0.25,0.75,-6,4.0,1.33
A. Klagenfurt,8,2,1,5,6,21,-15,7,austria,0.25,0.75,-15,4.0,1.33
Grazer AK,8,1,3,4,10,17,-7,6,austria,0.12,0.88,-7,8.33,1.14
Altach,8,1,1,6,5,14,-9,4,austria,0.12,0.88,-9,8.33,1.14
Ried,8,6,1,1,13,4,9,19,austria2,0.75,0.25,9,1.33,4.0
Admira Wacker,8,6,1,1,14,8,6,19,austria2,0.75,0.25,6,1.33,4.0
First Vienna,7,5,1,1,17,10,7,16,austria2,0.71,0.29,7,1.41,3.45
St. Polten,8,5,0,3,16,10,6,15,austria2,0.62,0.38,6,1.61,2.63
Liefering,8,4,1,3,10,13,-3,13,austria2,0.5,0.5,-3,2.0,2.0
Kapfenberger,8,4,1,3,8,14,-6,13,austria2,0.5,0.5,-6,2.0,2.0
Sturm Graz B,8,3,3,2,17,12,5,12,austria2,0.38,0.62,5,2.63,1.61
A. Lustenau,8,3,3,2,8,8,0,12,austria2,0.38,0.62,0,2.63,1.61
Voitsberg,8,3,2,3,11,9,2,11,austria2,0.38,0.62,2,2.63,1.61
Amstetten,7,3,2,2,10,8,2,11,austria2,0.43,0.57,2,2.33,1.75
Rapid Wien B,8,3,2,3,15,17,-2,11,austria2,0.38,0.62,-2,2.63,1.61
Bregenz,7,2,4,1,8,8,0,10,austria2,0.29,0.71,0,3.45,1.41
Floridsdorfer,8,2,2,4,9,10,-1,8,austria2,0.25,0.75,-1,4.0,1.33
SV Horn,8,2,0,6,6,22,-16,6,austria2,0.25,0.75,-16,4.0,1.33
Stripfing,8,0,4,4,5,11,-6,4,austria2,0.0,1.0,-6,0.0,1.0
Lafnitz,8,1,1,6,6,20,-14,4,austria2,0.12,0.88,-14,8.33,1.14
Araz,8,7,1,0,11,2,9,22,azerbaijan,0.88,0.12,9,1.14,8.33
Qarabag,8,6,2,0,20,3,17,20,azerbaijan,0.75,0.25,17,1.33,4.0
Turan,8,3,4,1,13,8,5,13,azerbaijan,0.38,0.62,5,2.63,1.61
Zira,8,4,1,3,12,8,4,13,azerbaijan,0.5,0.5,4,2.0,2.0
Sabah,7,3,2,2,13,10,3,11,azerbaijan,0.43,0.57,3,2.33,1.75
Shamakhi,8,2,1,5,8,13,-5,7,azerbaijan,0.25,0.75,-5,4.0,1.33
FK Sumqayit,7,1,1,5,4,11,-7,4,azerbaijan,0.14,0.86,-7,7.14,1.16
Neftci,8,0,4,4,5,14,-9,4,azerbaijan,0.0,1.0,-9,0.0,1.0
Kapaz,8,1,1,6,4,17,-13,4,azerbaijan,0.12,0.88,-13,8.33,1.14
Sebail,8,0,0,8,6,17,-11,0,azerbaijan,0.0,1.0,-11,0.0,1.0
Bahrain SC,4,2,1,1,5,7,-2,7,bahrain,0.5,0.5,-2,2.0,2.0
Al-Najma,3,2,0,1,6,5,1,6,bahrain,0.67,0.33,1,1.49,3.03
Al Shabbab,4,2,0,2,4,7,-3,6,bahrain,0.5,0.5,-3,2.0,2.0
Al-Muharraq,3,1,2,0,3,1,2,5,bahrain,0.33,0.67,2,3.03,1.49
Malkiya,4,1,1,2,4,8,-4,4,bahrain,0.25,0.75,-4,4.0,1.33
Khalidiya,2,1,0,1,6,3,3,3,bahrain,0.5,0.5,3,2.0,2.0
Sitra,1,1,0,0,2,0,2,3,bahrain,1.0,0.0,2,1.0,0.0
Al Ahli M.,3,1,0,2,5,7,-2,3,bahrain,0.33,0.67,-2,3.03,1.49
Al Riffa,2,0,1,1,0,1,-1,1,bahrain,0.0,1.0,-1,0.0,1.0
AAli FC,3,0,1,2,3,7,-4,1,bahrain,0.0,1.0,-4,0.0,1.0
East Riffa,3,0,0,3,2,5,-3,0,bahrain,0.0,1.0,-3,0.0,1.0
Manama,2,0,0,2,1,6,-5,0,bahrain,0.0,1.0,-5,0.0,1.0
Neman Grodno,8,5,3,0,15,3,12,18,belarus,0.62,0.38,12,1.61,2.63
T. Zhodino,8,4,2,2,11,5,6,14,belarus,0.5,0.5,6,2.0,2.0
Slutsk,8,4,2,2,8,8,0,14,belarus,0.5,0.5,0,2.0,2.0
Dinamo Minsk,8,3,3,2,9,5,4,12,belarus,0.38,0.62,4,2.63,1.61
BATE Borisov,8,3,2,3,7,9,-2,11,belarus,0.38,0.62,-2,2.63,1.61
Vitebsk,8,3,1,4,10,9,1,10,belarus,0.38,0.62,1,2.63,1.61
Naftan,8,3,1,4,9,8,1,10,belarus,0.38,0.62,1,2.63,1.61
Isloch,8,3,1,4,12,12,0,10,belarus,0.38,0.62,0,2.63,1.61
Dinamo Brest,8,3,0,5,15,14,1,9,belarus,0.38,0.62,1,2.63,1.61
Gomel,8,2,3,3,7,10,-3,9,belarus,0.25,0.75,-3,4.0,1.33
FC Minsk,8,2,3,3,7,11,-4,9,belarus,0.25,0.75,-4,4.0,1.33
Slavia Mozyr,8,1,4,3,4,9,-5,7,belarus,0.12,0.88,-5,8.33,1.14
Arsenal D.,8,1,3,4,7,9,-2,6,belarus,0.12,0.88,-2,8.33,1.14
Dnepr Mogilev,8,1,3,4,9,15,-6,6,belarus,0.12,0.88,-6,8.33,1.14
S. Soligorsk,8,1,3,4,3,9,-6,6,belarus,0.12,0.88,-6,8.33,1.14
Smorgon,8,0,2,6,9,18,-9,2,belarus,0.0,1.0,-9,0.0,1.0
Maxline,8,8,0,0,24,6,18,24,belarus2,1.0,0.0,18,1.0,0.0
Dinamo Minsk B,8,5,1,2,17,6,11,16,belarus2,0.62,0.38,11,1.61,2.63
Niva,8,5,1,2,11,5,6,16,belarus2,0.62,0.38,6,1.61,2.63
Belshina,8,4,2,2,26,16,10,14,belarus2,0.5,0.5,10,2.0,2.0
Molodechno,8,4,1,3,11,11,0,13,belarus2,0.5,0.5,0,2.0,2.0
ABFF U17,8,4,1,3,9,9,0,13,belarus2,0.5,0.5,0,2.0,2.0
Orsha,8,3,3,2,15,13,2,12,belarus2,0.38,0.62,2,2.63,1.61
Volna Pinsk,8,4,0,4,13,13,0,12,belarus2,0.5,0.5,0,2.0,2.0
Lida,8,3,2,3,12,10,2,11,belarus2,0.38,0.62,2,2.63,1.61
BATE B,8,3,1,4,9,17,-8,10,belarus2,0.38,0.62,-8,2.63,1.61
Baranovichi,8,2,3,3,9,12,-3,9,belarus2,0.25,0.75,-3,4.0,1.33
Ostrovets,8,3,0,5,11,16,-5,9,belarus2,0.38,0.62,-5,2.63,1.61
S. Soligorsk B,8,2,1,5,5,14,-9,7,belarus2,0.25,0.75,-9,4.0,1.33
Bumprom,8,0,4,4,1,9,-8,4,belarus2,0.0,1.0,-8,0.0,1.0
Energetik-BGU,8,1,1,6,6,15,-9,4,belarus2,0.12,0.88,-9,8.33,1.14
Lokomotiv Gomel,8,0,3,5,4,13,-9,3,belarus2,0.0,1.0,-9,0.0,1.0
T. Zhodhino B,8,1,0,7,3,23,-20,3,belarus2,0.12,0.88,-20,8.33,1.14
Slonim,8,1,0,7,3,25,-22,3,belarus2,0.12,0.88,-22,8.33,1.14
Club Brugge,8,5,2,1,15,9,6,17,belgium,0.62,0.38,6,1.61,2.63
KRC Genk,8,4,1,3,15,16,-1,13,belgium,0.5,0.5,-1,2.0,2.0
Anderlecht,8,3,3,2,13,7,6,12,belgium,0.38,0.62,6,2.63,1.61
Antwerp,8,3,2,3,8,9,-1,11,belgium,0.38,0.62,-1,2.63,1.61
Dender,8,2,3,3,9,16,-7,9,belgium,0.25,0.75,-7,4.0,1.33
KV Mechelen,8,2,2,4,10,12,-2,8,belgium,0.25,0.75,-2,4.0,1.33
Westerlo,8,2,1,5,9,14,-5,7,belgium,0.25,0.75,-5,4.0,1.33
Gent,8,1,4,3,8,14,-6,7,belgium,0.12,0.88,-6,8.33,1.14
OH Leuven,8,1,4,3,7,14,-7,7,belgium,0.12,0.88,-7,8.33,1.14
Royale Union SG,8,0,6,2,6,9,-3,6,belgium,0.0,1.0,-3,0.0,1.0
Standard Liege,8,1,2,5,3,15,-12,5,belgium,0.12,0.88,-12,8.33,1.14
Sint-Truiden,8,1,2,5,9,22,-13,5,belgium,0.12,0.88,-13,8.33,1.14
Charleroi,8,1,1,6,6,15,-9,4,belgium,0.12,0.88,-9,8.33,1.14
Cercle Brugge,8,1,1,6,6,17,-11,4,belgium,0.12,0.88,-11,8.33,1.14
Beerschot,8,0,1,7,4,21,-17,1,belgium,0.0,1.0,-17,0.0,1.0
Kortrijk,8,0,1,7,4,23,-19,1,belgium,0.0,1.0,-19,0.0,1.0
Bolivar,4,2,0,2,6,5,1,6,bolivia,0.5,0.5,1,2.0,2.0
Royal Pari,4,2,0,2,5,6,-1,6,bolivia,0.5,0.5,-1,2.0,2.0
Blooming,4,1,2,1,7,8,-1,5,bolivia,0.25,0.75,-1,4.0,1.33
SA Bulo Bulo,4,1,1,2,5,5,0,4,bolivia,0.25,0.75,0,4.0,1.33
Gualberto V. SJ,4,1,1,2,6,8,-2,4,bolivia,0.25,0.75,-2,4.0,1.33
Nacional Potosi,4,1,1,2,4,7,-3,4,bolivia,0.25,0.75,-3,4.0,1.33
Real Tomayapo,4,1,1,2,4,7,-3,4,bolivia,0.25,0.75,-3,4.0,1.33
The Strongest,4,1,1,2,8,13,-5,4,bolivia,0.25,0.75,-5,4.0,1.33
I. Petrolero,4,1,0,3,4,7,-3,3,bolivia,0.25,0.75,-3,4.0,1.33
Oriente P.,4,1,0,3,6,10,-4,3,bolivia,0.25,0.75,-4,4.0,1.33
Santa Cruz,4,1,0,3,4,8,-4,3,bolivia,0.25,0.75,-4,4.0,1.33
Aurora,4,0,2,2,1,3,-2,2,bolivia,0.0,1.0,-2,0.0,1.0
U. de Vinto,4,0,2,2,2,5,-3,2,bolivia,0.0,1.0,-3,0.0,1.0
Wilstermann,4,0,1,3,4,7,-3,1,bolivia,0.0,1.0,-3,0.0,1.0
Guabira,4,0,1,3,3,6,-3,1,bolivia,0.0,1.0,-3,0.0,1.0
Always Ready,4,0,1,3,3,7,-4,1,bolivia,0.0,1.0,-4,0.0,1.0
Bolivar,8,4,3,1,19,11,8,15,bolivia2,0.5,0.5,8,2.0,2.0
Aurora,8,3,4,1,14,14,0,13,bolivia2,0.38,0.62,0,2.63,1.61
Wilstermann,8,3,3,2,7,6,1,12,bolivia2,0.38,0.62,1,2.63,1.61
SA Bulo Bulo,8,3,2,3,10,8,2,11,bolivia2,0.38,0.62,2,2.63,1.61
Always Ready,8,3,2,3,11,11,0,11,bolivia2,0.38,0.62,0,2.63,1.61
Nacional Potosi,8,3,2,3,16,17,-1,11,bolivia2,0.38,0.62,-1,2.63,1.61
I. Petrolero,8,3,2,3,7,10,-3,11,bolivia2,0.38,0.62,-3,2.63,1.61
The Strongest,8,3,1,4,11,11,0,10,bolivia2,0.38,0.62,0,2.63,1.61
Gualberto V. SJ,8,2,2,4,12,15,-3,8,bolivia2,0.25,0.75,-3,4.0,1.33
Blooming,8,2,2,4,8,17,-9,8,bolivia2,0.25,0.75,-9,4.0,1.33
U. de Vinto,8,1,3,4,8,13,-5,6,bolivia2,0.12,0.88,-5,8.33,1.14
Santa Cruz,8,2,0,6,7,23,-16,6,bolivia2,0.25,0.75,-16,4.0,1.33
Oriente P.,8,1,2,5,7,16,-9,5,bolivia2,0.12,0.88,-9,8.33,1.14
Real Tomayapo,8,1,1,6,7,16,-9,4,bolivia2,0.12,0.88,-9,8.33,1.14
Guabira,8,1,1,6,5,20,-15,4,bolivia2,0.12,0.88,-15,8.33,1.14
Royal Pari,8,0,2,6,5,21,-16,2,bolivia2,0.0,1.0,-16,0.0,1.0
Palmeiras,8,6,1,1,13,7,6,19,brazil,0.75,0.25,6,1.33,4.0
Botafogo,8,5,2,1,9,4,5,17,brazil,0.62,0.38,5,1.61,2.63
Flamengo,8,4,2,2,12,7,5,14,brazil,0.5,0.5,5,2.0,2.0
Internacional,8,4,2,2,16,13,3,14,brazil,0.5,0.5,3,2.0,2.0
Corinthians,8,4,1,3,12,9,3,13,brazil,0.5,0.5,3,2.0,2.0
Vitoria,8,3,3,2,12,11,1,12,brazil,0.38,0.62,1,2.63,1.61
Fluminense,8,3,1,4,8,8,0,10,brazil,0.38,0.62,0,2.63,1.61
Juventude,8,2,3,3,11,13,-2,9,brazil,0.25,0.75,-2,4.0,1.33
Sao Paulo,8,2,2,4,8,10,-2,8,brazil,0.25,0.75,-2,4.0,1.33
Vasco da Gama,8,2,2,4,6,15,-9,8,brazil,0.25,0.75,-9,4.0,1.33
Bahia,8,2,1,5,10,16,-6,7,brazil,0.25,0.75,-6,4.0,1.33
Fortaleza,8,1,3,4,11,15,-4,6,brazil,0.12,0.88,-4,8.33,1.14
Cruzeiro,8,1,3,4,5,10,-5,6,brazil,0.12,0.88,-5,8.33,1.14
Gremio,8,0,5,3,7,10,-3,5,brazil,0.0,1.0,-3,0.0,1.0
Bragantino,8,1,2,5,5,13,-8,5,brazil,0.12,0.88,-8,8.33,1.14
Criciuma,8,1,2,5,5,17,-12,5,brazil,0.12,0.88,-12,8.33,1.14
Cuiaba,8,0,4,4,1,7,-6,4,brazil,0.0,1.0,-6,0.0,1.0
Atletico MG,8,0,3,5,4,12,-8,3,brazil,0.0,1.0,-8,0.0,1.0
Athletico PR,8,0,2,6,5,13,-8,2,brazil,0.0,1.0,-8,0.0,1.0
Atletico GO,8,0,1,7,4,18,-14,1,brazil,0.0,1.0,-14,0.0,1.0
Sport Recife,8,4,2,2,13,6,7,14,brazil2,0.5,0.5,7,2.0,2.0
Santos,8,4,1,3,11,9,2,13,brazil2,0.5,0.5,2,2.0,2.0
Goias,8,3,3,2,12,5,7,12,brazil2,0.38,0.62,7,2.63,1.61
Botafogo SP,8,3,2,3,8,9,-1,11,brazil2,0.38,0.62,-1,2.63,1.61
CRB,8,3,1,4,8,9,-1,10,brazil2,0.38,0.62,-1,2.63,1.61
Ituano,8,3,0,5,13,14,-1,9,brazil2,0.38,0.62,-1,2.63,1.61
Mirassol,8,2,3,3,7,8,-1,9,brazil2,0.25,0.75,-1,4.0,1.33
Novorizontino,8,2,2,4,7,7,0,8,brazil2,0.25,0.75,0,4.0,1.33
Ceara,8,2,2,4,10,11,-1,8,brazil2,0.25,0.75,-1,4.0,1.33
Chapecoense,8,2,2,4,8,10,-2,8,brazil2,0.25,0.75,-2,4.0,1.33
Operario PR,8,2,2,4,6,10,-4,8,brazil2,0.25,0.75,-4,4.0,1.33
Avai,8,2,1,5,7,11,-4,7,brazil2,0.25,0.75,-4,4.0,1.33
Coritiba,8,2,0,6,10,14,-4,6,brazil2,0.25,0.75,-4,4.0,1.33
Paysandu,8,1,3,4,8,12,-4,6,brazil2,0.12,0.88,-4,8.33,1.14
Amazonas,8,1,2,5,2,8,-6,5,brazil2,0.12,0.88,-6,8.33,1.14
America MG,8,1,1,6,6,10,-4,4,brazil2,0.12,0.88,-4,8.33,1.14
Ponte Preta,8,1,1,6,7,14,-7,4,brazil2,0.12,0.88,-7,8.33,1.14
Guarani,8,1,0,7,5,14,-9,3,brazil2,0.12,0.88,-9,8.33,1.14
Vila Nova,8,1,0,7,3,18,-15,3,brazil2,0.12,0.88,-15,8.33,1.14
Brusque,8,0,2,6,1,12,-11,2,brazil2,0.0,1.0,-11,0.0,1.0
Ludogorets,8,7,1,0,18,3,15,22,bulgaria,0.88,0.12,15,1.14,8.33
Cherno More,8,5,1,2,12,5,7,16,bulgaria,0.62,0.38,7,1.61,2.63
Botev Plovdiv,8,5,0,3,5,5,0,15,bulgaria,0.62,0.38,0,1.61,2.63
Levski Sofia,8,4,1,3,10,6,4,13,bulgaria,0.5,0.5,4,2.0,2.0
Arda,8,3,3,2,9,6,3,12,bulgaria,0.38,0.62,3,2.63,1.61
Septemvri Sofia,8,4,0,4,9,12,-3,12,bulgaria,0.5,0.5,-3,2.0,2.0
CSKA 1948 Sofia,8,2,5,1,11,9,2,11,bulgaria,0.25,0.75,2,4.0,1.33
CSKA Sofia,8,3,2,3,10,9,1,11,bulgaria,0.38,0.62,1,2.63,1.61
Beroe,8,3,2,3,9,9,0,11,bulgaria,0.38,0.62,0,2.63,1.61
Spartak Varna,8,3,2,3,8,12,-4,11,bulgaria,0.38,0.62,-4,2.63,1.61
L. Krumovgrad,8,2,3,3,5,9,-4,9,bulgaria,0.25,0.75,-4,4.0,1.33
Lok. Plovdiv,8,2,1,5,9,12,-3,7,bulgaria,0.25,0.75,-3,4.0,1.33
Slavia Sofia,8,2,0,6,8,13,-5,6,bulgaria,0.25,0.75,-5,4.0,1.33
Lokomotiv Sofia,8,1,1,6,6,17,-11,4,bulgaria,0.12,0.88,-11,8.33,1.14
Botev Vratsa,8,1,1,6,5,18,-13,4,bulgaria,0.12,0.88,-13,8.33,1.14
Hebar,8,0,2,6,6,17,-11,2,bulgaria,0.0,1.0,-11,0.0,1.0
Cavalry,8,7,0,1,15,6,9,21,canada,0.88,0.12,9,1.14,8.33
Forge,8,3,2,3,8,9,-1,11,canada,0.38,0.62,-1,2.63,1.61
York Utd,8,3,2,3,8,9,-1,11,canada,0.38,0.62,-1,2.63,1.61
A. Ottawa,8,2,3,3,10,12,-2,9,canada,0.25,0.75,-2,4.0,1.33
Valour,8,1,5,2,12,12,0,8,canada,0.12,0.88,0,8.33,1.14
Vancouver FC,8,1,4,3,8,12,-4,7,canada,0.12,0.88,-4,8.33,1.14
Pacific,8,1,2,5,6,11,-5,5,canada,0.12,0.88,-5,8.33,1.14
HFX Wanderers,8,0,2,6,6,17,-11,2,canada,0.0,1.0,-11,0.0,1.0
Colo-Colo,8,6,2,0,12,4,8,20,chile,0.75,0.25,8,1.33,4.0
U. de Chile,8,5,1,2,16,10,6,16,chile,0.62,0.38,6,1.61,2.63
Nublense,8,4,1,3,8,6,2,13,chile,0.5,0.5,2,2.0,2.0
Everton,8,3,3,2,16,12,4,12,chile,0.38,0.62,4,2.63,1.61
Union Espanola,8,3,2,3,10,10,0,11,chile,0.38,0.62,0,2.63,1.61
Union La Calera,8,2,3,3,4,7,-3,9,chile,0.25,0.75,-3,4.0,1.33
U. Catolica,8,2,2,4,8,11,-3,8,chile,0.25,0.75,-3,4.0,1.33
Audax Italiano,8,2,1,5,7,11,-4,7,chile,0.25,0.75,-4,4.0,1.33
OHiggins,8,2,1,5,8,14,-6,7,chile,0.25,0.75,-6,4.0,1.33
Coquimbo Unido,8,2,1,5,7,14,-7,7,chile,0.25,0.75,-7,4.0,1.33
Palestino,8,1,3,4,9,13,-4,6,chile,0.12,0.88,-4,8.33,1.14
Huachipato,8,2,0,6,8,15,-7,6,chile,0.25,0.75,-7,4.0,1.33
D. Iquique,8,1,2,5,9,17,-8,5,chile,0.12,0.88,-8,8.33,1.14
Copiapo,8,1,1,6,8,20,-12,4,chile,0.12,0.88,-12,8.33,1.14
Cobreloa,8,1,1,6,7,19,-12,4,chile,0.12,0.88,-12,8.33,1.14
Cobresal,8,0,2,6,3,15,-12,2,chile,0.0,1.0,-12,0.0,1.0
La Serena,8,4,4,0,10,4,6,16,chile2,0.5,0.5,6,2.0,2.0
Barnechea,8,4,2,2,16,11,5,14,chile2,0.5,0.5,5,2.0,2.0
Magallanes,8,4,2,2,11,8,3,14,chile2,0.5,0.5,3,2.0,2.0
S. Morning,8,3,3,2,9,8,1,12,chile2,0.38,0.62,1,2.63,1.61
Rangers,8,3,3,2,9,10,-1,12,chile2,0.38,0.62,-1,2.63,1.61
Curico Unido,8,3,2,3,8,8,0,11,chile2,0.38,0.62,0,2.63,1.61
U. San Felipe,8,3,2,3,7,12,-5,11,chile2,0.38,0.62,-5,2.63,1.61
Antofagasta,8,2,4,2,12,10,2,10,chile2,0.25,0.75,2,4.0,1.33
San Marcos,8,2,4,2,5,5,0,10,chile2,0.25,0.75,0,4.0,1.33
S. Wanderers,8,2,3,3,9,11,-2,9,chile2,0.25,0.75,-2,4.0,1.33
U. Concepcion,8,2,3,3,7,10,-3,9,chile2,0.25,0.75,-3,4.0,1.33
Recoleta,8,2,2,4,9,9,0,8,chile2,0.25,0.75,0,4.0,1.33
Deportes Temuco,8,2,1,5,8,13,-5,7,chile2,0.25,0.75,-5,4.0,1.33
D. Limache,8,2,1,5,6,14,-8,7,chile2,0.25,0.75,-8,4.0,1.33
San Luis,8,1,3,4,6,15,-9,6,chile2,0.12,0.88,-9,8.33,1.14
CD Santa Cruz,8,1,2,5,9,16,-7,5,chile2,0.12,0.88,-7,8.33,1.14
S. Shenhua,8,7,0,1,17,6,11,21,china,0.88,0.12,11,1.14,8.33
Shanghai Port,8,6,0,2,13,10,3,18,china,0.75,0.25,3,1.33,4.0
Chengdu,8,4,2,2,14,9,5,14,china,0.5,0.5,5,2.0,2.0
Henan SL,8,2,3,3,8,6,2,9,china,0.25,0.75,2,4.0,1.33
Beijing Guoan,8,2,3,3,13,15,-2,9,china,0.25,0.75,-2,4.0,1.33
Wuhan Three T.,8,2,3,3,5,7,-2,9,china,0.25,0.75,-2,4.0,1.33
Qingdao West C.,8,3,0,5,10,13,-3,9,china,0.38,0.62,-3,2.63,1.61
Shandong T.,8,2,2,4,12,18,-6,8,china,0.25,0.75,-6,4.0,1.33
Zhejiang,8,1,2,5,12,18,-6,5,china,0.12,0.88,-6,8.33,1.14
Cangzhou,8,1,2,5,7,16,-9,5,china,0.12,0.88,-9,8.33,1.14
Sichuan Jiuniu,8,1,2,5,7,16,-9,5,china,0.12,0.88,-9,8.33,1.14
Nantong Zhiyun,8,1,1,6,10,26,-16,4,china,0.12,0.88,-16,8.33,1.14
Qingdao Hainiu,8,1,1,6,6,24,-18,4,china,0.12,0.88,-18,8.33,1.14
Meizhou Hakka,8,0,2,6,9,24,-15,2,china,0.0,1.0,-15,0.0,1.0
Changchun Yatai,8,0,2,6,8,24,-16,2,china,0.0,1.0,-16,0.0,1.0
Tianjin T.,8,0,1,7,7,22,-15,1,china,0.0,1.0,-15,0.0,1.0
Liaoning Tieren,8,5,2,1,12,10,2,17,china2,0.62,0.38,2,1.61,2.63
Guangzhou FC,8,4,2,2,14,7,7,14,china2,0.5,0.5,7,2.0,2.0
Yunnan Yukun,8,4,1,3,17,9,8,13,china2,0.5,0.5,8,2.0,2.0
S. Gongfu,8,2,5,1,6,5,1,11,china2,0.25,0.75,1,4.0,1.33
Wuxi Wugou,8,3,2,3,9,11,-2,11,china2,0.38,0.62,-2,2.63,1.61
Yanbian Longdin,8,3,1,4,8,11,-3,10,china2,0.38,0.62,-3,2.63,1.61
Dalian Yingbo,8,3,1,4,9,13,-4,10,china2,0.38,0.62,-4,2.63,1.61
Heilongjiang IC,8,2,3,3,3,9,-6,9,china2,0.25,0.75,-6,4.0,1.33
Guangxi Baoyun,8,1,5,2,6,9,-3,8,china2,0.12,0.88,-3,8.33,1.14
Foshan Nanshi,8,2,2,4,5,13,-8,8,china2,0.25,0.75,-8,4.0,1.33
Suzhou Dongwu,8,1,4,3,9,11,-2,7,china2,0.12,0.88,-2,8.33,1.14
Shanghai Jiadin,8,0,6,2,6,9,-3,6,china2,0.0,1.0,-3,0.0,1.0
Chongqing T.,8,1,2,5,2,8,-6,5,china2,0.12,0.88,-6,8.33,1.14
Jiangxi Lushan,8,1,2,5,7,18,-11,5,china2,0.12,0.88,-11,8.33,1.14
Qingdao RL,8,0,3,5,6,18,-12,3,china2,0.0,1.0,-12,0.0,1.0
Nanjing City,8,0,1,7,5,16,-11,1,china2,0.0,1.0,-11,0.0,1.0
A. Bucaramanga,8,5,2,1,13,5,8,17,colombia2,0.62,0.38,8,1.61,2.63
Santa Fe,8,4,4,0,11,5,6,16,colombia2,0.5,0.5,6,2.0,2.0
Millonarios,8,4,2,2,13,7,6,14,colombia2,0.5,0.5,6,2.0,2.0
A. Nacional,8,4,1,3,8,7,1,13,colombia2,0.5,0.5,1,2.0,2.0
Deportes Tolima,8,4,0,4,7,5,2,12,colombia2,0.5,0.5,2,2.0,2.0
America de Cali,8,3,2,3,11,12,-1,11,colombia2,0.38,0.62,-1,2.63,1.61
Junior,8,2,4,2,5,3,2,10,colombia2,0.25,0.75,2,4.0,1.33
I. Medelin,8,2,4,2,10,9,1,10,colombia2,0.25,0.75,1,4.0,1.33
Fortaleza CEIF,8,2,3,3,9,9,0,9,colombia2,0.25,0.75,0,4.0,1.33
Deportivo Pasto,8,2,3,3,6,6,0,9,colombia2,0.25,0.75,0,4.0,1.33
R. Aguilas,8,2,3,3,7,13,-6,9,colombia2,0.25,0.75,-6,4.0,1.33
Once Caldas,8,2,2,4,6,11,-5,8,colombia2,0.25,0.75,-5,4.0,1.33
D. Pereira,8,1,4,3,6,9,-3,7,colombia2,0.12,0.88,-3,8.33,1.14
Deportivo Cali,8,1,4,3,7,13,-6,7,colombia2,0.12,0.88,-6,8.33,1.14
La Equidad,8,1,3,4,7,13,-6,6,colombia2,0.12,0.88,-6,8.33,1.14
Patriotas,8,1,1,6,8,18,-10,4,colombia2,0.12,0.88,-10,8.33,1.14
Jaguares de C.,8,1,1,6,4,15,-11,4,colombia2,0.12,0.88,-11,8.33,1.14
Boyaca Chico,8,1,0,7,5,20,-15,3,colombia2,0.12,0.88,-15,8.33,1.14
A. Petrolera,8,0,2,6,4,13,-9,2,colombia2,0.0,1.0,-9,0.0,1.0
Envigado,8,0,1,7,2,15,-13,1,colombia2,0.0,1.0,-13,0.0,1.0
San Carlos,8,5,1,2,19,17,2,16,costarica,0.62,0.38,2,1.61,2.63
Saprissa,8,4,2,2,10,7,3,14,costarica,0.5,0.5,3,2.0,2.0
Alajuelense,8,3,3,2,10,9,1,12,costarica,0.38,0.62,1,2.63,1.61
Herediano,8,3,2,3,11,11,0,11,costarica,0.38,0.62,0,2.63,1.61
Santos Guapiles,8,1,4,3,11,13,-2,7,costarica,0.12,0.88,-2,8.33,1.14
M. Liberia,8,2,1,5,10,14,-4,7,costarica,0.25,0.75,-4,4.0,1.33
Zeledon,8,1,4,3,6,11,-5,7,costarica,0.12,0.88,-5,8.33,1.14
Santa Ana,8,2,0,6,8,12,-4,6,costarica,0.25,0.75,-4,4.0,1.33
Guanacasteca,8,1,3,4,6,15,-9,6,costarica,0.12,0.88,-9,8.33,1.14
Cartagines,8,1,1,6,8,17,-9,4,costarica,0.12,0.88,-9,8.33,1.14
Puntarenas,8,1,1,6,8,17,-9,4,costarica,0.12,0.88,-9,8.33,1.14
Sporting SJ,8,0,1,7,3,12,-9,1,costarica,0.0,1.0,-9,0.0,1.0
Slavia Prague,8,7,1,0,17,3,14,22,czechrepublic,0.88,0.12,14,1.14,8.33
Banik Ostrava,8,4,3,1,13,10,3,15,czechrepublic,0.5,0.5,3,2.0,2.0
Sparta Prague,8,4,2,2,12,8,4,14,czechrepublic,0.5,0.5,4,2.0,2.0
Viktoria Plzen,8,4,2,2,10,7,3,14,czechrepublic,0.5,0.5,3,2.0,2.0
Mlada Boleslav,8,3,3,2,14,10,4,12,czechrepublic,0.38,0.62,4,2.63,1.61
Bohemians,8,3,3,2,9,8,1,12,czechrepublic,0.38,0.62,1,2.63,1.61
Jablonec,8,3,2,3,11,7,4,11,czechrepublic,0.38,0.62,4,2.63,1.61
Slovacko,8,3,2,3,11,15,-4,11,czechrepublic,0.38,0.62,-4,2.63,1.61
Hradec Kralove,8,2,2,4,6,8,-2,8,czechrepublic,0.25,0.75,-2,4.0,1.33
Teplice,8,2,2,4,7,12,-5,8,czechrepublic,0.25,0.75,-5,4.0,1.33
Slovan Liberec,8,2,1,5,10,10,0,7,czechrepublic,0.25,0.75,0,4.0,1.33
Karvina,8,2,1,5,9,20,-11,7,czechrepublic,0.25,0.75,-11,4.0,1.33
Sigma Olomouc,8,1,3,4,9,13,-4,6,czechrepublic,0.12,0.88,-4,8.33,1.14
Pardubice,8,0,3,5,4,13,-9,3,czechrepublic,0.0,1.0,-9,0.0,1.0
Dukla Praha,8,0,2,6,4,18,-14,2,czechrepublic,0.0,1.0,-14,0.0,1.0
C. Budejovice,8,0,1,7,4,27,-23,1,czechrepublic,0.0,1.0,-23,0.0,1.0
Randers FC,8,3,4,1,14,9,5,13,denmark,0.38,0.62,5,2.63,1.61
FC Kobenhavn,8,3,3,2,12,9,3,12,denmark,0.38,0.62,3,2.63,1.61
Brondby IF,8,3,2,3,18,14,4,11,denmark,0.38,0.62,4,2.63,1.61
FC Midtjylland,8,3,2,3,14,12,2,11,denmark,0.38,0.62,2,2.63,1.61
Silkeborg,8,2,4,2,12,10,2,10,denmark,0.25,0.75,2,4.0,1.33
AGF Aarhus,8,2,3,3,9,8,1,9,denmark,0.25,0.75,1,4.0,1.33
Viborg,8,1,4,3,12,11,1,7,denmark,0.12,0.88,1,8.33,1.14
Nordsjaelland,8,2,1,5,12,20,-8,7,denmark,0.25,0.75,-8,4.0,1.33
SonderjyskE,8,2,1,5,9,18,-9,7,denmark,0.25,0.75,-9,4.0,1.33
Aalborg BK,8,1,3,4,8,13,-5,6,denmark,0.12,0.88,-5,8.33,1.14
Lyngby,8,0,3,5,6,12,-6,3,denmark,0.0,1.0,-6,0.0,1.0
Vejle BK,8,0,1,7,7,20,-13,1,denmark,0.0,1.0,-13,0.0,1.0
Odense BK,8,6,2,0,24,7,17,20,denmark2,0.75,0.25,17,1.33,4.0
Fredericia,8,6,0,2,21,8,13,18,denmark2,0.75,0.25,13,1.33,4.0
Kolding IF,8,4,1,3,7,4,3,13,denmark2,0.5,0.5,3,2.0,2.0
AC Horsens,8,4,1,3,13,12,1,13,denmark2,0.5,0.5,1,2.0,2.0
Esbjerg,8,4,0,4,13,14,-1,12,denmark2,0.5,0.5,-1,2.0,2.0
Hillerod,8,2,4,2,12,8,4,10,denmark2,0.25,0.75,4,4.0,1.33
Hobro,8,3,1,4,11,12,-1,10,denmark2,0.38,0.62,-1,2.63,1.61
B 93,8,3,1,4,13,18,-5,10,denmark2,0.38,0.62,-5,2.63,1.61
HB Koge,8,2,3,3,11,12,-1,9,denmark2,0.25,0.75,-1,4.0,1.33
Vendsyssel,8,2,3,3,9,12,-3,9,denmark2,0.25,0.75,-3,4.0,1.33
Hvidovre,8,2,1,5,4,9,-5,7,denmark2,0.25,0.75,-5,4.0,1.33
Roskilde,8,1,1,6,6,16,-10,4,denmark2,0.12,0.88,-10,8.33,1.14
I. del Valle,7,4,3,0,8,4,4,15,ecuador,0.57,0.43,4,1.75,2.33
Barcelona SC,8,4,2,2,11,7,4,14,ecuador,0.5,0.5,4,2.0,2.0
LDU Quito,8,4,2,2,12,10,2,14,ecuador,0.5,0.5,2,2.0,2.0
Aucas,7,3,3,1,11,8,3,12,ecuador,0.43,0.57,3,2.33,1.75
Emelec,7,3,3,1,10,9,1,12,ecuador,0.43,0.57,1,2.33,1.75
El Nacional,8,4,0,4,9,10,-1,12,ecuador,0.5,0.5,-1,2.0,2.0
Macara,8,2,3,3,6,9,-3,9,ecuador,0.25,0.75,-3,4.0,1.33
U. Catolica,7,2,2,3,10,10,0,8,ecuador,0.29,0.71,0,3.45,1.41
Orense,8,1,3,4,3,10,-7,6,ecuador,0.12,0.88,-7,8.33,1.14
Imbabura,8,1,2,5,7,21,-14,5,ecuador,0.12,0.88,-14,8.33,1.14
D. Cuenca,7,0,3,4,6,13,-7,3,ecuador,0.0,1.0,-7,0.0,1.0
Mushuc Runa,7,0,3,4,4,12,-8,3,ecuador,0.0,1.0,-8,0.0,1.0
Tecnico U.,7,1,0,6,5,14,-9,3,ecuador,0.14,0.86,-9,7.14,1.16
Libertad,8,0,3,5,4,15,-11,3,ecuador,0.0,1.0,-11,0.0,1.0
Cumbaya,8,0,1,7,2,14,-12,1,ecuador,0.0,1.0,-12,0.0,1.0
Delfin,7,0,1,6,1,14,-13,1,ecuador,0.0,1.0,-13,0.0,1.0
Guayaquil City,8,3,3,2,7,6,1,12,ecuador3,0.38,0.62,1,2.63,1.61
Manta,8,3,3,2,7,8,-1,12,ecuador3,0.38,0.62,-1,2.63,1.61
San Antonio,8,2,5,1,4,3,1,11,ecuador3,0.25,0.75,1,4.0,1.33
I. Juniors,8,2,4,2,9,8,1,10,ecuador3,0.25,0.75,1,4.0,1.33
Cuniburo,8,2,3,3,17,12,5,9,ecuador3,0.25,0.75,5,4.0,1.33
Leones Norte,8,2,2,4,5,7,-2,8,ecuador3,0.25,0.75,-2,4.0,1.33
Gualaceo,8,2,1,5,5,12,-7,7,ecuador3,0.25,0.75,-7,4.0,1.33
Nueve Octubre,8,1,2,5,6,12,-6,5,ecuador3,0.12,0.88,-6,8.33,1.14
Vargas Torres,8,0,3,5,3,16,-13,3,ecuador3,0.0,1.0,-13,0.0,1.0
Chacaritas,8,0,2,6,5,18,-13,2,ecuador3,0.0,1.0,-13,0.0,1.0
Zamalek,2,2,0,0,6,0,6,6,egypt,1.0,0.0,6,1.0,0.0
Al Masry,2,2,0,0,3,0,3,6,egypt,1.0,0.0,3,1.0,0.0
El Geish,2,2,0,0,4,2,2,6,egypt,1.0,0.0,2,1.0,0.0
Smouha,2,1,1,0,3,1,2,4,egypt,0.5,0.5,2,2.0,2.0
Al Ittihad,2,1,1,0,2,1,1,4,egypt,0.5,0.5,1,2.0,2.0
Pharco,2,1,1,0,2,1,1,4,egypt,0.5,0.5,1,2.0,2.0
Al Ahly,2,1,1,0,1,0,1,4,egypt,0.5,0.5,1,2.0,2.0
Ghazl El M.,2,1,1,0,1,0,1,4,egypt,0.5,0.5,1,2.0,2.0
Pyramids FC,2,1,0,1,2,2,0,3,egypt,0.5,0.5,0,2.0,2.0
El Gouna,2,0,2,0,0,0,0,2,egypt,0.0,1.0,0,0.0,1.0
ZED FC,2,0,2,0,0,0,0,2,egypt,0.0,1.0,0,0.0,1.0
ENPPI,2,0,1,1,3,4,-1,1,egypt,0.0,1.0,-1,0.0,1.0
Petrojet,2,0,1,1,1,2,-1,1,egypt,0.0,1.0,-1,0.0,1.0
Ceramica C.,2,0,1,1,2,5,-3,1,egypt,0.0,1.0,-3,0.0,1.0
Modern Sport,2,0,1,1,2,5,-3,1,egypt,0.0,1.0,-3,0.0,1.0
Ismaily,2,0,0,2,0,2,-2,0,egypt,0.0,1.0,-2,0.0,1.0
National Bank,2,0,0,2,3,6,-3,0,egypt,0.0,1.0,-3,0.0,1.0
Haras El Hodood,2,0,0,2,0,3,-3,0,egypt,0.0,1.0,-3,0.0,1.0
Chelsea,8,6,1,1,23,10,13,19,england,0.75,0.25,13,1.33,4.0
Liverpool,7,5,2,0,16,8,8,17,england,0.71,0.29,8,1.41,3.45
Nottm Forest,8,4,2,2,11,12,-1,14,england,0.5,0.5,-1,2.0,2.0
Arsenal,8,3,3,2,12,9,3,12,england,0.38,0.62,3,2.63,1.61
Manchester City,8,3,2,3,12,11,1,11,england,0.38,0.62,1,2.63,1.61
Brighton,8,3,2,3,13,13,0,11,england,0.38,0.62,0,2.63,1.61
Bournemouth,8,3,2,3,13,14,-1,11,england,0.38,0.62,-1,2.63,1.61
Aston Villa,7,3,1,3,10,14,-4,10,england,0.43,0.57,-4,2.33,1.75
Fulham,7,2,3,2,8,7,1,9,england,0.29,0.71,1,3.45,1.41
Newcastle Utd,8,2,3,3,11,13,-2,9,england,0.25,0.75,-2,4.0,1.33
West Ham Utd,7,2,2,3,8,12,-4,8,england,0.29,0.71,-4,3.45,1.41
Tottenham,7,2,1,4,11,8,3,7,england,0.29,0.71,3,3.45,1.41
Manchester Utd,7,1,3,3,6,7,-1,6,england,0.14,0.86,-1,7.14,1.16
Crystal Palace,7,1,3,3,8,10,-2,6,england,0.14,0.86,-2,7.14,1.16
Ipswich Town,7,1,2,4,8,15,-7,5,england,0.14,0.86,-7,7.14,1.16
Wolverhampton,8,1,2,5,12,20,-8,5,england,0.12,0.88,-8,8.33,1.14
Leicester City,7,1,2,4,10,18,-8,5,england,0.14,0.86,-8,7.14,1.16
Everton,7,1,2,4,5,13,-8,5,england,0.14,0.86,-8,7.14,1.16
Brentford,7,0,1,6,5,14,-9,1,england,0.0,1.0,-9,0.0,1.0
Southampton,8,0,1,7,4,15,-11,1,england,0.0,1.0,-11,0.0,1.0
Burnley,8,4,3,1,7,2,5,15,england2,0.5,0.5,5,2.0,2.0
Middlesbrough,8,4,2,2,18,10,8,14,england2,0.5,0.5,8,2.0,2.0
Sheffield Wed,8,4,1,3,9,9,0,13,england2,0.5,0.5,0,2.0,2.0
Leeds Utd,8,3,3,2,11,8,3,12,england2,0.38,0.62,3,2.63,1.61
Sheffield Utd,8,3,3,2,10,8,2,12,england2,0.38,0.62,2,2.63,1.61
West Brom,8,2,5,1,10,7,3,11,england2,0.25,0.75,3,4.0,1.33
Swansea City,8,3,2,3,7,7,0,11,england2,0.38,0.62,0,2.63,1.61
Bristol City,8,3,2,3,10,11,-1,11,england2,0.38,0.62,-1,2.63,1.61
Blackburn,8,3,2,3,7,8,-1,11,england2,0.38,0.62,-1,2.63,1.61
Sunderland,8,2,3,3,7,8,-1,9,england2,0.25,0.75,-1,4.0,1.33
Coventry City,8,2,3,3,8,10,-2,9,england2,0.25,0.75,-2,4.0,1.33
QP Rangers,8,2,3,3,5,8,-3,9,england2,0.25,0.75,-3,4.0,1.33
Millwall,8,1,5,2,7,8,-1,8,england2,0.12,0.88,-1,8.33,1.14
Stoke City,8,2,2,4,5,8,-3,8,england2,0.25,0.75,-3,4.0,1.33
Hull City,8,2,1,5,8,14,-6,7,england2,0.25,0.75,-6,4.0,1.33
Derby County,8,1,3,4,6,11,-5,6,england2,0.12,0.88,-5,8.33,1.14
Norwich City,8,1,3,4,9,15,-6,6,england2,0.12,0.88,-6,8.33,1.14
Portsmouth,8,1,3,4,9,17,-8,6,england2,0.12,0.88,-8,8.33,1.14
Cardiff City,8,0,5,3,6,11,-5,5,england2,0.0,1.0,-5,0.0,1.0
Preston,8,0,5,3,8,14,-6,5,england2,0.0,1.0,-6,0.0,1.0
Watford,8,1,1,6,10,18,-8,4,england2,0.12,0.88,-8,8.33,1.14
Luton Town,8,1,0,7,7,21,-14,3,england2,0.12,0.88,-14,8.33,1.14
Oxford Utd,8,0,2,6,7,16,-9,2,england2,0.0,1.0,-9,0.0,1.0
Plymouth,8,0,1,7,2,22,-20,1,england2,0.0,1.0,-20,0.0,1.0
Wycombe,8,6,2,0,20,10,10,20,england3,0.75,0.25,10,1.33,4.0
Birmingham City,8,5,1,2,14,8,6,16,england3,0.62,0.38,6,1.61,2.63
Barnsley,8,4,1,3,10,9,1,13,england3,0.5,0.5,1,2.0,2.0
Bolton,8,4,1,3,13,14,-1,13,england3,0.5,0.5,-1,2.0,2.0
Mansfield,8,4,0,4,10,11,-1,12,england3,0.5,0.5,-1,2.0,2.0
Blackpool,8,4,0,4,10,14,-4,12,england3,0.5,0.5,-4,2.0,2.0
Huddersfield,8,3,2,3,12,8,4,11,england3,0.38,0.62,4,2.63,1.61
Wrexham,8,3,2,3,7,7,0,11,england3,0.38,0.62,0,2.63,1.61
Stockport,8,2,4,2,10,8,2,10,england3,0.25,0.75,2,4.0,1.33
Leyton Orient,8,3,1,4,8,10,-2,10,england3,0.38,0.62,-2,2.63,1.61
Exeter City,8,3,1,4,6,9,-3,10,england3,0.38,0.62,-3,2.63,1.61
Wigan Athletic,8,2,3,3,8,7,1,9,england3,0.25,0.75,1,4.0,1.33
Reading,8,2,3,3,12,17,-5,9,england3,0.25,0.75,-5,4.0,1.33
Charlton,8,2,2,4,7,9,-2,8,england3,0.25,0.75,-2,4.0,1.33
Lincoln City,8,1,4,3,6,9,-3,7,england3,0.12,0.88,-3,8.33,1.14
Peterborough,8,2,1,5,12,16,-4,7,england3,0.25,0.75,-4,4.0,1.33
Northampton,8,1,3,4,8,13,-5,6,england3,0.12,0.88,-5,8.33,1.14
Rotherham,8,1,3,4,6,11,-5,6,england3,0.12,0.88,-5,8.33,1.14
Burton Albion,8,1,3,4,8,14,-6,6,england3,0.12,0.88,-6,8.33,1.14
Bristol Rovers,8,2,0,6,8,15,-7,6,england3,0.25,0.75,-7,4.0,1.33
Stevenage,7,1,2,4,3,8,-5,5,england3,0.14,0.86,-5,7.14,1.16
Crawley Town,8,1,2,5,4,12,-8,5,england3,0.12,0.88,-8,8.33,1.14
Shrewsbury,8,1,1,6,9,18,-9,4,england3,0.12,0.88,-9,8.33,1.14
Cambridge Utd,8,1,1,6,5,16,-11,4,england3,0.12,0.88,-11,8.33,1.14
Grimsby,8,6,1,1,12,5,7,19,england4,0.75,0.25,7,1.33,4.0
Doncaster,8,5,2,1,15,9,6,17,england4,0.62,0.38,6,1.61,2.63
Port Vale,8,5,2,1,11,5,6,17,england4,0.62,0.38,6,1.61,2.63
Walsall,8,4,2,2,10,5,5,14,england4,0.5,0.5,5,2.0,2.0
AFC Wimbledon,8,4,1,3,11,6,5,13,england4,0.5,0.5,5,2.0,2.0
Crewe Alexandra,8,3,4,1,9,7,2,13,england4,0.38,0.62,2,2.63,1.61
Fleetwood,8,3,2,3,15,13,2,11,england4,0.38,0.62,2,2.63,1.61
Morecambe,8,3,2,3,11,13,-2,11,england4,0.38,0.62,-2,2.63,1.61
Chesterfield,8,3,1,4,14,11,3,10,england4,0.38,0.62,3,2.63,1.61
Milton Keynes,7,3,1,3,12,10,2,10,england4,0.43,0.57,2,2.33,1.75
Notts County,8,2,4,2,13,12,1,10,england4,0.25,0.75,1,4.0,1.33
Bromley,8,2,4,2,8,9,-1,10,england4,0.25,0.75,-1,4.0,1.33
Colchester Utd,8,1,6,1,8,11,-3,9,england4,0.12,0.88,-3,8.33,1.14
Cheltenham,8,2,2,4,11,13,-2,8,england4,0.25,0.75,-2,4.0,1.33
Salford City,8,1,5,2,8,10,-2,8,england4,0.12,0.88,-2,8.33,1.14
Barrow,8,2,2,4,5,8,-3,8,england4,0.25,0.75,-3,4.0,1.33
Gillingham,8,2,2,4,5,8,-3,8,england4,0.25,0.75,-3,4.0,1.33
Harrogate,8,2,2,4,4,9,-5,8,england4,0.25,0.75,-5,4.0,1.33
Carlisle Utd,8,2,2,4,6,13,-7,8,england4,0.25,0.75,-7,4.0,1.33
Bradford,8,1,4,3,8,9,-1,7,england4,0.12,0.88,-1,8.33,1.14
Accrington,8,2,1,5,12,17,-5,7,england4,0.25,0.75,-5,4.0,1.33
Tranmere,8,2,1,5,6,16,-10,7,england4,0.25,0.75,-10,4.0,1.33
Swindon Town,8,1,3,4,10,17,-7,6,england4,0.12,0.88,-7,8.33,1.14
Newport,8,1,2,5,6,14,-8,5,england4,0.12,0.88,-8,8.33,1.14
Forest Green,8,5,2,1,15,7,8,17,england5,0.62,0.38,8,1.61,2.63
Solihull Moors,8,5,1,2,14,6,8,16,england5,0.62,0.38,8,1.61,2.63
York City,8,4,2,2,10,7,3,14,england5,0.5,0.5,3,2.0,2.0
Yeovil Town,8,4,2,2,10,8,2,14,england5,0.5,0.5,2,2.0,2.0
Halifax Town,8,4,2,2,6,4,2,14,england5,0.5,0.5,2,2.0,2.0
Oldham,8,3,4,1,13,11,2,13,england5,0.38,0.62,2,2.63,1.61
Rochdale,8,4,1,3,12,10,2,13,england5,0.5,0.5,2,2.0,2.0
Barnet,8,4,1,3,14,13,1,13,england5,0.5,0.5,1,2.0,2.0
Sutton Utd,8,4,1,3,12,12,0,13,england5,0.5,0.5,0,2.0,2.0
Southend Utd,8,3,3,2,9,7,2,12,england5,0.38,0.62,2,2.63,1.61
Gateshead FC,8,3,2,3,15,17,-2,11,england5,0.38,0.62,-2,2.63,1.61
Maidenhead Utd,8,3,0,5,12,18,-6,9,england5,0.38,0.62,-6,2.63,1.61
Altrincham,8,2,2,4,13,12,1,8,england5,0.25,0.75,1,4.0,1.33
Wealdstone,8,1,5,2,10,10,0,8,england5,0.12,0.88,0,8.33,1.14
Hartlepool,8,2,2,4,13,16,-3,8,england5,0.25,0.75,-3,4.0,1.33
Tamworth,8,2,1,5,6,19,-13,7,england5,0.25,0.75,-13,4.0,1.33
Dagenham & R.,8,1,3,4,7,10,-3,6,england5,0.12,0.88,-3,8.33,1.14
Eastleigh,8,1,3,4,6,11,-5,6,england5,0.12,0.88,-5,8.33,1.14
Boston Utd,8,1,3,4,7,13,-6,6,england5,0.12,0.88,-6,8.33,1.14
Aldershot Town,8,0,4,4,10,17,-7,4,england5,0.0,1.0,-7,0.0,1.0
Braintree Town,8,1,1,6,8,15,-7,4,england5,0.12,0.88,-7,8.33,1.14
Woking,8,0,3,5,6,14,-8,3,england5,0.0,1.0,-8,0.0,1.0
AFC Fylde,8,1,0,7,2,18,-16,3,england5,0.12,0.88,-16,8.33,1.14
Ebbsfleet Utd,8,0,2,6,7,20,-13,2,england5,0.0,1.0,-13,0.0,1.0
Paide,8,7,0,1,21,6,15,21,estonia,0.88,0.12,15,1.14,8.33
Levadia,8,6,0,2,16,6,10,18,estonia,0.75,0.25,10,1.33,4.0
Nomme Kalju,8,5,1,2,18,10,8,16,estonia,0.62,0.38,8,1.61,2.63
Narva Trans,8,4,3,1,15,10,5,15,estonia,0.5,0.5,5,2.0,2.0
Flora,8,3,1,4,13,15,-2,10,estonia,0.38,0.62,-2,2.63,1.61
Tammeka,8,3,1,4,9,14,-5,10,estonia,0.38,0.62,-5,2.63,1.61
Vaprus,8,2,1,5,6,11,-5,7,estonia,0.25,0.75,-5,4.0,1.33
Kuressaare,8,2,1,5,13,19,-6,7,estonia,0.25,0.75,-6,4.0,1.33
Nomme Utd,8,0,2,6,6,20,-14,2,estonia,0.0,1.0,-14,0.0,1.0
Tallinna Kalev,8,0,2,6,7,23,-16,2,estonia,0.0,1.0,-16,0.0,1.0
Harju JK,8,6,0,2,28,11,17,18,estonia2,0.75,0.25,17,1.33,4.0
Viimsi,8,5,1,2,14,11,3,16,estonia2,0.62,0.38,3,1.61,2.63
Flora B,8,4,2,2,22,17,5,14,estonia2,0.5,0.5,5,2.0,2.0
Tartu Welco,8,4,2,2,13,8,5,14,estonia2,0.5,0.5,5,2.0,2.0
Elva,8,3,2,3,12,11,1,11,estonia2,0.38,0.62,1,2.63,1.61
FC Tallinn,8,3,2,3,9,11,-2,11,estonia2,0.38,0.62,-2,2.63,1.61
Tallinna K. B,8,3,2,3,18,21,-3,11,estonia2,0.38,0.62,-3,2.63,1.61
Paide B,8,2,1,5,9,20,-11,7,estonia2,0.25,0.75,-11,4.0,1.33
Levadia B,8,1,0,7,7,23,-16,3,estonia2,0.12,0.88,-16,8.33,1.14
Tabasalu,8,0,1,7,9,27,-18,1,estonia2,0.0,1.0,-18,0.0,1.0
Vikingur,8,7,1,0,24,4,20,22,faroeislands,0.88,0.12,20,1.14,8.33
Klaksvik,8,7,0,1,17,7,10,21,faroeislands,0.88,0.12,10,1.14,8.33
B36 Torshavn,8,4,2,2,20,12,8,14,faroeislands,0.5,0.5,8,2.0,2.0
B68 Toftir,8,2,2,4,9,12,-3,8,faroeislands,0.25,0.75,-3,4.0,1.33
NSI Runavik,8,2,2,4,11,16,-5,8,faroeislands,0.25,0.75,-5,4.0,1.33
HB Torshavn,8,2,1,5,13,12,1,7,faroeislands,0.25,0.75,1,4.0,1.33
Streymur,8,2,0,6,6,16,-10,6,faroeislands,0.25,0.75,-10,4.0,1.33
07 Vestur,8,1,1,6,8,25,-17,4,faroeislands,0.12,0.88,-17,8.33,1.14
IF Fuglafjordur,8,0,1,7,8,24,-16,1,faroeislands,0.0,1.0,-16,0.0,1.0
Skala,8,0,1,7,2,20,-18,1,faroeislands,0.0,1.0,-18,0.0,1.0
Vikingur B,8,5,3,0,22,7,15,18,faroeislands2,0.62,0.38,15,1.61,2.63
TB Tvoroyri,8,3,5,0,9,5,4,14,faroeislands2,0.38,0.62,4,2.63,1.61
B71 Sandur,8,3,3,2,11,9,2,12,faroeislands2,0.38,0.62,2,2.63,1.61
Suduroy,8,2,5,1,17,13,4,11,faroeislands2,0.25,0.75,4,4.0,1.33
AB Argir,8,3,2,3,11,14,-3,11,faroeislands2,0.38,0.62,-3,2.63,1.61
B36 Torshavn B,8,3,1,4,16,15,1,10,faroeislands2,0.38,0.62,1,2.63,1.61
Hoyvik,8,2,4,2,9,10,-1,10,faroeislands2,0.25,0.75,-1,4.0,1.33
Klaksvik B,8,3,0,5,10,18,-8,9,faroeislands2,0.38,0.62,-8,2.63,1.61
NSI Runavik B,8,2,1,5,10,19,-9,7,faroeislands2,0.25,0.75,-9,4.0,1.33
HB T. B,8,1,1,6,6,26,-20,4,faroeislands2,0.12,0.88,-20,8.33,1.14
Ilves,8,4,2,2,12,8,4,14,finland,0.5,0.5,4,2.0,2.0
Inter Turku,8,4,1,3,12,4,8,13,finland,0.5,0.5,8,2.0,2.0
HJK Helsinki,8,4,1,3,14,9,5,13,finland,0.5,0.5,5,2.0,2.0
KuPS,8,4,1,3,11,10,1,13,finland,0.5,0.5,1,2.0,2.0
Haka,8,4,0,4,11,11,0,12,finland,0.5,0.5,0,2.0,2.0
SJK,8,3,2,3,13,13,0,11,finland,0.38,0.62,0,2.63,1.61
Gnistan,8,2,2,4,12,16,-4,8,finland,0.25,0.75,-4,4.0,1.33
Ekenas IF,8,2,2,4,6,18,-12,8,finland,0.25,0.75,-12,4.0,1.33
VPS,8,2,1,5,12,18,-6,7,finland,0.25,0.75,-6,4.0,1.33
Oulu,8,1,2,5,6,15,-9,5,finland,0.12,0.88,-9,8.33,1.14
Lahti,8,0,4,4,9,18,-9,4,finland,0.0,1.0,-9,0.0,1.0
Mariehamn,8,1,0,7,6,17,-11,3,finland,0.12,0.88,-11,8.33,1.14
KTP,8,5,1,2,24,12,12,16,finland2,0.62,0.38,12,1.61,2.63
JIPPO,8,5,0,3,15,8,7,15,finland2,0.62,0.38,7,1.61,2.63
Jaro,8,4,1,3,13,13,0,13,finland2,0.5,0.5,0,2.0,2.0
JaPS,8,4,1,3,15,19,-4,13,finland2,0.5,0.5,-4,2.0,2.0
SalPa,8,4,0,4,8,16,-8,12,finland2,0.5,0.5,-8,2.0,2.0
TPS,8,2,5,1,7,5,2,11,finland2,0.25,0.75,2,4.0,1.33
PK-35,8,2,3,3,8,11,-3,9,finland2,0.25,0.75,-3,4.0,1.33
Mikkelin,8,2,2,4,11,16,-5,8,finland2,0.25,0.75,-5,4.0,1.33
KaPa,8,2,1,5,19,26,-7,7,finland2,0.25,0.75,-7,4.0,1.33
SJK Akatemia,8,1,3,4,10,15,-5,6,finland2,0.12,0.88,-5,8.33,1.14
Marseille,8,7,0,1,23,7,16,21,france,0.88,0.12,16,1.14,8.33
Paris SG,7,4,3,0,16,6,10,15,france,0.57,0.43,10,1.75,2.33
Monaco,6,4,0,2,12,6,6,12,france,0.67,0.33,6,1.49,3.03
Lille,7,3,3,1,11,5,6,12,france,0.43,0.57,6,2.33,1.75
Lyon,7,3,3,1,11,6,5,12,france,0.43,0.57,5,2.33,1.75
Lens,7,3,3,1,9,5,4,12,france,0.43,0.57,4,2.33,1.75
Reims,7,3,2,2,11,7,4,11,france,0.43,0.57,4,2.33,1.75
Angers,7,2,3,2,5,6,-1,9,france,0.29,0.71,-1,3.45,1.41
Nice,7,2,2,3,8,10,-2,8,france,0.29,0.71,-2,3.45,1.41
Toulouse,7,2,1,4,7,10,-3,7,france,0.29,0.71,-3,3.45,1.41
Nantes,7,1,3,3,8,11,-3,6,france,0.14,0.86,-3,7.14,1.16
Le Havre,7,2,0,5,6,10,-4,6,france,0.29,0.71,-4,3.45,1.41
Auxerre,7,1,1,5,9,16,-7,4,france,0.14,0.86,-7,7.14,1.16
Brest,7,1,0,6,7,18,-11,3,france,0.14,0.86,-11,7.14,1.16
Strasbourg,7,0,2,5,11,19,-8,2,france,0.0,1.0,-8,0.0,1.0
Rennes,7,0,1,6,4,15,-11,1,france,0.0,1.0,-11,0.0,1.0
Saint-Etienne,7,0,1,6,4,25,-21,1,france,0.0,1.0,-21,0.0,1.0
Montpellier,7,0,0,7,3,19,-16,0,france,0.0,1.0,-16,0.0,1.0
Paris FC,8,5,2,1,12,3,9,17,france2,0.62,0.38,9,1.61,2.63
Laval,8,3,2,3,11,7,4,11,france2,0.38,0.62,4,2.63,1.61
Metz,7,3,1,3,8,8,0,10,france2,0.43,0.57,0,2.33,1.75
Rodez Aveyron,8,2,3,3,14,12,2,9,france2,0.25,0.75,2,4.0,1.33
Lorient,8,2,3,3,8,9,-1,9,france2,0.25,0.75,-1,4.0,1.33
Guingamp,7,3,0,4,6,11,-5,9,france2,0.43,0.57,-5,2.33,1.75
SC Bastia,8,1,5,2,6,8,-2,8,france2,0.12,0.88,-2,8.33,1.14
Annecy,8,1,5,2,10,14,-4,8,france2,0.12,0.88,-4,8.33,1.14
Martigues,6,2,2,2,7,13,-6,8,france2,0.33,0.67,-6,3.03,1.49
USL Dunkerque,7,2,1,4,9,13,-4,7,france2,0.29,0.71,-4,3.45,1.41
Troyes,8,2,1,5,6,11,-5,7,france2,0.25,0.75,-5,4.0,1.33
Clermont,7,2,1,4,3,9,-6,7,france2,0.29,0.71,-6,3.45,1.41
Red Star,8,2,1,5,8,16,-8,7,france2,0.25,0.75,-8,4.0,1.33
Amiens,8,2,0,6,8,15,-7,6,france2,0.25,0.75,-7,4.0,1.33
Pau FC,8,1,2,5,7,15,-8,5,france2,0.12,0.88,-8,8.33,1.14
Caen,7,1,1,5,7,11,-4,4,france2,0.14,0.86,-4,7.14,1.16
Grenoble,7,1,1,5,6,11,-5,4,france2,0.14,0.86,-5,7.14,1.16
AC Ajaccio,7,0,1,6,2,11,-9,1,france2,0.0,1.0,-9,0.0,1.0
Nancy,8,4,3,1,13,9,4,15,france3,0.5,0.5,4,2.0,2.0
Orleans,7,4,2,1,10,6,4,14,france3,0.57,0.43,4,1.75,2.33
Le Mans,8,4,1,3,10,9,1,13,france3,0.5,0.5,1,2.0,2.0
Bourg-en-Bresse,8,3,1,4,6,8,-2,10,france3,0.38,0.62,-2,2.63,1.61
Boulogne,7,3,1,3,7,11,-4,10,france3,0.43,0.57,-4,2.33,1.75
Paris 13 A.,7,2,2,3,8,10,-2,8,france3,0.29,0.71,-2,3.45,1.41
Dijon,7,2,2,3,5,7,-2,8,france3,0.29,0.71,-2,3.45,1.41
Sochaux,5,1,4,0,4,3,1,7,france3,0.2,0.8,1,5.0,1.25
Concarneau,6,2,1,3,9,12,-3,7,france3,0.33,0.67,-3,3.03,1.49
Quevilly Rouen,7,2,1,4,7,11,-4,7,france3,0.29,0.71,-4,3.45,1.41
Versailles,6,1,3,2,7,8,-1,6,france3,0.17,0.83,-1,5.88,1.2
Rouen,6,1,2,3,6,8,-2,5,france3,0.17,0.83,-2,5.88,1.2
Villefranche,6,0,4,2,5,8,-3,4,france3,0.0,1.0,-3,0.0,1.0
Aubagne,6,1,1,4,2,5,-3,4,france3,0.17,0.83,-3,5.88,1.2
Valenciennes,6,0,3,3,3,10,-7,3,france3,0.0,1.0,-7,0.0,1.0
Nimes,5,0,2,3,1,5,-4,2,france3,0.0,1.0,-4,0.0,1.0
Chateauroux,7,0,2,5,6,16,-10,2,france3,0.0,1.0,-10,0.0,1.0
Iberia,8,7,0,1,19,9,10,21,georgia,0.88,0.12,10,1.14,8.33
Dila Gori,8,4,2,2,18,8,10,14,georgia,0.5,0.5,10,2.0,2.0
Dinamo Batumi,8,4,1,3,10,11,-1,13,georgia,0.5,0.5,-1,2.0,2.0
Samgurali,8,1,5,2,8,8,0,8,georgia,0.12,0.88,0,8.33,1.14
Torpedo Kutaisi,8,2,2,4,10,13,-3,8,georgia,0.25,0.75,-3,4.0,1.33
Gagra,8,2,1,5,8,14,-6,7,georgia,0.25,0.75,-6,4.0,1.33
Kolkheti Poti,8,2,1,5,9,17,-8,7,georgia,0.25,0.75,-8,4.0,1.33
Dinamo Tbilisi,8,1,3,4,4,12,-8,6,georgia,0.12,0.88,-8,8.33,1.14
Samtredia,8,1,2,5,9,16,-7,5,georgia,0.12,0.88,-7,8.33,1.14
Telavi,8,0,3,5,5,14,-9,3,georgia,0.0,1.0,-9,0.0,1.0
Gareji Sagarejo,8,4,3,1,17,12,5,15,georgia2,0.5,0.5,5,2.0,2.0
L. Tbilisi,8,4,2,2,9,7,2,14,georgia2,0.5,0.5,2,2.0,2.0
Spaeri,8,4,1,3,13,7,6,13,georgia2,0.5,0.5,6,2.0,2.0
Aragvi Dusheti,8,4,0,4,11,11,0,12,georgia2,0.5,0.5,0,2.0,2.0
WIT Georgia,8,2,2,4,10,10,0,8,georgia2,0.25,0.75,0,4.0,1.33
Shturmi,8,2,2,4,9,13,-4,8,georgia2,0.25,0.75,-4,4.0,1.33
Rustavi,8,2,1,5,11,16,-5,7,georgia2,0.25,0.75,-5,4.0,1.33
Bolnisi,8,2,1,5,10,16,-6,7,georgia2,0.25,0.75,-6,4.0,1.33
D. Tbilisi B,8,1,2,5,4,17,-13,5,georgia2,0.12,0.88,-13,8.33,1.14
Kolkheti Khobi,8,1,0,7,6,26,-20,3,georgia2,0.12,0.88,-20,8.33,1.14
Bayern Munich,7,5,2,0,24,7,17,17,germany,0.71,0.29,17,1.41,3.45
Wolfsburg,6,4,1,1,16,7,9,13,germany,0.67,0.33,9,1.49,3.03
E. Frankfurt,7,4,1,2,15,10,5,13,germany,0.57,0.43,5,1.75,2.33
RB Leipzig,7,4,1,2,12,8,4,13,germany,0.57,0.43,4,1.75,2.33
Werder Bremen,7,4,1,2,14,13,1,13,germany,0.57,0.43,1,1.75,2.33
Leverkusen,6,3,3,0,13,8,5,12,germany,0.5,0.5,5,2.0,2.0
FSV Mainz,6,3,2,1,15,9,6,11,germany,0.5,0.5,6,2.0,2.0
Freiburg,7,2,2,3,6,10,-4,8,germany,0.29,0.71,-4,3.45,1.41
Sankt Pauli,7,2,0,5,8,10,-2,6,germany,0.29,0.71,-2,3.45,1.41
Stuttgart,6,1,3,2,8,12,-4,6,germany,0.17,0.83,-4,5.88,1.2
Heidenheim,7,2,0,5,12,17,-5,6,germany,0.29,0.71,-5,3.45,1.41
Monchengladbach,6,1,2,3,5,8,-3,5,germany,0.17,0.83,-3,5.88,1.2
Union Berlin,7,1,2,4,5,9,-4,5,germany,0.14,0.86,-4,7.14,1.16
Hoffenheim,6,0,3,3,3,8,-5,3,germany,0.0,1.0,-5,0.0,1.0
Holstein Kiel,6,0,2,4,9,14,-5,2,germany,0.0,1.0,-5,0.0,1.0
Dortmund,6,0,2,4,5,13,-8,2,germany,0.0,1.0,-8,0.0,1.0
FC Augsburg,6,0,2,4,4,17,-13,2,germany,0.0,1.0,-13,0.0,1.0
Bochum,7,0,0,7,6,20,-14,0,germany,0.0,1.0,-14,0.0,1.0
Magdeburg,8,6,1,1,17,9,8,19,germany2,0.75,0.25,8,1.33,4.0
Dusseldorf,7,5,1,1,13,5,8,16,germany2,0.71,0.29,8,1.41,3.45
Hertha Berlin,8,4,2,2,17,13,4,14,germany2,0.5,0.5,4,2.0,2.0
Kaiserslautern,8,4,2,2,11,8,3,14,germany2,0.5,0.5,3,2.0,2.0
FC Koln,7,4,2,1,11,10,1,14,germany2,0.57,0.43,1,1.75,2.33
Paderborn,8,3,4,1,14,13,1,13,germany2,0.38,0.62,1,2.63,1.61
Karlsruher SC,8,3,3,2,14,14,0,12,germany2,0.38,0.62,0,2.63,1.61
Darmstadt,7,3,2,2,18,17,1,11,germany2,0.43,0.57,1,2.33,1.75
Hamburger SV,7,3,1,3,13,12,1,10,germany2,0.43,0.57,1,2.33,1.75
Elversberg,7,2,3,2,9,6,3,9,germany2,0.29,0.71,3,3.45,1.41
Greuther Furth,7,2,3,2,13,11,2,9,germany2,0.29,0.71,2,3.45,1.41
Schalke 04,8,2,3,3,11,13,-2,9,germany2,0.25,0.75,-2,4.0,1.33
FC Nurnberg,8,2,2,4,13,13,0,8,germany2,0.25,0.75,0,4.0,1.33
Ulm,8,1,4,3,8,10,-2,7,germany2,0.12,0.88,-2,8.33,1.14
Preuss. Munster,7,1,3,3,9,12,-3,6,germany2,0.14,0.86,-3,7.14,1.16
Hannover 96,7,1,2,4,7,10,-3,5,germany2,0.14,0.86,-3,7.14,1.16
Braunschweig,8,0,2,6,6,25,-19,2,germany2,0.0,1.0,-19,0.0,1.0
Regensburg,7,0,1,6,3,22,-19,1,germany2,0.0,1.0,-19,0.0,1.0
1860 Munchen,8,5,2,1,15,10,5,17,germany3,0.62,0.38,5,1.61,2.63
Energie Cottbus,8,5,1,2,14,9,5,16,germany3,0.62,0.38,5,1.61,2.63
Dynamo Dresden,8,4,1,3,15,10,5,13,germany3,0.5,0.5,5,2.0,2.0
Saarbrucken,8,3,4,1,12,11,1,13,germany3,0.38,0.62,1,2.63,1.61
Hannover 96 B,8,3,2,3,11,8,3,11,germany3,0.38,0.62,3,2.63,1.61
Verl,8,3,2,3,15,13,2,11,germany3,0.38,0.62,2,2.63,1.61
Sandhausen,8,2,5,1,8,6,2,11,germany3,0.25,0.75,2,4.0,1.33
Wehen Wiesbaden,8,2,4,2,15,14,1,10,germany3,0.25,0.75,1,4.0,1.33
Erzgebirge Aue,8,3,1,4,8,12,-4,10,germany3,0.38,0.62,-4,2.63,1.61
Bielefeld,8,2,3,3,8,10,-2,9,germany3,0.25,0.75,-2,4.0,1.33
Alemannia A.,8,2,3,3,7,13,-6,9,germany3,0.25,0.75,-6,4.0,1.33
FC Ingolstadt,8,2,2,4,18,17,1,8,germany3,0.25,0.75,1,4.0,1.33
Viktoria Koln,8,2,1,5,8,12,-4,7,germany3,0.25,0.75,-4,4.0,1.33
Mannheim,8,1,4,3,5,10,-5,7,germany3,0.12,0.88,-5,8.33,1.14
Hansa Rostock,8,2,1,5,6,12,-6,7,germany3,0.25,0.75,-6,4.0,1.33
Dortmund B,8,1,2,5,14,21,-7,5,germany3,0.12,0.88,-7,8.33,1.14
RW Essen,8,1,2,5,9,16,-7,5,germany3,0.12,0.88,-7,8.33,1.14
Osnabruck,8,0,2,6,9,19,-10,2,germany3,0.0,1.0,-10,0.0,1.0
VfB Stuttgart B,8,0,2,6,5,17,-12,2,germany3,0.0,1.0,-12,0.0,1.0
Unterhaching,8,0,1,7,7,22,-15,1,germany3,0.0,1.0,-15,0.0,1.0
Nations,6,4,1,1,6,2,4,13,ghana,0.67,0.33,4,1.49,3.03
Hearts of Oak,6,3,2,1,5,3,2,11,ghana,0.5,0.5,2,2.0,2.0
Medeama,6,3,1,2,7,6,1,10,ghana,0.5,0.5,1,2.0,2.0
Asante Kotoko,6,2,2,2,6,5,1,8,ghana,0.33,0.67,1,3.03,1.49
Heart of Lions,6,1,4,1,4,4,0,7,ghana,0.17,0.83,0,5.88,1.2
Karela,6,2,1,3,3,3,0,7,ghana,0.33,0.67,0,3.03,1.49
Bibiani GS,6,1,4,1,3,4,-1,7,ghana,0.17,0.83,-1,5.88,1.2
Berekum Chelsea,6,1,3,2,2,3,-1,6,ghana,0.17,0.83,-1,5.88,1.2
Bechem Utd,6,1,3,2,5,7,-2,6,ghana,0.17,0.83,-2,5.88,1.2
Dreams,6,1,2,3,1,4,-3,5,ghana,0.17,0.83,-3,5.88,1.2
Young Apostles,6,1,2,3,2,6,-4,5,ghana,0.17,0.83,-4,5.88,1.2
Samartex,6,0,4,2,2,4,-2,4,ghana,0.0,1.0,-2,0.0,1.0
Holy Stars,6,1,1,4,4,8,-4,4,ghana,0.17,0.83,-4,5.88,1.2
Aduana Stars,6,0,4,2,2,6,-4,4,ghana,0.0,1.0,-4,0.0,1.0
Vision,6,1,1,4,3,8,-5,4,ghana,0.17,0.83,-5,5.88,1.2
Accra Lions,6,0,2,4,2,6,-4,2,ghana,0.0,1.0,-4,0.0,1.0
Legon Cities,6,0,1,5,4,13,-9,1,ghana,0.0,1.0,-9,0.0,1.0
Nsoatreman,6,0,1,5,2,11,-9,1,ghana,0.0,1.0,-9,0.0,1.0
Lincoln RI,7,6,1,0,24,1,23,19,gibraltar,0.86,0.14,23,1.16,7.14
Europa FC,7,6,1,0,20,6,14,19,gibraltar,0.86,0.14,14,1.16,7.14
St Josephs,7,5,2,0,18,5,13,17,gibraltar,0.71,0.29,13,1.41,3.45
Magpies,6,4,0,2,22,6,16,12,gibraltar,0.67,0.33,16,1.49,3.03
Manchester 62,6,3,1,2,11,7,4,10,gibraltar,0.5,0.5,4,2.0,2.0
Glacis Utd,6,2,0,4,8,15,-7,6,gibraltar,0.33,0.67,-7,3.03,1.49
Lions FC,6,1,2,3,9,9,0,5,gibraltar,0.17,0.83,0,5.88,1.2
College 1975,6,1,1,4,3,11,-8,4,gibraltar,0.17,0.83,-8,5.88,1.2
Mons Calpe,6,1,0,5,7,17,-10,3,gibraltar,0.17,0.83,-10,5.88,1.2
Europa Point,6,0,2,4,5,13,-8,2,gibraltar,0.0,1.0,-8,0.0,1.0
Lynx,7,0,1,6,7,18,-11,1,gibraltar,0.0,1.0,-11,0.0,1.0
PAOK,7,6,1,0,17,6,11,19,greece,0.86,0.14,11,1.16,7.14
Panathinaikos,7,4,2,1,7,5,2,14,greece,0.57,0.43,2,1.75,2.33
Olympiakos,7,4,1,2,11,5,6,13,greece,0.57,0.43,6,1.75,2.33
Panaitolikos,7,3,3,1,7,5,2,12,greece,0.43,0.57,2,2.33,1.75
Volos,7,4,0,3,7,9,-2,12,greece,0.57,0.43,-2,1.75,2.33
Atromitos,7,3,2,2,11,9,2,11,greece,0.43,0.57,2,2.33,1.75
OFI Crete,7,3,2,2,10,12,-2,11,greece,0.43,0.57,-2,2.33,1.75
AEK Athens,7,3,1,3,7,7,0,10,greece,0.43,0.57,0,2.33,1.75
Asteras T.,7,2,3,2,7,8,-1,9,greece,0.29,0.71,-1,3.45,1.41
Panserraikos,7,3,0,4,9,13,-4,9,greece,0.43,0.57,-4,2.33,1.75
Aris,7,2,2,3,7,11,-4,8,greece,0.29,0.71,-4,3.45,1.41
Levadiakos,7,1,3,3,11,13,-2,6,greece,0.14,0.86,-2,7.14,1.16
Lamia,7,1,3,3,6,10,-4,6,greece,0.14,0.86,-4,7.14,1.16
A. Kallithea,7,0,5,2,6,9,-3,5,greece,0.0,1.0,-3,0.0,1.0
Comunicaciones,8,3,2,3,11,12,-1,11,guatemala,0.38,0.62,-1,2.63,1.61
Xelaju,8,2,4,2,8,5,3,10,guatemala,0.25,0.75,3,4.0,1.33
Coban Imperial,8,3,1,4,8,8,0,10,guatemala,0.38,0.62,0,2.63,1.61
Municipal,8,2,4,2,5,10,-5,10,guatemala,0.25,0.75,-5,4.0,1.33
Malacateco,8,2,3,3,7,10,-3,9,guatemala,0.25,0.75,-3,4.0,1.33
Xinabajul,8,2,3,3,11,15,-4,9,guatemala,0.25,0.75,-4,4.0,1.33
Achuapa,8,2,2,4,5,10,-5,8,guatemala,0.25,0.75,-5,4.0,1.33
Mixco,8,2,1,5,8,16,-8,7,guatemala,0.25,0.75,-8,4.0,1.33
Antigua GFC,8,1,3,4,9,15,-6,6,guatemala,0.12,0.88,-6,8.33,1.14
Guastatoya,8,0,4,4,3,11,-8,4,guatemala,0.0,1.0,-8,0.0,1.0
Marquense,8,0,2,6,3,19,-16,2,guatemala,0.0,1.0,-16,0.0,1.0
Zacapa Tellioz,8,0,2,6,3,21,-18,2,guatemala,0.0,1.0,-18,0.0,1.0
Motagua,8,5,2,1,17,6,11,17,honduras,0.62,0.38,11,1.61,2.63
Olimpia,8,4,2,2,10,7,3,14,honduras,0.5,0.5,3,2.0,2.0
Real Espana,8,3,2,3,8,6,2,11,honduras,0.38,0.62,2,2.63,1.61
Marathon,8,3,2,3,8,10,-2,11,honduras,0.38,0.62,-2,2.63,1.61
Genesis,8,2,2,4,10,15,-5,8,honduras,0.25,0.75,-5,4.0,1.33
Olancho,8,1,4,3,6,12,-6,7,honduras,0.12,0.88,-6,8.33,1.14
Real Sociedad,8,1,3,4,11,19,-8,6,honduras,0.12,0.88,-8,8.33,1.14
UPNFM,8,1,2,5,4,16,-12,5,honduras,0.12,0.88,-12,8.33,1.14
Juticalpa,8,1,2,5,5,20,-15,5,honduras,0.12,0.88,-15,8.33,1.14
Victoria,8,0,2,6,8,18,-10,2,honduras,0.0,1.0,-10,0.0,1.0
Eastern,4,2,2,0,6,3,3,8,hongkong,0.5,0.5,3,2.0,2.0
Kowloon City,5,2,0,3,8,16,-8,6,hongkong,0.4,0.6,-8,2.5,1.67
Southern D.,4,1,2,1,7,7,0,5,hongkong,0.25,0.75,0,4.0,1.33
Kitchee,3,1,1,1,7,3,4,4,hongkong,0.33,0.67,4,3.03,1.49
Tai Po,2,1,1,0,4,1,3,4,hongkong,0.5,0.5,3,2.0,2.0
LM Warriors,3,1,1,1,4,4,0,4,hongkong,0.33,0.67,0,3.03,1.49
HK Rangers,7,1,1,5,7,21,-14,4,hongkong,0.14,0.86,-14,7.14,1.16
Hong Kong FC,4,0,0,4,2,13,-11,0,hongkong,0.0,1.0,-11,0.0,1.0
North District,5,0,0,5,3,15,-12,0,hongkong,0.0,1.0,-12,0.0,1.0
Puskas A.,8,5,0,3,14,10,4,15,hungary,0.62,0.38,4,1.61,2.63
DVTK,8,3,4,1,12,10,2,13,hungary,0.38,0.62,2,2.63,1.61
Ujpest,8,4,1,3,11,10,1,13,hungary,0.5,0.5,1,2.0,2.0
MTK Budapest,8,4,0,4,10,11,-1,12,hungary,0.5,0.5,-1,2.0,2.0
Ferencvaros,7,3,2,2,12,10,2,11,hungary,0.43,0.57,2,2.33,1.75
Gyor,8,2,4,2,11,9,2,10,hungary,0.25,0.75,2,4.0,1.33
Paks,8,2,2,4,14,15,-1,8,hungary,0.25,0.75,-1,4.0,1.33
Debrecen,8,1,2,5,9,15,-6,5,hungary,0.12,0.88,-6,8.33,1.14
Fehervar,8,1,2,5,6,16,-10,5,hungary,0.12,0.88,-10,8.33,1.14
Zalaegerszegi,8,0,4,4,8,13,-5,4,hungary,0.0,1.0,-5,0.0,1.0
Nyiregyhaza,8,1,1,6,6,14,-8,4,hungary,0.12,0.88,-8,8.33,1.14
Kecskemeti TE,8,1,1,6,7,17,-10,4,hungary,0.12,0.88,-10,8.33,1.14
BVSC,8,4,2,2,10,8,2,14,hungary2,0.5,0.5,2,2.0,2.0
Kazincbarcika,7,3,3,1,20,8,12,12,hungary2,0.43,0.57,12,2.33,1.75
Budafoki,7,3,3,1,13,11,2,12,hungary2,0.43,0.57,2,2.33,1.75
Kozarmisleny,6,3,2,1,10,7,3,11,hungary2,0.5,0.5,3,2.0,2.0
Szentlorinc,8,3,2,3,8,9,-1,11,hungary2,0.38,0.62,-1,2.63,1.61
Mezokovesd,7,3,1,3,9,9,0,10,hungary2,0.43,0.57,0,2.33,1.75
Kisvarda,8,3,1,4,11,14,-3,10,hungary2,0.38,0.62,-3,2.63,1.61
Vasas,7,3,0,4,10,11,-1,9,hungary2,0.43,0.57,-1,2.33,1.75
Szeged,8,1,5,2,4,5,-1,8,hungary2,0.12,0.88,-1,8.33,1.14
Ajka,6,2,1,3,9,13,-4,7,hungary2,0.33,0.67,-4,3.03,1.49
Soroksar,7,1,2,4,6,10,-4,5,hungary2,0.14,0.86,-4,7.14,1.16
Bekescsaba,8,1,2,5,3,8,-5,5,hungary2,0.12,0.88,-5,8.33,1.14
Tatabanya,6,1,1,4,5,9,-4,4,hungary2,0.17,0.83,-4,5.88,1.2
Honved,8,0,3,5,8,18,-10,3,hungary2,0.0,1.0,-10,0.0,1.0
Csakvari,6,0,2,4,5,12,-7,2,hungary2,0.0,1.0,-7,0.0,1.0
Gyirmot,8,0,2,6,11,20,-9,2,hungary2,0.0,1.0,-9,0.0,1.0
Vikingur R.,8,6,1,1,25,10,15,19,iceland,0.75,0.25,15,1.33,4.0
Breidablik,8,5,2,1,15,8,7,17,iceland,0.62,0.38,7,1.61,2.63
KA Akureyri,8,4,3,1,15,8,7,15,iceland,0.5,0.5,7,2.0,2.0
Stjarnan,8,2,4,2,14,11,3,10,iceland,0.25,0.75,3,4.0,1.33
Fylkir,8,2,2,4,7,14,-7,8,iceland,0.25,0.75,-7,4.0,1.33
KR Reykjavik,8,2,1,5,11,15,-4,7,iceland,0.25,0.75,-4,4.0,1.33
Hafnarfjordur,8,2,1,5,13,20,-7,7,iceland,0.25,0.75,-7,4.0,1.33
Valur,8,1,3,4,15,17,-2,6,iceland,0.12,0.88,-2,8.33,1.14
Vestri,8,1,3,4,12,15,-3,6,iceland,0.12,0.88,-3,8.33,1.14
IA Akranes,8,1,2,5,6,20,-14,5,iceland,0.12,0.88,-14,8.33,1.14
Fram,8,1,1,6,7,17,-10,4,iceland,0.12,0.88,-10,8.33,1.14
HK Kopavogur,8,0,1,7,10,32,-22,1,iceland,0.0,1.0,-22,0.0,1.0
Afturelding,8,6,0,2,20,12,8,18,iceland2,0.75,0.25,8,1.33,4.0
IBV,8,4,1,3,19,10,9,13,iceland2,0.5,0.5,9,2.0,2.0
Leiknir R.,8,3,2,3,12,12,0,11,iceland2,0.38,0.62,0,2.63,1.61
Thor Akureyri,8,3,1,4,12,15,-3,10,iceland2,0.38,0.62,-3,2.63,1.61
Keflavik,8,2,4,2,6,9,-3,10,iceland2,0.25,0.75,-3,4.0,1.33
Throttur R.,8,2,3,3,11,11,0,9,iceland2,0.25,0.75,0,4.0,1.33
Fjolnir,8,2,3,3,5,10,-5,9,iceland2,0.25,0.75,-5,4.0,1.33
IR Reykjavik,8,2,3,3,9,17,-8,9,iceland2,0.25,0.75,-8,4.0,1.33
Njardvik,8,1,5,2,11,14,-3,8,iceland2,0.12,0.88,-3,8.33,1.14
Grindavik,8,2,1,5,13,22,-9,7,iceland2,0.25,0.75,-9,4.0,1.33
Dalvik / Reynir,8,1,1,6,8,18,-10,4,iceland2,0.12,0.88,-10,8.33,1.14
Grotta,8,0,0,8,8,21,-13,0,iceland2,0.0,1.0,-13,0.0,1.0
Selfoss,8,7,0,1,16,8,8,21,iceland3,0.88,0.12,8,1.14,8.33
Throttur Vogar,8,5,2,1,26,14,12,17,iceland3,0.62,0.38,12,1.61,2.63
Volsungur,8,5,2,1,19,14,5,17,iceland3,0.62,0.38,5,1.61,2.63
Hottur/Huginn,8,4,1,3,19,24,-5,13,iceland3,0.5,0.5,-5,2.0,2.0
Fjardabyggd/L.,8,4,0,4,12,15,-3,12,iceland3,0.5,0.5,-3,2.0,2.0
KFG,8,3,2,3,12,12,0,11,iceland3,0.38,0.62,0,2.63,1.61
Haukar,8,3,1,4,11,15,-4,10,iceland3,0.38,0.62,-4,2.63,1.61
AEggir,8,2,2,4,9,16,-7,8,iceland3,0.25,0.75,-7,4.0,1.33
Kormakur/Hvot,8,2,2,4,5,16,-11,8,iceland3,0.25,0.75,-11,4.0,1.33
V. Olafsvik,8,1,3,4,14,18,-4,6,iceland3,0.12,0.88,-4,8.33,1.14
Reynir,8,2,0,6,14,22,-8,6,iceland3,0.25,0.75,-8,4.0,1.33
Fjallabyggd,8,0,1,7,5,23,-18,1,iceland3,0.0,1.0,-18,0.0,1.0
Goa,5,3,2,0,9,5,4,11,india,0.6,0.4,4,1.67,2.5
Mohun Bagan,5,3,1,1,7,4,3,10,india,0.6,0.4,3,1.67,2.5
Chennaiyin,7,3,1,3,13,12,1,10,india,0.43,0.57,1,2.33,1.75
NorthEast Utd,6,2,2,2,10,10,0,8,india,0.33,0.67,0,3.03,1.49
Bengaluru,5,2,1,2,7,9,-2,7,india,0.4,0.6,-2,2.5,1.67
Punjab,4,2,0,2,6,4,2,6,india,0.5,0.5,2,2.0,2.0
Mumbai City,5,1,3,1,7,7,0,6,india,0.2,0.8,0,5.0,1.25
Hyderabad,6,2,0,4,7,9,-2,6,india,0.33,0.67,-2,3.03,1.49
Kerala Blasters,5,1,2,2,9,12,-3,5,india,0.2,0.8,-3,5.0,1.25
Odisha FC,4,1,1,2,10,6,4,4,india,0.25,0.75,4,4.0,1.33
Mohammedan,5,1,1,3,2,8,-6,4,india,0.2,0.8,-6,5.0,1.25
East Bengal,5,1,0,4,4,7,-3,3,india,0.2,0.8,-3,5.0,1.25
Jamshedpur,4,1,0,3,3,11,-8,3,india,0.25,0.75,-8,4.0,1.33
Churchill B.,4,2,1,1,7,5,2,7,india2,0.5,0.5,2,2.0,2.0
Dempo,4,2,1,1,4,3,1,7,india2,0.5,0.5,1,2.0,2.0
Gokulam,2,1,1,0,4,3,1,4,india2,0.5,0.5,1,2.0,2.0
Delhi FC,4,1,1,2,3,7,-4,4,india2,0.25,0.75,-4,4.0,1.33
Rajasthan,4,1,0,3,4,13,-9,3,india2,0.25,0.75,-9,4.0,1.33
Inter Kashi,2,0,2,0,1,1,0,2,india2,0.0,1.0,0,0.0,1.0
Aizawl,2,0,1,1,2,4,-2,1,india2,0.0,1.0,-2,0.0,1.0
Namdhari,0,0,0,0,0,0,0,0,india2,,,0,,
Real Kashmir,0,0,0,0,0,0,0,0,india2,,,0,,
Shillong Lajong,0,0,0,0,0,0,0,0,india2,,,0,,
Sreenidi Deccan,0,0,0,0,0,0,0,0,india2,,,0,,
SC Bengaluru,2,0,0,2,0,3,-3,0,india2,0.0,1.0,-3,0.0,1.0
Arema,8,4,2,2,14,11,3,14,indonesia,0.5,0.5,3,2.0,2.0
Persebaya S.,6,4,1,1,5,3,2,13,indonesia,0.67,0.33,2,1.49,3.03
Persita,7,4,1,2,6,5,1,13,indonesia,0.57,0.43,1,1.75,2.33
Persik Kediri,6,3,2,1,9,7,2,11,indonesia,0.5,0.5,2,2.0,2.0
Persija,7,3,1,3,7,8,-1,10,indonesia,0.43,0.57,-1,2.33,1.75
Persib,5,2,3,0,8,5,3,9,indonesia,0.4,0.6,3,2.5,1.67
Bali Utd,6,3,0,3,8,7,1,9,indonesia,0.5,0.5,1,2.0,2.0
Malut United,7,2,3,2,7,7,0,9,indonesia,0.29,0.71,0,3.45,1.41
PSBS Biak N.,6,3,0,3,6,8,-2,9,indonesia,0.5,0.5,-2,2.0,2.0
Borneo,7,2,2,3,9,8,1,8,indonesia,0.29,0.71,1,3.45,1.41
PSIS Semarang,7,2,2,3,4,6,-2,8,indonesia,0.29,0.71,-2,3.45,1.41
Dewa Utd,7,1,4,2,10,6,4,7,indonesia,0.14,0.86,4,7.14,1.16
PSS Sleman,6,2,1,3,6,4,2,7,indonesia,0.33,0.67,2,3.03,1.49
PSM,5,1,4,0,6,5,1,7,indonesia,0.2,0.8,1,5.0,1.25
Barito Putera,6,1,2,3,5,9,-4,5,indonesia,0.17,0.83,-4,5.88,1.2
Semen Padang,6,0,1,5,4,10,-6,1,indonesia,0.0,1.0,-6,0.0,1.0
Madura Utd,7,0,1,6,5,17,-12,1,indonesia,0.0,1.0,-12,0.0,1.0
Persis Solo,7,0,1,6,2,15,-13,1,indonesia,0.0,1.0,-13,0.0,1.0
Tractor Sazi,6,6,0,0,13,1,12,18,iran,1.0,0.0,12,1.0,0.0
Foolad,6,4,0,2,7,7,0,12,iran,0.67,0.33,0,1.49,3.03
Sepahan,5,3,2,0,9,4,5,11,iran,0.6,0.4,5,1.67,2.5
Esteghlal,6,3,1,2,9,8,1,10,iran,0.5,0.5,1,2.0,2.0
Gol Gohar,6,2,3,1,3,1,2,9,iran,0.33,0.67,2,3.03,1.49
Zob Ahan,6,2,2,2,6,4,2,8,iran,0.33,0.67,2,3.03,1.49
Havadar,5,1,4,0,3,1,2,7,iran,0.2,0.8,2,5.0,1.25
Persepolis,4,2,1,1,3,2,1,7,iran,0.5,0.5,1,2.0,2.0
Malavan,5,1,3,1,7,6,1,6,iran,0.2,0.8,1,5.0,1.25
N. Mazandaran,5,1,3,1,3,3,0,6,iran,0.2,0.8,0,5.0,1.25
E. Khuzestan,5,1,2,2,3,5,-2,5,iran,0.2,0.8,-2,5.0,1.25
Mes Rafsanjan,5,1,1,3,3,5,-2,4,iran,0.2,0.8,-2,5.0,1.25
Aluminium Arak,6,1,1,4,5,8,-3,4,iran,0.17,0.83,-3,5.88,1.2
K. Khorramabad,5,1,1,3,2,5,-3,4,iran,0.2,0.8,-3,5.0,1.25
Chadormalu,6,1,1,4,4,9,-5,4,iran,0.17,0.83,-5,5.88,1.2
Shams A. Qazvin,6,1,1,4,2,9,-7,4,iran,0.17,0.83,-7,5.88,1.2
Al Naft,6,2,4,0,4,1,3,10,iraq,0.33,0.67,3,3.03,1.49
Al Shorta,3,3,0,0,9,0,9,9,iraq,1.0,0.0,9,1.0,0.0
Naft Maysan,5,3,0,2,7,7,0,9,iraq,0.6,0.4,0,1.67,2.5
Al Quwa Al J.,4,2,2,0,4,2,2,8,iraq,0.5,0.5,2,2.0,2.0
Zakho,5,2,2,1,4,3,1,8,iraq,0.4,0.6,1,2.5,1.67
Al-Karma,5,2,1,2,10,6,4,7,iraq,0.4,0.6,4,2.5,1.67
Al Kahrabaa,6,1,4,1,4,4,0,7,iraq,0.17,0.83,0,5.88,1.2
Al Najaf,5,1,3,1,4,4,0,6,iraq,0.2,0.8,0,5.0,1.25
Al Zawraa,5,1,3,1,2,2,0,6,iraq,0.2,0.8,0,5.0,1.25
Al Karkh,6,2,0,4,6,7,-1,6,iraq,0.33,0.67,-1,3.03,1.49
Duhok,2,1,1,0,3,2,1,4,iraq,0.5,0.5,1,2.0,2.0
Al-Qasim,4,1,1,2,3,4,-1,4,iraq,0.25,0.75,-1,4.0,1.33
Karbala,4,1,1,2,2,7,-5,4,iraq,0.25,0.75,-5,4.0,1.33
Erbil,5,1,1,3,3,11,-8,4,iraq,0.2,0.8,-8,5.0,1.25
Al Hudod,5,1,0,4,5,10,-5,3,iraq,0.2,0.8,-5,5.0,1.25
Naft Al-Basra,5,1,0,4,3,9,-6,3,iraq,0.2,0.8,-6,5.0,1.25
Newroz SC,4,0,2,2,2,4,-2,2,iraq,0.0,1.0,-2,0.0,1.0
Diala,5,0,2,3,5,10,-5,2,iraq,0.0,1.0,-5,0.0,1.0
Al Minaa Basra,4,0,1,3,2,5,-3,1,iraq,0.0,1.0,-3,0.0,1.0
Al Talaba,4,0,1,3,0,3,-3,1,iraq,0.0,1.0,-3,0.0,1.0
St. Patricks,8,5,2,1,14,6,8,17,ireland,0.62,0.38,8,1.61,2.63
Shamrock Rovers,8,4,1,3,9,9,0,13,ireland,0.5,0.5,0,2.0,2.0
Bohemians,8,2,5,1,10,7,3,11,ireland,0.25,0.75,3,4.0,1.33
Shelbourne,8,3,2,3,6,7,-1,11,ireland,0.38,0.62,-1,2.63,1.61
Derry City,8,3,1,4,7,7,0,10,ireland,0.38,0.62,0,2.63,1.61
Galway Utd,8,2,3,3,7,9,-2,9,ireland,0.25,0.75,-2,4.0,1.33
Waterford,8,2,0,6,7,15,-8,6,ireland,0.25,0.75,-8,4.0,1.33
Sligo Rovers,8,1,3,4,7,18,-11,6,ireland,0.12,0.88,-11,8.33,1.14
Drogheda Utd,8,1,2,5,7,19,-12,5,ireland,0.12,0.88,-12,8.33,1.14
Dundalk,8,0,4,4,5,9,-4,4,ireland,0.0,1.0,-4,0.0,1.0
Cork City,8,4,2,2,14,11,3,14,ireland2,0.5,0.5,3,2.0,2.0
Treaty Utd,8,4,2,2,12,10,2,14,ireland2,0.5,0.5,2,2.0,2.0
Wexford,8,4,1,3,13,18,-5,13,ireland2,0.5,0.5,-5,2.0,2.0
UC Dublin,8,3,3,2,9,9,0,12,ireland2,0.38,0.62,0,2.63,1.61
Athlone Town,8,3,2,3,8,9,-1,11,ireland2,0.38,0.62,-1,2.63,1.61
Bray Wanderers,8,2,3,3,7,10,-3,9,ireland2,0.25,0.75,-3,4.0,1.33
Cobh Ramblers,8,3,0,5,6,14,-8,9,ireland2,0.38,0.62,-8,2.63,1.61
Finn Harps,8,1,3,4,9,12,-3,6,ireland2,0.12,0.88,-3,8.33,1.14
Longford Town,8,1,1,6,8,16,-8,4,ireland2,0.12,0.88,-8,8.33,1.14
Kerry,8,0,3,5,7,17,-10,3,ireland2,0.0,1.0,-10,0.0,1.0
M. Tel Aviv,7,5,1,1,15,6,9,16,israel,0.71,0.29,9,1.41,3.45
Maccabi Haifa,8,4,2,2,17,10,7,14,israel,0.5,0.5,7,2.0,2.0
H. Beer Sheva,5,4,0,1,10,3,7,12,israel,0.8,0.2,7,1.25,5.0
Hapoel Haifa,8,3,2,3,7,6,1,11,israel,0.38,0.62,1,2.63,1.61
M. Bnei Raina,6,3,1,2,9,7,2,10,israel,0.5,0.5,2,2.0,2.0
B. Jerusalem,6,2,1,3,11,10,1,7,israel,0.33,0.67,1,3.03,1.49
Kiryat Shmona,6,2,1,3,4,6,-2,7,israel,0.33,0.67,-2,3.03,1.49
Maccabi Netanya,7,2,1,4,11,14,-3,7,israel,0.29,0.71,-3,3.45,1.41
M. Petah Tikva,6,2,1,3,4,12,-8,7,israel,0.33,0.67,-8,3.03,1.49
Ashdod,6,1,2,3,10,11,-1,5,israel,0.17,0.83,-1,5.88,1.2
Sakhnin,7,1,2,4,2,7,-5,5,israel,0.14,0.86,-5,7.14,1.16
Hapoel Hadera,6,0,4,2,8,11,-3,4,israel,0.0,1.0,-3,0.0,1.0
H. Jerusalem,5,1,0,4,4,11,-7,3,israel,0.2,0.8,-7,5.0,1.25
Ironi Tiberias,7,0,2,5,1,10,-9,2,israel,0.0,1.0,-9,0.0,1.0
H. Kfar Shalem,8,6,1,1,23,11,12,19,israel2,0.75,0.25,12,1.33,4.0
H. Ramat Gan,7,5,1,1,15,6,9,16,israel2,0.71,0.29,9,1.41,3.45
Hapoel Tel Aviv,8,4,3,1,15,11,4,15,israel2,0.5,0.5,4,2.0,2.0
H. Petah Tikva,6,4,2,0,11,5,6,14,israel2,0.67,0.33,6,1.49,3.03
H. Nof Hagalil,7,4,1,2,12,8,4,13,israel2,0.57,0.43,4,1.75,2.33
H. Kfar Saba,7,3,2,2,8,8,0,11,israel2,0.43,0.57,0,2.33,1.75
Hapoel Akko,8,3,1,4,9,14,-5,10,israel2,0.38,0.62,-5,2.63,1.61
Kafr Qasim,8,2,3,3,6,9,-3,9,israel2,0.25,0.75,-3,4.0,1.33
Bnei Yehuda,6,2,2,2,9,10,-1,8,israel2,0.33,0.67,-1,3.03,1.49
M. Herziliya,8,2,1,5,7,17,-10,7,israel2,0.25,0.75,-10,4.0,1.33
Ramat Hasharon,6,2,0,4,10,12,-2,6,israel2,0.33,0.67,-2,3.03,1.49
Hapoel Raanana,6,1,2,3,8,12,-4,5,israel2,0.17,0.83,-4,5.88,1.2
H. Ironi Rishon,6,1,1,4,9,13,-4,4,israel2,0.17,0.83,-4,5.88,1.2
Hapoel Afula,6,0,4,2,6,10,-4,4,israel2,0.0,1.0,-4,0.0,1.0
Maccabi Jaffa,6,0,2,4,4,11,-7,2,israel2,0.0,1.0,-7,0.0,1.0
H. Umm al-Fahm,8,0,2,6,6,16,-10,2,israel2,0.0,1.0,-10,0.0,1.0
Atalanta,8,5,1,2,16,8,8,16,italy,0.62,0.38,8,1.61,2.63
Inter Milan,6,4,2,0,15,5,10,14,italy,0.67,0.33,10,1.49,3.03
Fiorentina,7,4,2,1,13,4,9,14,italy,0.57,0.43,9,1.75,2.33
Napoli,7,4,2,1,9,4,5,14,italy,0.57,0.43,5,1.75,2.33
Juventus,7,3,4,0,13,5,8,13,italy,0.43,0.57,8,2.33,1.75
Lazio,8,4,0,4,13,11,2,12,italy,0.5,0.5,2,2.0,2.0
Empoli,8,3,3,2,12,10,2,12,italy,0.38,0.62,2,2.63,1.61
Bologna,8,3,3,2,13,15,-2,12,italy,0.38,0.62,-2,2.63,1.61
Genoa,6,3,0,3,5,10,-5,9,italy,0.5,0.5,-5,2.0,2.0
AC Milan,7,2,2,3,11,12,-1,8,italy,0.29,0.71,-1,3.45,1.41
Torino,8,2,2,4,10,13,-3,8,italy,0.25,0.75,-3,4.0,1.33
Udinese,8,2,2,4,10,14,-4,8,italy,0.25,0.75,-4,4.0,1.33
Monza,7,1,4,2,7,8,-1,7,italy,0.14,0.86,-1,7.14,1.16
Parma,7,1,4,2,9,11,-2,7,italy,0.14,0.86,-2,7.14,1.16
Como,8,1,3,4,8,12,-4,6,italy,0.12,0.88,-4,8.33,1.14
Cagliari,7,1,2,4,7,11,-4,5,italy,0.14,0.86,-4,7.14,1.16
AS Roma,7,0,4,3,5,11,-6,4,italy,0.0,1.0,-6,0.0,1.0
Lecce,8,1,1,6,2,12,-10,4,italy,0.12,0.88,-10,8.33,1.14
Hellas Verona,7,1,0,6,7,16,-9,3,italy,0.14,0.86,-9,7.14,1.16
Venezia,8,0,2,6,5,17,-12,2,italy,0.0,1.0,-12,0.0,1.0
Sassuolo,8,5,3,0,15,6,9,18,italy2,0.62,0.38,9,1.61,2.63
Pisa,8,5,1,2,14,9,5,16,italy2,0.62,0.38,5,1.61,2.63
Cremonese,8,4,1,3,16,10,6,13,italy2,0.5,0.5,6,2.0,2.0
Palermo,8,3,3,2,10,8,2,12,italy2,0.38,0.62,2,2.63,1.61
Spezia,8,2,5,1,9,6,3,11,italy2,0.25,0.75,3,4.0,1.33
Juve Stabia,8,2,5,1,8,8,0,11,italy2,0.25,0.75,0,4.0,1.33
Bari,7,2,4,1,8,4,4,10,italy2,0.29,0.71,4,3.45,1.41
Cosenza,7,2,4,1,10,9,1,10,italy2,0.29,0.71,1,3.45,1.41
Reggiana,8,2,3,3,7,8,-1,9,italy2,0.25,0.75,-1,4.0,1.33
Cittadella,8,3,0,5,6,18,-12,9,italy2,0.38,0.62,-12,2.63,1.61
Brescia,8,2,2,4,6,10,-4,8,italy2,0.25,0.75,-4,4.0,1.33
Sampdoria,8,2,2,4,13,18,-5,8,italy2,0.25,0.75,-5,4.0,1.33
Frosinone,8,2,2,4,5,11,-6,8,italy2,0.25,0.75,-6,4.0,1.33
Catanzaro,7,0,6,1,6,8,-2,6,italy2,0.0,1.0,-2,0.0,1.0
Salernitana,8,1,3,4,6,12,-6,6,italy2,0.12,0.88,-6,8.33,1.14
Sudtirol,8,2,0,6,6,13,-7,6,italy2,0.25,0.75,-7,4.0,1.33
Cesena,8,1,2,5,8,12,-4,5,italy2,0.12,0.88,-4,8.33,1.14
Modena,8,0,5,3,7,11,-4,5,italy2,0.0,1.0,-4,0.0,1.0
Carrarese,8,1,1,6,6,16,-10,4,italy2,0.12,0.88,-10,8.33,1.14
Mantova,8,0,3,5,7,14,-7,3,italy2,0.0,1.0,-7,0.0,1.0
Montego Bay,7,4,2,1,14,7,7,14,jamaica,0.57,0.43,7,1.75,2.33
Arnett Gardens,6,4,1,1,8,3,5,13,jamaica,0.67,0.33,5,1.49,3.03
Mount Pleasant,7,3,3,1,18,8,10,12,jamaica,0.43,0.57,10,2.33,1.75
Waterhouse,5,2,3,0,5,2,3,9,jamaica,0.4,0.6,3,2.5,1.67
Portmore Utd,5,2,2,1,7,6,1,8,jamaica,0.4,0.6,1,2.5,1.67
Cavalier,5,1,3,1,4,3,1,6,jamaica,0.2,0.8,1,5.0,1.25
Tivoli Gardens,7,1,2,4,8,11,-3,5,jamaica,0.14,0.86,-3,7.14,1.16
Humble Lions,5,1,2,2,3,6,-3,5,jamaica,0.2,0.8,-3,5.0,1.25
Vere Utd,7,1,2,4,6,10,-4,5,jamaica,0.14,0.86,-4,7.14,1.16
Harbour View,7,1,1,5,5,15,-10,4,jamaica,0.14,0.86,-10,7.14,1.16
Molynes Utd,7,1,1,5,4,19,-15,4,jamaica,0.14,0.86,-15,7.14,1.16
Chapelton,6,1,0,5,4,12,-8,3,jamaica,0.17,0.83,-8,5.88,1.2
Racing United,7,0,2,5,4,13,-9,2,jamaica,0.0,1.0,-9,0.0,1.0
Dunbeholden,7,0,1,6,4,16,-12,1,jamaica,0.0,1.0,-12,0.0,1.0
Shonan Bellmare,8,6,0,2,12,9,3,18,japan,0.75,0.25,3,1.33,4.0
Tokyo Verdy,8,4,3,1,9,4,5,15,japan,0.5,0.5,5,2.0,2.0
Vissel Kobe,8,4,3,1,13,11,2,15,japan,0.5,0.5,2,2.0,2.0
Kyoto Sanga,8,5,0,3,12,11,1,15,japan,0.62,0.38,1,1.61,2.63
Yokohama M.,8,5,0,3,16,19,-3,15,japan,0.62,0.38,-3,1.61,2.63
K. Frontale,8,4,2,2,17,13,4,14,japan,0.5,0.5,4,2.0,2.0
Gamba Osaka,8,3,4,1,12,9,3,13,japan,0.38,0.62,3,2.63,1.61
S. Hiroshima,8,4,1,3,13,13,0,13,japan,0.5,0.5,0,2.0,2.0
C. Sapporo,8,3,2,3,13,14,-1,11,japan,0.38,0.62,-1,2.63,1.61
Kashima Antlers,8,3,1,4,14,12,2,10,japan,0.38,0.62,2,2.63,1.61
FC Tokyo,8,3,1,4,10,12,-2,10,japan,0.38,0.62,-2,2.63,1.61
Machida Zelvia,8,2,3,3,7,8,-1,9,japan,0.25,0.75,-1,4.0,1.33
Albirex Niigata,8,2,3,3,5,12,-7,9,japan,0.25,0.75,-7,4.0,1.33
Nagoya G.,8,2,2,4,11,14,-3,8,japan,0.25,0.75,-3,4.0,1.33
Cerezo Osaka,8,2,2,4,6,14,-8,8,japan,0.25,0.75,-8,4.0,1.33
Urawa RD,8,1,4,3,5,7,-2,7,japan,0.12,0.88,-2,8.33,1.14
Jubilo Iwata,8,2,1,5,6,19,-13,7,japan,0.25,0.75,-13,4.0,1.33
Avispa Fukuoka,8,0,6,2,6,9,-3,6,japan,0.0,1.0,-3,0.0,1.0
Kashiwa Reysol,8,1,2,5,4,9,-5,5,japan,0.12,0.88,-5,8.33,1.14
Sagan Tosu,8,1,1,6,9,18,-9,4,japan,0.12,0.88,-9,8.33,1.14
M. Yamagata,8,7,1,0,18,5,13,22,japan2,0.88,0.12,13,1.14,8.33
Shimizu S-Pulse,8,5,1,2,13,10,3,16,japan2,0.62,0.38,3,1.61,2.63
Yokohama FC,8,4,3,1,15,9,6,15,japan2,0.5,0.5,6,2.0,2.0
R. Kumamoto,8,5,0,3,16,11,5,15,japan2,0.62,0.38,5,1.61,2.63
Iwaki,8,4,1,3,11,8,3,13,japan2,0.5,0.5,3,2.0,2.0
Tokushima V.,8,4,1,3,7,7,0,13,japan2,0.5,0.5,0,2.0,2.0
Mito Hollyhock,8,4,1,3,9,14,-5,13,japan2,0.5,0.5,-5,2.0,2.0
V-V. Nagasaki,8,3,3,2,11,10,1,12,japan2,0.38,0.62,1,2.63,1.61
Fagiano Okayama,8,2,4,2,10,10,0,10,japan2,0.25,0.75,0,4.0,1.33
Blaublitz Akita,8,3,1,4,5,8,-3,10,japan2,0.38,0.62,-3,2.63,1.61
JEF Utd Chiba,8,3,1,4,8,12,-4,10,japan2,0.38,0.62,-4,2.63,1.61
Vegalta Sendai,8,3,1,4,7,11,-4,10,japan2,0.38,0.62,-4,2.63,1.61
Fujieda MYFC,8,3,0,5,8,16,-8,9,japan2,0.38,0.62,-8,2.63,1.61
Ventforet Kofu,8,2,2,4,6,11,-5,8,japan2,0.25,0.75,-5,4.0,1.33
Tochigi SC,8,1,4,3,6,7,-1,7,japan2,0.12,0.88,-1,8.33,1.14
Oita Trinita,8,1,2,5,8,15,-7,5,japan2,0.12,0.88,-7,8.33,1.14
R. Yamaguchi,8,1,2,5,6,17,-11,5,japan2,0.12,0.88,-11,8.33,1.14
Ehime FC,8,1,2,5,6,18,-12,5,japan2,0.12,0.88,-12,8.33,1.14
Kusatsu,8,0,1,7,4,19,-15,1,japan2,0.0,1.0,-15,0.0,1.0
Kagoshima Utd,8,0,0,8,2,13,-11,0,japan2,0.0,1.0,-11,0.0,1.0
Al Faysali,8,8,0,0,26,4,22,24,jordan,1.0,0.0,22,1.0,0.0
Al Hussein,8,6,2,0,14,3,11,20,jordan,0.75,0.25,11,1.33,4.0
Al Ramtha,8,4,1,3,15,9,6,13,jordan,0.5,0.5,6,2.0,2.0
Al Ahli,8,4,1,3,5,10,-5,13,jordan,0.5,0.5,-5,2.0,2.0
Al Wihdat,8,2,4,2,8,7,1,10,jordan,0.25,0.75,1,4.0,1.33
Maan,8,3,0,5,7,9,-2,9,jordan,0.38,0.62,-2,2.63,1.61
Shabab Al Ordon,8,3,0,5,10,16,-6,9,jordan,0.38,0.62,-6,2.63,1.61
Aqaba,8,2,3,3,5,12,-7,9,jordan,0.25,0.75,-7,4.0,1.33
Al Salt,8,2,1,5,7,11,-4,7,jordan,0.25,0.75,-4,4.0,1.33
Moghayer Al S.,8,2,1,5,9,20,-11,7,jordan,0.25,0.75,-11,4.0,1.33
Sahab,8,1,1,6,6,16,-10,4,jordan,0.12,0.88,-10,8.33,1.14
Al Jalil,8,0,3,5,3,14,-11,3,jordan,0.0,1.0,-11,0.0,1.0
Kairat Almaty,8,5,1,2,12,6,6,16,kazakhstan,0.62,0.38,6,1.61,2.63
FC Astana,8,5,1,2,11,5,6,16,kazakhstan,0.62,0.38,6,1.61,2.63
Ordabasy,8,4,1,3,11,9,2,13,kazakhstan,0.5,0.5,2,2.0,2.0
Aktobe,8,3,3,2,10,11,-1,12,kazakhstan,0.38,0.62,-1,2.63,1.61
Tobol,8,3,2,3,13,11,2,11,kazakhstan,0.38,0.62,2,2.63,1.61
Atyrau,8,3,1,4,12,10,2,10,kazakhstan,0.38,0.62,2,2.63,1.61
Kaisar K.,8,2,2,4,8,10,-2,8,kazakhstan,0.25,0.75,-2,4.0,1.33
Kyzylzhar,8,2,2,4,6,9,-3,8,kazakhstan,0.25,0.75,-3,4.0,1.33
Zhenys,8,1,4,3,7,9,-2,7,kazakhstan,0.12,0.88,-2,8.33,1.14
Yelimay Semey,8,2,1,5,10,15,-5,7,kazakhstan,0.25,0.75,-5,4.0,1.33
Zhetysu,8,0,3,5,3,15,-12,3,kazakhstan,0.0,1.0,-12,0.0,1.0
Turan,8,0,2,6,3,21,-18,2,kazakhstan,0.0,1.0,-18,0.0,1.0
Aksu,0,0,0,0,0,0,0,0,kazakhstan,,,0,,
S. Karagandy,8,0,0,8,4,19,-15,0,kazakhstan,0.0,1.0,-15,0.0,1.0
Drita,8,4,3,1,10,6,4,15,kosovo,0.5,0.5,4,2.0,2.0
Malisheva,8,4,2,2,11,7,4,14,kosovo,0.5,0.5,4,2.0,2.0
Prishtina,8,3,1,4,10,11,-1,10,kosovo,0.38,0.62,-1,2.63,1.61
Ferizaj,8,2,3,3,6,11,-5,9,kosovo,0.25,0.75,-5,4.0,1.33
Ballkani,8,1,5,2,9,8,1,8,kosovo,0.12,0.88,1,8.33,1.14
Gjilani,8,1,4,3,14,14,0,7,kosovo,0.12,0.88,0,8.33,1.14
Llapi,7,2,0,5,8,11,-3,6,kosovo,0.29,0.71,-3,3.45,1.41
Suhareka,8,1,3,4,7,14,-7,6,kosovo,0.12,0.88,-7,8.33,1.14
Dukagjini,8,2,0,6,7,15,-8,6,kosovo,0.25,0.75,-8,4.0,1.33
Feronikeli,7,0,1,6,5,15,-10,1,kosovo,0.0,1.0,-10,0.0,1.0
Al Kuwait,5,5,0,0,18,5,13,15,kuwait,1.0,0.0,13,1.0,0.0
Al Arabi SC,4,3,0,1,9,5,4,9,kuwait,0.75,0.25,4,1.33,4.0
Al Fahaheel,4,2,2,0,12,7,5,8,kuwait,0.5,0.5,5,2.0,2.0
Al Tadhamon,4,1,1,2,10,10,0,4,kuwait,0.25,0.75,0,4.0,1.33
Al Salmiyah,3,1,1,1,5,5,0,4,kuwait,0.33,0.67,0,3.03,1.49
Al Qadsia,4,1,1,2,3,4,-1,4,kuwait,0.25,0.75,-1,4.0,1.33
Al Nasar,5,1,0,4,4,9,-5,3,kuwait,0.2,0.8,-5,5.0,1.25
Kazma,5,1,0,4,3,9,-6,3,kuwait,0.2,0.8,-6,5.0,1.25
Khaitan,5,1,0,4,3,11,-8,3,kuwait,0.2,0.8,-8,5.0,1.25
Yarmouk,5,0,2,3,4,8,-4,2,kuwait,0.0,1.0,-4,0.0,1.0
RFS,8,7,1,0,18,4,14,22,latvia,0.88,0.12,14,1.14,8.33
Riga FC,8,6,2,0,25,7,18,20,latvia,0.75,0.25,18,1.33,4.0
Auda,8,6,0,2,18,8,10,18,latvia,0.75,0.25,10,1.33,4.0
Liepaja,8,4,1,3,10,9,1,13,latvia,0.5,0.5,1,2.0,2.0
Valmiera,8,3,2,3,15,12,3,11,latvia,0.38,0.62,3,2.63,1.61
Tukums,8,2,2,4,10,23,-13,8,latvia,0.25,0.75,-13,4.0,1.33
Metta,8,2,1,5,5,21,-16,7,latvia,0.25,0.75,-16,4.0,1.33
Grobina,8,1,1,6,3,19,-16,4,latvia,0.12,0.88,-16,8.33,1.14
FS Jelgava,8,1,1,6,9,29,-20,4,latvia,0.12,0.88,-20,8.33,1.14
Daugavpils,8,0,3,5,7,16,-9,3,latvia,0.0,1.0,-9,0.0,1.0
Kauno Zalgiris,8,4,3,1,12,11,1,15,lithuania,0.5,0.5,1,2.0,2.0
Dainava,8,4,2,2,10,6,4,14,lithuania,0.5,0.5,4,2.0,2.0
Hegelmann L.,8,4,2,2,13,10,3,14,lithuania,0.5,0.5,3,2.0,2.0
Zalgiris,8,3,2,3,11,7,4,11,lithuania,0.38,0.62,4,2.63,1.61
Panevezys,8,2,5,1,14,12,2,11,lithuania,0.25,0.75,2,4.0,1.33
Banga,8,3,1,4,7,11,-4,10,lithuania,0.38,0.62,-4,2.63,1.61
Suduva,8,2,2,4,11,10,1,8,lithuania,0.25,0.75,1,4.0,1.33
Dziugas Telsiai,8,2,2,4,6,6,0,8,lithuania,0.25,0.75,0,4.0,1.33
TransINVEST,8,2,2,4,7,10,-3,8,lithuania,0.25,0.75,-3,4.0,1.33
Siauliai,8,1,2,5,10,17,-7,5,lithuania,0.12,0.88,-7,8.33,1.14
Riteriai,8,7,0,1,14,4,10,21,lithuania2,0.88,0.12,10,1.14,8.33
Siauliai B,8,5,0,3,21,15,6,15,lithuania2,0.62,0.38,6,1.61,2.63
Babrungas,8,4,2,2,17,8,9,14,lithuania2,0.5,0.5,9,2.0,2.0
Tauras,8,4,2,2,16,11,5,14,lithuania2,0.5,0.5,5,2.0,2.0
Nevezis,8,4,2,2,11,7,4,14,lithuania2,0.5,0.5,4,2.0,2.0
Atmosfera,8,3,4,1,6,5,1,13,lithuania2,0.38,0.62,1,2.63,1.61
Ekranas,8,3,3,2,11,13,-2,12,lithuania2,0.38,0.62,-2,2.63,1.61
Neptuna K.,8,3,1,4,12,13,-1,10,lithuania2,0.38,0.62,-1,2.63,1.61
Panevezys B,8,3,1,4,10,15,-5,10,lithuania2,0.38,0.62,-5,2.63,1.61
BFA Vilnius,8,2,3,3,11,13,-2,9,lithuania2,0.25,0.75,-2,4.0,1.33
Be1 NFA,8,2,3,3,8,11,-3,9,lithuania2,0.25,0.75,-3,4.0,1.33
Kauno Z. B,8,3,0,5,10,20,-10,9,lithuania2,0.38,0.62,-10,2.63,1.61
Garliava,8,2,1,5,8,18,-10,7,lithuania2,0.25,0.75,-10,4.0,1.33
Hegelmann B,8,1,0,7,6,18,-12,3,lithuania2,0.12,0.88,-12,8.33,1.14
Minija,8,0,2,6,6,18,-12,2,lithuania2,0.0,1.0,-12,0.0,1.0
Banga B,8,0,0,8,2,23,-21,0,lithuania2,0.0,1.0,-21,0.0,1.0
Differdange,8,7,0,1,23,4,19,21,luxembourg,0.88,0.12,19,1.14,8.33
Dudelange,7,4,2,1,14,7,7,14,luxembourg,0.57,0.43,7,1.75,2.33
UNA Strassen,7,4,2,1,11,4,7,14,luxembourg,0.57,0.43,7,1.75,2.33
Hesperange,7,3,2,2,12,9,3,11,luxembourg,0.43,0.57,3,2.33,1.75
Niedercorn,7,3,2,2,8,5,3,11,luxembourg,0.43,0.57,3,2.33,1.75
Bettembourg,7,3,1,3,8,9,-1,10,luxembourg,0.43,0.57,-1,2.33,1.75
Mondorf,7,2,3,2,11,7,4,9,luxembourg,0.29,0.71,4,3.45,1.41
Racing,7,2,3,2,9,7,2,9,luxembourg,0.29,0.71,2,3.45,1.41
Hostert,8,3,0,5,15,17,-2,9,luxembourg,0.38,0.62,-2,2.63,1.61
Wiltz,8,3,0,5,11,15,-4,9,luxembourg,0.38,0.62,-4,2.63,1.61
Jeunesse Esch,8,2,2,4,7,18,-11,8,luxembourg,0.25,0.75,-11,4.0,1.33
Petange,7,1,3,3,3,8,-5,6,luxembourg,0.14,0.86,-5,7.14,1.16
V. Rosport,8,1,2,5,8,20,-12,5,luxembourg,0.12,0.88,-12,8.33,1.14
Mondercange,8,1,0,7,7,22,-15,3,luxembourg,0.12,0.88,-15,8.33,1.14
Fola Esch,6,0,0,6,5,19,-14,0,luxembourg,0.0,1.0,-14,0.0,1.0
Rodange,7,0,0,7,6,23,-17,0,luxembourg,0.0,1.0,-17,0.0,1.0
Johor Darul,7,6,1,0,27,4,23,19,malaysia,0.86,0.14,23,1.16,7.14
Sabah,7,5,0,2,16,11,5,15,malaysia,0.71,0.29,5,1.41,3.45
Selangor,8,4,2,2,10,7,3,14,malaysia,0.5,0.5,3,2.0,2.0
Perak,7,4,1,2,12,7,5,13,malaysia,0.57,0.43,5,1.75,2.33
Terengganu,8,2,4,2,8,10,-2,10,malaysia,0.25,0.75,-2,4.0,1.33
Pahang,7,1,5,1,7,9,-2,8,malaysia,0.14,0.86,-2,7.14,1.16
PDRM,8,2,2,4,8,15,-7,8,malaysia,0.25,0.75,-7,4.0,1.33
Kedah,7,2,1,4,5,18,-13,7,malaysia,0.29,0.71,-13,3.45,1.41
Kuala Lumpur,6,2,0,4,8,10,-2,6,malaysia,0.33,0.67,-2,3.03,1.49
Negeri Sembilan,8,1,3,4,10,17,-7,6,malaysia,0.12,0.88,-7,8.33,1.14
Pulau Pinang,8,1,3,4,8,17,-9,6,malaysia,0.12,0.88,-9,8.33,1.14
Kuching,6,1,2,3,6,11,-5,5,malaysia,0.17,0.83,-5,5.88,1.2
Kelantan United,8,1,0,7,4,19,-15,3,malaysia,0.12,0.88,-15,8.33,1.14
Birkirkara,6,5,1,0,12,3,9,16,malta,0.83,0.17,9,1.2,5.88
Floriana,6,4,2,0,12,3,9,14,malta,0.67,0.33,9,1.49,3.03
Hamrun Spartans,8,4,2,2,16,8,8,14,malta,0.5,0.5,8,2.0,2.0
Marsaxlokk,5,3,2,0,9,4,5,11,malta,0.6,0.4,5,1.67,2.5
Hibernians,8,3,2,3,8,9,-1,11,malta,0.38,0.62,-1,2.63,1.61
Sliema,7,2,4,1,7,4,3,10,malta,0.29,0.71,3,3.45,1.41
Melita,7,2,3,2,11,11,0,9,malta,0.29,0.71,0,3.45,1.41
Zabbar,8,3,0,5,11,13,-2,9,malta,0.38,0.62,-2,2.63,1.61
Gzira Utd,6,2,1,3,7,9,-2,7,malta,0.33,0.67,-2,3.03,1.49
Mosta,8,2,0,6,9,15,-6,6,malta,0.25,0.75,-6,4.0,1.33
Naxxar Lions,5,1,2,2,7,7,0,5,malta,0.2,0.8,0,5.0,1.25
Balzan,7,0,1,6,4,14,-10,1,malta,0.0,1.0,-10,0.0,1.0
Cruz Azul,8,6,1,1,19,9,10,19,mexico,0.75,0.25,10,1.33,4.0
Monterrey,8,4,2,2,10,7,3,14,mexico,0.5,0.5,3,2.0,2.0
Tigres,8,4,1,3,13,9,4,13,mexico,0.5,0.5,4,2.0,2.0
Toluca,8,3,3,2,10,9,1,12,mexico,0.38,0.62,1,2.63,1.61
Pumas UNAM,8,3,3,2,6,6,0,12,mexico,0.38,0.62,0,2.63,1.61
Juarez,8,4,0,4,10,18,-8,12,mexico,0.5,0.5,-8,2.0,2.0
Guadalajara,8,3,1,4,9,8,1,10,mexico,0.38,0.62,1,2.63,1.61
CF America,8,2,3,3,12,14,-2,9,mexico,0.25,0.75,-2,4.0,1.33
Tijuana,8,2,3,3,6,12,-6,9,mexico,0.25,0.75,-6,4.0,1.33
Atlas,8,2,2,4,7,16,-9,8,mexico,0.25,0.75,-9,4.0,1.33
A. San Luis,8,2,1,5,7,12,-5,7,mexico,0.25,0.75,-5,4.0,1.33
Club Leon,8,1,3,4,12,18,-6,6,mexico,0.12,0.88,-6,8.33,1.14
Queretaro,8,1,2,5,6,17,-11,5,mexico,0.12,0.88,-11,8.33,1.14
Mazatlan,8,0,4,4,0,7,-7,4,mexico,0.0,1.0,-7,0.0,1.0
Pachuca,8,1,1,6,7,16,-9,4,mexico,0.12,0.88,-9,8.33,1.14
Puebla,8,1,1,6,4,16,-12,4,mexico,0.12,0.88,-12,8.33,1.14
Necaxa,8,0,3,5,7,17,-10,3,mexico,0.0,1.0,-10,0.0,1.0
Santos Laguna,8,0,1,7,5,17,-12,1,mexico,0.0,1.0,-12,0.0,1.0
Buducnost,8,7,0,1,17,3,14,21,montenegro,0.88,0.12,14,1.14,8.33
Sutjeska,8,4,1,3,9,6,3,13,montenegro,0.5,0.5,3,2.0,2.0
Petrovac,8,4,1,3,9,8,1,13,montenegro,0.5,0.5,1,2.0,2.0
Bokelj,8,3,3,2,8,9,-1,12,montenegro,0.38,0.62,-1,2.63,1.61
Arsenal Tivat,8,3,2,3,10,11,-1,11,montenegro,0.38,0.62,-1,2.63,1.61
Mornar Bar,8,3,2,3,10,15,-5,11,montenegro,0.38,0.62,-5,2.63,1.61
Decic,8,1,6,1,8,9,-1,9,montenegro,0.12,0.88,-1,8.33,1.14
Jezero,8,1,3,4,6,10,-4,6,montenegro,0.12,0.88,-4,8.33,1.14
Otrant,8,0,4,4,1,5,-4,4,montenegro,0.0,1.0,-4,0.0,1.0
Jedinstvo,8,1,1,6,5,19,-14,4,montenegro,0.12,0.88,-14,8.33,1.14
Berkane,7,5,2,0,10,3,7,17,morocco,0.71,0.29,7,1.41,3.45
R. Zemamra,6,3,1,2,4,4,0,10,morocco,0.5,0.5,0,2.0,2.0
Maghreb de Fes,6,2,3,1,6,5,1,9,morocco,0.33,0.67,1,3.03,1.49
Ittihad Tanger,7,2,3,2,8,9,-1,9,morocco,0.29,0.71,-1,3.45,1.41
FAR Rabat,6,2,2,2,9,3,6,8,morocco,0.33,0.67,6,3.03,1.49
Union Touarga,5,2,2,1,7,4,3,8,morocco,0.4,0.6,3,2.5,1.67
Raja Casablanca,6,2,2,2,8,8,0,8,morocco,0.33,0.67,0,3.03,1.49
FUS Rabat,7,2,2,3,7,8,-1,8,morocco,0.29,0.71,-1,3.45,1.41
Difaa El Jadida,7,2,2,3,12,15,-3,8,morocco,0.29,0.71,-3,3.45,1.41
Olympic Safi,7,2,2,3,6,9,-3,8,morocco,0.29,0.71,-3,3.45,1.41
Hassania Agadir,6,2,1,3,4,5,-1,7,morocco,0.33,0.67,-1,3.03,1.49
JS Sousalem,6,1,3,2,3,3,0,6,morocco,0.17,0.83,0,5.88,1.2
Wydad,6,1,3,2,4,6,-2,6,morocco,0.17,0.83,-2,5.88,1.2
Moghreb Tetouan,6,1,0,5,3,8,-5,3,morocco,0.17,0.83,-5,5.88,1.2
Meknes,6,0,3,3,1,11,-10,3,morocco,0.0,1.0,-10,0.0,1.0
C. Mohammedia,7,0,2,5,5,17,-12,2,morocco,0.0,1.0,-12,0.0,1.0
R. Beni Mellal,5,2,2,1,9,5,4,8,morocco2,0.4,0.6,4,2.5,1.67
C. Benguerir,4,2,2,0,6,3,3,8,morocco2,0.5,0.5,3,2.0,2.0
RAC Casablanca,4,2,1,1,7,7,0,7,morocco2,0.5,0.5,0,2.0,2.0
Yacoub El Manso,4,2,0,2,5,6,-1,6,morocco2,0.5,0.5,-1,2.0,2.0
Kawkab M.,4,1,2,1,2,1,1,5,morocco2,0.25,0.75,1,4.0,1.33
Rapide Oued Z.,4,1,2,1,2,3,-1,5,morocco2,0.25,0.75,-1,4.0,1.33
Stade Marocain,4,1,2,1,2,3,-1,5,morocco2,0.25,0.75,-1,4.0,1.33
Youssoufia B.,4,1,1,2,6,5,1,4,morocco2,0.25,0.75,1,4.0,1.33
El Massira,5,0,4,1,4,5,-1,4,morocco2,0.0,1.0,-1,0.0,1.0
Wydad Fes,5,1,1,3,4,7,-3,4,morocco2,0.2,0.8,-3,5.0,1.25
Chabab Atlas K.,3,0,2,1,3,5,-2,2,morocco2,0.0,1.0,-2,0.0,1.0
Dcheira,3,0,1,2,2,4,-2,1,morocco2,0.0,1.0,-2,0.0,1.0
KAC Kenitra,3,0,1,2,4,9,-5,1,morocco2,0.0,1.0,-5,0.0,1.0
Khouribga,4,0,1,3,4,11,-7,1,morocco2,0.0,1.0,-7,0.0,1.0
Mouloudia Oujda,5,0,1,4,3,10,-7,1,morocco2,0.0,1.0,-7,0.0,1.0
USM Oujda,3,0,1,2,1,10,-9,1,morocco2,0.0,1.0,-9,0.0,1.0
Shan Utd,7,7,0,0,26,7,19,21,myanmar,1.0,0.0,19,1.0,0.0
Yangon Utd,6,4,2,0,20,9,11,14,myanmar,0.67,0.33,11,1.49,3.03
Dagon,8,4,1,3,13,6,7,13,myanmar,0.5,0.5,7,2.0,2.0
Hantharwady,5,4,1,0,10,3,7,13,myanmar,0.8,0.2,7,1.25,5.0
Sagaing Utd,7,3,0,4,11,11,0,9,myanmar,0.43,0.57,0,2.33,1.75
Yadanarbon,7,2,2,3,6,9,-3,8,myanmar,0.29,0.71,-3,3.45,1.41
Thitsar Arman,7,2,1,4,14,14,0,7,myanmar,0.29,0.71,0,3.45,1.41
Ayeyawady,7,2,1,4,6,11,-5,7,myanmar,0.29,0.71,-5,3.45,1.41
Ispe FC,6,1,2,3,7,10,-3,5,myanmar,0.17,0.83,-3,5.88,1.2
Dagon Port,8,1,2,5,15,30,-15,5,myanmar,0.12,0.88,-15,8.33,1.14
Myawady,8,1,0,7,4,18,-14,3,myanmar,0.12,0.88,-14,8.33,1.14
Rakhine Utd,8,0,2,6,9,22,-13,2,myanmar,0.0,1.0,-13,0.0,1.0
PSV Eindhoven,8,7,0,1,27,9,18,21,netherlands,0.88,0.12,18,1.14,8.33
FC Utrecht,8,6,2,0,17,8,9,20,netherlands,0.75,0.25,9,1.33,4.0
Feyenoord,8,5,3,0,23,9,14,18,netherlands,0.62,0.38,14,1.61,2.63
Ajax Amsterdam,8,4,2,2,15,11,4,14,netherlands,0.5,0.5,4,2.0,2.0
AZ Alkmaar,7,4,1,2,10,6,4,13,netherlands,0.57,0.43,4,1.75,2.33
FC Twente,8,4,1,3,15,14,1,13,netherlands,0.5,0.5,1,2.0,2.0
Willem II,7,2,2,3,7,9,-2,8,netherlands,0.29,0.71,-2,3.45,1.41
Sparta,7,2,1,4,6,9,-3,7,netherlands,0.29,0.71,-3,3.45,1.41
Go Ahead Eagles,7,2,1,4,7,12,-5,7,netherlands,0.29,0.71,-5,3.45,1.41
Fortuna Sittard,8,1,4,3,7,13,-6,7,netherlands,0.12,0.88,-6,8.33,1.14
NAC Breda,8,2,1,5,7,16,-9,7,netherlands,0.25,0.75,-9,4.0,1.33
NEC Nijmegen,7,2,0,5,6,10,-4,6,netherlands,0.29,0.71,-4,3.45,1.41
PEC Zwolle,8,0,4,4,4,14,-10,4,netherlands,0.0,1.0,-10,0.0,1.0
Heracles Almelo,7,1,1,5,3,15,-12,4,netherlands,0.14,0.86,-12,7.14,1.16
FC Groningen,7,1,1,5,5,19,-14,4,netherlands,0.14,0.86,-14,7.14,1.16
Heerenveen,8,1,0,7,4,24,-20,3,netherlands,0.12,0.88,-20,8.33,1.14
Almere City,7,0,2,5,2,12,-10,2,netherlands,0.0,1.0,-10,0.0,1.0
RKC Waalwijk,7,0,2,5,7,20,-13,2,netherlands,0.0,1.0,-13,0.0,1.0
FC Emmen,8,6,0,2,15,7,8,18,netherlands2,0.75,0.25,8,1.33,4.0
Cambuur,8,5,1,2,17,7,10,16,netherlands2,0.62,0.38,10,1.61,2.63
Helmond Sport,8,5,1,2,13,12,1,16,netherlands2,0.62,0.38,1,1.61,2.63
Excelsior,8,4,3,1,15,7,8,15,netherlands2,0.5,0.5,8,2.0,2.0
FC Volendam,8,4,3,1,17,12,5,15,netherlands2,0.5,0.5,5,2.0,2.0
FC Den Bosch,8,4,2,2,11,7,4,14,netherlands2,0.5,0.5,4,2.0,2.0
FC Eindhoven,8,4,0,4,16,15,1,12,netherlands2,0.5,0.5,1,2.0,2.0
Roda JC,8,3,3,2,11,10,1,12,netherlands2,0.38,0.62,1,2.63,1.61
De Graafschap,8,2,4,2,12,13,-1,10,netherlands2,0.25,0.75,-1,4.0,1.33
Jong AZ,8,3,1,4,8,11,-3,10,netherlands2,0.38,0.62,-3,2.63,1.61
FC Dordrecht,8,3,1,4,10,15,-5,10,netherlands2,0.38,0.62,-5,2.63,1.61
ADO Den Haag,8,2,3,3,16,12,4,9,netherlands2,0.25,0.75,4,4.0,1.33
Jong PSV,8,3,0,5,11,11,0,9,netherlands2,0.38,0.62,0,2.63,1.61
Jong Ajax,8,2,2,4,10,14,-4,8,netherlands2,0.25,0.75,-4,4.0,1.33
VVV,8,2,1,5,7,19,-12,7,netherlands2,0.25,0.75,-12,4.0,1.33
Telstar,8,1,3,4,8,13,-5,6,netherlands2,0.12,0.88,-5,8.33,1.14
MVV Maastricht,8,1,3,4,11,17,-6,6,netherlands2,0.12,0.88,-6,8.33,1.14
Vitesse Arnhem,8,1,3,4,11,19,-8,6,netherlands2,0.12,0.88,-8,8.33,1.14
Jong Utrecht,8,0,5,3,8,13,-5,5,netherlands2,0.0,1.0,-5,0.0,1.0
TOP Oss,8,0,4,4,4,15,-11,4,netherlands2,0.0,1.0,-11,0.0,1.0
Diriangen,8,4,4,0,21,7,14,16,nicaragua,0.5,0.5,14,2.0,2.0
Real Esteli,8,5,1,2,14,9,5,16,nicaragua,0.62,0.38,5,1.61,2.63
Walter Ferreti,8,4,2,2,8,5,3,14,nicaragua,0.5,0.5,3,2.0,2.0
Matagalpa,8,3,3,2,9,7,2,12,nicaragua,0.38,0.62,2,2.63,1.61
Export Sebaco,8,1,4,3,7,10,-3,7,nicaragua,0.12,0.88,-3,8.33,1.14
Managua FC,8,1,3,4,9,15,-6,6,nicaragua,0.12,0.88,-6,8.33,1.14
Jalapa,8,1,2,5,8,21,-13,5,nicaragua,0.12,0.88,-13,8.33,1.14
UNAN Managua,8,1,1,6,7,17,-10,4,nicaragua,0.12,0.88,-10,8.33,1.14
Rancho Santana,8,1,1,6,5,15,-10,4,nicaragua,0.12,0.88,-10,8.33,1.14
D. Ocotal,8,0,2,6,3,24,-21,2,nicaragua,0.0,1.0,-21,0.0,1.0
Linfield,8,5,2,1,15,7,8,17,northernireland,0.62,0.38,8,1.61,2.63
Ballymena Utd,8,5,0,3,8,5,3,15,northernireland,0.62,0.38,3,1.61,2.63
Portadown,8,4,1,3,13,8,5,13,northernireland,0.5,0.5,5,2.0,2.0
Crusaders,8,4,1,3,9,7,2,13,northernireland,0.5,0.5,2,2.0,2.0
Cliftonville,8,3,2,3,15,11,4,11,northernireland,0.38,0.62,4,2.63,1.61
Larne,6,3,2,1,8,4,4,11,northernireland,0.5,0.5,4,2.0,2.0
Dungannon,8,3,2,3,11,11,0,11,northernireland,0.38,0.62,0,2.63,1.61
Glentoran,8,3,1,4,12,11,1,10,northernireland,0.38,0.62,1,2.63,1.61
Coleraine,8,2,2,4,14,13,1,8,northernireland,0.25,0.75,1,4.0,1.33
Glenavon,8,2,2,4,4,9,-5,8,northernireland,0.25,0.75,-5,4.0,1.33
Carrick Rangers,8,1,3,4,7,14,-7,6,northernireland,0.12,0.88,-7,8.33,1.14
Loughgall,8,1,0,7,5,19,-14,3,northernireland,0.12,0.88,-14,8.33,1.14
Bangor,8,7,0,1,21,12,9,21,northernireland2,0.88,0.12,9,1.14,8.33
Limavady,8,4,3,1,16,9,7,15,northernireland2,0.5,0.5,7,2.0,2.0
Ballyclare,8,5,0,3,12,11,1,15,northernireland2,0.62,0.38,1,1.61,2.63
Dundela,8,4,2,2,12,8,4,14,northernireland2,0.5,0.5,4,2.0,2.0
HW Welders,7,3,2,2,19,14,5,11,northernireland2,0.43,0.57,5,2.33,1.75
Ballinamallard,8,3,1,4,13,12,1,10,northernireland2,0.38,0.62,1,2.63,1.61
Armagh City,8,2,3,3,7,14,-7,9,northernireland2,0.25,0.75,-7,4.0,1.33
Ards,8,2,2,4,15,19,-4,8,northernireland2,0.25,0.75,-4,4.0,1.33
Institute,8,2,2,4,10,14,-4,8,northernireland2,0.25,0.75,-4,4.0,1.33
Annagh Utd,8,1,2,5,7,11,-4,5,northernireland2,0.12,0.88,-4,8.33,1.14
Newington,8,1,0,7,5,24,-19,3,northernireland2,0.12,0.88,-19,8.33,1.14
Newry City,8,0,2,6,8,20,-12,2,northernireland2,0.0,1.0,-12,0.0,1.0
Sileks,8,5,2,1,11,2,9,17,northmacedonia,0.62,0.38,9,1.61,2.63
Gostivar,8,4,3,1,9,4,5,15,northmacedonia,0.5,0.5,5,2.0,2.0
Rabotnicki,8,3,4,1,8,3,5,13,northmacedonia,0.38,0.62,5,2.63,1.61
Struga,8,3,4,1,12,9,3,13,northmacedonia,0.38,0.62,3,2.63,1.61
Shkendija,8,3,4,1,6,4,2,13,northmacedonia,0.38,0.62,2,2.63,1.61
Shkupi,8,2,1,5,9,12,-3,7,northmacedonia,0.25,0.75,-3,4.0,1.33
Brera Strumica,8,2,1,5,8,16,-8,7,northmacedonia,0.25,0.75,-8,4.0,1.33
Vardar,8,1,2,5,3,12,-9,5,northmacedonia,0.12,0.88,-9,8.33,1.14
Pelister,8,1,2,5,4,14,-10,5,northmacedonia,0.12,0.88,-10,8.33,1.14
Tikves,8,0,4,4,3,9,-6,4,northmacedonia,0.0,1.0,-6,0.0,1.0
Voska Sport,8,1,1,6,8,20,-12,4,northmacedonia,0.12,0.88,-12,8.33,1.14
Besa,8,0,3,5,6,14,-8,3,northmacedonia,0.0,1.0,-8,0.0,1.0
Brann,8,5,2,1,17,8,9,17,norway,0.62,0.38,9,1.61,2.63
Rosenborg,8,5,2,1,16,7,9,17,norway,0.62,0.38,9,1.61,2.63
Viking,8,3,3,2,16,13,3,12,norway,0.38,0.62,3,2.63,1.61
Sarpsborg 08,8,3,3,2,12,14,-2,12,norway,0.38,0.62,-2,2.63,1.61
Molde,8,3,2,3,13,8,5,11,norway,0.38,0.62,5,2.63,1.61
HamKam,8,3,2,3,9,13,-4,11,norway,0.38,0.62,-4,2.63,1.61
KFUM Oslo,8,3,1,4,9,9,0,10,norway,0.38,0.62,0,2.63,1.61
Bodo/Glimt,8,2,4,2,10,11,-1,10,norway,0.25,0.75,-1,4.0,1.33
Fredrikstad,8,3,1,4,7,14,-7,10,norway,0.38,0.62,-7,2.63,1.61
Sandefjord,8,2,2,4,10,12,-2,8,norway,0.25,0.75,-2,4.0,1.33
Kristiansund,8,2,2,4,5,10,-5,8,norway,0.25,0.75,-5,4.0,1.33
Tromso,8,2,0,6,6,15,-9,6,norway,0.25,0.75,-9,4.0,1.33
Haugesund,8,1,3,4,8,18,-10,6,norway,0.12,0.88,-10,8.33,1.14
Stromsgodset,8,0,3,5,5,15,-10,3,norway,0.0,1.0,-10,0.0,1.0
Odd,8,0,2,6,5,15,-10,2,norway,0.0,1.0,-10,0.0,1.0
Lillestrom,8,0,0,8,7,25,-18,0,norway,0.0,1.0,-18,0.0,1.0
Valerenga,8,6,2,0,18,6,12,20,norway2,0.75,0.25,12,1.33,4.0
Bryne,8,5,1,2,17,10,7,16,norway2,0.62,0.38,7,1.61,2.63
Aalesund,8,5,1,2,14,8,6,16,norway2,0.62,0.38,6,1.61,2.63
Ranheim,8,5,1,2,16,11,5,16,norway2,0.62,0.38,5,1.61,2.63
Lyn,8,4,2,2,13,11,2,14,norway2,0.5,0.5,2,2.0,2.0
Raufoss,8,4,1,3,9,10,-1,13,norway2,0.5,0.5,-1,2.0,2.0
Kongsvinger,8,3,3,2,12,9,3,12,norway2,0.38,0.62,3,2.63,1.61
Start,8,3,2,3,16,17,-1,11,norway2,0.38,0.62,-1,2.63,1.61
Asane,8,3,2,3,12,15,-3,11,norway2,0.38,0.62,-3,2.63,1.61
Mjondalen,8,3,1,4,7,14,-7,10,norway2,0.38,0.62,-7,2.63,1.61
Stabaek,8,3,1,4,10,18,-8,10,norway2,0.38,0.62,-8,2.63,1.61
Egersund,8,3,0,5,12,17,-5,9,norway2,0.38,0.62,-5,2.63,1.61
Moss,8,2,2,4,9,11,-2,8,norway2,0.25,0.75,-2,4.0,1.33
Levanger,8,1,4,3,13,17,-4,7,norway2,0.12,0.88,-4,8.33,1.14
Sogndal,8,2,1,5,4,13,-9,7,norway2,0.25,0.75,-9,4.0,1.33
Sandnes Ulf,8,1,1,6,4,20,-16,4,norway2,0.12,0.88,-16,8.33,1.14
Al-Nahda,6,5,1,0,9,2,7,16,oman,0.83,0.17,7,1.2,5.88
Al Seeb,5,5,0,0,12,3,9,15,oman,1.0,0.0,9,1.0,0.0
Oman Club,5,3,2,0,6,2,4,11,oman,0.6,0.4,4,1.67,2.5
Al Nasr,5,2,1,2,3,2,1,7,oman,0.4,0.6,1,2.5,1.67
Ibri,5,2,1,2,4,5,-1,7,oman,0.4,0.6,-1,2.5,1.67
Saham,5,2,0,3,7,7,0,6,oman,0.4,0.6,0,2.5,1.67
Al-Khabourah,5,2,0,3,3,6,-3,6,oman,0.4,0.6,-3,2.5,1.67
Bahla,4,0,2,2,2,5,-3,2,oman,0.0,1.0,-3,0.0,1.0
Sohar,5,0,2,3,6,11,-5,2,oman,0.0,1.0,-5,0.0,1.0
Sur,5,0,1,4,1,8,-7,1,oman,0.0,1.0,-7,0.0,1.0
Al-Shabab Club,4,0,0,4,1,5,-4,0,oman,0.0,1.0,-4,0.0,1.0
Al-Rustaq,4,0,0,4,3,8,-5,0,oman,0.0,1.0,-5,0.0,1.0
San Francisco,8,5,1,2,7,6,1,16,panama,0.62,0.38,1,1.61,2.63
Tauro,8,4,2,2,14,7,7,14,panama,0.5,0.5,7,2.0,2.0
Costa del Este,8,4,2,2,10,8,2,14,panama,0.5,0.5,2,2.0,2.0
Herrera,7,4,1,2,12,9,3,13,panama,0.57,0.43,3,1.75,2.33
Plaza Amador,8,4,1,3,9,6,3,13,panama,0.5,0.5,3,2.0,2.0
Alianza,8,3,3,2,10,11,-1,12,panama,0.38,0.62,-1,2.63,1.61
Independiente,8,2,3,3,9,9,0,9,panama,0.25,0.75,0,4.0,1.33
San Miguelito,8,2,3,3,6,7,-1,9,panama,0.25,0.75,-1,4.0,1.33
Universitario,8,1,5,2,10,10,0,8,panama,0.12,0.88,0,8.33,1.14
UMECIT,8,2,2,4,6,9,-3,8,panama,0.25,0.75,-3,4.0,1.33
Arabe Unido,8,1,2,5,9,15,-6,5,panama,0.12,0.88,-6,8.33,1.14
Veraguas,8,0,0,8,11,20,-9,0,panama,0.0,1.0,-9,0.0,1.0
San Miguelito,8,4,2,2,8,4,4,14,panama2,0.5,0.5,4,2.0,2.0
Independiente,8,4,2,2,12,9,3,14,panama2,0.5,0.5,3,2.0,2.0
Tauro,8,3,1,4,7,10,-3,10,panama2,0.38,0.62,-3,2.63,1.61
Plaza Amador,6,2,3,1,8,7,1,9,panama2,0.33,0.67,1,3.03,1.49
Arabe Unido,8,2,3,3,6,5,1,9,panama2,0.25,0.75,1,4.0,1.33
Veraguas,6,3,0,3,11,12,-1,9,panama2,0.5,0.5,-1,2.0,2.0
UMECIT,8,2,3,3,6,7,-1,9,panama2,0.25,0.75,-1,4.0,1.33
Universitario,7,3,0,4,6,9,-3,9,panama2,0.43,0.57,-3,2.33,1.75
Alianza,7,2,1,4,7,10,-3,7,panama2,0.29,0.71,-3,3.45,1.41
San Francisco,8,1,3,4,8,11,-3,6,panama2,0.12,0.88,-3,8.33,1.14
Costa del Este,8,0,4,4,3,11,-8,4,panama2,0.0,1.0,-8,0.0,1.0
Herrera,8,0,2,6,5,12,-7,2,panama2,0.0,1.0,-7,0.0,1.0
Guarani,8,4,3,1,9,5,4,15,paraguay2,0.5,0.5,4,2.0,2.0
S. Ameliano,8,4,2,2,12,5,7,14,paraguay2,0.5,0.5,7,2.0,2.0
Olimpia,8,4,2,2,5,4,1,14,paraguay2,0.5,0.5,1,2.0,2.0
2 de Mayo,8,3,3,2,10,7,3,12,paraguay2,0.38,0.62,3,2.63,1.61
G. Caballero,8,3,2,3,7,6,1,11,paraguay2,0.38,0.62,1,2.63,1.61
Sol de America,8,2,3,3,9,8,1,9,paraguay2,0.25,0.75,1,4.0,1.33
S. Luqueno,8,2,3,3,14,14,0,9,paraguay2,0.25,0.75,0,4.0,1.33
Libertad,8,2,2,4,8,12,-4,8,paraguay2,0.25,0.75,-4,4.0,1.33
Cerro Porteno,8,2,1,5,7,12,-5,7,paraguay2,0.25,0.75,-5,4.0,1.33
Nacional,8,1,3,4,8,10,-2,6,paraguay2,0.12,0.88,-2,8.33,1.14
Tacuary,8,1,2,5,7,12,-5,5,paraguay2,0.12,0.88,-5,8.33,1.14
S. Trinidense,8,0,4,4,5,9,-4,4,paraguay2,0.0,1.0,-4,0.0,1.0
S. Cristal,8,5,1,2,16,12,4,16,peru,0.62,0.38,4,1.61,2.63
FBC Melgar,8,4,2,2,17,12,5,14,peru,0.5,0.5,5,2.0,2.0
Universitario,8,3,4,1,7,6,1,13,peru,0.38,0.62,1,2.63,1.61
Alianza Lima,8,4,0,4,12,9,3,12,peru,0.5,0.5,3,2.0,2.0
Cienciano,8,3,3,2,8,9,-1,12,peru,0.38,0.62,-1,2.63,1.61
Comerciantes U.,8,3,1,4,11,21,-10,10,peru,0.38,0.62,-10,2.63,1.61
D. Garcilaso,8,2,2,4,11,12,-1,8,peru,0.25,0.75,-1,4.0,1.33
ADT,8,2,2,4,11,14,-3,8,peru,0.25,0.75,-3,4.0,1.33
Atletico Grau,8,1,2,5,6,11,-5,5,peru,0.12,0.88,-5,8.33,1.14
Sport Huancayo,8,1,2,5,6,20,-14,5,peru,0.12,0.88,-14,8.33,1.14
Sport Boys,8,1,1,6,7,14,-7,4,peru,0.12,0.88,-7,8.33,1.14
Cesar Vallejo,8,0,4,4,4,13,-9,4,peru,0.0,1.0,-9,0.0,1.0
Cusco,8,1,1,6,3,16,-13,4,peru,0.12,0.88,-13,8.33,1.14
Cajamarca,8,0,3,5,4,12,-8,3,peru,0.0,1.0,-8,0.0,1.0
Carlos Manucci,8,0,3,5,4,17,-13,3,peru,0.0,1.0,-13,0.0,1.0
Union Comercio,8,0,2,6,5,16,-11,2,peru,0.0,1.0,-11,0.0,1.0
Alianza A.,8,0,2,6,1,12,-11,2,peru,0.0,1.0,-11,0.0,1.0
Los Chankas,8,0,2,6,6,20,-14,2,peru,0.0,1.0,-14,0.0,1.0
Alianza Lima,8,5,1,2,11,5,6,16,peru2,0.62,0.38,6,1.61,2.63
Atletico Grau,8,4,3,1,9,5,4,15,peru2,0.5,0.5,4,2.0,2.0
Cusco,8,4,2,2,14,13,1,14,peru2,0.5,0.5,1,2.0,2.0
Alianza A.,8,3,3,2,7,9,-2,12,peru2,0.38,0.62,-2,2.63,1.61
Universitario,8,2,4,2,9,6,3,10,peru2,0.25,0.75,3,4.0,1.33
S. Cristal,8,2,3,3,20,12,8,9,peru2,0.25,0.75,8,4.0,1.33
FBC Melgar,8,2,3,3,12,13,-1,9,peru2,0.25,0.75,-1,4.0,1.33
Sport Huancayo,8,2,2,4,8,13,-5,8,peru2,0.25,0.75,-5,4.0,1.33
ADT,8,1,4,3,5,7,-2,7,peru2,0.12,0.88,-2,8.33,1.14
Carlos Manucci,8,2,1,5,10,13,-3,7,peru2,0.25,0.75,-3,4.0,1.33
Cienciano,8,2,1,5,8,18,-10,7,peru2,0.25,0.75,-10,4.0,1.33
D. Garcilaso,8,1,2,5,7,11,-4,5,peru2,0.12,0.88,-4,8.33,1.14
Sport Boys,8,1,2,5,5,13,-8,5,peru2,0.12,0.88,-8,8.33,1.14
Cajamarca,8,0,3,5,3,15,-12,3,peru2,0.0,1.0,-12,0.0,1.0
Los Chankas,8,0,2,6,5,13,-8,2,peru2,0.0,1.0,-8,0.0,1.0
Comerciantes U.,8,0,1,7,5,19,-14,1,peru2,0.0,1.0,-14,0.0,1.0
Union Comercio,8,0,1,7,2,18,-16,1,peru2,0.0,1.0,-16,0.0,1.0
Cesar Vallejo,8,0,0,8,6,20,-14,0,peru2,0.0,1.0,-14,0.0,1.0
DH Cebu,4,3,1,0,13,4,9,10,philippines,0.75,0.25,9,1.33,4.0
Manila Digger,3,3,0,0,7,1,6,9,philippines,1.0,0.0,6,1.0,0.0
Stallion,3,3,0,0,7,1,6,9,philippines,1.0,0.0,6,1.0,0.0
Kaya FC,3,2,1,0,7,2,5,7,philippines,0.67,0.33,5,1.49,3.03
One Taguig,3,2,1,0,5,2,3,7,philippines,0.67,0.33,3,1.49,3.03
Davao Aguilas,3,2,0,1,5,3,2,6,philippines,0.67,0.33,2,1.49,3.03
Loyola,4,2,0,2,8,9,-1,6,philippines,0.5,0.5,-1,2.0,2.0
Maharlika,3,1,0,2,5,6,-1,3,philippines,0.33,0.67,-1,3.03,1.49
PFF Development,3,0,1,2,0,8,-8,1,philippines,0.0,1.0,-8,0.0,1.0
Mendiola,5,0,1,4,5,25,-20,1,philippines,0.0,1.0,-20,0.0,1.0
Rakow C.,8,5,3,0,11,5,6,18,poland,0.62,0.38,6,1.61,2.63
Cracovia Krakow,8,5,1,2,17,11,6,16,poland,0.62,0.38,6,1.61,2.63
Gornik Zabrze,8,4,2,2,14,10,4,14,poland,0.5,0.5,4,2.0,2.0
Lech Poznan,8,4,2,2,9,6,3,14,poland,0.5,0.5,3,2.0,2.0
Jagiellonia,8,4,2,2,11,11,0,14,poland,0.5,0.5,0,2.0,2.0
Motor Lublin,8,3,2,3,13,18,-5,11,poland,0.38,0.62,-5,2.63,1.61
Legia Warsaw,8,2,4,2,13,12,1,10,poland,0.25,0.75,1,4.0,1.33
Piast Gliwice,8,3,1,4,6,7,-1,10,poland,0.38,0.62,-1,2.63,1.61
Korona Kielce,8,2,4,2,7,11,-4,10,poland,0.25,0.75,-4,4.0,1.33
Katowice,8,2,2,4,14,16,-2,8,poland,0.25,0.75,-2,4.0,1.33
Widzew Lodz,8,2,2,4,11,14,-3,8,poland,0.25,0.75,-3,4.0,1.33
Radomiak Radom,8,2,0,6,7,13,-6,6,poland,0.25,0.75,-6,4.0,1.33
Zaglebie Lubin,8,1,3,4,6,14,-8,6,poland,0.12,0.88,-8,8.33,1.14
Puszcza Niepolo,8,1,2,5,3,10,-7,5,poland,0.12,0.88,-7,8.33,1.14
Lechia Gdansk,8,1,2,5,11,19,-8,5,poland,0.12,0.88,-8,8.33,1.14
Pogon Szczecin,8,1,1,6,7,13,-6,4,poland,0.12,0.88,-6,8.33,1.14
Stal Mielec,8,1,1,6,7,13,-6,4,poland,0.12,0.88,-6,8.33,1.14
Slask Wroclaw,8,0,3,5,6,14,-8,3,poland,0.0,1.0,-8,0.0,1.0
T. Nieciecza,8,7,0,1,15,4,11,21,poland2,0.88,0.12,11,1.14,8.33
Arka Gdynia,8,5,2,1,18,6,12,17,poland2,0.62,0.38,12,1.61,2.63
Miedz Legnica,8,5,2,1,14,6,8,17,poland2,0.62,0.38,8,1.61,2.63
LKS Lodz,8,4,2,2,17,11,6,14,poland2,0.5,0.5,6,2.0,2.0
Wisla Krakow,8,4,1,3,16,10,6,13,poland2,0.5,0.5,6,2.0,2.0
Gornik Leczna,8,3,4,1,15,11,4,13,poland2,0.38,0.62,4,2.63,1.61
Ruch Chorzow,8,4,0,4,9,11,-2,12,poland2,0.5,0.5,-2,2.0,2.0
Wisla Plock,8,3,2,3,12,14,-2,11,poland2,0.38,0.62,-2,2.63,1.61
Stal Rzeszow,8,2,4,2,12,10,2,10,poland2,0.25,0.75,2,4.0,1.33
Tychy,8,2,4,2,8,10,-2,10,poland2,0.25,0.75,-2,4.0,1.33
Odra Opole,8,2,3,3,7,19,-12,9,poland2,0.25,0.75,-12,4.0,1.33
Polonia Warszaw,8,2,2,4,10,14,-4,8,poland2,0.25,0.75,-4,4.0,1.33
Znicz Pruszkow,8,1,5,2,7,11,-4,8,poland2,0.12,0.88,-4,8.33,1.14
Warta Poznan,8,2,2,4,4,13,-9,8,poland2,0.25,0.75,-9,4.0,1.33
Stalowa Wola,8,1,2,5,3,13,-10,5,poland2,0.12,0.88,-10,8.33,1.14
Chrobry Glogow,8,1,1,6,6,18,-12,4,poland2,0.12,0.88,-12,8.33,1.14
K. Kolobrzeg,8,1,1,6,6,20,-14,4,poland2,0.12,0.88,-14,8.33,1.14
Pogon Siedlce,8,1,0,7,6,14,-8,3,poland2,0.12,0.88,-8,8.33,1.14
Pogon Grodzisk,8,6,2,0,18,5,13,20,poland3,0.75,0.25,13,1.33,4.0
Wieczysta K.,8,6,1,1,20,5,15,19,poland3,0.75,0.25,15,1.33,4.0
Polonia Bytom,8,4,2,2,13,10,3,14,poland3,0.5,0.5,3,2.0,2.0
LKS Lodz B,8,4,1,3,11,12,-1,13,poland3,0.5,0.5,-1,2.0,2.0
Podbeskidzie,8,3,2,3,14,12,2,11,poland3,0.38,0.62,2,2.63,1.61
Rekord Bielsko,8,3,2,3,18,18,0,11,poland3,0.38,0.62,0,2.63,1.61
Chojniczanka,8,3,2,3,7,8,-1,11,poland3,0.38,0.62,-1,2.63,1.61
Kalisz,8,3,2,3,5,7,-2,11,poland3,0.38,0.62,-2,2.63,1.61
Z. Sosnowiec,8,2,3,3,7,9,-2,9,poland3,0.25,0.75,-2,4.0,1.33
Hutnik Krakow,8,2,3,3,9,17,-8,9,poland3,0.25,0.75,-8,4.0,1.33
Jastrzebie,8,2,2,4,7,8,-1,8,poland3,0.25,0.75,-1,4.0,1.33
O. Grudziadz,8,2,2,4,10,12,-2,8,poland3,0.25,0.75,-2,4.0,1.33
Resovia Rzeszow,8,2,1,5,10,15,-5,7,poland3,0.25,0.75,-5,4.0,1.33
Swit Skolwin,8,1,3,4,7,14,-7,6,poland3,0.12,0.88,-7,8.33,1.14
Wisla Pulawy,8,2,0,6,10,21,-11,6,poland3,0.25,0.75,-11,4.0,1.33
SKRA Czestochow,8,1,1,6,5,18,-13,4,poland3,0.12,0.88,-13,8.33,1.14
Zaglebie L. B,8,0,3,5,11,19,-8,3,poland3,0.0,1.0,-8,0.0,1.0
Olimpia Elblag,8,0,1,7,6,22,-16,1,poland3,0.0,1.0,-16,0.0,1.0
Sporting CP,7,6,0,1,25,5,20,18,portugal,0.86,0.14,20,1.16,7.14
Sporting Braga,6,4,1,1,8,3,5,13,portugal,0.67,0.33,5,1.49,3.03
FC Porto,6,3,1,2,12,7,5,10,portugal,0.5,0.5,5,2.0,2.0
Benfica,5,3,1,1,8,4,4,10,portugal,0.6,0.4,4,1.67,2.5
Santa Clara,6,3,0,3,8,8,0,9,portugal,0.5,0.5,0,2.0,2.0
Boavista,7,2,3,2,7,7,0,9,portugal,0.29,0.71,0,3.45,1.41
Famalicao,6,2,2,2,9,7,2,8,portugal,0.33,0.67,2,3.03,1.49
Guimaraes,7,2,2,3,6,6,0,8,portugal,0.29,0.71,0,3.45,1.41
Moreirense,7,2,0,5,9,13,-4,6,portugal,0.29,0.71,-4,3.45,1.41
Casa Pia,6,1,2,3,4,10,-6,5,portugal,0.17,0.83,-6,5.88,1.2
Arouca,7,1,1,5,4,14,-10,4,portugal,0.14,0.86,-10,7.14,1.16
AVS,6,0,3,3,5,11,-6,3,portugal,0.0,1.0,-6,0.0,1.0
Estoril,6,0,3,3,4,10,-6,3,portugal,0.0,1.0,-6,0.0,1.0
Farense,7,0,3,4,3,9,-6,3,portugal,0.0,1.0,-6,0.0,1.0
Rio Ave,7,1,0,6,3,16,-13,3,portugal,0.14,0.86,-13,7.14,1.16
Nacional,7,0,2,5,2,8,-6,2,portugal,0.0,1.0,-6,0.0,1.0
Gil Vicente,7,0,2,5,5,18,-13,2,portugal,0.0,1.0,-13,0.0,1.0
Estrela Amadora,6,0,1,5,2,12,-10,1,portugal,0.0,1.0,-10,0.0,1.0
Tondela,7,3,4,0,15,7,8,13,portugal2,0.43,0.57,8,2.33,1.75
Chaves,7,4,1,2,10,6,4,13,portugal2,0.57,0.43,4,1.75,2.33
Penafiel,6,4,1,1,11,8,3,13,portugal2,0.67,0.33,3,1.49,3.03
Maritimo,8,4,1,3,13,13,0,13,portugal2,0.5,0.5,0,2.0,2.0
Benfica B,6,3,2,1,11,6,5,11,portugal2,0.5,0.5,5,2.0,2.0
Academico Viseu,7,3,2,2,12,8,4,11,portugal2,0.43,0.57,4,2.33,1.75
Uniao de Leiria,7,3,1,3,12,6,6,10,portugal2,0.43,0.57,6,2.33,1.75
Felgueiras,6,2,3,1,10,7,3,9,portugal2,0.33,0.67,3,3.03,1.49
Alverca,7,2,3,2,10,8,2,9,portugal2,0.29,0.71,2,3.45,1.41
Vizela,7,2,3,2,7,7,0,9,portugal2,0.29,0.71,0,3.45,1.41
Portimonense,7,2,3,2,8,9,-1,9,portugal2,0.29,0.71,-1,3.45,1.41
Pacos Ferreira,6,2,1,3,8,9,-1,7,portugal2,0.33,0.67,-1,3.03,1.49
Torreense,6,2,1,3,6,8,-2,7,portugal2,0.33,0.67,-2,3.03,1.49
Mafra,6,1,3,2,6,7,-1,6,portugal2,0.17,0.83,-1,5.88,1.2
Feirense,6,1,2,3,1,3,-2,5,portugal2,0.17,0.83,-2,5.88,1.2
Leixoes,6,1,2,3,3,6,-3,5,portugal2,0.17,0.83,-3,5.88,1.2
FC Porto B,7,0,3,4,6,13,-7,3,portugal2,0.0,1.0,-7,0.0,1.0
Oliveirense,6,0,2,4,6,13,-7,2,portugal2,0.0,1.0,-7,0.0,1.0
Al Duhail,6,5,0,1,21,5,16,15,qatar,0.83,0.17,16,1.2,5.88
Al Ahli Doha,5,3,2,0,12,6,6,11,qatar,0.6,0.4,6,1.67,2.5
Al Sadd,6,3,1,2,17,12,5,10,qatar,0.5,0.5,5,2.0,2.0
Al Shamal,6,3,1,2,10,8,2,10,qatar,0.5,0.5,2,2.0,2.0
Al Gharafa,6,2,2,2,10,9,1,8,qatar,0.33,0.67,1,3.03,1.49
Al Wakrah,5,2,1,2,6,6,0,7,qatar,0.4,0.6,0,2.5,1.67
Qatar SC,4,2,1,1,6,7,-1,7,qatar,0.5,0.5,-1,2.0,2.0
Umm Salal,6,2,0,4,8,11,-3,6,qatar,0.33,0.67,-3,3.03,1.49
Al Rayyan,6,2,0,4,7,12,-5,6,qatar,0.33,0.67,-5,3.03,1.49
Al Khor,5,1,2,2,5,7,-2,5,qatar,0.2,0.8,-2,5.0,1.25
Al Shahaniya,6,1,1,4,10,15,-5,4,qatar,0.17,0.83,-5,5.88,1.2
Al Arabi,5,0,2,3,6,16,-10,2,qatar,0.0,1.0,-10,0.0,1.0
CFR Cluj,8,4,3,1,10,4,6,15,romania,0.5,0.5,6,2.0,2.0
FCSB,8,4,2,2,12,8,4,14,romania,0.5,0.5,4,2.0,2.0
U. Cluj,8,4,2,2,12,8,4,14,romania,0.5,0.5,4,2.0,2.0
Din. Bucharest,8,3,4,1,9,6,3,13,romania,0.38,0.62,3,2.63,1.61
Petrolul,8,3,4,1,9,7,2,13,romania,0.38,0.62,2,2.63,1.61
Rapid Bucharest,8,2,4,2,7,9,-2,10,romania,0.25,0.75,-2,4.0,1.33
Sepsi OSK,8,2,3,3,13,14,-1,9,romania,0.25,0.75,-1,4.0,1.33
Univ. Craiova,8,2,3,3,10,12,-2,9,romania,0.25,0.75,-2,4.0,1.33
UTA Arad,8,3,0,5,5,8,-3,9,romania,0.38,0.62,-3,2.63,1.61
Unirea Slobozia,8,3,0,5,7,14,-7,9,romania,0.38,0.62,-7,2.63,1.61
Farul Constanta,8,1,5,2,6,11,-5,8,romania,0.12,0.88,-5,8.33,1.14
Otelul,8,1,4,3,3,6,-3,7,romania,0.12,0.88,-3,8.33,1.14
P. Iasi,8,1,2,5,6,16,-10,5,romania,0.12,0.88,-10,8.33,1.14
Hermannstadt,8,1,1,6,7,17,-10,4,romania,0.12,0.88,-10,8.33,1.14
FC Buzau,8,1,1,6,10,21,-11,4,romania,0.12,0.88,-11,8.33,1.14
Botosani,8,0,3,5,4,13,-9,3,romania,0.0,1.0,-9,0.0,1.0
Zenit,8,6,1,1,17,4,13,19,russia,0.75,0.25,13,1.33,4.0
CSKA Moscow,8,6,1,1,13,5,8,19,russia,0.75,0.25,8,1.33,4.0
FC Krasnodar,8,5,3,0,17,6,11,18,russia,0.62,0.38,11,1.61,2.63
Lokomotiv M.,8,4,2,2,16,11,5,14,russia,0.5,0.5,5,2.0,2.0
Spartak Moscow,8,4,2,2,12,7,5,14,russia,0.5,0.5,5,2.0,2.0
Dinamo Moscow,8,3,4,1,15,10,5,13,russia,0.38,0.62,5,2.63,1.61
Rubin Kazan,8,3,3,2,10,9,1,12,russia,0.38,0.62,1,2.63,1.61
Akron,8,2,3,3,7,15,-8,9,russia,0.25,0.75,-8,4.0,1.33
Krylya Sovetov,8,2,2,4,9,12,-3,8,russia,0.25,0.75,-3,4.0,1.33
Rostov,8,2,2,4,9,17,-8,8,russia,0.25,0.75,-8,4.0,1.33
Nizhny Novgorod,8,2,2,4,8,16,-8,8,russia,0.25,0.75,-8,4.0,1.33
Makhachkala,8,1,4,3,3,7,-4,7,russia,0.12,0.88,-4,8.33,1.14
Khimki,8,1,3,4,9,19,-10,6,russia,0.12,0.88,-10,8.33,1.14
Akhmat Grozny,8,1,2,5,6,14,-8,5,russia,0.12,0.88,-8,8.33,1.14
Fakel Voronezh,8,1,2,5,6,16,-10,5,russia,0.12,0.88,-10,8.33,1.14
Orenburg,8,0,1,7,3,13,-10,1,russia,0.0,1.0,-10,0.0,1.0
Baltika,8,6,0,2,12,7,5,18,russia2,0.75,0.25,5,1.33,4.0
Chernomorets,8,5,1,2,13,11,2,16,russia2,0.62,0.38,2,1.61,2.63
Torpedo Moscow,8,3,5,0,12,7,5,14,russia2,0.38,0.62,5,2.63,1.61
Rotor Volgograd,8,3,3,2,8,8,0,12,russia2,0.38,0.62,0,2.63,1.61
PFC Sochi,8,2,5,1,11,10,1,11,russia2,0.25,0.75,1,4.0,1.33
Ural,8,3,2,3,10,10,0,11,russia2,0.38,0.62,0,2.63,1.61
Shinnik,8,1,5,2,5,8,-3,8,russia2,0.12,0.88,-3,8.33,1.14
Chayka,8,2,2,4,4,12,-8,8,russia2,0.25,0.75,-8,4.0,1.33
SKA Khabarovsk,8,1,4,3,7,12,-5,7,russia2,0.12,0.88,-5,8.33,1.14
Neftekhimik,8,1,3,4,6,8,-2,6,russia2,0.12,0.88,-2,8.33,1.14
Arsenal Tula,8,0,6,2,7,10,-3,6,russia2,0.0,1.0,-3,0.0,1.0
Rodina Moskva,8,1,3,4,6,10,-4,6,russia2,0.12,0.88,-4,8.33,1.14
A. Vladikavkaz,8,1,3,4,2,10,-8,6,russia2,0.12,0.88,-8,8.33,1.14
Kamaz,8,1,2,5,5,9,-4,5,russia2,0.12,0.88,-4,8.33,1.14
Ufa,8,1,2,5,5,12,-7,5,russia2,0.12,0.88,-7,8.33,1.14
Sokol Saratov,8,1,2,5,4,17,-13,5,russia2,0.12,0.88,-13,8.33,1.14
Yenisey,8,1,1,6,7,17,-10,4,russia2,0.12,0.88,-10,8.33,1.14
Tyumen,8,1,0,7,5,15,-10,3,russia2,0.12,0.88,-10,8.33,1.14
Al Hilal,7,5,1,1,17,8,9,16,saudiarabia,0.71,0.29,9,1.41,3.45
Al Ittihad,6,5,0,1,11,4,7,15,saudiarabia,0.83,0.17,7,1.2,5.88
Al Riyadh,7,4,2,1,11,9,2,14,saudiarabia,0.57,0.43,2,1.75,2.33
Al Nassr,6,4,1,1,14,7,7,13,saudiarabia,0.67,0.33,7,1.49,3.03
Al Shabab,6,4,1,1,8,2,6,13,saudiarabia,0.67,0.33,6,1.49,3.03
Al Quadisiya,7,4,1,2,10,6,4,13,saudiarabia,0.57,0.43,4,1.75,2.33
Al Ittifaq,7,3,3,1,8,7,1,12,saudiarabia,0.43,0.57,1,2.33,1.75
Al Ahli Jeddah,7,3,1,3,9,6,3,10,saudiarabia,0.43,0.57,3,2.33,1.75
Al Khaleej,6,3,0,3,7,9,-2,9,saudiarabia,0.5,0.5,-2,2.0,2.0
Al Kholood,7,2,2,3,7,9,-2,8,saudiarabia,0.29,0.71,-2,3.45,1.41
Al Akhdoud,6,2,1,3,9,10,-1,7,saudiarabia,0.33,0.67,-1,3.03,1.49
Al Raed,7,2,1,4,10,12,-2,7,saudiarabia,0.29,0.71,-2,3.45,1.41
Al Orubah,8,2,1,5,9,19,-10,7,saudiarabia,0.25,0.75,-10,4.0,1.33
Al Taawon,6,1,1,4,4,8,-4,4,saudiarabia,0.17,0.83,-4,5.88,1.2
Al Feiha,7,0,4,3,5,11,-6,4,saudiarabia,0.0,1.0,-6,0.0,1.0
Damak,6,1,0,5,8,14,-6,3,saudiarabia,0.17,0.83,-6,5.88,1.2
Al Fateh,6,0,1,5,3,12,-9,1,saudiarabia,0.0,1.0,-9,0.0,1.0
Al Wahda,5,0,1,4,4,15,-11,1,saudiarabia,0.0,1.0,-11,0.0,1.0
Neom SC,6,5,0,1,14,5,9,15,saudiarabia2,0.83,0.17,9,1.2,5.88
Al Tai,6,3,2,1,5,5,0,11,saudiarabia2,0.5,0.5,0,2.0,2.0
Al Bukayriyah,6,3,1,2,7,4,3,10,saudiarabia2,0.5,0.5,3,2.0,2.0
Al Arabi,6,3,1,2,7,8,-1,10,saudiarabia2,0.5,0.5,-1,2.0,2.0
Abha,6,3,0,3,7,11,-4,9,saudiarabia2,0.5,0.5,-4,2.0,2.0
Al Jubail,5,2,2,1,4,2,2,8,saudiarabia2,0.4,0.6,2,2.5,1.67
Jeddah,6,2,2,2,7,9,-2,8,saudiarabia2,0.33,0.67,-2,3.03,1.49
Al Hazm,6,2,1,3,9,11,-2,7,saudiarabia2,0.33,0.67,-2,3.03,1.49
Al Ain,7,2,1,4,7,9,-2,7,saudiarabia2,0.29,0.71,-2,3.45,1.41
Al Najma,6,2,1,3,6,9,-3,7,saudiarabia2,0.33,0.67,-3,3.03,1.49
Al Safa,6,2,1,3,4,7,-3,7,saudiarabia2,0.33,0.67,-3,3.03,1.49
Al Batin,7,1,4,2,7,12,-5,7,saudiarabia2,0.14,0.86,-5,7.14,1.16
Al Jandal,7,2,1,4,6,11,-5,7,saudiarabia2,0.29,0.71,-5,3.45,1.41
Al Jabalain,6,1,3,2,5,7,-2,6,saudiarabia2,0.17,0.83,-2,5.88,1.2
Al Faisaly,6,2,0,4,6,9,-3,6,saudiarabia2,0.33,0.67,-3,3.03,1.49
Al Adalha,7,1,3,3,5,9,-4,6,saudiarabia2,0.14,0.86,-4,7.14,1.16
Al Zulfi,6,0,2,4,4,11,-7,2,saudiarabia2,0.0,1.0,-7,0.0,1.0
Ohod,5,0,1,4,3,9,-6,1,saudiarabia2,0.0,1.0,-6,0.0,1.0
Celtic,8,8,0,0,23,2,21,24,scotland,1.0,0.0,21,1.0,0.0
Aberdeen,7,3,3,1,12,10,2,12,scotland,0.43,0.57,2,2.33,1.75
Motherwell,8,4,0,4,11,13,-2,12,scotland,0.5,0.5,-2,2.0,2.0
Dundee Utd,7,2,4,1,8,7,1,10,scotland,0.29,0.71,1,3.45,1.41
Rangers,7,3,1,3,6,6,0,10,scotland,0.43,0.57,0,2.33,1.75
Kilmarnock,8,2,2,4,11,18,-7,8,scotland,0.25,0.75,-7,4.0,1.33
Dundee FC,8,1,3,4,7,15,-8,6,scotland,0.12,0.88,-8,8.33,1.14
St. Johnstone,8,1,2,5,8,16,-8,5,scotland,0.12,0.88,-8,8.33,1.14
Hibernian,8,1,2,5,7,15,-8,5,scotland,0.12,0.88,-8,8.33,1.14
Hearts,8,1,1,6,8,16,-8,4,scotland,0.12,0.88,-8,8.33,1.14
St. Mirren,7,1,1,5,7,16,-9,4,scotland,0.14,0.86,-9,7.14,1.16
Ross County,7,0,3,4,1,18,-17,3,scotland,0.0,1.0,-17,0.0,1.0
Falkirk,8,5,1,2,12,6,6,16,scotland2,0.62,0.38,6,1.61,2.63
Livingston,8,3,4,1,7,6,1,13,scotland2,0.38,0.62,1,2.63,1.61
Queens Park,8,3,2,3,10,11,-1,11,scotland2,0.38,0.62,-1,2.63,1.61
Ayr Utd,8,2,3,3,6,8,-2,9,scotland2,0.25,0.75,-2,4.0,1.33
Partick Thistle,6,2,1,3,4,5,-1,7,scotland2,0.33,0.67,-1,3.03,1.49
Greenock Morton,8,1,3,4,4,14,-10,6,scotland2,0.12,0.88,-10,8.33,1.14
Hamilton,8,1,2,5,12,18,-6,5,scotland2,0.12,0.88,-6,8.33,1.14
Dunfermline,7,0,1,6,3,10,-7,1,scotland2,0.0,1.0,-7,0.0,1.0
Airdrieonians,8,0,1,7,4,14,-10,1,scotland2,0.0,1.0,-10,0.0,1.0
Raith Rovers,7,0,1,6,2,13,-11,1,scotland2,0.0,1.0,-11,0.0,1.0
Cove Rangers,8,4,2,2,15,8,7,14,scotland3,0.5,0.5,7,2.0,2.0
Alloa Athletic,8,3,4,1,10,7,3,13,scotland3,0.38,0.62,3,2.63,1.61
Kelty Hearts,8,3,3,2,15,8,7,12,scotland3,0.38,0.62,7,2.63,1.61
Arbroath,6,2,2,2,10,9,1,8,scotland3,0.33,0.67,1,3.03,1.49
Montrose,8,2,2,4,4,5,-1,8,scotland3,0.25,0.75,-1,4.0,1.33
Inverness,7,2,2,3,8,10,-2,8,scotland3,0.29,0.71,-2,3.45,1.41
Stenhousemuir,8,2,2,4,7,9,-2,8,scotland3,0.25,0.75,-2,4.0,1.33
Dumbarton,8,1,4,3,8,14,-6,7,scotland3,0.12,0.88,-6,8.33,1.14
Annan Athletic,8,1,0,7,5,21,-16,3,scotland3,0.12,0.88,-16,8.33,1.14
Queen of South,8,0,2,6,2,9,-7,2,scotland3,0.0,1.0,-7,0.0,1.0
Elgin City,8,3,3,2,8,7,1,12,scotland4,0.38,0.62,1,2.63,1.61
Edinburgh City,7,3,2,2,13,10,3,11,scotland4,0.43,0.57,3,2.33,1.75
Peterhead,7,3,2,2,10,7,3,11,scotland4,0.43,0.57,3,2.33,1.75
Stirling Albion,7,3,1,3,9,9,0,10,scotland4,0.43,0.57,0,2.33,1.75
East Fife,7,2,2,3,10,10,0,8,scotland4,0.29,0.71,0,3.45,1.41
Bonnyrigg Rose,7,2,2,3,9,14,-5,8,scotland4,0.29,0.71,-5,3.45,1.41
Spartans,7,1,3,3,8,9,-1,6,scotland4,0.14,0.86,-1,7.14,1.16
Stranraer,7,2,0,5,5,9,-4,6,scotland4,0.29,0.71,-4,3.45,1.41
Forfar Athletic,7,1,0,6,5,11,-6,3,scotland4,0.14,0.86,-6,7.14,1.16
Clyde,6,0,2,4,5,13,-8,2,scotland4,0.0,1.0,-8,0.0,1.0
Red Star,8,8,0,0,24,3,21,24,serbia,1.0,0.0,21,1.0,0.0
Partizan,8,6,1,1,17,8,9,19,serbia,0.75,0.25,9,1.33,4.0
Mladost Lucani,8,5,3,0,10,5,5,18,serbia,0.62,0.38,5,1.61,2.63
Radnicki 1923,8,4,2,2,17,11,6,14,serbia,0.5,0.5,6,2.0,2.0
OFK Beograd,8,4,2,2,8,6,2,14,serbia,0.5,0.5,2,2.0,2.0
Vojvodina,8,3,3,2,15,9,6,12,serbia,0.38,0.62,6,2.63,1.61
Backa Topola,8,3,2,3,13,11,2,11,serbia,0.38,0.62,2,2.63,1.61
Cukaricki,8,2,4,2,11,13,-2,10,serbia,0.25,0.75,-2,4.0,1.33
Z. Pancevo,8,3,0,5,7,11,-4,9,serbia,0.38,0.62,-4,2.63,1.61
Novi Pazar,8,2,2,4,9,13,-4,8,serbia,0.25,0.75,-4,4.0,1.33
IMT N. Beograd,8,2,1,5,12,16,-4,7,serbia,0.25,0.75,-4,4.0,1.33
Radnicki Nis,8,2,1,5,12,23,-11,7,serbia,0.25,0.75,-11,4.0,1.33
Napredak,8,1,3,4,5,10,-5,6,serbia,0.12,0.88,-5,8.33,1.14
S. Subotica,8,1,3,4,5,11,-6,6,serbia,0.12,0.88,-6,8.33,1.14
Tekstilac Odzac,8,1,1,6,3,19,-16,4,serbia,0.12,0.88,-16,8.33,1.14
Jedinstvo U.,8,0,1,7,5,19,-14,1,serbia,0.0,1.0,-14,0.0,1.0
Javor Ivanjica,8,3,4,1,9,5,4,13,serbia2,0.38,0.62,4,2.63,1.61
Vrsac,8,3,3,2,10,10,0,12,serbia2,0.38,0.62,0,2.63,1.61
Mladost,8,2,5,1,7,5,2,11,serbia2,0.25,0.75,2,4.0,1.33
R. Surdulica,8,3,2,3,7,5,2,11,serbia2,0.38,0.62,2,2.63,1.61
Dubocica,8,2,4,2,10,9,1,10,serbia2,0.25,0.75,1,4.0,1.33
Macva Sabac,8,3,1,4,6,8,-2,10,serbia2,0.38,0.62,-2,2.63,1.61
Vozdovac,8,3,0,5,7,10,-3,9,serbia2,0.38,0.62,-3,2.63,1.61
Indija,8,2,3,3,5,9,-4,9,serbia2,0.25,0.75,-4,4.0,1.33
Trajal Krusevac,8,2,1,5,7,10,-3,7,serbia2,0.25,0.75,-3,4.0,1.33
Borac Cacak,8,1,3,4,6,16,-10,6,serbia2,0.12,0.88,-10,8.33,1.14
Smederevo,8,2,0,6,3,14,-11,6,serbia2,0.25,0.75,-11,4.0,1.33
Zemun,8,0,5,3,7,12,-5,5,serbia2,0.0,1.0,-5,0.0,1.0
S. Mitrovica,8,0,5,3,3,9,-6,5,serbia2,0.0,1.0,-6,0.0,1.0
Sloboda Uzice,8,1,1,6,5,11,-6,4,serbia2,0.12,0.88,-6,8.33,1.14
Graficar,8,1,1,6,7,16,-9,4,serbia2,0.12,0.88,-9,8.33,1.14
Sloven Ruma,8,0,2,6,3,16,-13,2,serbia2,0.0,1.0,-13,0.0,1.0
Geylang,8,5,3,0,30,12,18,18,singapore,0.62,0.38,18,1.61,2.63
Lion City,8,5,2,1,26,9,17,17,singapore,0.62,0.38,17,1.61,2.63
Tampines Rovers,8,5,2,1,22,8,14,17,singapore,0.62,0.38,14,1.61,2.63
Young Lions,8,3,2,3,16,15,1,11,singapore,0.38,0.62,1,2.63,1.61
DPMM FC,8,3,1,4,17,20,-3,10,singapore,0.38,0.62,-3,2.63,1.61
A. Niigata (S),8,3,1,4,10,19,-9,10,singapore,0.38,0.62,-9,2.63,1.61
Khalsa,8,2,3,3,25,24,1,9,singapore,0.25,0.75,1,4.0,1.33
Hougang,8,1,2,5,11,25,-14,5,singapore,0.12,0.88,-14,8.33,1.14
Tanjong Pagar,8,0,1,7,8,34,-26,1,singapore,0.0,1.0,-26,0.0,1.0
S. Bratislava,8,6,1,1,17,9,8,19,slovakia,0.75,0.25,8,1.33,4.0
Spartak Trnava,8,5,2,1,15,8,7,17,slovakia,0.62,0.38,7,1.61,2.63
Zilina,8,4,3,1,15,5,10,15,slovakia,0.5,0.5,10,2.0,2.0
DAC Streda,8,4,3,1,13,5,8,15,slovakia,0.5,0.5,8,2.0,2.0
Podbrezova,8,3,2,3,9,12,-3,11,slovakia,0.38,0.62,-3,2.63,1.61
Komarno,8,3,1,4,10,17,-7,10,slovakia,0.38,0.62,-7,2.63,1.61
FC Kosice,8,2,3,3,10,11,-1,9,slovakia,0.25,0.75,-1,4.0,1.33
Z. Michalovce,8,2,2,4,9,14,-5,8,slovakia,0.25,0.75,-5,4.0,1.33
Ruzomberok,8,1,2,5,10,16,-6,5,slovakia,0.12,0.88,-6,8.33,1.14
Banska Bystrica,8,0,4,4,5,11,-6,4,slovakia,0.0,1.0,-6,0.0,1.0
Trencin,8,0,4,4,8,18,-10,4,slovakia,0.0,1.0,-10,0.0,1.0
Skalica,8,1,1,6,9,21,-12,4,slovakia,0.12,0.88,-12,8.33,1.14
Presov,7,5,1,1,13,8,5,16,slovakia2,0.71,0.29,5,1.41,3.45
Zlate Moravce,7,5,0,2,6,3,3,15,slovakia2,0.71,0.29,3,1.41,3.45
L. Mikulas,7,3,3,1,13,10,3,12,slovakia2,0.43,0.57,3,2.33,1.75
Petrzalka,7,3,2,2,8,6,2,11,slovakia2,0.43,0.57,2,2.33,1.75
Malzenice,5,2,1,2,8,7,1,7,slovakia2,0.4,0.6,1,2.5,1.67
S. Bratislava B,8,2,0,6,9,14,-5,6,slovakia2,0.25,0.75,-5,4.0,1.33
Puchov,7,1,3,3,7,12,-5,6,slovakia2,0.14,0.86,-5,7.14,1.16
Zilina B,7,2,0,5,7,15,-8,6,slovakia2,0.29,0.71,-8,3.45,1.41
Samorin,8,2,0,6,10,19,-9,6,slovakia2,0.25,0.75,-9,4.0,1.33
Humenne,7,1,2,4,6,10,-4,5,slovakia2,0.14,0.86,-4,7.14,1.16
P. Bystrica,7,1,2,4,6,12,-6,5,slovakia2,0.14,0.86,-6,7.14,1.16
Pohronie,7,1,2,4,7,15,-8,5,slovakia2,0.14,0.86,-8,7.14,1.16
Zvolen,7,1,1,5,3,15,-12,4,slovakia2,0.14,0.86,-12,7.14,1.16
S. Lubovna,7,1,0,6,5,9,-4,3,slovakia2,0.14,0.86,-4,7.14,1.16
NK Olimpija,8,5,3,0,9,2,7,18,slovenia,0.62,0.38,7,1.61,2.63
Koper,8,5,0,3,11,6,5,15,slovenia,0.62,0.38,5,1.61,2.63
Maribor,8,3,3,2,10,6,4,12,slovenia,0.38,0.62,4,2.63,1.61
NK Celje,8,3,3,2,14,11,3,12,slovenia,0.38,0.62,3,2.63,1.61
Bravo,8,3,3,2,12,11,1,12,slovenia,0.38,0.62,1,2.63,1.61
Primorje,8,3,2,3,12,16,-4,11,slovenia,0.38,0.62,-4,2.63,1.61
Radomlje,8,2,1,5,7,10,-3,7,slovenia,0.25,0.75,-3,4.0,1.33
Mura,8,1,2,5,9,15,-6,5,slovenia,0.12,0.88,-6,8.33,1.14
Domzale,8,1,2,5,6,17,-11,5,slovenia,0.12,0.88,-11,8.33,1.14
Nafta,8,0,1,7,3,19,-16,1,slovenia,0.0,1.0,-16,0.0,1.0
Stellenbosch,4,2,2,0,4,1,3,8,southafrica,0.5,0.5,3,2.0,2.0
Kaizer Chiefs,5,2,1,2,7,7,0,7,southafrica,0.4,0.6,0,2.5,1.67
Orlando Pirates,2,2,0,0,3,0,3,6,southafrica,1.0,0.0,3,1.0,0.0
TS Galaxy,7,1,3,3,7,8,-1,6,southafrica,0.14,0.86,-1,7.14,1.16
Golden Arrows,4,2,0,2,5,6,-1,6,southafrica,0.5,0.5,-1,2.0,2.0
Polokwane,5,2,0,3,3,6,-3,6,southafrica,0.4,0.6,-3,2.5,1.67
SuperSport Utd,6,1,2,3,1,5,-4,5,southafrica,0.17,0.83,-4,5.88,1.2
Magesi,5,1,1,3,2,6,-4,4,southafrica,0.2,0.8,-4,5.0,1.25
Mamelodi S.,2,1,0,1,2,2,0,3,southafrica,0.5,0.5,0,2.0,2.0
Royal AM,4,0,3,1,3,4,-1,3,southafrica,0.0,1.0,-1,0.0,1.0
AmaZulu,5,1,0,4,5,7,-2,3,southafrica,0.2,0.8,-2,5.0,1.25
Tshakhuma,4,1,0,3,2,7,-5,3,southafrica,0.25,0.75,-5,4.0,1.33
Chippa Utd,3,0,1,2,2,5,-3,1,southafrica,0.0,1.0,-3,0.0,1.0
Richards Bay,5,0,1,4,1,6,-5,1,southafrica,0.0,1.0,-5,0.0,1.0
Cape Town City,5,0,1,4,3,11,-8,1,southafrica,0.0,1.0,-8,0.0,1.0
Sekhukhune,2,0,0,2,0,5,-5,0,southafrica,0.0,1.0,-5,0.0,1.0
Orbit College,7,4,2,1,10,7,3,14,southafrica2,0.57,0.43,3,1.75,2.33
Milford,7,3,2,2,10,9,1,11,southafrica2,0.43,0.57,1,2.33,1.75
Casric Stars,8,3,2,3,7,8,-1,11,southafrica2,0.38,0.62,-1,2.63,1.61
JDR Stars,7,3,1,3,7,7,0,10,southafrica2,0.43,0.57,0,2.33,1.75
Durban City,6,2,3,1,7,5,2,9,southafrica2,0.33,0.67,2,3.03,1.49
Kruger United,6,2,2,2,8,5,3,8,southafrica2,0.33,0.67,3,3.03,1.49
Upington City,6,2,2,2,6,5,1,8,southafrica2,0.33,0.67,1,3.03,1.49
Pretoria C.,7,2,2,3,4,6,-2,8,southafrica2,0.29,0.71,-2,3.45,1.41
Baroka,7,2,2,3,5,8,-3,8,southafrica2,0.29,0.71,-3,3.45,1.41
Hungry Lions,7,2,1,4,9,10,-1,7,southafrica2,0.29,0.71,-1,3.45,1.41
Black Leopards,5,2,1,2,8,9,-1,7,southafrica2,0.4,0.6,-1,2.5,1.67
Pretoria U.,6,2,1,3,2,4,-2,7,southafrica2,0.33,0.67,-2,3.03,1.49
Highbury,6,1,3,2,6,5,1,6,southafrica2,0.17,0.83,1,5.88,1.2
Venda FC,7,1,1,5,8,14,-6,4,southafrica2,0.14,0.86,-6,7.14,1.16
Leruma United,5,1,0,4,2,11,-9,3,southafrica2,0.2,0.8,-9,5.0,1.25
Cape Town Spurs,7,0,2,5,0,7,-7,2,southafrica2,0.0,1.0,-7,0.0,1.0
Daejeon Citizen,8,4,3,1,13,9,4,15,southkorea,0.5,0.5,4,2.0,2.0
Seoul,8,4,2,2,9,7,2,14,southkorea,0.5,0.5,2,2.0,2.0
Incheon Utd,8,4,1,3,9,7,2,13,southkorea,0.5,0.5,2,2.0,2.0
Ulsan,8,3,3,2,5,4,1,12,southkorea,0.38,0.62,1,2.63,1.61
Gwangju,8,3,1,4,5,8,-3,10,southkorea,0.38,0.62,-3,2.63,1.61
Daegu,8,2,3,3,11,10,1,9,southkorea,0.25,0.75,1,4.0,1.33
Gimcheon Sangmu,8,3,0,5,10,11,-1,9,southkorea,0.38,0.62,-1,2.63,1.61
Jeonbuk Motors,8,2,2,4,13,14,-1,8,southkorea,0.25,0.75,-1,4.0,1.33
Gangwon,8,2,1,5,8,15,-7,7,southkorea,0.25,0.75,-7,4.0,1.33
Jeju Utd,8,2,1,5,8,17,-9,7,southkorea,0.25,0.75,-9,4.0,1.33
Suwon City,8,1,3,4,8,12,-4,6,southkorea,0.12,0.88,-4,8.33,1.14
Pohang Steelers,8,1,2,5,13,17,-4,5,southkorea,0.12,0.88,-4,8.33,1.14
Busan IPark,8,6,0,2,17,11,6,18,southkorea2,0.75,0.25,6,1.33,4.0
Seoul E-Land,8,4,3,1,15,7,8,15,southkorea2,0.5,0.5,8,2.0,2.0
Asan,8,5,0,3,14,10,4,15,southkorea2,0.62,0.38,4,1.61,2.63
Gimpo,8,3,3,2,8,6,2,12,southkorea2,0.38,0.62,2,2.63,1.61
Cheonan City,8,3,3,2,14,13,1,12,southkorea2,0.38,0.62,1,2.63,1.61
Suwon Bluewings,8,2,5,1,10,8,2,11,southkorea2,0.25,0.75,2,4.0,1.33
Jeonnam,8,3,1,4,13,11,2,10,southkorea2,0.38,0.62,2,2.63,1.61
Cheongju,8,2,3,3,5,7,-2,9,southkorea2,0.25,0.75,-2,4.0,1.33
Anyang,8,2,2,4,8,9,-1,8,southkorea2,0.25,0.75,-1,4.0,1.33
Bucheon FC,8,2,2,4,11,13,-2,8,southkorea2,0.25,0.75,-2,4.0,1.33
Ansan Greeners,8,1,2,5,8,13,-5,5,southkorea2,0.12,0.88,-5,8.33,1.14
Gyeongnam,8,0,5,3,8,14,-6,5,southkorea2,0.0,1.0,-6,0.0,1.0
Seongnam,8,0,3,5,6,18,-12,3,southkorea2,0.0,1.0,-12,0.0,1.0
Real Madrid,8,4,3,1,14,6,8,15,spain,0.5,0.5,8,2.0,2.0
Atletico Madrid,8,4,3,1,12,5,7,15,spain,0.5,0.5,7,2.0,2.0
FC Barcelona,8,4,2,2,23,11,12,14,spain,0.5,0.5,12,2.0,2.0
Real Sociedad,8,4,2,2,7,2,5,14,spain,0.5,0.5,5,2.0,2.0
Villarreal,8,4,2,2,11,11,0,14,spain,0.5,0.5,0,2.0,2.0
Mallorca,8,4,0,4,9,10,-1,12,spain,0.5,0.5,-1,2.0,2.0
Athletic Bilbao,7,3,2,2,10,8,2,11,spain,0.43,0.57,2,2.33,1.75
Rayo Vallecano,8,3,2,3,6,6,0,11,spain,0.38,0.62,0,2.63,1.61
Girona,8,2,3,3,7,10,-3,9,spain,0.25,0.75,-3,4.0,1.33
Las Palmas,8,3,0,5,11,15,-4,9,spain,0.38,0.62,-4,2.63,1.61
Sevilla FC,8,1,3,4,10,15,-5,6,spain,0.12,0.88,-5,8.33,1.14
Real Betis,8,1,3,4,6,12,-6,6,spain,0.12,0.88,-6,8.33,1.14
Osasuna,7,1,3,3,5,13,-8,6,spain,0.14,0.86,-8,7.14,1.16
Leganes,8,0,5,3,8,13,-5,5,spain,0.0,1.0,-5,0.0,1.0
Celta Vigo,7,1,1,5,10,18,-8,4,spain,0.14,0.86,-8,7.14,1.16
Alaves,8,1,1,6,9,17,-8,4,spain,0.12,0.88,-8,8.33,1.14
Valladolid,8,1,0,7,6,22,-16,3,spain,0.12,0.88,-16,8.33,1.14
Getafe,7,0,2,5,3,9,-6,2,spain,0.0,1.0,-6,0.0,1.0
Valencia,7,0,2,5,3,13,-10,2,spain,0.0,1.0,-10,0.0,1.0
Espanyol,8,0,1,7,4,18,-14,1,spain,0.0,1.0,-14,0.0,1.0
Racing,8,6,1,1,10,7,3,19,spain2,0.75,0.25,3,1.33,4.0
Castellon,8,4,3,1,16,10,6,15,spain2,0.5,0.5,6,2.0,2.0
Granada,8,4,2,2,13,11,2,14,spain2,0.5,0.5,2,2.0,2.0
Deportivo,8,3,2,3,17,12,5,11,spain2,0.38,0.62,5,2.63,1.61
Almeria,8,3,2,3,13,14,-1,11,spain2,0.38,0.62,-1,2.63,1.61
Mirandes,8,3,2,3,7,8,-1,11,spain2,0.38,0.62,-1,2.63,1.61
Real Zaragoza,8,2,4,2,10,10,0,10,spain2,0.25,0.75,0,4.0,1.33
Sporting Gijon,8,2,3,3,11,10,1,9,spain2,0.25,0.75,1,4.0,1.33
Elche,8,2,3,3,7,7,0,9,spain2,0.25,0.75,0,4.0,1.33
Albacete,8,2,2,4,10,13,-3,8,spain2,0.25,0.75,-3,4.0,1.33
Cadiz,8,2,2,4,9,12,-3,8,spain2,0.25,0.75,-3,4.0,1.33
Levante,8,2,2,4,7,10,-3,8,spain2,0.25,0.75,-3,4.0,1.33
Huesca,8,2,1,5,8,8,0,7,spain2,0.25,0.75,0,4.0,1.33
Real Oviedo,8,1,4,3,9,13,-4,7,spain2,0.12,0.88,-4,8.33,1.14
Racing Ferrol,8,1,4,3,3,7,-4,7,spain2,0.12,0.88,-4,8.33,1.14
Malaga,8,0,6,2,6,10,-4,6,spain2,0.0,1.0,-4,0.0,1.0
Cartagena,8,2,0,6,6,12,-6,6,spain2,0.25,0.75,-6,4.0,1.33
Burgos,8,2,0,6,5,13,-8,6,spain2,0.25,0.75,-8,4.0,1.33
Eibar,8,1,1,6,4,9,-5,4,spain2,0.12,0.88,-5,8.33,1.14
Eldense,8,1,1,6,6,13,-7,4,spain2,0.12,0.88,-7,8.33,1.14
Tenerife,8,0,2,6,6,18,-12,2,spain2,0.0,1.0,-12,0.0,1.0
Cordoba,8,0,1,7,3,19,-16,1,spain2,0.0,1.0,-16,0.0,1.0
AIK,8,6,0,2,9,5,4,18,sweden,0.75,0.25,4,1.33,4.0
Hammarby,8,5,1,2,13,3,10,16,sweden,0.62,0.38,10,1.61,2.63
Sirius,8,4,1,3,12,11,1,13,sweden,0.5,0.5,1,2.0,2.0
Elfsborg,8,3,3,2,15,14,1,12,sweden,0.38,0.62,1,2.63,1.61
Malmo FF,8,2,5,1,11,10,1,11,sweden,0.25,0.75,1,4.0,1.33
Hacken,8,3,2,3,13,14,-1,11,sweden,0.38,0.62,-1,2.63,1.61
GAIS,8,3,2,3,8,10,-2,11,sweden,0.38,0.62,-2,2.63,1.61
Djurgarden,8,3,1,4,6,13,-7,10,sweden,0.38,0.62,-7,2.63,1.61
IFK Goteborg,8,2,3,3,10,11,-1,9,sweden,0.25,0.75,-1,4.0,1.33
Norrkoping,8,2,3,3,9,11,-2,9,sweden,0.25,0.75,-2,4.0,1.33
Mjallby,8,2,3,3,7,9,-2,9,sweden,0.25,0.75,-2,4.0,1.33
Brommapojkarna,8,2,2,4,14,16,-2,8,sweden,0.25,0.75,-2,4.0,1.33
Varnamo,8,1,5,2,5,7,-2,8,sweden,0.12,0.88,-2,8.33,1.14
Kalmar,8,1,4,3,9,13,-4,7,sweden,0.12,0.88,-4,8.33,1.14
Halmstad,8,1,1,6,6,18,-12,4,sweden,0.12,0.88,-12,8.33,1.14
Vasteras,8,1,0,7,5,15,-10,3,sweden,0.12,0.88,-10,8.33,1.14
Degerfors,8,4,3,1,12,6,6,15,sweden2,0.5,0.5,6,2.0,2.0
Varberg BoIS,8,4,2,2,21,14,7,14,sweden2,0.5,0.5,7,2.0,2.0
Orgryte,8,4,2,2,11,7,4,14,sweden2,0.5,0.5,4,2.0,2.0
Helsingborg,8,4,1,3,13,10,3,13,sweden2,0.5,0.5,3,2.0,2.0
Oster,8,3,3,2,9,7,2,12,sweden2,0.38,0.62,2,2.63,1.61
Oddevold,8,3,3,2,12,13,-1,12,sweden2,0.38,0.62,-1,2.63,1.61
GIF Sundsvall,8,3,2,3,7,9,-2,11,sweden2,0.38,0.62,-2,2.63,1.61
Brage,8,2,3,3,6,8,-2,9,sweden2,0.25,0.75,-2,4.0,1.33
Trelleborg,8,3,0,5,10,13,-3,9,sweden2,0.38,0.62,-3,2.63,1.61
Landskrona,8,2,1,5,9,12,-3,7,sweden2,0.25,0.75,-3,4.0,1.33
Orebro,8,1,3,4,9,14,-5,6,sweden2,0.12,0.88,-5,8.33,1.14
Utsikten,8,1,3,4,7,13,-6,6,sweden2,0.12,0.88,-6,8.33,1.14
Gefle,8,2,0,6,4,17,-13,6,sweden2,0.25,0.75,-13,4.0,1.33
Sandviken,8,1,2,5,11,18,-7,5,sweden2,0.12,0.88,-7,8.33,1.14
Skovde AIK,8,0,4,4,10,20,-10,4,sweden2,0.0,1.0,-10,0.0,1.0
Ostersunds,8,0,1,7,7,19,-12,1,sweden2,0.0,1.0,-12,0.0,1.0
FC Basel,8,4,2,2,23,8,15,14,switzerland,0.5,0.5,15,2.0,2.0
Luzern,8,3,3,2,15,15,0,12,switzerland,0.38,0.62,0,2.63,1.61
Servette,8,3,2,3,11,12,-1,11,switzerland,0.38,0.62,-1,2.63,1.61
FC Zurich,8,3,2,3,11,15,-4,11,switzerland,0.38,0.62,-4,2.63,1.61
Lugano,8,2,3,3,9,11,-2,9,switzerland,0.25,0.75,-2,4.0,1.33
St. Gallen,8,2,2,4,11,14,-3,8,switzerland,0.25,0.75,-3,4.0,1.33
Sion,8,2,1,5,7,12,-5,7,switzerland,0.25,0.75,-5,4.0,1.33
Yverdon,8,1,4,3,6,11,-5,7,switzerland,0.12,0.88,-5,8.33,1.14
Lausanne Sport,8,1,3,4,7,12,-5,6,switzerland,0.12,0.88,-5,8.33,1.14
BSC Young Boys,8,1,3,4,8,14,-6,6,switzerland,0.12,0.88,-6,8.33,1.14
Grasshopper,8,1,1,6,4,12,-8,4,switzerland,0.12,0.88,-8,8.33,1.14
Winterthur,8,0,3,5,5,18,-13,3,switzerland,0.0,1.0,-13,0.0,1.0
Bangkok Utd,8,5,1,2,16,9,7,16,thailand,0.62,0.38,7,1.61,2.63
Pathum Utd,8,3,3,2,14,12,2,12,thailand,0.38,0.62,2,2.63,1.61
Port FC,7,3,3,1,11,9,2,12,thailand,0.43,0.57,2,2.33,1.75
Buriram Utd,5,3,2,0,13,1,12,11,thailand,0.6,0.4,12,1.67,2.5
N. Ratchasima,8,2,4,2,8,10,-2,10,thailand,0.25,0.75,-2,4.0,1.33
Uthai Thani,8,2,2,4,8,12,-4,8,thailand,0.25,0.75,-4,4.0,1.33
Prachuap,7,1,3,3,5,12,-7,6,thailand,0.14,0.86,-7,7.14,1.16
Sukhothai,8,1,3,4,8,17,-9,6,thailand,0.12,0.88,-9,8.33,1.14
Rayong,7,2,0,5,5,15,-10,6,thailand,0.29,0.71,-10,3.45,1.41
Lamphun Warrior,7,1,2,4,7,12,-5,5,thailand,0.14,0.86,-5,7.14,1.16
Khon Kaen Utd,6,1,1,4,2,11,-9,4,thailand,0.17,0.83,-9,5.88,1.2
Muang Thong Utd,4,0,3,1,3,4,-1,3,thailand,0.0,1.0,-1,0.0,1.0
Chiangrai Utd,7,1,0,6,4,15,-11,3,thailand,0.14,0.86,-11,7.14,1.16
N. Bua Pitchaya,7,0,2,5,9,20,-11,2,thailand,0.0,1.0,-11,0.0,1.0
Nakhon Pathom,8,0,2,6,6,17,-11,2,thailand,0.0,1.0,-11,0.0,1.0
Ratchaburi,6,0,1,5,5,17,-12,1,thailand,0.0,1.0,-12,0.0,1.0
Phrae Utd,8,7,0,1,15,6,9,21,thailand2,0.88,0.12,9,1.14,8.33
Kasetsart,7,3,4,0,13,10,3,13,thailand2,0.43,0.57,3,2.33,1.75
Bangkok FC,8,4,1,3,13,14,-1,13,thailand2,0.5,0.5,-1,2.0,2.0
Chiangmai Utd,8,3,3,2,12,12,0,12,thailand2,0.38,0.62,0,2.63,1.61
Ayutthaya Utd,7,3,2,2,9,6,3,11,thailand2,0.43,0.57,3,2.33,1.75
Kanchanaburi,7,2,5,0,12,10,2,11,thailand2,0.29,0.71,2,3.45,1.41
Chonburi,8,3,2,3,11,10,1,11,thailand2,0.38,0.62,1,2.63,1.61
Lampang,7,2,3,2,11,11,0,9,thailand2,0.29,0.71,0,3.45,1.41
Pattaya United,8,1,2,5,11,11,0,5,thailand2,0.12,0.88,0,8.33,1.14
Sisaket Utd,5,1,2,2,2,4,-2,5,thailand2,0.2,0.8,-2,5.0,1.25
Chainat,8,0,5,3,5,8,-3,5,thailand2,0.0,1.0,-3,0.0,1.0
Chanthaburi,8,1,2,5,5,12,-7,5,thailand2,0.12,0.88,-7,8.33,1.14
Mahasarakham,7,1,1,5,4,9,-5,4,thailand2,0.14,0.86,-5,7.14,1.16
Trat FC,8,1,1,6,4,11,-7,4,thailand2,0.12,0.88,-7,8.33,1.14
Police Tero,7,0,2,5,8,14,-6,2,thailand2,0.0,1.0,-6,0.0,1.0
Nakhon Si,8,0,2,6,4,17,-13,2,thailand2,0.0,1.0,-13,0.0,1.0
Samut Prakan,7,0,1,6,5,12,-7,1,thailand2,0.0,1.0,-7,0.0,1.0
Suphanburi,8,0,0,8,2,17,-15,0,thailand2,0.0,1.0,-15,0.0,1.0
Galatasaray,6,6,0,0,17,5,12,18,turkey,1.0,0.0,12,1.0,0.0
Fenerbahce,8,5,2,1,22,9,13,17,turkey,0.62,0.38,13,1.61,2.63
Samsunspor,7,5,0,2,14,8,6,15,turkey,0.71,0.29,6,1.41,3.45
Kasimpasa,7,3,4,0,12,8,4,13,turkey,0.43,0.57,4,2.33,1.75
Besiktas,7,2,4,1,9,5,4,10,turkey,0.29,0.71,4,3.45,1.41
Eyupspor,8,2,4,2,10,10,0,10,turkey,0.25,0.75,0,4.0,1.33
Kayserispor,7,2,3,2,6,10,-4,9,turkey,0.29,0.71,-4,3.45,1.41
Rizespor,7,3,0,4,6,11,-5,9,turkey,0.43,0.57,-5,2.33,1.75
Konyaspor,8,3,0,5,9,15,-6,9,turkey,0.38,0.62,-6,2.63,1.61
Sivasspor,7,2,1,4,9,14,-5,7,turkey,0.29,0.71,-5,3.45,1.41
Basaksehir,7,2,1,4,6,11,-5,7,turkey,0.29,0.71,-5,3.45,1.41
Goztepe,7,1,2,4,10,14,-4,5,turkey,0.14,0.86,-4,7.14,1.16
Alanyaspor,7,1,2,4,5,11,-6,5,turkey,0.14,0.86,-6,7.14,1.16
Antalyaspor,7,1,2,4,8,15,-7,5,turkey,0.14,0.86,-7,7.14,1.16
Trabzonspor,7,0,4,3,4,8,-4,4,turkey,0.0,1.0,-4,0.0,1.0
Gaziantep,7,1,1,5,10,17,-7,4,turkey,0.14,0.86,-7,7.14,1.16
Bodrumspor,7,1,1,5,4,15,-11,4,turkey,0.14,0.86,-11,7.14,1.16
Hatayspor,7,0,2,5,6,14,-8,2,turkey,0.0,1.0,-8,0.0,1.0
Adana Demirspor,7,0,2,5,5,16,-11,2,turkey,0.0,1.0,-11,0.0,1.0
Kocaelispor,7,5,0,2,13,9,4,15,turkey2,0.71,0.29,4,1.41,3.45
Corum,8,4,2,2,12,9,3,14,turkey2,0.5,0.5,3,2.0,2.0
Pendikspor,8,4,2,2,12,11,1,14,turkey2,0.5,0.5,1,2.0,2.0
Keciorengucu,8,3,4,1,8,8,0,13,turkey2,0.38,0.62,0,2.63,1.61
Bandirmaspor,7,3,3,1,9,7,2,12,turkey2,0.43,0.57,2,2.33,1.75
Igdir,7,3,2,2,7,9,-2,11,turkey2,0.43,0.57,-2,2.33,1.75
Amed SK,7,2,4,1,7,6,1,10,turkey2,0.29,0.71,1,3.45,1.41
Umraniyespor,8,3,1,4,8,13,-5,10,turkey2,0.38,0.62,-5,2.63,1.61
Erokspor,8,3,0,5,9,11,-2,9,turkey2,0.38,0.62,-2,2.63,1.61
F. Karagumruk,7,2,2,3,11,10,1,8,turkey2,0.29,0.71,1,3.45,1.41
Genclerbirligi,8,2,2,4,8,11,-3,8,turkey2,0.25,0.75,-3,4.0,1.33
Erzurum BB,7,2,1,4,5,8,-3,7,turkey2,0.29,0.71,-3,3.45,1.41
Istanbulspor,7,2,0,5,9,11,-2,6,turkey2,0.29,0.71,-2,3.45,1.41
Ankaragucu,7,2,0,5,8,10,-2,6,turkey2,0.29,0.71,-2,3.45,1.41
Boluspor,7,1,3,3,6,9,-3,6,turkey2,0.14,0.86,-3,7.14,1.16
Sakaryaspor,8,1,3,4,9,16,-7,6,turkey2,0.12,0.88,-7,8.33,1.14
Manisa BB,8,2,0,6,8,15,-7,6,turkey2,0.25,0.75,-7,4.0,1.33
Sanliurfaspor,8,1,2,5,6,12,-6,5,turkey2,0.12,0.88,-6,8.33,1.14
Adanaspor,8,0,3,5,3,18,-15,3,turkey2,0.0,1.0,-15,0.0,1.0
Y. Malatyaspor,7,0,0,7,3,23,-20,0,turkey2,0.0,1.0,-20,0.0,1.0
Al Sharjah,5,4,0,1,12,4,8,12,uae,0.8,0.2,8,1.25,5.0
Shabab Al Ahli,4,3,1,0,12,4,8,10,uae,0.75,0.25,8,1.33,4.0
Khorfakkan,5,3,0,2,12,14,-2,9,uae,0.6,0.4,-2,1.67,2.5
Al Wahda,4,2,1,1,7,6,1,7,uae,0.5,0.5,1,2.0,2.0
Al Nasr,5,2,0,3,11,13,-2,6,uae,0.4,0.6,-2,2.5,1.67
Al Jazira,5,1,2,2,9,10,-1,5,uae,0.2,0.8,-1,5.0,1.25
Al Ain,2,1,1,0,7,5,2,4,uae,0.5,0.5,2,2.0,2.0
Ittihad Kalba,4,1,1,2,3,4,-1,4,uae,0.25,0.75,-1,4.0,1.33
Al Wasl,4,0,3,1,6,8,-2,3,uae,0.0,1.0,-2,0.0,1.0
Al Bataeh,5,1,0,4,5,11,-6,3,uae,0.2,0.8,-6,5.0,1.25
Dibba Al Hisn,5,0,2,3,5,11,-6,2,uae,0.0,1.0,-6,0.0,1.0
Bani Yas,5,0,1,4,3,12,-9,1,uae,0.0,1.0,-9,0.0,1.0
Ajman,4,0,0,4,2,11,-9,0,uae,0.0,1.0,-9,0.0,1.0
Al Urooba,4,0,0,4,1,10,-9,0,uae,0.0,1.0,-9,0.0,1.0
Dynamo Kyiv,7,5,2,0,16,4,12,17,ukraine,0.71,0.29,12,1.41,3.45
Kryvbas KR,8,5,1,2,10,7,3,16,ukraine,0.62,0.38,3,1.61,2.63
Shakhtar,6,3,2,1,12,6,6,11,ukraine,0.5,0.5,6,2.0,2.0
Oleksandria,6,3,2,1,6,5,1,11,ukraine,0.5,0.5,1,2.0,2.0
Polessya,7,3,1,3,11,9,2,10,ukraine,0.43,0.57,2,2.33,1.75
Zorya Luhansk,8,3,1,4,8,10,-2,10,ukraine,0.38,0.62,-2,2.63,1.61
Rukh Lviv,8,1,5,2,5,8,-3,8,ukraine,0.12,0.88,-3,8.33,1.14
Veres,6,2,2,2,5,9,-4,8,ukraine,0.33,0.67,-4,3.03,1.49
Karpaty Lviv,7,2,1,4,6,12,-6,7,ukraine,0.29,0.71,-6,3.45,1.41
Kolos Kovalivka,7,1,3,3,5,7,-2,6,ukraine,0.14,0.86,-2,7.14,1.16
Livyi Bereh,7,1,2,4,3,8,-5,5,ukraine,0.14,0.86,-5,7.14,1.16
Vorskla Poltava,8,1,2,5,7,14,-7,5,ukraine,0.12,0.88,-7,8.33,1.14
Inhulets,8,1,2,5,7,17,-10,5,ukraine,0.12,0.88,-10,8.33,1.14
LNZ Cherkasy,8,1,2,5,7,17,-10,5,ukraine,0.12,0.88,-10,8.33,1.14
Obolon,8,1,2,5,2,13,-11,5,ukraine,0.12,0.88,-11,8.33,1.14
Chornomorets,7,0,2,5,4,12,-8,2,ukraine,0.0,1.0,-8,0.0,1.0
Dnipro-1,0,0,0,0,0,0,0,0,ukraine,,,0,,
Defensor S.,4,3,0,1,5,2,3,9,uruguay2,0.75,0.25,3,1.33,4.0
Danubio,4,2,2,0,7,5,2,8,uruguay2,0.5,0.5,2,2.0,2.0
Cerro Largo,3,2,1,0,3,0,3,7,uruguay2,0.67,0.33,3,1.49,3.03
Nacional,3,2,0,1,10,3,7,6,uruguay2,0.67,0.33,7,1.49,3.03
Penarol,3,2,0,1,5,3,2,6,uruguay2,0.67,0.33,2,1.49,3.03
River Plate,4,2,0,2,4,3,1,6,uruguay2,0.5,0.5,1,2.0,2.0
Miramar Misione,4,2,0,2,4,7,-3,6,uruguay2,0.5,0.5,-3,2.0,2.0
D. Maldonado,4,1,2,1,3,3,0,5,uruguay2,0.25,0.75,0,4.0,1.33
Wanderers,3,1,1,1,3,4,-1,4,uruguay2,0.33,0.67,-1,3.03,1.49
Rampla Juniors,4,1,1,2,3,7,-4,4,uruguay2,0.25,0.75,-4,4.0,1.33
Racing CM,4,0,3,1,6,7,-1,3,uruguay2,0.0,1.0,-1,0.0,1.0
Fenix,3,1,0,2,4,5,-1,3,uruguay2,0.33,0.67,-1,3.03,1.49
Cerro,3,1,0,2,1,3,-2,3,uruguay2,0.33,0.67,-2,3.03,1.49
Progreso,3,0,2,1,4,6,-2,2,uruguay2,0.0,1.0,-2,0.0,1.0
Boston River,3,0,1,2,1,3,-2,1,uruguay2,0.0,1.0,-2,0.0,1.0
Liverpool M.,4,0,0,4,3,8,-5,0,uruguay2,0.0,1.0,-5,0.0,1.0
Columbus Crew,8,5,2,1,19,8,11,17,usa,0.62,0.38,11,1.61,2.63
Inter Miami,8,5,2,1,16,14,2,17,usa,0.62,0.38,2,1.61,2.63
Seattle,8,5,1,2,15,7,8,16,usa,0.62,0.38,8,1.61,2.63
Los Angeles FC,8,5,1,2,15,10,5,16,usa,0.62,0.38,5,1.61,2.63
DC United,8,5,1,2,16,19,-3,16,usa,0.62,0.38,-3,1.61,2.63
Orlando City,8,5,0,3,19,15,4,15,usa,0.62,0.38,4,1.61,2.63
Houston Dynamo,8,5,0,3,14,11,3,15,usa,0.62,0.38,3,1.61,2.63
Minnesota Utd,8,4,2,2,12,8,4,14,usa,0.5,0.5,4,2.0,2.0
Cincinnati,8,4,1,3,13,14,-1,13,usa,0.5,0.5,-1,2.0,2.0
Vancouver,8,3,2,3,13,12,1,11,usa,0.38,0.62,1,2.63,1.61
Austin,8,3,1,4,8,10,-2,10,usa,0.38,0.62,-2,2.63,1.61
Charlotte,8,2,3,3,11,10,1,9,usa,0.25,0.75,1,4.0,1.33
LA Galaxy,8,3,0,5,12,13,-1,9,usa,0.38,0.62,-1,2.63,1.61
Real Salt Lake,8,2,3,3,11,16,-5,9,usa,0.25,0.75,-5,4.0,1.33
Atlanta Utd,8,2,2,4,9,14,-5,8,usa,0.25,0.75,-5,4.0,1.33
New York RB,8,1,4,3,10,10,0,7,usa,0.12,0.88,0,8.33,1.14
New York City,8,1,4,3,12,13,-1,7,usa,0.12,0.88,-1,8.33,1.14
Portland,8,1,4,3,12,14,-2,7,usa,0.12,0.88,-2,8.33,1.14
Toronto,8,2,1,5,5,15,-10,7,usa,0.25,0.75,-10,4.0,1.33
Philadelphia,8,2,0,6,17,19,-2,6,usa,0.25,0.75,-2,4.0,1.33
Dallas,8,1,3,4,13,16,-3,6,usa,0.12,0.88,-3,8.33,1.14
Colorado Rapids,8,2,0,6,12,20,-8,6,usa,0.25,0.75,-8,4.0,1.33
St. Louis City,8,1,3,4,11,19,-8,6,usa,0.12,0.88,-8,8.33,1.14
Nashville SC,8,2,0,6,8,16,-8,6,usa,0.25,0.75,-8,4.0,1.33
CF Montreal,8,1,3,4,10,19,-9,6,usa,0.12,0.88,-9,8.33,1.14
Chicago Fire,8,1,1,6,8,14,-6,4,usa,0.12,0.88,-6,8.33,1.14
Sporting KC,8,1,1,6,7,17,-10,4,usa,0.12,0.88,-10,8.33,1.14
SJ Earthquakes,8,1,1,6,7,20,-13,4,usa,0.12,0.88,-13,8.33,1.14
New England,8,1,0,7,9,26,-17,3,usa,0.12,0.88,-17,8.33,1.14
Detroit City,8,4,3,1,13,7,6,15,usa2,0.5,0.5,6,2.0,2.0
Pittsburgh,8,4,2,2,12,5,7,14,usa2,0.5,0.5,7,2.0,2.0
Las Vegas L.,8,4,2,2,14,10,4,14,usa2,0.5,0.5,4,2.0,2.0
Louisville City,8,3,2,3,13,12,1,11,usa2,0.38,0.62,1,2.63,1.61
Colorado S.,8,3,2,3,11,12,-1,11,usa2,0.38,0.62,-1,2.63,1.61
New Mexico,8,3,2,3,7,9,-2,11,usa2,0.38,0.62,-2,2.63,1.61
San Antonio,8,3,2,3,6,9,-3,11,usa2,0.38,0.62,-3,2.63,1.61
Oakland Roots,8,3,2,3,9,17,-8,11,usa2,0.38,0.62,-8,2.63,1.61
Hartford A.,8,2,4,2,12,12,0,10,usa2,0.25,0.75,0,4.0,1.33
Memphis,8,3,1,4,14,15,-1,10,usa2,0.38,0.62,-1,2.63,1.61
FC Tulsa,8,3,1,4,9,11,-2,10,usa2,0.38,0.62,-2,2.63,1.61
North Carolina,8,3,1,4,9,11,-2,10,usa2,0.38,0.62,-2,2.63,1.61
Phoenix Rising,8,3,1,4,5,11,-6,10,usa2,0.38,0.62,-6,2.63,1.61
Rhode Island,8,2,3,3,8,8,0,9,usa2,0.25,0.75,0,4.0,1.33
Birmingham L.,8,2,2,4,13,14,-1,8,usa2,0.25,0.75,-1,4.0,1.33
Loudoun Utd,8,2,2,4,7,8,-1,8,usa2,0.25,0.75,-1,4.0,1.33
Monterey Bay,8,2,2,4,9,13,-4,8,usa2,0.25,0.75,-4,4.0,1.33
El Paso,8,2,2,4,3,9,-6,8,usa2,0.25,0.75,-6,4.0,1.33
Charleston,8,1,3,4,8,15,-7,6,usa2,0.12,0.88,-7,8.33,1.14
Indy Eleven,8,1,3,4,3,13,-10,6,usa2,0.12,0.88,-10,8.33,1.14
Orange County,8,1,3,4,3,14,-11,6,usa2,0.12,0.88,-11,8.33,1.14
Tampa Bay,8,1,2,5,9,16,-7,5,usa2,0.12,0.88,-7,8.33,1.14
Sacramento R.,8,1,1,6,9,15,-6,4,usa2,0.12,0.88,-6,8.33,1.14
Miami FC,8,0,0,8,2,24,-22,0,usa2,0.0,1.0,-22,0.0,1.0
N. Colorado,8,5,2,1,10,5,5,17,usa3,0.62,0.38,5,1.61,2.63
Charlotte I.,8,4,4,0,14,8,6,16,usa3,0.5,0.5,6,2.0,2.0
Union Omaha,8,5,1,2,17,12,5,16,usa3,0.62,0.38,5,1.61,2.63
Forward Madison,8,3,3,2,14,9,5,12,usa3,0.38,0.62,5,2.63,1.61
Greenville,8,4,0,4,14,14,0,12,usa3,0.5,0.5,0,2.0,2.0
One Knoxville,8,2,4,2,4,4,0,10,usa3,0.25,0.75,0,4.0,1.33
Lexington,8,2,2,4,13,17,-4,8,usa3,0.25,0.75,-4,4.0,1.33
Spokane V.,8,2,2,4,7,12,-5,8,usa3,0.25,0.75,-5,4.0,1.33
Chattanooga RW,8,2,1,5,10,15,-5,7,usa3,0.25,0.75,-5,4.0,1.33
Richmond K.,8,1,3,4,8,15,-7,6,usa3,0.12,0.88,-7,8.33,1.14
Tormenta,8,1,3,4,8,17,-9,6,usa3,0.12,0.88,-9,8.33,1.14
Central Valley,8,1,1,6,10,24,-14,4,usa3,0.12,0.88,-14,8.33,1.14
Sogdiana,8,5,2,1,12,4,8,17,uzbekistan,0.62,0.38,8,1.61,2.63
Nasaf Qarshi,8,5,2,1,9,5,4,17,uzbekistan,0.62,0.38,4,1.61,2.63
Navbahor,8,5,1,2,15,9,6,16,uzbekistan,0.62,0.38,6,1.61,2.63
Neftchi,8,3,4,1,8,4,4,13,uzbekistan,0.38,0.62,4,2.63,1.61
Bunyodkor,8,4,1,3,11,10,1,13,uzbekistan,0.5,0.5,1,2.0,2.0
Dinamo Samarqan,8,4,0,4,14,15,-1,12,uzbekistan,0.5,0.5,-1,2.0,2.0
AGMK,8,3,2,3,10,10,0,11,uzbekistan,0.38,0.62,0,2.63,1.61
Termez Surkhon,8,3,1,4,9,12,-3,10,uzbekistan,0.38,0.62,-3,2.63,1.61
L. Tashkent,8,2,2,4,8,12,-4,8,uzbekistan,0.25,0.75,-4,4.0,1.33
Metallurg,8,1,3,4,7,10,-3,6,uzbekistan,0.12,0.88,-3,8.33,1.14
Pakhtakor,8,2,0,6,9,17,-8,6,uzbekistan,0.25,0.75,-8,4.0,1.33
FK Olympic,8,1,3,4,8,18,-10,6,uzbekistan,0.12,0.88,-10,8.33,1.14
Andijan,8,0,5,3,9,16,-7,5,uzbekistan,0.0,1.0,-7,0.0,1.0
Qizilqum,8,0,3,5,4,11,-7,3,uzbekistan,0.0,1.0,-7,0.0,1.0
Thanh Hoa,5,4,1,0,9,3,6,13,vietnam,0.8,0.2,6,1.25,5.0
Nam Dinh,5,3,1,1,9,3,6,10,vietnam,0.6,0.4,6,1.67,2.5
Viettel,4,2,2,0,8,2,6,8,vietnam,0.5,0.5,6,2.0,2.0
Hong Linh Ha T.,4,1,3,0,6,4,2,6,vietnam,0.25,0.75,2,4.0,1.33
Cong An Nhan,5,1,2,2,6,5,1,5,vietnam,0.2,0.8,1,5.0,1.25
Ha Noi,4,1,2,1,5,4,1,5,vietnam,0.25,0.75,1,4.0,1.33
Ho Chi Minh,4,1,2,1,3,5,-2,5,vietnam,0.25,0.75,-2,4.0,1.33
Gia Lai,5,1,1,3,6,8,-2,4,vietnam,0.2,0.8,-2,5.0,1.25
Binh Duong,5,1,1,3,3,5,-2,4,vietnam,0.2,0.8,-2,5.0,1.25
Binh Dinh,4,1,1,2,1,4,-3,4,vietnam,0.25,0.75,-3,4.0,1.33
Hai Phong,5,0,3,2,4,7,-3,3,vietnam,0.0,1.0,-3,0.0,1.0
Quang Nam,4,0,2,2,0,2,-2,2,vietnam,0.0,1.0,-2,0.0,1.0
Song Lam Nghe,4,0,2,2,4,9,-5,2,vietnam,0.0,1.0,-5,0.0,1.0
Da Nang,5,0,1,4,2,12,-10,1,vietnam,0.0,1.0,-10,0.0,1.0
Phu Dong,3,3,0,0,6,0,6,9,vietnam2,1.0,0.0,6,1.0,0.0
Binh Phuoc,3,2,1,0,2,0,2,7,vietnam2,0.67,0.33,2,1.49,3.03
PVF-CAND,3,1,2,0,3,0,3,5,vietnam2,0.33,0.67,3,3.03,1.49
Hue,2,1,0,1,4,3,1,3,vietnam2,0.5,0.5,1,2.0,2.0
Dong Thap,2,0,2,0,2,2,0,2,vietnam2,0.0,1.0,0,0.0,1.0
Ho Chi Minh B,2,0,1,1,1,3,-2,1,vietnam2,0.0,1.0,-2,0.0,1.0
Long An,2,0,1,1,0,2,-2,1,vietnam2,0.0,1.0,-2,0.0,1.0
S. Khanh Hoa,2,0,1,1,0,2,-2,1,vietnam2,0.0,1.0,-2,0.0,1.0
Dong Nai,3,0,1,2,2,6,-4,1,vietnam2,0.0,1.0,-4,0.0,1.0
Ba Ria Vung Tau,1,0,0,1,2,3,-1,0,vietnam2,0.0,1.0,-1,0.0,1.0
Hoa Binh,2,0,0,2,1,3,-2,0,vietnam2,0.0,1.0,-2,0.0,1.0
Penybont,8,5,2,1,15,6,9,17,wales,0.62,0.38,9,1.61,2.63
The New Saints,8,5,0,3,19,11,8,15,wales,0.62,0.38,8,1.61,2.63
Caernarfon,8,4,3,1,9,7,2,15,wales,0.5,0.5,2,2.0,2.0
Haverfordwest,8,4,1,3,10,6,4,13,wales,0.5,0.5,4,2.0,2.0
Cardiff MU,8,4,0,4,11,10,1,12,wales,0.5,0.5,1,2.0,2.0
Connahs Quay,8,3,2,3,13,9,4,11,wales,0.38,0.62,4,2.63,1.61
Barry,8,3,2,3,11,15,-4,11,wales,0.38,0.62,-4,2.63,1.61
Bala Town,8,1,7,0,11,10,1,10,wales,0.12,0.88,1,8.33,1.14
Newtown,8,2,2,4,10,15,-5,8,wales,0.25,0.75,-5,4.0,1.33
Flint,8,2,1,5,11,20,-9,7,wales,0.25,0.75,-9,4.0,1.33
Briton Ferry,7,1,0,6,6,13,-7,3,wales,0.14,0.86,-7,7.14,1.16
Aberystwyth,8,1,0,7,4,20,-16,3,wales,0.12,0.88,-16,8.33,1.14
