Equipe_Fora,GP,W,D,L,GF,GA,GD,Pts_Away,Liga,PIA,PIA_HA,GD_Away,GF_AVG_Away,Odd_Justa_MO,Odd_Justa_HA,Rank_Away
Egnatia R.,8,4,1,3,13,7,6,13,Albania - Abissnet Superiore,0.5,0.5,6,1.62,2.0,2.0,1
Vllaznia S.,8,3,3,2,12,8,4,12,Albania - Abissnet Superiore,0.38,0.62,4,1.5,2.63,1.61,2
Partizani T.,8,3,3,2,9,7,2,12,Albania - Abissnet Superiore,0.38,0.62,2,1.12,2.63,1.61,2
Dinamo Tirana,8,2,5,1,13,8,5,11,Albania - Abissnet Superiore,0.25,0.75,5,1.62,4.0,1.33,3
AF Elbasani,8,1,5,2,10,12,-2,8,Albania - Abissnet Superiore,0.12,0.88,-2,1.25,8.33,1.14,4
Laci,8,2,2,4,6,8,-2,8,Albania - Abissnet Superiore,0.25,0.75,-2,0.75,4.0,1.33,4
Bylis,8,2,2,4,10,16,-6,8,Albania - Abissnet Superiore,0.25,0.75,-6,1.25,4.0,1.33,4
KF Tirana,8,1,3,4,9,11,-2,6,Albania - Abissnet Superiore,0.12,0.88,-2,1.12,8.33,1.14,5
Skenderbeu K.,8,0,4,4,4,9,-5,4,Albania - Abissnet Superiore,0.0,1.0,-5,0.5,0.0,1.0,6
Teuta Durres,8,0,2,6,4,17,-13,2,Albania - Abissnet Superiore,0.0,1.0,-13,0.5,0.0,1.0,7
MC Alger,8,5,3,0,12,4,8,18,Algeria - Ligue 1,0.62,0.38,8,1.5,1.61,2.63,1
CR Belouizdad,8,4,2,2,9,5,4,14,Algeria - Ligue 1,0.5,0.5,4,1.12,2.0,2.0,2
El Bayadh,8,3,1,4,5,9,-4,10,Algeria - Ligue 1,0.38,0.62,-4,0.62,2.63,1.61,3
Paradou AC,8,2,3,3,9,10,-1,9,Algeria - Ligue 1,0.25,0.75,-1,1.12,4.0,1.33,4
O. Akbou,8,2,2,4,7,8,-1,8,Algeria - Ligue 1,0.25,0.75,-1,0.88,4.0,1.33,5
USM Alger,8,1,5,2,3,4,-1,8,Algeria - Ligue 1,0.12,0.88,-1,0.38,8.33,1.14,5
CS Constantine,8,2,2,4,7,9,-2,8,Algeria - Ligue 1,0.25,0.75,-2,0.88,4.0,1.33,5
ES Setif,8,2,2,4,7,9,-2,8,Algeria - Ligue 1,0.25,0.75,-2,0.88,4.0,1.33,5
ASO Chlef,8,1,5,2,5,7,-2,8,Algeria - Ligue 1,0.12,0.88,-2,0.62,8.33,1.14,5
JS Kabylie,8,1,4,3,7,10,-3,7,Algeria - Ligue 1,0.12,0.88,-3,0.88,8.33,1.14,6
Khenchela,8,1,2,5,3,15,-12,5,Algeria - Ligue 1,0.12,0.88,-12,0.38,8.33,1.14,7
Mostaganem,8,1,1,6,4,11,-7,4,Algeria - Ligue 1,0.12,0.88,-7,0.5,8.33,1.14,8
JS Saoura,8,1,1,6,6,14,-8,4,Algeria - Ligue 1,0.12,0.88,-8,0.75,8.33,1.14,8
Biskra,8,0,3,5,4,10,-6,3,Algeria - Ligue 1,0.0,1.0,-6,0.5,0.0,1.0,9
NC Magra,8,0,3,5,3,12,-9,3,Algeria - Ligue 1,0.0,1.0,-9,0.38,0.0,1.0,9
MC Oran,8,0,1,7,4,15,-11,1,Algeria - Ligue 1,0.0,1.0,-11,0.5,0.0,1.0,10
Rosario Central,5,2,2,1,5,2,3,8,Argentina - Liga Profesional,0.4,0.6,3,1.0,2.5,1.67,1
Defensa y J.,4,2,1,1,7,3,4,7,Argentina - Liga Profesional,0.5,0.5,4,1.75,2.0,2.0,2
D. Riestra,4,2,1,1,6,2,4,7,Argentina - Liga Profesional,0.5,0.5,4,1.5,2.0,2.0,2
Argentinos Jrs,3,2,1,0,4,2,2,7,Argentina - Liga Profesional,0.67,0.33,2,1.33,1.49,3.03,2
I. Rivadavia,4,2,1,1,4,2,2,7,Argentina - Liga Profesional,0.5,0.5,2,1.0,2.0,2.0,2
San Lorenzo,4,2,1,1,3,2,1,7,Argentina - Liga Profesional,0.5,0.5,1,0.75,2.0,2.0,2
River Plate,4,1,3,0,3,1,2,6,Argentina - Liga Profesional,0.25,0.75,2,0.75,4.0,1.33,3
Barracas C.,3,1,2,0,4,2,2,5,Argentina - Liga Profesional,0.33,0.67,2,1.33,3.03,1.49,4
T. de Cordoba,3,1,1,1,1,1,0,4,Argentina - Liga Profesional,0.33,0.67,0,0.33,3.03,1.49,5
Independiente,3,1,1,1,4,5,-1,4,Argentina - Liga Profesional,0.33,0.67,-1,1.33,3.03,1.49,5
Platense,4,1,1,2,3,4,-1,4,Argentina - Liga Profesional,0.25,0.75,-1,0.75,4.0,1.33,5
Boca Juniors,3,1,1,1,2,3,-1,4,Argentina - Liga Profesional,0.33,0.67,-1,0.67,3.03,1.49,5
Godoy Cruz,3,1,1,1,2,3,-1,4,Argentina - Liga Profesional,0.33,0.67,-1,0.67,3.03,1.49,5
A. Tucuman,4,1,1,2,3,6,-3,4,Argentina - Liga Profesional,0.25,0.75,-3,0.75,4.0,1.33,5
Gimnasia,4,1,1,2,1,5,-4,4,Argentina - Liga Profesional,0.25,0.75,-4,0.25,4.0,1.33,5
Estudiantes,3,0,3,0,4,4,0,3,Argentina - Liga Profesional,0.0,1.0,0,1.33,0.0,1.0,6
Tigre,3,1,0,2,4,4,0,3,Argentina - Liga Profesional,0.33,0.67,0,1.33,3.03,1.49,6
Racing Club,3,1,0,2,3,4,-1,3,Argentina - Liga Profesional,0.33,0.67,-1,1.0,3.03,1.49,6
Lanus,3,1,0,2,2,3,-1,3,Argentina - Liga Profesional,0.33,0.67,-1,0.67,3.03,1.49,6
Banfield,4,1,0,3,1,3,-2,3,Argentina - Liga Profesional,0.25,0.75,-2,0.25,4.0,1.33,6
Huracan,3,0,2,1,3,4,-1,2,Argentina - Liga Profesional,0.0,1.0,-1,1.0,0.0,1.0,7
SM San Juan,3,0,2,1,1,2,-1,2,Argentina - Liga Profesional,0.0,1.0,-1,0.33,0.0,1.0,7
Central Cordoba,3,0,1,2,6,8,-2,1,Argentina - Liga Profesional,0.0,1.0,-2,2.0,0.0,1.0,8
Instituto,4,0,1,3,0,4,-4,1,Argentina - Liga Profesional,0.0,1.0,-4,0.0,0.0,1.0,8
Velez Sarsfield,4,0,1,3,0,8,-8,1,Argentina - Liga Profesional,0.0,1.0,-8,0.0,0.0,1.0,8
Belgrano,4,0,1,3,2,12,-10,1,Argentina - Liga Profesional,0.0,1.0,-10,0.5,0.0,1.0,8
Union Santa Fe,3,0,0,3,1,5,-4,0,Argentina - Liga Profesional,0.0,1.0,-4,0.33,0.0,1.0,9
Aldosivi,4,0,0,4,1,6,-5,0,Argentina - Liga Profesional,0.0,1.0,-5,0.25,0.0,1.0,9
Newells,3,0,0,3,0,7,-7,0,Argentina - Liga Profesional,0.0,1.0,-7,0.0,0.0,1.0,9
D. de Belgrano,2,1,1,0,3,0,3,4,Argentina - Primera Nacional,0.5,0.5,3,1.5,2.0,2.0,1
Patronato,2,1,1,0,4,2,2,4,Argentina - Primera Nacional,0.5,0.5,2,2.0,2.0,2.0,1
San Telmo,3,1,1,1,3,2,1,4,Argentina - Primera Nacional,0.33,0.67,1,1.0,3.03,1.49,1
CA Estudiantes,2,1,1,0,2,1,1,4,Argentina - Primera Nacional,0.5,0.5,1,1.0,2.0,2.0,1
Chacarita J.,2,1,1,0,2,1,1,4,Argentina - Primera Nacional,0.5,0.5,1,1.0,2.0,2.0,1
Defensores U.,2,1,1,0,2,1,1,4,Argentina - Primera Nacional,0.5,0.5,1,1.0,2.0,2.0,1
Gimnasia y Tiro,2,1,1,0,2,1,1,4,Argentina - Primera Nacional,0.5,0.5,1,1.0,2.0,2.0,1
Los Andes,2,1,1,0,2,1,1,4,Argentina - Primera Nacional,0.5,0.5,1,1.0,2.0,2.0,1
SM Tucuman,2,1,1,0,1,0,1,4,Argentina - Primera Nacional,0.5,0.5,1,0.5,2.0,2.0,1
Chaco For Ever,1,1,0,0,2,0,2,3,Argentina - Primera Nacional,1.0,0.0,2,2.0,1.0,0.0,2
Racing Cordoba,1,1,0,0,2,1,1,3,Argentina - Primera Nacional,1.0,0.0,1,2.0,1.0,0.0,2
Colon Santa Fe,1,1,0,0,1,0,1,3,Argentina - Primera Nacional,1.0,0.0,1,1.0,1.0,0.0,2
G. Mendoza,1,1,0,0,1,0,1,3,Argentina - Primera Nacional,1.0,0.0,1,1.0,1.0,0.0,2
Deportivo Maipu,2,1,0,1,1,2,-1,3,Argentina - Primera Nacional,0.5,0.5,-1,0.5,2.0,2.0,2
Atlanta,2,0,2,0,1,1,0,2,Argentina - Primera Nacional,0.0,1.0,0,0.5,0.0,1.0,3
All Boys,2,0,2,0,0,0,0,2,Argentina - Primera Nacional,0.0,1.0,0,0.0,0.0,1.0,3
Agropecuario,1,0,1,0,1,1,0,1,Argentina - Primera Nacional,0.0,1.0,0,1.0,0.0,1.0,4
Arsenal Sarandi,1,0,1,0,1,1,0,1,Argentina - Primera Nacional,0.0,1.0,0,1.0,0.0,1.0,4
Gimnasia Jujuy,1,0,1,0,1,1,0,1,Argentina - Primera Nacional,0.0,1.0,0,1.0,0.0,1.0,4
Colegiales,1,0,1,0,0,0,0,1,Argentina - Primera Nacional,0.0,1.0,0,0.0,0.0,1.0,4
E. Rio Cuarto,2,0,1,1,2,3,-1,1,Argentina - Primera Nacional,0.0,1.0,-1,1.0,0.0,1.0,4
Alvarado,2,0,1,1,1,2,-1,1,Argentina - Primera Nacional,0.0,1.0,-1,0.5,0.0,1.0,4
D. Madryn,2,0,1,1,1,2,-1,1,Argentina - Primera Nacional,0.0,1.0,-1,0.5,0.0,1.0,4
Deportivo Moron,2,0,1,1,1,2,-1,1,Argentina - Primera Nacional,0.0,1.0,-1,0.5,0.0,1.0,4
Tristan Suarez,2,0,1,1,1,2,-1,1,Argentina - Primera Nacional,0.0,1.0,-1,0.5,0.0,1.0,4
CA Guemes,2,0,1,1,0,2,-2,1,Argentina - Primera Nacional,0.0,1.0,-2,0.0,0.0,1.0,4
Temperley,2,0,1,1,0,2,-2,1,Argentina - Primera Nacional,0.0,1.0,-2,0.0,0.0,1.0,4
Almagro,1,0,0,1,1,2,-1,0,Argentina - Primera Nacional,0.0,1.0,-1,1.0,0.0,1.0,5
Nueva Chicago,1,0,0,1,1,2,-1,0,Argentina - Primera Nacional,0.0,1.0,-1,1.0,0.0,1.0,5
Deportivo Merlo,8,5,2,1,7,2,5,17,Argentina - Primera B,0.62,0.38,5,0.88,1.61,2.63,1
A. Quilmes,8,4,3,1,8,3,5,15,Argentina - Primera B,0.5,0.5,5,1.0,2.0,2.0,2
Dock Sud,8,4,2,2,11,8,3,14,Argentina - Primera B,0.5,0.5,3,1.38,2.0,2.0,3
D. Armenio,8,4,2,2,10,7,3,14,Argentina - Primera B,0.5,0.5,3,1.25,2.0,2.0,3
Comunicaciones,8,4,2,2,7,4,3,14,Argentina - Primera B,0.5,0.5,3,0.88,2.0,2.0,3
Argentino Merlo,8,4,2,2,8,8,0,14,Argentina - Primera B,0.5,0.5,0,1.0,2.0,2.0,3
Colegiales,8,4,0,4,11,11,0,12,Argentina - Primera B,0.5,0.5,0,1.38,2.0,2.0,4
Villa Dalmine,8,3,2,3,4,4,0,11,Argentina - Primera B,0.38,0.62,0,0.5,2.63,1.61,5
Midland,8,2,4,2,9,7,2,10,Argentina - Primera B,0.25,0.75,2,1.12,4.0,1.33,6
Acassuso,8,2,4,2,6,7,-1,10,Argentina - Primera B,0.25,0.75,-1,0.75,4.0,1.33,6
UAI Urquiza,8,3,1,4,8,12,-4,10,Argentina - Primera B,0.38,0.62,-4,1.0,2.63,1.61,6
V. San Carlos,8,2,3,3,5,9,-4,9,Argentina - Primera B,0.25,0.75,-4,0.62,4.0,1.33,7
Sacachispas,8,2,2,4,4,8,-4,8,Argentina - Primera B,0.25,0.75,-4,0.5,4.0,1.33,8
Flandria,8,2,2,4,6,11,-5,8,Argentina - Primera B,0.25,0.75,-5,0.75,4.0,1.33,8
Excursionistas,8,1,4,3,8,12,-4,7,Argentina - Primera B,0.12,0.88,-4,1.0,8.33,1.14,9
Liniers,8,1,4,3,3,8,-5,7,Argentina - Primera B,0.12,0.88,-5,0.38,8.33,1.14,9
S. Italiano,8,1,3,4,7,13,-6,6,Argentina - Primera B,0.12,0.88,-6,0.88,8.33,1.14,10
Canuelas,8,1,2,5,6,10,-4,5,Argentina - Primera B,0.12,0.88,-4,0.75,8.33,1.14,11
D. Laferrere,8,0,4,4,1,12,-11,4,Argentina - Primera B,0.0,1.0,-11,0.12,0.0,1.0,12
Los Andes,8,0,2,6,4,13,-9,2,Argentina - Primera B,0.0,1.0,-9,0.5,0.0,1.0,13
SM Burzaco,8,0,1,7,2,14,-12,1,Argentina - Primera B,0.0,1.0,-12,0.25,0.0,1.0,14
Fenix,8,0,1,7,1,15,-14,1,Argentina - Primera B,0.0,1.0,-14,0.12,0.0,1.0,14
Olimpo Bahia B.,8,4,3,1,11,6,5,15,Argentina - Torneo Federal,0.5,0.5,5,1.38,2.0,2.0,1
Gutierrez,8,4,3,1,7,4,3,15,Argentina - Torneo Federal,0.5,0.5,3,0.88,2.0,2.0,1
Camioneros,8,3,5,0,10,5,5,14,Argentina - Torneo Federal,0.38,0.62,5,1.25,2.63,1.61,2
Central Norte,8,4,2,2,10,6,4,14,Argentina - Torneo Federal,0.5,0.5,4,1.25,2.0,2.0,2
D. Belgrano VR,8,3,4,1,7,4,3,13,Argentina - Torneo Federal,0.38,0.62,3,0.88,2.63,1.61,3
Villa Mitre,8,3,3,2,7,5,2,12,Argentina - Torneo Federal,0.38,0.62,2,0.88,2.63,1.61,4
S. Belgrano,8,3,2,3,6,3,3,11,Argentina - Torneo Federal,0.38,0.62,3,0.75,2.63,1.61,5
S. Las Parejas,8,3,2,3,7,6,1,11,Argentina - Torneo Federal,0.38,0.62,1,0.88,2.63,1.61,5
Germinal,8,2,5,1,7,7,0,11,Argentina - Torneo Federal,0.25,0.75,0,0.88,4.0,1.33,5
Argentino MM,8,3,2,3,5,5,0,11,Argentina - Torneo Federal,0.38,0.62,0,0.62,2.63,1.61,5
Kimberley,8,2,4,2,7,7,0,10,Argentina - Torneo Federal,0.25,0.75,0,0.88,4.0,1.33,6
9 Julio Rafaela,8,2,4,2,8,9,-1,10,Argentina - Torneo Federal,0.25,0.75,-1,1.0,4.0,1.33,6
El Linqueno,8,3,1,4,5,7,-2,10,Argentina - Torneo Federal,0.38,0.62,-2,0.62,2.63,1.61,6
Juventud U. U.,8,3,1,4,7,11,-4,10,Argentina - Torneo Federal,0.38,0.62,-4,0.88,2.63,1.61,6
Douglas Haig,8,2,3,3,9,10,-1,9,Argentina - Torneo Federal,0.25,0.75,-1,1.12,4.0,1.33,7
Sarmiento DLB,8,2,3,3,7,8,-1,9,Argentina - Torneo Federal,0.25,0.75,-1,0.88,4.0,1.33,7
I. Chivilcoy,8,1,5,2,3,4,-1,8,Argentina - Torneo Federal,0.12,0.88,-1,0.38,8.33,1.14,8
SM Formosa,8,2,2,4,6,8,-2,8,Argentina - Torneo Federal,0.25,0.75,-2,0.75,4.0,1.33,8
Santamarina,8,2,2,4,5,8,-3,8,Argentina - Torneo Federal,0.25,0.75,-3,0.62,4.0,1.33,8
Ciudad Bolivar,8,2,1,5,8,7,1,7,Argentina - Torneo Federal,0.25,0.75,1,1.0,4.0,1.33,9
Sol de America,8,1,4,3,5,9,-4,7,Argentina - Torneo Federal,0.12,0.88,-4,0.62,8.33,1.14,9
Atenas,8,2,0,6,7,12,-5,6,Argentina - Torneo Federal,0.25,0.75,-5,0.88,4.0,1.33,10
SM Mendoza,8,2,0,6,4,9,-5,6,Argentina - Torneo Federal,0.25,0.75,-5,0.5,4.0,1.33,10
Huracan Las H.,8,0,5,3,5,9,-4,5,Argentina - Torneo Federal,0.0,1.0,-4,0.62,0.0,1.0,11
Crucero del N.,8,1,2,5,6,12,-6,5,Argentina - Torneo Federal,0.12,0.88,-6,0.75,8.33,1.14,11
Gimnasia E.,8,1,2,5,5,16,-11,5,Argentina - Torneo Federal,0.12,0.88,-11,0.62,8.33,1.14,11
Cipolletti,8,0,4,4,4,10,-6,4,Argentina - Torneo Federal,0.0,1.0,-6,0.5,0.0,1.0,12
Boca Unidos,8,1,1,6,7,14,-7,4,Argentina - Torneo Federal,0.12,0.88,-7,0.88,8.33,1.14,12
S. Estudiantes,8,1,1,6,6,15,-9,4,Argentina - Torneo Federal,0.12,0.88,-9,0.75,8.33,1.14,12
Pyunik,8,6,0,2,17,6,11,18,Armenia - Premier League,0.75,0.25,11,2.12,1.33,4.0,1
Noah,8,5,1,2,19,7,12,16,Armenia - Premier League,0.62,0.38,12,2.38,1.61,2.63,2
Ararat-Armenia,8,4,2,2,16,10,6,14,Armenia - Premier League,0.5,0.5,6,2.0,2.0,2.0,3
Urartu,8,4,1,3,14,10,4,13,Armenia - Premier League,0.5,0.5,4,1.75,2.0,2.0,4
Van,8,4,1,3,10,10,0,13,Armenia - Premier League,0.5,0.5,0,1.25,2.0,2.0,4
Shirak,8,4,1,3,9,11,-2,13,Armenia - Premier League,0.5,0.5,-2,1.12,2.0,2.0,4
BKMA,8,3,1,4,19,19,0,10,Armenia - Premier League,0.38,0.62,0,2.38,2.63,1.61,5
West Armenia,8,3,0,5,7,20,-13,9,Armenia - Premier League,0.38,0.62,-13,0.88,2.63,1.61,6
Ararat Yerevan,8,2,1,5,7,17,-10,7,Armenia - Premier League,0.25,0.75,-10,0.88,4.0,1.33,7
Alashkert,8,1,2,5,3,12,-9,5,Armenia - Premier League,0.12,0.88,-9,0.38,8.33,1.14,8
Gandzasar,8,0,2,6,3,19,-16,2,Armenia - Premier League,0.0,1.0,-16,0.38,0.0,1.0,9
Western United,8,6,1,1,23,14,9,19,Australia - A-League,0.75,0.25,9,2.88,1.33,4.0,1
Auckland,8,5,2,1,14,6,8,17,Australia - A-League,0.62,0.38,8,1.75,1.61,2.63,2
WS Wanderers,8,5,2,1,19,12,7,17,Australia - A-League,0.62,0.38,7,2.38,1.61,2.63,2
Macarthur FC,8,5,1,2,15,9,6,16,Australia - A-League,0.62,0.38,6,1.88,1.61,2.63,3
Adelaide Utd,8,5,1,2,17,15,2,16,Australia - A-League,0.62,0.38,2,2.12,1.61,2.63,3
Central Coast,8,3,4,1,13,11,2,13,Australia - A-League,0.38,0.62,2,1.62,2.63,1.61,4
Sydney FC,8,2,4,2,11,11,0,10,Australia - A-League,0.25,0.75,0,1.38,4.0,1.33,5
Newcastle Jets,8,3,1,4,12,14,-2,10,Australia - A-League,0.38,0.62,-2,1.5,2.63,1.61,5
Melbourne City,8,2,3,3,9,10,-1,9,Australia - A-League,0.25,0.75,-1,1.12,4.0,1.33,6
Wellington,8,3,0,5,10,16,-6,9,Australia - A-League,0.38,0.62,-6,1.25,2.63,1.61,6
Melbourne V.,8,2,2,4,8,12,-4,8,Australia - A-League,0.25,0.75,-4,1.0,4.0,1.33,7
Brisbane Roar,8,1,3,4,12,17,-5,6,Australia - A-League,0.12,0.88,-5,1.5,8.33,1.14,8
Perth Glory,8,1,3,4,6,16,-10,6,Australia - A-League,0.12,0.88,-10,0.75,8.33,1.14,8
Avondale,2,2,0,0,5,2,3,6,Australia - NPL Victoria,1.0,0.0,3,2.5,1.0,0.0,1
Oakleigh C.,2,1,1,0,3,1,2,4,Australia - NPL Victoria,0.5,0.5,2,1.5,2.0,2.0,2
Hume City,3,1,1,1,5,4,1,4,Australia - NPL Victoria,0.33,0.67,1,1.67,3.03,1.49,2
South Melbourne,2,1,1,0,4,3,1,4,Australia - NPL Victoria,0.5,0.5,1,2.0,2.0,2.0,2
Heidelberg Utd,2,1,0,1,4,4,0,3,Australia - NPL Victoria,0.5,0.5,0,2.0,2.0,2.0,3
Dandenong T.,2,1,0,1,2,2,0,3,Australia - NPL Victoria,0.5,0.5,0,1.0,2.0,2.0,3
Preston Lions,2,0,2,0,3,3,0,2,Australia - NPL Victoria,0.0,1.0,0,1.5,0.0,1.0,4
Dandenong City,1,0,1,0,2,2,0,1,Australia - NPL Victoria,0.0,1.0,0,2.0,0.0,1.0,5
St. Albans,2,0,1,1,4,5,-1,1,Australia - NPL Victoria,0.0,1.0,-1,2.0,0.0,1.0,5
Altona Magic,2,0,1,1,1,2,-1,1,Australia - NPL Victoria,0.0,1.0,-1,0.5,0.0,1.0,5
Green Gully,2,0,0,2,1,3,-2,0,Australia - NPL Victoria,0.0,1.0,-2,0.5,0.0,1.0,6
Port Melbourne,1,0,0,1,1,4,-3,0,Australia - NPL Victoria,0.0,1.0,-3,1.0,0.0,1.0,6
M. Victory B,2,0,0,2,1,5,-4,0,Australia - NPL Victoria,0.0,1.0,-4,0.5,0.0,1.0,6
Melbourne K.,2,0,0,2,1,6,-5,0,Australia - NPL Victoria,0.0,1.0,-5,0.5,0.0,1.0,6
Moreton City E.,1,1,0,0,3,1,2,3,Australia - NPL Queensland,1.0,0.0,2,3.0,1.0,0.0,1
Gold C. Knights,1,1,0,0,2,0,2,3,Australia - NPL Queensland,1.0,0.0,2,2.0,1.0,0.0,1
Olympic FC,1,1,0,0,2,0,2,3,Australia - NPL Queensland,1.0,0.0,2,2.0,1.0,0.0,1
St George W.,2,0,1,1,1,3,-2,1,Australia - NPL Queensland,0.0,1.0,-2,0.5,0.0,1.0,2
Brisbane City,0,0,0,0,0,0,0,0,Australia - NPL Queensland,0.0,0.0,0,0.0,0.0,0.0,3
Eastern Suburbs,0,0,0,0,0,0,0,0,Australia - NPL Queensland,0.0,0.0,0,0.0,0.0,0.0,3
Gold C. Utd,0,0,0,0,0,0,0,0,Australia - NPL Queensland,0.0,0.0,0,0.0,0.0,0.0,3
Peninsula,0,0,0,0,0,0,0,0,Australia - NPL Queensland,0.0,0.0,0,0.0,0.0,0.0,3
Q. Lions,1,0,0,1,1,3,-2,0,Australia - NPL Queensland,0.0,1.0,-2,1.0,0.0,1.0,3
SC Wanderers,1,0,0,1,1,3,-2,0,Australia - NPL Queensland,0.0,1.0,-2,1.0,0.0,1.0,3
Wynnum Wolves,1,0,0,1,1,3,-2,0,Australia - NPL Queensland,0.0,1.0,-2,1.0,0.0,1.0,3
Brisbane Roar B,2,0,0,2,0,7,-7,0,Australia - NPL Queensland,0.0,1.0,-7,0.0,0.0,1.0,3
Sturm Graz,8,5,2,1,14,9,5,17,Austria - Bundesliga,0.62,0.38,5,1.75,1.61,2.63,1
Wolfsberger AC,8,5,1,2,20,12,8,16,Austria - Bundesliga,0.62,0.38,8,2.5,1.61,2.63,2
Austria Wien,8,3,3,2,10,9,1,12,Austria - Bundesliga,0.38,0.62,1,1.25,2.63,1.61,3
LASK Linz,8,3,2,3,9,9,0,11,Austria - Bundesliga,0.38,0.62,0,1.12,2.63,1.61,4
Hartberg,8,2,3,3,8,10,-2,9,Austria - Bundesliga,0.25,0.75,-2,1.0,4.0,1.33,5
Rapid Wien,8,1,5,2,8,9,-1,8,Austria - Bundesliga,0.12,0.88,-1,1.0,8.33,1.14,6
BW Linz,8,2,2,4,7,10,-3,8,Austria - Bundesliga,0.25,0.75,-3,0.88,4.0,1.33,6
Grazer AK,8,2,2,4,12,18,-6,8,Austria - Bundesliga,0.25,0.75,-6,1.5,4.0,1.33,6
Tirol,8,2,1,5,10,14,-4,7,Austria - Bundesliga,0.25,0.75,-4,1.25,4.0,1.33,7
Salzburg,8,1,4,3,4,11,-7,7,Austria - Bundesliga,0.12,0.88,-7,0.5,8.33,1.14,7
A. Klagenfurt,8,1,2,5,5,21,-16,5,Austria - Bundesliga,0.12,0.88,-16,0.62,8.33,1.14,8
Altach,8,1,1,6,6,14,-8,4,Austria - Bundesliga,0.12,0.88,-8,0.75,8.33,1.14,9
St. Polten,8,6,1,1,17,6,11,19,Austria - 2. Liga,0.75,0.25,11,2.12,1.33,4.0,1
Ried,8,6,1,1,13,4,9,19,Austria - 2. Liga,0.75,0.25,9,1.62,1.33,4.0,1
Admira Wacker,8,5,2,1,13,9,4,17,Austria - 2. Liga,0.62,0.38,4,1.62,1.61,2.63,2
First Vienna,8,5,1,2,18,13,5,16,Austria - 2. Liga,0.62,0.38,5,2.25,1.61,2.63,3
Sturm Graz B,8,3,4,1,17,10,7,13,Austria - 2. Liga,0.38,0.62,7,2.12,2.63,1.61,4
Liefering,8,4,1,3,10,13,-3,13,Austria - 2. Liga,0.5,0.5,-3,1.25,2.0,2.0,4
Voitsberg,8,3,2,3,11,9,2,11,Austria - 2. Liga,0.38,0.62,2,1.38,2.63,1.61,5
Amstetten,8,3,2,3,10,10,0,11,Austria - 2. Liga,0.38,0.62,0,1.25,2.63,1.61,5
Kapfenberger,8,3,2,3,8,15,-7,11,Austria - 2. Liga,0.38,0.62,-7,1.0,2.63,1.61,5
Bregenz,8,2,4,2,9,10,-1,10,Austria - 2. Liga,0.25,0.75,-1,1.12,4.0,1.33,6
A. Lustenau,8,2,3,3,6,9,-3,9,Austria - 2. Liga,0.25,0.75,-3,0.75,4.0,1.33,7
Rapid Wien B,8,2,2,4,12,16,-4,8,Austria - 2. Liga,0.25,0.75,-4,1.5,4.0,1.33,8
SV Horn,8,2,0,6,6,22,-16,6,Austria - 2. Liga,0.25,0.75,-16,0.75,4.0,1.33,9
Floridsdorfer,8,1,2,5,7,12,-5,5,Austria - 2. Liga,0.12,0.88,-5,0.88,8.33,1.14,10
Stripfing,8,0,4,4,6,13,-7,4,Austria - 2. Liga,0.0,1.0,-7,0.75,0.0,1.0,11
Lafnitz,8,1,0,7,7,24,-17,3,Austria - 2. Liga,0.12,0.88,-17,0.88,8.33,1.14,12
Qarabag,8,5,2,1,16,4,12,17,Azerbaijan - Premier League,0.62,0.38,12,2.0,1.61,2.63,1
Zira,8,5,1,2,14,8,6,16,Azerbaijan - Premier League,0.62,0.38,6,1.75,1.61,2.63,2
Araz,8,4,1,3,6,4,2,13,Azerbaijan - Premier League,0.5,0.5,2,0.75,2.0,2.0,3
Turan,8,3,2,3,11,12,-1,11,Azerbaijan - Premier League,0.38,0.62,-1,1.38,2.63,1.61,4
Sabah,8,1,4,3,7,10,-3,7,Azerbaijan - Premier League,0.12,0.88,-3,0.88,8.33,1.14,5
Sebail,8,1,3,4,4,11,-7,6,Azerbaijan - Premier League,0.12,0.88,-7,0.5,8.33,1.14,6
Kapaz,8,1,2,5,5,12,-7,5,Azerbaijan - Premier League,0.12,0.88,-7,0.62,8.33,1.14,7
Neftci,8,1,2,5,7,16,-9,5,Azerbaijan - Premier League,0.12,0.88,-9,0.88,8.33,1.14,7
Sumqayit,8,1,2,5,2,12,-10,5,Azerbaijan - Premier League,0.12,0.88,-10,0.25,8.33,1.14,7
Shamakhi,8,0,2,6,8,17,-9,2,Azerbaijan - Premier League,0.0,1.0,-9,1.0,0.0,1.0,8
Al-Najma,6,4,1,1,11,7,4,13,Bahrain - Premier League,0.67,0.33,4,1.83,1.49,3.03,1
Al Shabbab,6,4,0,2,9,8,1,12,Bahrain - Premier League,0.67,0.33,1,1.5,1.49,3.03,2
Malkiya,6,3,1,2,7,8,-1,10,Bahrain - Premier League,0.5,0.5,-1,1.17,2.0,2.0,3
Khalidiya,5,3,0,2,12,7,5,9,Bahrain - Premier League,0.6,0.4,5,2.4,1.67,2.5,4
Al-Muharraq,5,2,2,1,6,3,3,8,Bahrain - Premier League,0.4,0.6,3,1.2,2.5,1.67,5
Bahrain SC,6,2,2,2,6,11,-5,8,Bahrain - Premier League,0.33,0.67,-5,1.0,3.03,1.49,5
Sitra,4,1,2,1,6,6,0,5,Bahrain - Premier League,0.25,0.75,0,1.5,4.0,1.33,6
Al Riffa,5,1,2,2,2,3,-1,5,Bahrain - Premier League,0.2,0.8,-1,0.4,5.0,1.25,6
Al Ahli M.,5,1,1,3,8,11,-3,4,Bahrain - Premier League,0.2,0.8,-3,1.6,5.0,1.25,7
Manama,5,1,1,3,3,10,-7,4,Bahrain - Premier League,0.2,0.8,-7,0.6,5.0,1.25,7
AAli FC,6,0,2,4,5,16,-11,2,Bahrain - Premier League,0.0,1.0,-11,0.83,0.0,1.0,8
East Riffa,5,0,1,4,5,9,-4,1,Bahrain - Premier League,0.0,1.0,-4,1.0,0.0,1.0,9
Mohammedan,5,5,0,0,18,3,15,15,Bangladesh - Premier League,1.0,0.0,15,3.6,1.0,0.0,1
Abahani,6,3,2,1,7,1,6,11,Bangladesh - Premier League,0.5,0.5,6,1.17,2.0,2.0,2
Bashundhara K.,6,3,1,2,13,3,10,10,Bangladesh - Premier League,0.5,0.5,10,2.17,2.0,2.0,3
Rahmatgonj,5,2,0,3,11,10,1,6,Bangladesh - Premier League,0.4,0.6,1,2.2,2.5,1.67,4
Fakirerpool,6,2,0,4,6,17,-11,6,Bangladesh - Premier League,0.33,0.67,-11,1.0,3.03,1.49,4
Brothers Union,5,1,2,2,7,7,0,5,Bangladesh - Premier League,0.2,0.8,0,1.4,5.0,1.25,5
Fortis,4,1,1,2,5,5,0,4,Bangladesh - Premier League,0.25,0.75,0,1.25,4.0,1.33,6
B. Police,4,1,0,3,5,5,0,3,Bangladesh - Premier League,0.25,0.75,0,1.25,4.0,1.33,7
Dhaka Wanderers,5,0,1,4,3,15,-12,1,Bangladesh - Premier League,0.0,1.0,-12,0.6,0.0,1.0,8
Chittagong,4,0,0,4,0,11,-11,0,Bangladesh - Premier League,0.0,1.0,-11,0.0,0.0,1.0,9
Neman Grodno,8,5,3,0,15,3,12,18,Belarus - Vysshaya Liga,0.62,0.38,12,1.88,1.61,2.63,1
T. Zhodino,8,4,2,2,11,5,6,14,Belarus - Vysshaya Liga,0.5,0.5,6,1.38,2.0,2.0,2
Slutsk,8,4,2,2,8,8,0,14,Belarus - Vysshaya Liga,0.5,0.5,0,1.0,2.0,2.0,2
Dinamo Minsk,8,3,3,2,9,5,4,12,Belarus - Vysshaya Liga,0.38,0.62,4,1.12,2.63,1.61,3
BATE Borisov,8,3,2,3,7,9,-2,11,Belarus - Vysshaya Liga,0.38,0.62,-2,0.88,2.63,1.61,4
Vitebsk,8,3,1,4,10,9,1,10,Belarus - Vysshaya Liga,0.38,0.62,1,1.25,2.63,1.61,5
Naftan,8,3,1,4,9,8,1,10,Belarus - Vysshaya Liga,0.38,0.62,1,1.12,2.63,1.61,5
Isloch,8,3,1,4,12,12,0,10,Belarus - Vysshaya Liga,0.38,0.62,0,1.5,2.63,1.61,5
Dinamo Brest,8,3,0,5,15,14,1,9,Belarus - Vysshaya Liga,0.38,0.62,1,1.88,2.63,1.61,6
Gomel,8,2,3,3,7,10,-3,9,Belarus - Vysshaya Liga,0.25,0.75,-3,0.88,4.0,1.33,6
FC Minsk,8,2,3,3,7,11,-4,9,Belarus - Vysshaya Liga,0.25,0.75,-4,0.88,4.0,1.33,6
Slavia Mozyr,8,1,4,3,4,9,-5,7,Belarus - Vysshaya Liga,0.12,0.88,-5,0.5,8.33,1.14,7
Arsenal D.,8,1,3,4,7,9,-2,6,Belarus - Vysshaya Liga,0.12,0.88,-2,0.88,8.33,1.14,8
Dnepr Mogilev,8,1,3,4,9,15,-6,6,Belarus - Vysshaya Liga,0.12,0.88,-6,1.12,8.33,1.14,8
S. Soligorsk,8,1,3,4,3,9,-6,6,Belarus - Vysshaya Liga,0.12,0.88,-6,0.38,8.33,1.14,8
Smorgon,8,0,2,6,9,18,-9,2,Belarus - Vysshaya Liga,0.0,1.0,-9,1.12,0.0,1.0,9
Maxline,8,8,0,0,24,6,18,24,Belarus - First League,1.0,0.0,18,3.0,1.0,0.0,1
Dinamo Minsk B,8,5,1,2,17,6,11,16,Belarus - First League,0.62,0.38,11,2.12,1.61,2.63,2
Niva,8,5,1,2,11,5,6,16,Belarus - First League,0.62,0.38,6,1.38,1.61,2.63,2
Belshina,8,4,2,2,26,16,10,14,Belarus - First League,0.5,0.5,10,3.25,2.0,2.0,3
Molodechno,8,4,1,3,11,11,0,13,Belarus - First League,0.5,0.5,0,1.38,2.0,2.0,4
ABFF U17,8,4,1,3,9,9,0,13,Belarus - First League,0.5,0.5,0,1.12,2.0,2.0,4
Orsha,8,3,3,2,15,13,2,12,Belarus - First League,0.38,0.62,2,1.88,2.63,1.61,5
Volna Pinsk,8,4,0,4,13,13,0,12,Belarus - First League,0.5,0.5,0,1.62,2.0,2.0,5
Lida,8,3,2,3,12,10,2,11,Belarus - First League,0.38,0.62,2,1.5,2.63,1.61,6
BATE B,8,3,1,4,9,17,-8,10,Belarus - First League,0.38,0.62,-8,1.12,2.63,1.61,7
Baranovichi,8,2,3,3,9,12,-3,9,Belarus - First League,0.25,0.75,-3,1.12,4.0,1.33,8
Ostrovets,8,3,0,5,11,16,-5,9,Belarus - First League,0.38,0.62,-5,1.38,2.63,1.61,8
S. Soligorsk B,8,2,1,5,5,14,-9,7,Belarus - First League,0.25,0.75,-9,0.62,4.0,1.33,9
Bumprom,8,0,4,4,1,9,-8,4,Belarus - First League,0.0,1.0,-8,0.12,0.0,1.0,10
Energetik-BGU,8,1,1,6,6,15,-9,4,Belarus - First League,0.12,0.88,-9,0.75,8.33,1.14,10
Lokomotiv Gomel,8,0,3,5,4,13,-9,3,Belarus - First League,0.0,1.0,-9,0.5,0.0,1.0,11
T. Zhodhino B,8,1,0,7,3,23,-20,3,Belarus - First League,0.12,0.88,-20,0.38,8.33,1.14,11
Slonim,8,1,0,7,3,25,-22,3,Belarus - First League,0.12,0.88,-22,0.38,8.33,1.14,11
Royale Union SG,8,5,3,0,15,5,10,18,Belgium - Pro League,0.62,0.38,10,1.88,1.61,2.63,1
Club Brugge,8,4,3,1,15,10,5,15,Belgium - Pro League,0.5,0.5,5,1.88,2.0,2.0,2
Anderlecht,8,4,1,3,11,5,6,13,Belgium - Pro League,0.5,0.5,6,1.38,2.0,2.0,3
KRC Genk,8,3,3,2,11,14,-3,12,Belgium - Pro League,0.38,0.62,-3,1.38,2.63,1.61,4
Charleroi,8,3,2,3,9,10,-1,11,Belgium - Pro League,0.38,0.62,-1,1.12,2.63,1.61,5
Standard Liege,8,2,4,2,8,13,-5,10,Belgium - Pro League,0.25,0.75,-5,1.0,4.0,1.33,6
Antwerp,8,2,3,3,9,11,-2,9,Belgium - Pro League,0.25,0.75,-2,1.12,4.0,1.33,7
Gent,8,1,6,1,6,11,-5,9,Belgium - Pro League,0.12,0.88,-5,0.75,8.33,1.14,7
Cercle Brugge,8,1,4,3,8,10,-2,7,Belgium - Pro League,0.12,0.88,-2,1.0,8.33,1.14,8
KV Mechelen,8,2,1,5,10,14,-4,7,Belgium - Pro League,0.25,0.75,-4,1.25,4.0,1.33,8
Dender,8,2,1,5,10,18,-8,7,Belgium - Pro League,0.25,0.75,-8,1.25,4.0,1.33,8
OH Leuven,8,1,3,4,6,9,-3,6,Belgium - Pro League,0.12,0.88,-3,0.75,8.33,1.14,9
Westerlo,8,1,1,6,9,16,-7,4,Belgium - Pro League,0.12,0.88,-7,1.12,8.33,1.14,10
Sint-Truiden,8,1,1,6,7,19,-12,4,Belgium - Pro League,0.12,0.88,-12,0.88,8.33,1.14,10
Kortrijk,8,0,2,6,6,20,-14,2,Belgium - Pro League,0.0,1.0,-14,0.75,0.0,1.0,11
Beerschot,8,0,1,7,5,16,-11,1,Belgium - Pro League,0.0,1.0,-11,0.62,0.0,1.0,12
Club Brugge B,8,5,1,2,14,9,5,16,Belgium - Challenger Pro League,0.62,0.38,5,1.75,1.61,2.63,1
Patro Eisden,8,4,3,1,15,6,9,15,Belgium - Challenger Pro League,0.5,0.5,9,1.88,2.0,2.0,2
La Louviere,8,4,2,2,15,9,6,14,Belgium - Challenger Pro League,0.5,0.5,6,1.88,2.0,2.0,3
Beveren,8,4,2,2,10,10,0,14,Belgium - Challenger Pro League,0.5,0.5,0,1.25,2.0,2.0,3
Lokeren-Temse,8,4,2,2,9,10,-1,14,Belgium - Challenger Pro League,0.5,0.5,-1,1.12,2.0,2.0,3
RWDM,8,3,3,2,12,9,3,12,Belgium - Challenger Pro League,0.38,0.62,3,1.5,2.63,1.61,4
Zulte-Waregem,8,3,3,2,12,9,3,12,Belgium - Challenger Pro League,0.38,0.62,3,1.5,2.63,1.61,4
Seraing,8,3,2,3,10,15,-5,11,Belgium - Challenger Pro League,0.38,0.62,-5,1.25,2.63,1.61,5
Francs Borains,8,3,2,3,7,13,-6,11,Belgium - Challenger Pro League,0.38,0.62,-6,0.88,2.63,1.61,5
RFC Liege,8,3,0,5,9,13,-4,9,Belgium - Challenger Pro League,0.38,0.62,-4,1.12,2.63,1.61,6
Lierse K.,8,2,2,4,11,13,-2,8,Belgium - Challenger Pro League,0.25,0.75,-2,1.38,4.0,1.33,7
Eupen,8,1,4,3,11,11,0,7,Belgium - Challenger Pro League,0.12,0.88,0,1.38,8.33,1.14,8
Anderlecht B,8,1,4,3,8,12,-4,7,Belgium - Challenger Pro League,0.12,0.88,-4,1.0,8.33,1.14,8
Lommel SK,8,2,1,5,11,20,-9,7,Belgium - Challenger Pro League,0.25,0.75,-9,1.38,4.0,1.33,8
KRC Genk B,8,0,2,6,7,19,-12,2,Belgium - Challenger Pro League,0.0,1.0,-12,0.88,0.0,1.0,9
Deinze,0,0,0,0,0,0,0,0,Belgium - Challenger Pro League,0.0,0.0,0,0.0,0.0,0.0,10
Bolivar,4,2,0,2,6,5,1,6,Bolivia - Primera Div. - Apertura,0.5,0.5,1,1.5,2.0,2.0,1
Royal Pari,4,2,0,2,5,6,-1,6,Bolivia - Primera Div. - Apertura,0.5,0.5,-1,1.25,2.0,2.0,1
Blooming,4,1,2,1,7,8,-1,5,Bolivia - Primera Div. - Apertura,0.25,0.75,-1,1.75,4.0,1.33,2
SA Bulo Bulo,4,1,1,2,5,5,0,4,Bolivia - Primera Div. - Apertura,0.25,0.75,0,1.25,4.0,1.33,3
Gualberto V. SJ,4,1,1,2,6,8,-2,4,Bolivia - Primera Div. - Apertura,0.25,0.75,-2,1.5,4.0,1.33,3
Nacional Potosi,4,1,1,2,4,7,-3,4,Bolivia - Primera Div. - Apertura,0.25,0.75,-3,1.0,4.0,1.33,3
Real Tomayapo,4,1,1,2,4,7,-3,4,Bolivia - Primera Div. - Apertura,0.25,0.75,-3,1.0,4.0,1.33,3
The Strongest,4,1,1,2,8,13,-5,4,Bolivia - Primera Div. - Apertura,0.25,0.75,-5,2.0,4.0,1.33,3
I. Petrolero,4,1,0,3,4,7,-3,3,Bolivia - Primera Div. - Apertura,0.25,0.75,-3,1.0,4.0,1.33,4
Oriente P.,4,1,0,3,6,10,-4,3,Bolivia - Primera Div. - Apertura,0.25,0.75,-4,1.5,4.0,1.33,4
Santa Cruz,4,1,0,3,4,8,-4,3,Bolivia - Primera Div. - Apertura,0.25,0.75,-4,1.0,4.0,1.33,4
Aurora,4,0,2,2,1,3,-2,2,Bolivia - Primera Div. - Apertura,0.0,1.0,-2,0.25,0.0,1.0,5
U. de Vinto,4,0,2,2,2,5,-3,2,Bolivia - Primera Div. - Apertura,0.0,1.0,-3,0.5,0.0,1.0,5
Wilstermann,4,0,1,3,4,7,-3,1,Bolivia - Primera Div. - Apertura,0.0,1.0,-3,1.0,0.0,1.0,6
Guabira,4,0,1,3,3,6,-3,1,Bolivia - Primera Div. - Apertura,0.0,1.0,-3,0.75,0.0,1.0,6
Always Ready,4,0,1,3,3,7,-4,1,Bolivia - Primera Div. - Apertura,0.0,1.0,-4,0.75,0.0,1.0,6
Bolivar,8,5,2,1,24,12,12,17,Bolivia - Primera Div. - Clausura,0.62,0.38,12,3.0,1.61,2.63,1
Always Ready,8,4,1,3,16,12,4,13,Bolivia - Primera Div. - Clausura,0.5,0.5,4,2.0,2.0,2.0,2
Aurora,8,3,3,2,14,16,-2,12,Bolivia - Primera Div. - Clausura,0.38,0.62,-2,1.75,2.63,1.61,3
Nacional Potosi,8,3,2,3,15,16,-1,11,Bolivia - Primera Div. - Clausura,0.38,0.62,-1,1.88,2.63,1.61,4
Wilstermann,8,3,2,3,9,10,-1,11,Bolivia - Primera Div. - Clausura,0.38,0.62,-1,1.12,2.63,1.61,4
The Strongest,8,3,1,4,11,14,-3,10,Bolivia - Primera Div. - Clausura,0.38,0.62,-3,1.38,2.63,1.61,5
SA Bulo Bulo,8,3,1,4,7,13,-6,10,Bolivia - Primera Div. - Clausura,0.38,0.62,-6,0.88,2.63,1.61,5
Blooming,8,3,1,4,6,18,-12,10,Bolivia - Primera Div. - Clausura,0.38,0.62,-12,0.75,2.63,1.61,5
Santa Cruz,8,3,0,5,11,25,-14,9,Bolivia - Primera Div. - Clausura,0.38,0.62,-14,1.38,2.63,1.61,6
Gualberto V. SJ,8,2,2,4,11,15,-4,8,Bolivia - Primera Div. - Clausura,0.25,0.75,-4,1.38,4.0,1.33,7
U. de Vinto,8,2,2,4,9,16,-7,8,Bolivia - Primera Div. - Clausura,0.25,0.75,-7,1.12,4.0,1.33,7
I. Petrolero,8,2,1,5,8,15,-7,7,Bolivia - Primera Div. - Clausura,0.25,0.75,-7,1.0,4.0,1.33,8
Guabira,8,1,2,5,8,18,-10,5,Bolivia - Primera Div. - Clausura,0.12,0.88,-10,1.0,8.33,1.14,9
Royal Pari,8,1,2,5,6,17,-11,5,Bolivia - Primera Div. - Clausura,0.12,0.88,-11,0.75,8.33,1.14,9
Real Tomayapo,8,1,0,7,10,19,-9,3,Bolivia - Primera Div. - Clausura,0.12,0.88,-9,1.25,8.33,1.14,10
Oriente P.,8,0,2,6,10,24,-14,2,Bolivia - Primera Div. - Clausura,0.0,1.0,-14,1.25,0.0,1.0,11
Palmeiras,8,6,1,1,13,7,6,19,Brazil - Serie A,0.75,0.25,6,1.62,1.33,4.0,1
Botafogo,8,5,2,1,9,4,5,17,Brazil - Serie A,0.62,0.38,5,1.12,1.61,2.63,2
Flamengo,8,4,2,2,12,7,5,14,Brazil - Serie A,0.5,0.5,5,1.5,2.0,2.0,3
Internacional,8,4,2,2,16,13,3,14,Brazil - Serie A,0.5,0.5,3,2.0,2.0,2.0,3
Corinthians,8,4,1,3,12,9,3,13,Brazil - Serie A,0.5,0.5,3,1.5,2.0,2.0,4
Vitoria,8,3,3,2,12,11,1,12,Brazil - Serie A,0.38,0.62,1,1.5,2.63,1.61,5
Fluminense,8,3,1,4,8,8,0,10,Brazil - Serie A,0.38,0.62,0,1.0,2.63,1.61,6
Juventude,8,2,3,3,11,13,-2,9,Brazil - Serie A,0.25,0.75,-2,1.38,4.0,1.33,7
Sao Paulo,8,2,2,4,8,10,-2,8,Brazil - Serie A,0.25,0.75,-2,1.0,4.0,1.33,8
Vasco da Gama,8,2,2,4,6,15,-9,8,Brazil - Serie A,0.25,0.75,-9,0.75,4.0,1.33,8
Bahia,8,2,1,5,10,16,-6,7,Brazil - Serie A,0.25,0.75,-6,1.25,4.0,1.33,9
Fortaleza,8,1,3,4,11,15,-4,6,Brazil - Serie A,0.12,0.88,-4,1.38,8.33,1.14,10
Cruzeiro,8,1,3,4,5,10,-5,6,Brazil - Serie A,0.12,0.88,-5,0.62,8.33,1.14,10
Gremio,8,0,5,3,7,10,-3,5,Brazil - Serie A,0.0,1.0,-3,0.88,0.0,1.0,11
Bragantino,8,1,2,5,5,13,-8,5,Brazil - Serie A,0.12,0.88,-8,0.62,8.33,1.14,11
Criciuma,8,1,2,5,5,17,-12,5,Brazil - Serie A,0.12,0.88,-12,0.62,8.33,1.14,11
Cuiaba,8,0,4,4,1,7,-6,4,Brazil - Serie A,0.0,1.0,-6,0.12,0.0,1.0,12
Atletico MG,8,0,3,5,4,12,-8,3,Brazil - Serie A,0.0,1.0,-8,0.5,0.0,1.0,13
Athletico PR,8,0,2,6,5,13,-8,2,Brazil - Serie A,0.0,1.0,-8,0.62,0.0,1.0,14
Atletico GO,8,0,1,7,4,18,-14,1,Brazil - Serie A,0.0,1.0,-14,0.5,0.0,1.0,15
Sport Recife,8,4,2,2,13,6,7,14,Brazil - Serie B,0.5,0.5,7,1.62,2.0,2.0,1
Santos,8,4,1,3,11,9,2,13,Brazil - Serie B,0.5,0.5,2,1.38,2.0,2.0,2
Goias,8,3,3,2,12,5,7,12,Brazil - Serie B,0.38,0.62,7,1.5,2.63,1.61,3
Botafogo SP,8,3,2,3,8,9,-1,11,Brazil - Serie B,0.38,0.62,-1,1.0,2.63,1.61,4
CRB,8,3,1,4,8,9,-1,10,Brazil - Serie B,0.38,0.62,-1,1.0,2.63,1.61,5
Ituano,8,3,0,5,13,14,-1,9,Brazil - Serie B,0.38,0.62,-1,1.62,2.63,1.61,6
Mirassol,8,2,3,3,7,8,-1,9,Brazil - Serie B,0.25,0.75,-1,0.88,4.0,1.33,6
Novorizontino,8,2,2,4,7,7,0,8,Brazil - Serie B,0.25,0.75,0,0.88,4.0,1.33,7
Ceara,8,2,2,4,10,11,-1,8,Brazil - Serie B,0.25,0.75,-1,1.25,4.0,1.33,7
Chapecoense,8,2,2,4,8,10,-2,8,Brazil - Serie B,0.25,0.75,-2,1.0,4.0,1.33,7
Operario PR,8,2,2,4,6,10,-4,8,Brazil - Serie B,0.25,0.75,-4,0.75,4.0,1.33,7
Avai,8,2,1,5,7,11,-4,7,Brazil - Serie B,0.25,0.75,-4,0.88,4.0,1.33,8
Coritiba,8,2,0,6,10,14,-4,6,Brazil - Serie B,0.25,0.75,-4,1.25,4.0,1.33,9
Paysandu,8,1,3,4,8,12,-4,6,Brazil - Serie B,0.12,0.88,-4,1.0,8.33,1.14,9
Amazonas,8,1,2,5,2,8,-6,5,Brazil - Serie B,0.12,0.88,-6,0.25,8.33,1.14,10
America MG,8,1,1,6,6,10,-4,4,Brazil - Serie B,0.12,0.88,-4,0.75,8.33,1.14,11
Ponte Preta,8,1,1,6,7,14,-7,4,Brazil - Serie B,0.12,0.88,-7,0.88,8.33,1.14,11
Guarani,8,1,0,7,5,14,-9,3,Brazil - Serie B,0.12,0.88,-9,0.62,8.33,1.14,12
Vila Nova,8,1,0,7,3,18,-15,3,Brazil - Serie B,0.12,0.88,-15,0.38,8.33,1.14,12
Brusque,8,0,2,6,1,12,-11,2,Brazil - Serie B,0.0,1.0,-11,0.12,0.0,1.0,13
Ferroviaria,8,3,4,1,4,2,2,13,Brazil - Serie C,0.38,0.62,2,0.5,2.63,1.61,1
CSA,8,4,1,3,8,7,1,13,Brazil - Serie C,0.5,0.5,1,1.0,2.0,2.0,1
Botafogo PB,8,3,3,2,10,9,1,12,Brazil - Serie C,0.38,0.62,1,1.25,2.63,1.61,2
Londrina,8,3,2,3,7,7,0,11,Brazil - Serie C,0.38,0.62,0,0.88,2.63,1.61,3
Sao Bernardo,8,3,2,3,10,11,-1,11,Brazil - Serie C,0.38,0.62,-1,1.25,2.63,1.61,3
Volta Redonda,8,3,2,3,12,15,-3,11,Brazil - Serie C,0.38,0.62,-3,1.5,2.63,1.61,3
Athletic Club,8,2,4,2,10,11,-1,10,Brazil - Serie C,0.25,0.75,-1,1.25,4.0,1.33,4
Floresta,8,2,3,3,4,8,-4,9,Brazil - Serie C,0.25,0.75,-4,0.5,4.0,1.33,5
Ypiranga,8,2,2,4,6,12,-6,8,Brazil - Serie C,0.25,0.75,-6,0.75,4.0,1.33,6
ABC,8,1,4,3,8,8,0,7,Brazil - Serie C,0.12,0.88,0,1.0,8.33,1.14,7
Tombense,8,1,4,3,10,11,-1,7,Brazil - Serie C,0.12,0.88,-1,1.25,8.33,1.14,7
Remo,8,2,1,5,9,14,-5,7,Brazil - Serie C,0.25,0.75,-5,1.12,4.0,1.33,7
Nautico,8,0,4,4,9,14,-5,4,Brazil - Serie C,0.0,1.0,-5,1.12,0.0,1.0,8
Sampaio Correa,8,0,4,4,3,8,-5,4,Brazil - Serie C,0.0,1.0,-5,0.38,0.0,1.0,8
Ferroviario,8,1,1,6,7,16,-9,4,Brazil - Serie C,0.12,0.88,-9,0.88,8.33,1.14,8
Figueirense,8,1,1,6,7,16,-9,4,Brazil - Serie C,0.12,0.88,-9,0.88,8.33,1.14,8
Aparecidense,8,1,1,6,6,15,-9,4,Brazil - Serie C,0.12,0.88,-9,0.75,8.33,1.14,8
EC Sao Jose,8,0,3,5,5,11,-6,3,Brazil - Serie C,0.0,1.0,-6,0.62,0.0,1.0,9
Confianca,8,0,1,7,4,14,-10,1,Brazil - Serie C,0.0,1.0,-10,0.5,0.0,1.0,10
Caxias,8,0,0,8,4,14,-10,0,Brazil - Serie C,0.0,1.0,-10,0.5,0.0,1.0,11
Manauara,7,4,3,0,14,3,11,15,Brazil - Serie D,0.57,0.43,11,2.0,1.75,2.33,1
Treze,7,4,2,1,15,6,9,14,Brazil - Serie D,0.57,0.43,9,2.14,1.75,2.33,2
Brasiliense,7,4,1,2,13,7,6,13,Brazil - Serie D,0.57,0.43,6,1.86,1.75,2.33,3
Itabuna,7,4,1,2,11,7,4,13,Brazil - Serie D,0.57,0.43,4,1.57,1.75,2.33,3
Anapolis,7,4,1,2,8,5,3,13,Brazil - Serie D,0.57,0.43,3,1.14,1.75,2.33,3
Maranhao,7,3,3,1,8,5,3,12,Brazil - Serie D,0.43,0.57,3,1.14,2.33,1.75,4
Nova Iguacu,7,3,3,1,6,4,2,12,Brazil - Serie D,0.43,0.57,2,0.86,2.33,1.75,4
Cianorte,7,4,0,3,6,6,0,12,Brazil - Serie D,0.57,0.43,0,0.86,1.75,2.33,4
Altos,7,3,2,2,10,9,1,11,Brazil - Serie D,0.43,0.57,1,1.43,2.33,1.75,5
Maringa,7,3,2,2,10,9,1,11,Brazil - Serie D,0.43,0.57,1,1.43,2.33,1.75,5
P. do Solimoes,7,3,2,2,9,10,-1,11,Brazil - Serie D,0.43,0.57,-1,1.29,2.33,1.75,5
Portuguesa RJ,7,2,4,1,6,4,2,10,Brazil - Serie D,0.29,0.71,2,0.86,3.45,1.41,6
Itabaiana,7,3,1,3,8,7,1,10,Brazil - Serie D,0.43,0.57,1,1.14,2.33,1.75,6
CSE,7,3,1,3,9,10,-1,10,Brazil - Serie D,0.43,0.57,-1,1.29,2.33,1.75,6
Juazeirense,7,3,1,3,5,6,-1,10,Brazil - Serie D,0.43,0.57,-1,0.71,2.33,1.75,6
Manaus,7,2,3,2,11,10,1,9,Brazil - Serie D,0.29,0.71,1,1.57,3.45,1.41,7
Hercilio Luz,7,1,6,0,5,4,1,9,Brazil - Serie D,0.14,0.86,1,0.71,7.14,1.16,7
Serra,7,2,3,2,9,10,-1,9,Brazil - Serie D,0.29,0.71,-1,1.29,3.45,1.41,7
Novo Hamburgo,7,2,3,2,8,9,-1,9,Brazil - Serie D,0.29,0.71,-1,1.14,3.45,1.41,7
Atletico CE,7,2,3,2,7,9,-2,9,Brazil - Serie D,0.29,0.71,-2,1.0,3.45,1.41,7
Porto Velho,7,3,0,4,8,11,-3,9,Brazil - Serie D,0.43,0.57,-3,1.14,2.33,1.75,7
Trem,7,3,0,4,11,15,-4,9,Brazil - Serie D,0.43,0.57,-4,1.57,2.33,1.75,7
Barra FC,7,2,2,3,6,5,1,8,Brazil - Serie D,0.29,0.71,1,0.86,3.45,1.41,8
Inter Limeira,7,2,2,3,4,3,1,8,Brazil - Serie D,0.29,0.71,1,0.57,3.45,1.41,8
River,7,2,2,3,8,8,0,8,Brazil - Serie D,0.29,0.71,0,1.14,3.45,1.41,8
ASA,7,2,2,3,8,9,-1,8,Brazil - Serie D,0.29,0.71,-1,1.14,3.45,1.41,8
Retro,7,2,2,3,7,8,-1,8,Brazil - Serie D,0.29,0.71,-1,1.0,3.45,1.41,8
Costa Rica MS,7,2,2,3,5,6,-1,8,Brazil - Serie D,0.29,0.71,-1,0.71,3.45,1.41,8
CRAC,7,1,5,1,4,5,-1,8,Brazil - Serie D,0.14,0.86,-1,0.57,7.14,1.16,8
Flamengo,5,3,2,0,13,1,12,11,Brazil - Carioca,0.6,0.4,12,2.6,1.67,2.5,1
Volta Redonda,6,3,1,2,8,8,0,10,Brazil - Carioca,0.5,0.5,0,1.33,2.0,2.0,2
Madureira,6,2,1,3,7,6,1,7,Brazil - Carioca,0.33,0.67,1,1.17,3.03,1.49,3
Fluminense,5,2,1,2,6,5,1,7,Brazil - Carioca,0.4,0.6,1,1.2,2.5,1.67,3
Nova Iguacu,5,2,1,2,3,5,-2,7,Brazil - Carioca,0.4,0.6,-2,0.6,2.5,1.67,3
Boavista,5,1,3,1,3,3,0,6,Brazil - Carioca,0.2,0.8,0,0.6,5.0,1.25,4
Vasco da Gama,5,1,3,1,3,4,-1,6,Brazil - Carioca,0.2,0.8,-1,0.6,5.0,1.25,4
Sampaio Correa,6,1,3,2,4,6,-2,6,Brazil - Carioca,0.17,0.83,-2,0.67,5.88,1.2,4
Botafogo,5,1,1,3,3,5,-2,4,Brazil - Carioca,0.2,0.8,-2,0.6,5.0,1.25,5
Portuguesa RJ,6,1,1,4,6,13,-7,4,Brazil - Carioca,0.17,0.83,-7,1.0,5.88,1.2,5
CFRJ . Marica,6,1,1,4,5,13,-8,4,Brazil - Carioca,0.17,0.83,-8,0.83,5.88,1.2,5
Bangu,6,0,3,3,4,10,-6,3,Brazil - Carioca,0.0,1.0,-6,0.67,0.0,1.0,6
Betim,4,3,1,0,8,2,6,10,Brazil - Mineiro,0.75,0.25,6,2.0,1.33,4.0,1
Atletico MG,4,2,2,0,3,0,3,8,Brazil - Mineiro,0.5,0.5,3,0.75,2.0,2.0,2
Democrata GV,4,2,2,0,4,2,2,8,Brazil - Mineiro,0.5,0.5,2,1.0,2.0,2.0,2
Tombense,4,2,0,2,4,4,0,6,Brazil - Mineiro,0.5,0.5,0,1.0,2.0,2.0,3
America MG,4,1,2,1,4,4,0,5,Brazil - Mineiro,0.25,0.75,0,1.0,4.0,1.33,4
Cruzeiro,4,1,1,2,6,5,1,4,Brazil - Mineiro,0.25,0.75,1,1.5,4.0,1.33,5
Itabirito,4,1,1,2,5,6,-1,4,Brazil - Mineiro,0.25,0.75,-1,1.25,4.0,1.33,5
Uberlandia,4,1,1,2,4,6,-2,4,Brazil - Mineiro,0.25,0.75,-2,1.0,4.0,1.33,5
Pouso Alegre,4,1,1,2,5,11,-6,4,Brazil - Mineiro,0.25,0.75,-6,1.25,4.0,1.33,5
Villa Nova,4,1,1,2,3,9,-6,4,Brazil - Mineiro,0.25,0.75,-6,0.75,4.0,1.33,5
Athletic Club,4,1,0,3,1,6,-5,3,Brazil - Mineiro,0.25,0.75,-5,0.25,4.0,1.33,6
Aymores,4,0,2,2,0,3,-3,2,Brazil - Mineiro,0.0,1.0,-3,0.0,0.0,1.0,7
Atletico GO,5,3,1,1,10,4,6,10,Brazil - Goiano,0.6,0.4,6,2.0,1.67,2.5,1
Anapolis,5,3,1,1,6,3,3,10,Brazil - Goiano,0.6,0.4,3,1.2,1.67,2.5,1
Vila Nova,5,3,1,1,7,5,2,10,Brazil - Goiano,0.6,0.4,2,1.4,1.67,2.5,1
CRAC,6,2,2,2,4,4,0,8,Brazil - Goiano,0.33,0.67,0,0.67,3.03,1.49,2
Goias,5,2,1,2,4,4,0,7,Brazil - Goiano,0.4,0.6,0,0.8,2.5,1.67,3
Goiatuba EC,6,1,4,1,4,4,0,7,Brazil - Goiano,0.17,0.83,0,0.67,5.88,1.2,3
Inhumas,6,1,2,3,3,6,-3,5,Brazil - Goiano,0.17,0.83,-3,0.5,5.88,1.2,4
Jataiense,6,1,1,4,4,8,-4,4,Brazil - Goiano,0.17,0.83,-4,0.67,5.88,1.2,5
Goianesia,6,1,1,4,4,9,-5,4,Brazil - Goiano,0.17,0.83,-5,0.67,5.88,1.2,5
ABECAT Ouvidore,6,1,1,4,3,8,-5,4,Brazil - Goiano,0.17,0.83,-5,0.5,5.88,1.2,5
Aparecidense,5,0,2,3,2,5,-3,2,Brazil - Goiano,0.0,1.0,-3,0.4,0.0,1.0,6
Goiania,5,0,0,5,2,12,-10,0,Brazil - Goiano,0.0,1.0,-10,0.4,0.0,1.0,7
Sport Recife,4,2,1,1,5,3,2,7,Brazil - Pernambucano,0.5,0.5,2,1.25,2.0,2.0,1
Maguary PE,5,2,1,2,5,9,-4,7,Brazil - Pernambucano,0.4,0.6,-4,1.0,2.5,1.67,1
Santa Cruz,4,1,2,1,6,3,3,5,Brazil - Pernambucano,0.25,0.75,3,1.5,4.0,1.33,2
Decisao,5,1,2,2,5,10,-5,5,Brazil - Pernambucano,0.2,0.8,-5,1.0,5.0,1.25,2
Retro,4,1,1,2,3,5,-2,4,Brazil - Pernambucano,0.25,0.75,-2,0.75,4.0,1.33,3
Nautico,4,1,0,3,3,5,-2,3,Brazil - Pernambucano,0.25,0.75,-2,0.75,4.0,1.33,4
Central,4,0,2,2,2,4,-2,2,Brazil - Pernambucano,0.0,1.0,-2,0.5,0.0,1.0,5
Jaguar,5,0,2,3,5,10,-5,2,Brazil - Pernambucano,0.0,1.0,-5,1.0,0.0,1.0,5
Petrolina,5,0,2,3,3,9,-6,2,Brazil - Pernambucano,0.0,1.0,-6,0.6,0.0,1.0,5
Afogados,5,0,1,4,1,9,-8,1,Brazil - Pernambucano,0.0,1.0,-8,0.2,0.0,1.0,6
Ponte Preta,6,5,1,0,9,4,5,16,Brazil - Paulista,0.83,0.17,5,1.5,1.2,5.88,1
Palmeiras,6,4,2,0,14,6,8,14,Brazil - Paulista,0.67,0.33,8,2.33,1.49,3.03,2
Sao Bernardo,6,4,1,1,9,7,2,13,Brazil - Paulista,0.67,0.33,2,1.5,1.49,3.03,3
Novorizontino,6,3,3,0,9,6,3,12,Brazil - Paulista,0.5,0.5,3,1.5,2.0,2.0,4
Corinthians,6,3,2,1,8,7,1,11,Brazil - Paulista,0.5,0.5,1,1.33,2.0,2.0,5
Sao Paulo,6,2,2,2,6,6,0,8,Brazil - Paulista,0.33,0.67,0,1.0,3.03,1.49,6
Mirassol,6,2,0,4,6,12,-6,6,Brazil - Paulista,0.33,0.67,-6,1.0,3.03,1.49,7
Santos,6,1,2,3,7,8,-1,5,Brazil - Paulista,0.17,0.83,-1,1.17,5.88,1.2,8
Bragantino,6,1,2,3,5,8,-3,5,Brazil - Paulista,0.17,0.83,-3,0.83,5.88,1.2,8
Inter Limeira,6,0,4,2,6,9,-3,4,Brazil - Paulista,0.0,1.0,-3,1.0,0.0,1.0,9
Portuguesa,6,0,4,2,4,7,-3,4,Brazil - Paulista,0.0,1.0,-3,0.67,0.0,1.0,9
Noroeste,6,1,1,4,5,10,-5,4,Brazil - Paulista,0.17,0.83,-5,0.83,5.88,1.2,9
Velo Clube,6,0,3,3,6,9,-3,3,Brazil - Paulista,0.0,1.0,-3,1.0,0.0,1.0,10
Botafogo SP,6,0,3,3,4,9,-5,3,Brazil - Paulista,0.0,1.0,-5,0.67,0.0,1.0,10
Guarani,6,0,2,4,4,9,-5,2,Brazil - Paulista,0.0,1.0,-5,0.67,0.0,1.0,11
Agua Santa,6,0,1,5,3,17,-14,1,Brazil - Paulista,0.0,1.0,-14,0.5,0.0,1.0,12
EC de Patos,5,3,0,2,11,8,3,9,Brazil - Paraibano,0.6,0.4,3,2.2,1.67,2.5,1
Sousa,4,2,2,0,5,1,4,8,Brazil - Paraibano,0.5,0.5,4,1.25,2.0,2.0,2
Treze,4,2,1,1,11,6,5,7,Brazil - Paraibano,0.5,0.5,5,2.75,2.0,2.0,3
Botafogo PB,4,2,0,2,4,4,0,6,Brazil - Paraibano,0.5,0.5,0,1.0,2.0,2.0,4
Auto Esporte,5,1,2,2,6,11,-5,5,Brazil - Paraibano,0.2,0.8,-5,1.2,5.0,1.25,5
Serra Branca,4,1,1,2,3,4,-1,4,Brazil - Paraibano,0.25,0.75,-1,0.75,4.0,1.33,6
Pombal,5,1,1,3,4,6,-2,4,Brazil - Paraibano,0.2,0.8,-2,0.8,5.0,1.25,6
Campinense,5,1,1,3,3,8,-5,4,Brazil - Paraibano,0.2,0.8,-5,0.6,5.0,1.25,6
Nacional Patos,5,0,2,3,7,13,-6,2,Brazil - Paraibano,0.0,1.0,-6,1.4,0.0,1.0,7
Picuiense,4,0,1,3,2,19,-17,1,Brazil - Paraibano,0.0,1.0,-17,0.5,0.0,1.0,8
Criciuma,5,3,2,0,8,3,5,11,Brazil - Catarinense,0.6,0.4,5,1.6,1.67,2.5,1
Chapecoense,6,2,3,1,11,9,2,9,Brazil - Catarinense,0.33,0.67,2,1.83,3.03,1.49,2
Avai,5,1,3,1,3,1,2,6,Brazil - Catarinense,0.2,0.8,2,0.6,5.0,1.25,3
Santa Catarina,6,1,3,2,8,9,-1,6,Brazil - Catarinense,0.17,0.83,-1,1.33,5.88,1.2,3
Brusque,5,1,2,2,5,4,1,5,Brazil - Catarinense,0.2,0.8,1,1.0,5.0,1.25,4
Figueirense,5,1,2,2,4,5,-1,5,Brazil - Catarinense,0.2,0.8,-1,0.8,5.0,1.25,4
Barra FC,5,1,2,2,2,5,-3,5,Brazil - Catarinense,0.2,0.8,-3,0.4,5.0,1.25,4
Joinville,6,1,2,3,3,9,-6,5,Brazil - Catarinense,0.17,0.83,-6,0.5,5.88,1.2,4
Caravaggio,6,1,1,4,5,13,-8,4,Brazil - Catarinense,0.17,0.83,-8,0.83,5.88,1.2,5
Hercilio Luz,6,0,2,4,3,8,-5,2,Brazil - Catarinense,0.0,1.0,-5,0.5,0.0,1.0,6
Marcilio Dias,5,0,2,3,2,7,-5,2,Brazil - Catarinense,0.0,1.0,-5,0.4,0.0,1.0,6
Concordia,6,0,1,5,3,14,-11,1,Brazil - Catarinense,0.0,1.0,-11,0.5,0.0,1.0,7
Internacional,4,2,2,0,8,4,4,8,Brazil - Gaucho,0.5,0.5,4,2.0,2.0,2.0,1
Gremio,4,2,1,1,4,2,2,7,Brazil - Gaucho,0.5,0.5,2,1.0,2.0,2.0,2
Juventude,4,2,1,1,6,5,1,7,Brazil - Gaucho,0.5,0.5,1,1.5,2.0,2.0,2
Caxias,4,2,1,1,2,4,-2,7,Brazil - Gaucho,0.5,0.5,-2,0.5,2.0,2.0,2
Ypiranga,4,1,2,1,2,3,-1,5,Brazil - Gaucho,0.25,0.75,-1,0.5,4.0,1.33,3
Guarany de Bage,4,1,1,2,3,3,0,4,Brazil - Gaucho,0.25,0.75,0,0.75,4.0,1.33,4
Monsoon,4,1,1,2,4,6,-2,4,Brazil - Gaucho,0.25,0.75,-2,1.0,4.0,1.33,4
Sao Luiz,4,1,1,2,2,7,-5,4,Brazil - Gaucho,0.25,0.75,-5,0.5,4.0,1.33,4
EC Sao Jose,4,0,2,2,3,6,-3,2,Brazil - Gaucho,0.0,1.0,-3,0.75,0.0,1.0,5
Brasil de P.,4,0,2,2,3,8,-5,2,Brazil - Gaucho,0.0,1.0,-5,0.75,0.0,1.0,5
Pelotas,4,0,2,2,2,8,-6,2,Brazil - Gaucho,0.0,1.0,-6,0.5,0.0,1.0,5
Avenida,4,0,0,4,2,6,-4,0,Brazil - Gaucho,0.0,1.0,-4,0.5,0.0,1.0,6
Ludogorets,8,5,2,1,19,8,11,17,Bulgaria - Parva Liga,0.62,0.38,11,2.38,1.61,2.63,1
Levski Sofia,8,5,1,2,14,6,8,16,Bulgaria - Parva Liga,0.62,0.38,8,1.75,1.61,2.63,2
Cherno More,8,5,1,2,13,6,7,16,Bulgaria - Parva Liga,0.62,0.38,7,1.62,1.61,2.63,2
Septemvri Sofia,8,5,0,3,10,10,0,15,Bulgaria - Parva Liga,0.62,0.38,0,1.25,1.61,2.63,3
CSKA Sofia,8,4,2,2,12,5,7,14,Bulgaria - Parva Liga,0.5,0.5,7,1.5,2.0,2.0,4
Arda,8,3,3,2,9,7,2,12,Bulgaria - Parva Liga,0.38,0.62,2,1.12,2.63,1.61,5
Botev Plovdiv,8,4,0,4,4,6,-2,12,Bulgaria - Parva Liga,0.5,0.5,-2,0.5,2.0,2.0,5
Beroe,8,3,2,3,11,8,3,11,Bulgaria - Parva Liga,0.38,0.62,3,1.38,2.63,1.61,6
Spartak Varna,8,3,2,3,7,11,-4,11,Bulgaria - Parva Liga,0.38,0.62,-4,0.88,2.63,1.61,6
L. Krumovgrad,8,2,4,2,5,4,1,10,Bulgaria - Parva Liga,0.25,0.75,1,0.62,4.0,1.33,7
CSKA 1948 Sofia,8,1,6,1,9,10,-1,9,Bulgaria - Parva Liga,0.12,0.88,-1,1.12,8.33,1.14,8
Lokomotiv Sofia,8,3,0,5,13,15,-2,9,Bulgaria - Parva Liga,0.38,0.62,-2,1.62,2.63,1.61,8
Lok. Plovdiv,8,2,1,5,7,11,-4,7,Bulgaria - Parva Liga,0.25,0.75,-4,0.88,4.0,1.33,9
Slavia Sofia,8,1,1,6,8,14,-6,4,Bulgaria - Parva Liga,0.12,0.88,-6,1.0,8.33,1.14,10
Hebar,8,0,3,5,7,17,-10,3,Bulgaria - Parva Liga,0.0,1.0,-10,0.88,0.0,1.0,11
Botev Vratsa,8,0,2,6,5,17,-12,2,Bulgaria - Parva Liga,0.0,1.0,-12,0.62,0.0,1.0,12
Cavalry,8,7,0,1,15,6,9,21,Canada - Premier League,0.88,0.12,9,1.88,1.14,8.33,1
Forge,8,3,2,3,8,9,-1,11,Canada - Premier League,0.38,0.62,-1,1.0,2.63,1.61,2
York Utd,8,3,2,3,8,9,-1,11,Canada - Premier League,0.38,0.62,-1,1.0,2.63,1.61,2
A. Ottawa,8,2,3,3,10,12,-2,9,Canada - Premier League,0.25,0.75,-2,1.25,4.0,1.33,3
Valour,8,1,5,2,12,12,0,8,Canada - Premier League,0.12,0.88,0,1.5,8.33,1.14,4
Vancouver FC,8,1,4,3,8,12,-4,7,Canada - Premier League,0.12,0.88,-4,1.0,8.33,1.14,5
Pacific,8,1,2,5,6,11,-5,5,Canada - Premier League,0.12,0.88,-5,0.75,8.33,1.14,6
HFX Wanderers,8,0,2,6,6,17,-11,2,Canada - Premier League,0.0,1.0,-11,0.75,0.0,1.0,7
Coquimbo Unido,2,2,0,0,5,1,4,6,Chile - Primera Division,1.0,0.0,4,2.5,1.0,0.0,1
Palestino,1,1,0,0,3,0,3,3,Chile - Primera Division,1.0,0.0,3,3.0,1.0,0.0,2
Colo-Colo,1,1,0,0,3,1,2,3,Chile - Primera Division,1.0,0.0,2,3.0,1.0,0.0,2
OHiggins,1,1,0,0,1,0,1,3,Chile - Primera Division,1.0,0.0,1,1.0,1.0,0.0,2
D. Limache,1,0,1,0,1,1,0,1,Chile - Primera Division,0.0,1.0,0,1.0,0.0,1.0,3
Huachipato,1,0,1,0,0,0,0,1,Chile - Primera Division,0.0,1.0,0,0.0,0.0,1.0,3
Everton,2,0,1,1,1,5,-4,1,Chile - Primera Division,0.0,1.0,-4,0.5,0.0,1.0,3
U. de Chile,0,0,0,0,0,0,0,0,Chile - Primera Division,0.0,0.0,0,0.0,0.0,0.0,4
Cobresal,1,0,0,1,1,2,-1,0,Chile - Primera Division,0.0,1.0,-1,1.0,0.0,1.0,4
U. Catolica,1,0,0,1,0,1,-1,0,Chile - Primera Division,0.0,1.0,-1,0.0,0.0,1.0,4
Union La Calera,1,0,0,1,0,1,-1,0,Chile - Primera Division,0.0,1.0,-1,0.0,0.0,1.0,4
D. Iquique,1,0,0,1,2,4,-2,0,Chile - Primera Division,0.0,1.0,-2,2.0,0.0,1.0,4
Audax Italiano,1,0,0,1,1,3,-2,0,Chile - Primera Division,0.0,1.0,-2,1.0,0.0,1.0,4
La Serena,1,0,0,1,1,3,-2,0,Chile - Primera Division,0.0,1.0,-2,1.0,0.0,1.0,4
Union Espanola,1,0,0,1,0,4,-4,0,Chile - Primera Division,0.0,1.0,-4,0.0,0.0,1.0,4
Nublense,1,0,0,1,0,5,-5,0,Chile - Primera Division,0.0,1.0,-5,0.0,0.0,1.0,4
Rangers,1,1,0,0,3,0,3,3,Chile - Primera B,1.0,0.0,3,3.0,1.0,0.0,1
Curico Unido,1,1,0,0,2,1,1,3,Chile - Primera B,1.0,0.0,1,2.0,1.0,0.0,1
S. Morning,1,0,1,0,2,2,0,1,Chile - Primera B,0.0,1.0,0,2.0,0.0,1.0,2
U. San Felipe,1,0,1,0,1,1,0,1,Chile - Primera B,0.0,1.0,0,1.0,0.0,1.0,2
Antofagasta,1,0,1,0,0,0,0,1,Chile - Primera B,0.0,1.0,0,0.0,0.0,1.0,2
U. Concepcion,1,0,1,0,0,0,0,1,Chile - Primera B,0.0,1.0,0,0.0,0.0,1.0,2
Deportes Temuco,2,0,1,1,3,4,-1,1,Chile - Primera B,0.0,1.0,-1,1.5,0.0,1.0,2
Cobreloa,0,0,0,0,0,0,0,0,Chile - Primera B,0.0,0.0,0,0.0,0.0,0.0,3
Concepcion,0,0,0,0,0,0,0,0,Chile - Primera B,0.0,0.0,0,0.0,0.0,0.0,3
Copiapo,0,0,0,0,0,0,0,0,Chile - Primera B,0.0,0.0,0,0.0,0.0,0.0,3
S. Wanderers,0,0,0,0,0,0,0,0,Chile - Primera B,0.0,0.0,0,0.0,0.0,0.0,3
San Luis,0,0,0,0,0,0,0,0,Chile - Primera B,0.0,0.0,0,0.0,0.0,0.0,3
San Marcos,0,0,0,0,0,0,0,0,Chile - Primera B,0.0,0.0,0,0.0,0.0,0.0,3
CD Santa Cruz,1,0,0,1,2,3,-1,0,Chile - Primera B,0.0,1.0,-1,2.0,0.0,1.0,3
Magallanes,1,0,0,1,1,2,-1,0,Chile - Primera B,0.0,1.0,-1,1.0,0.0,1.0,3
Recoleta,1,0,0,1,0,3,-3,0,Chile - Primera B,0.0,1.0,-3,0.0,0.0,1.0,3
Beijing Guoan,2,1,1,0,4,2,2,4,China - Super League,0.5,0.5,2,2.0,2.0,2.0,1
Sichuan Jiuniu,2,1,0,1,2,3,-1,3,China - Super League,0.5,0.5,-1,1.0,2.0,2.0,2
Meizhou Hakka,1,0,1,0,2,2,0,1,China - Super League,0.0,1.0,0,2.0,0.0,1.0,3
Qingdao West C.,1,0,1,0,2,2,0,1,China - Super League,0.0,1.0,0,2.0,0.0,1.0,3
Zhejiang,1,0,1,0,1,1,0,1,China - Super League,0.0,1.0,0,1.0,0.0,1.0,3
Henan SL,2,0,1,1,1,2,-1,1,China - Super League,0.0,1.0,-1,0.5,0.0,1.0,3
Dalian Yingbo,2,0,1,1,2,5,-3,1,China - Super League,0.0,1.0,-3,1.0,0.0,1.0,3
Chengdu,0,0,0,0,0,0,0,0,China - Super League,0.0,0.0,0,0.0,0.0,0.0,4
Qingdao Hainiu,0,0,0,0,0,0,0,0,China - Super League,0.0,0.0,0,0.0,0.0,0.0,4
S. Shenhua,0,0,0,0,0,0,0,0,China - Super League,0.0,0.0,0,0.0,0.0,0.0,4
Shandong T.,0,0,0,0,0,0,0,0,China - Super League,0.0,0.0,0,0.0,0.0,0.0,4
Shanghai Port,0,0,0,0,0,0,0,0,China - Super League,0.0,0.0,0,0.0,0.0,0.0,4
Tianjin T.,0,0,0,0,0,0,0,0,China - Super League,0.0,0.0,0,0.0,0.0,0.0,4
Yunnan Yukun,0,0,0,0,0,0,0,0,China - Super League,0.0,0.0,0,0.0,0.0,0.0,4
Wuhan Three T.,1,0,0,1,0,1,-1,0,China - Super League,0.0,1.0,-1,0.0,0.0,1.0,4
Changchun Yatai,2,0,0,2,1,4,-3,0,China - Super League,0.0,1.0,-3,0.5,0.0,1.0,4
Liaoning Tieren,8,5,2,1,12,10,2,17,China - League One,0.62,0.38,2,1.5,1.61,2.63,1
Guangzhou FC,8,4,2,2,14,7,7,14,China - League One,0.5,0.5,7,1.75,2.0,2.0,2
Yunnan Yukun,8,4,1,3,17,9,8,13,China - League One,0.5,0.5,8,2.12,2.0,2.0,3
S. Gongfu,8,2,5,1,6,5,1,11,China - League One,0.25,0.75,1,0.75,4.0,1.33,4
Wuxi Wugou,8,3,2,3,9,11,-2,11,China - League One,0.38,0.62,-2,1.12,2.63,1.61,4
Yanbian Longdin,8,3,1,4,8,11,-3,10,China - League One,0.38,0.62,-3,1.0,2.63,1.61,5
Dalian Yingbo,8,3,1,4,9,13,-4,10,China - League One,0.38,0.62,-4,1.12,2.63,1.61,5
Heilongjiang IC,8,2,3,3,3,9,-6,9,China - League One,0.25,0.75,-6,0.38,4.0,1.33,6
Guangxi Baoyun,8,1,5,2,6,9,-3,8,China - League One,0.12,0.88,-3,0.75,8.33,1.14,7
Foshan Nanshi,8,2,2,4,5,13,-8,8,China - League One,0.25,0.75,-8,0.62,4.0,1.33,7
Suzhou Dongwu,8,1,4,3,9,11,-2,7,China - League One,0.12,0.88,-2,1.12,8.33,1.14,8
Shanghai Jiadin,8,0,6,2,6,9,-3,6,China - League One,0.0,1.0,-3,0.75,0.0,1.0,9
Chongqing T.,8,1,2,5,2,8,-6,5,China - League One,0.12,0.88,-6,0.25,8.33,1.14,10
Jiangxi Lushan,8,1,2,5,7,18,-11,5,China - League One,0.12,0.88,-11,0.88,8.33,1.14,10
Qingdao RL,8,0,3,5,6,18,-12,3,China - League One,0.0,1.0,-12,0.75,0.0,1.0,11
Nanjing City,8,0,1,7,5,16,-11,1,China - League One,0.0,1.0,-11,0.62,0.0,1.0,12
Ganzhou Ruishi,8,4,1,3,11,10,1,13,China - League Two,0.5,0.5,1,1.38,2.0,2.0,1
Shaanxi Union,8,3,2,3,13,12,1,11,China - League Two,0.38,0.62,1,1.62,2.63,1.61,2
Guangxi Lanhang,8,3,2,3,11,10,1,11,China - League Two,0.38,0.62,1,1.38,2.63,1.61,2
Guangdong GZP,8,3,2,3,8,7,1,11,China - League Two,0.38,0.62,1,1.0,2.63,1.61,2
Dalian Kuncheng,8,3,1,4,7,7,0,10,China - League Two,0.38,0.62,0,0.88,2.63,1.61,3
Guangxi H.,8,3,1,4,8,9,-1,10,China - League Two,0.38,0.62,-1,1.0,2.63,1.61,3
Shanghai Port B,8,3,1,4,10,12,-2,10,China - League Two,0.38,0.62,-2,1.25,2.63,1.61,3
Shenzhen J.,8,2,3,3,10,8,2,9,China - League Two,0.25,0.75,2,1.25,4.0,1.33,4
Shandong T. B,8,3,0,5,8,11,-3,9,China - League Two,0.38,0.62,-3,1.0,2.63,1.61,4
Haikou M.,8,2,3,3,10,14,-4,9,China - League Two,0.25,0.75,-4,1.25,4.0,1.33,4
Langfang Glory,8,2,2,4,6,8,-2,8,China - League Two,0.25,0.75,-2,0.75,4.0,1.33,5
Xian Ronghai,8,2,2,4,9,12,-3,8,China - League Two,0.25,0.75,-3,1.12,4.0,1.33,5
Taian Tiankuang,8,2,2,4,8,16,-8,8,China - League Two,0.25,0.75,-8,1.0,4.0,1.33,5
Hubei Istar,8,2,1,5,9,12,-3,7,China - League Two,0.25,0.75,-3,1.12,4.0,1.33,6
Hunan Billows,8,1,4,3,7,15,-8,7,China - League Two,0.12,0.88,-8,0.88,8.33,1.14,6
Jiangxi DH,8,1,3,4,6,7,-1,6,China - League Two,0.12,0.88,-1,0.75,8.33,1.14,7
Beijing IT,8,1,3,4,7,12,-5,6,China - League Two,0.12,0.88,-5,0.88,8.33,1.14,7
Rizhao Yuqi,8,0,5,3,6,12,-6,5,China - League Two,0.0,1.0,-6,0.75,0.0,1.0,8
Nantong Haimen,8,1,2,5,7,19,-12,5,China - League Two,0.12,0.88,-12,0.88,8.33,1.14,8
Quanzhou Yassin,8,0,0,8,5,24,-19,0,China - League Two,0.0,1.0,-19,0.62,0.0,1.0,9
I. Medelin,3,2,1,0,3,1,2,7,Colombia - Primera A - Apertura,0.67,0.33,2,1.0,1.49,3.03,1
Millonarios,4,2,1,1,7,6,1,7,Colombia - Primera A - Apertura,0.5,0.5,1,1.75,2.0,2.0,1
Envigado,4,2,1,1,5,4,1,7,Colombia - Primera A - Apertura,0.5,0.5,1,1.25,2.0,2.0,1
Santa Fe,3,1,1,1,7,3,4,4,Colombia - Primera A - Apertura,0.33,0.67,4,2.33,3.03,1.49,2
America de Cali,2,1,1,0,4,0,4,4,Colombia - Primera A - Apertura,0.5,0.5,4,2.0,2.0,2.0,2
Junior,2,1,1,0,2,0,2,4,Colombia - Primera A - Apertura,0.5,0.5,2,1.0,2.0,2.0,2
A. Nacional,3,1,1,1,5,5,0,4,Colombia - Primera A - Apertura,0.33,0.67,0,1.67,3.03,1.49,2
Deportivo Cali,3,1,1,1,1,1,0,4,Colombia - Primera A - Apertura,0.33,0.67,0,0.33,3.03,1.49,2
Deportivo Pasto,3,1,1,1,2,3,-1,4,Colombia - Primera A - Apertura,0.33,0.67,-1,0.67,3.03,1.49,2
Boyaca Chico,3,1,0,2,1,6,-5,3,Colombia - Primera A - Apertura,0.33,0.67,-5,0.33,3.03,1.49,3
Once Caldas,3,1,0,2,1,6,-5,3,Colombia - Primera A - Apertura,0.33,0.67,-5,0.33,3.03,1.49,3
Deportes Tolima,2,0,2,0,0,0,0,2,Colombia - Primera A - Apertura,0.0,1.0,0,0.0,0.0,1.0,4
R. Aguilas,3,0,2,1,4,5,-1,2,Colombia - Primera A - Apertura,0.0,1.0,-1,1.33,0.0,1.0,4
La Equidad,3,0,2,1,2,3,-1,2,Colombia - Primera A - Apertura,0.0,1.0,-1,0.67,0.0,1.0,4
A. Petrolera,3,0,2,1,1,3,-2,2,Colombia - Primera A - Apertura,0.0,1.0,-2,0.33,0.0,1.0,4
A. Bucaramanga,3,0,1,2,1,3,-2,1,Colombia - Primera A - Apertura,0.0,1.0,-2,0.33,0.0,1.0,5
Union Magdalena,3,0,1,2,2,5,-3,1,Colombia - Primera A - Apertura,0.0,1.0,-3,0.67,0.0,1.0,5
Llaneros,3,0,1,2,5,9,-4,1,Colombia - Primera A - Apertura,0.0,1.0,-4,1.67,0.0,1.0,5
Fortaleza CEIF,2,0,0,2,1,4,-3,0,Colombia - Primera A - Apertura,0.0,1.0,-3,0.5,0.0,1.0,6
D. Pereira,3,0,0,3,2,8,-6,0,Colombia - Primera A - Apertura,0.0,1.0,-6,0.67,0.0,1.0,6
A. Bucaramanga,8,5,2,1,13,5,8,17,Colombia - Primera A - Clausura,0.62,0.38,8,1.62,1.61,2.63,1
Santa Fe,8,4,4,0,11,5,6,16,Colombia - Primera A - Clausura,0.5,0.5,6,1.38,2.0,2.0,2
Millonarios,8,4,2,2,13,7,6,14,Colombia - Primera A - Clausura,0.5,0.5,6,1.62,2.0,2.0,3
A. Nacional,8,4,1,3,8,7,1,13,Colombia - Primera A - Clausura,0.5,0.5,1,1.0,2.0,2.0,4
Deportes Tolima,8,4,0,4,7,5,2,12,Colombia - Primera A - Clausura,0.5,0.5,2,0.88,2.0,2.0,5
America de Cali,8,3,2,3,11,12,-1,11,Colombia - Primera A - Clausura,0.38,0.62,-1,1.38,2.63,1.61,6
Junior,8,2,4,2,5,3,2,10,Colombia - Primera A - Clausura,0.25,0.75,2,0.62,4.0,1.33,7
I. Medelin,8,2,4,2,10,9,1,10,Colombia - Primera A - Clausura,0.25,0.75,1,1.25,4.0,1.33,7
Fortaleza CEIF,8,2,3,3,9,9,0,9,Colombia - Primera A - Clausura,0.25,0.75,0,1.12,4.0,1.33,8
Deportivo Pasto,8,2,3,3,6,6,0,9,Colombia - Primera A - Clausura,0.25,0.75,0,0.75,4.0,1.33,8
R. Aguilas,8,2,3,3,7,13,-6,9,Colombia - Primera A - Clausura,0.25,0.75,-6,0.88,4.0,1.33,8
Once Caldas,8,2,2,4,6,11,-5,8,Colombia - Primera A - Clausura,0.25,0.75,-5,0.75,4.0,1.33,9
D. Pereira,8,1,4,3,6,9,-3,7,Colombia - Primera A - Clausura,0.12,0.88,-3,0.75,8.33,1.14,10
Deportivo Cali,8,1,4,3,7,13,-6,7,Colombia - Primera A - Clausura,0.12,0.88,-6,0.88,8.33,1.14,10
La Equidad,8,1,3,4,7,13,-6,6,Colombia - Primera A - Clausura,0.12,0.88,-6,0.88,8.33,1.14,11
Patriotas,8,1,1,6,8,18,-10,4,Colombia - Primera A - Clausura,0.12,0.88,-10,1.0,8.33,1.14,12
Jaguares de C.,8,1,1,6,4,15,-11,4,Colombia - Primera A - Clausura,0.12,0.88,-11,0.5,8.33,1.14,12
Boyaca Chico,8,1,0,7,5,20,-15,3,Colombia - Primera A - Clausura,0.12,0.88,-15,0.62,8.33,1.14,13
A. Petrolera,8,0,2,6,4,13,-9,2,Colombia - Primera A - Clausura,0.0,1.0,-9,0.5,0.0,1.0,14
Envigado,8,0,1,7,2,15,-13,1,Colombia - Primera A - Clausura,0.0,1.0,-13,0.25,0.0,1.0,15
San Carlos,8,5,1,2,19,17,2,16,Costa Rica - Primera Div. - Apertura,0.62,0.38,2,2.38,1.61,2.63,1
Saprissa,8,4,2,2,10,7,3,14,Costa Rica - Primera Div. - Apertura,0.5,0.5,3,1.25,2.0,2.0,2
Alajuelense,8,3,3,2,10,9,1,12,Costa Rica - Primera Div. - Apertura,0.38,0.62,1,1.25,2.63,1.61,3
Herediano,8,3,2,3,11,11,0,11,Costa Rica - Primera Div. - Apertura,0.38,0.62,0,1.38,2.63,1.61,4
Santos Guapiles,8,1,4,3,11,13,-2,7,Costa Rica - Primera Div. - Apertura,0.12,0.88,-2,1.38,8.33,1.14,5
M. Liberia,8,2,1,5,10,14,-4,7,Costa Rica - Primera Div. - Apertura,0.25,0.75,-4,1.25,4.0,1.33,5
Zeledon,8,1,4,3,6,11,-5,7,Costa Rica - Primera Div. - Apertura,0.12,0.88,-5,0.75,8.33,1.14,5
Santa Ana,8,2,0,6,8,12,-4,6,Costa Rica - Primera Div. - Apertura,0.25,0.75,-4,1.0,4.0,1.33,6
Guanacasteca,8,1,3,4,6,15,-9,6,Costa Rica - Primera Div. - Apertura,0.12,0.88,-9,0.75,8.33,1.14,6
Cartagines,8,1,1,6,8,17,-9,4,Costa Rica - Primera Div. - Apertura,0.12,0.88,-9,1.0,8.33,1.14,7
Puntarenas,8,1,1,6,8,17,-9,4,Costa Rica - Primera Div. - Apertura,0.12,0.88,-9,1.0,8.33,1.14,7
Sporting SJ,8,0,1,7,3,12,-9,1,Costa Rica - Primera Div. - Apertura,0.0,1.0,-9,0.38,0.0,1.0,8
Slavia Prague,8,6,1,1,15,5,10,19,CzechRepublic - 1. Liga,0.75,0.25,10,1.88,1.33,4.0,1
Banik Ostrava,8,5,1,2,13,7,6,16,CzechRepublic - 1. Liga,0.62,0.38,6,1.62,1.61,2.63,2
Sparta Prague,8,4,2,2,13,8,5,14,CzechRepublic - 1. Liga,0.5,0.5,5,1.62,2.0,2.0,3
Viktoria Plzen,8,4,1,3,10,9,1,13,CzechRepublic - 1. Liga,0.5,0.5,1,1.25,2.0,2.0,4
Mlada Boleslav,8,3,3,2,13,8,5,12,CzechRepublic - 1. Liga,0.38,0.62,5,1.62,2.63,1.61,5
Bohemians,8,3,3,2,10,9,1,12,CzechRepublic - 1. Liga,0.38,0.62,1,1.25,2.63,1.61,5
Sigma Olomouc,8,3,2,3,13,11,2,11,CzechRepublic - 1. Liga,0.38,0.62,2,1.62,2.63,1.61,6
Hradec Kralove,8,3,2,3,7,9,-2,11,CzechRepublic - 1. Liga,0.38,0.62,-2,0.88,2.63,1.61,6
Jablonec,8,2,2,4,11,10,1,8,CzechRepublic - 1. Liga,0.25,0.75,1,1.38,4.0,1.33,7
Slovacko,8,2,1,5,11,20,-9,7,CzechRepublic - 1. Liga,0.25,0.75,-9,1.38,4.0,1.33,8
Slovan Liberec,8,1,3,4,8,9,-1,6,CzechRepublic - 1. Liga,0.12,0.88,-1,1.0,8.33,1.14,9
Teplice,8,1,3,4,6,13,-7,6,CzechRepublic - 1. Liga,0.12,0.88,-7,0.75,8.33,1.14,9
Karvina,8,1,2,5,11,23,-12,5,CzechRepublic - 1. Liga,0.12,0.88,-12,1.38,8.33,1.14,10
Pardubice,8,0,3,5,4,15,-11,3,CzechRepublic - 1. Liga,0.0,1.0,-11,0.5,0.0,1.0,11
Dukla Praha,8,0,3,5,4,17,-13,3,CzechRepublic - 1. Liga,0.0,1.0,-13,0.5,0.0,1.0,11
C. Budejovice,8,0,1,7,7,26,-19,1,CzechRepublic - 1. Liga,0.0,1.0,-19,0.88,0.0,1.0,12
Silkeborg,8,3,4,1,15,9,6,13,Denmark - Superligaen,0.38,0.62,6,1.88,2.63,1.61,1
Randers FC,8,3,4,1,13,8,5,13,Denmark - Superligaen,0.38,0.62,5,1.62,2.63,1.61,1
FC Kobenhavn,8,3,3,2,12,10,2,12,Denmark - Superligaen,0.38,0.62,2,1.5,2.63,1.61,2
AGF Aarhus,8,2,4,2,11,7,4,10,Denmark - Superligaen,0.25,0.75,4,1.38,4.0,1.33,3
FC Midtjylland,8,3,1,4,12,11,1,10,Denmark - Superligaen,0.38,0.62,1,1.5,2.63,1.61,3
Brondby IF,8,2,3,3,18,16,2,9,Denmark - Superligaen,0.25,0.75,2,2.25,4.0,1.33,4
Viborg,8,1,4,3,11,12,-1,7,Denmark - Superligaen,0.12,0.88,-1,1.38,8.33,1.14,5
SonderjyskE,8,2,1,5,11,17,-6,7,Denmark - Superligaen,0.25,0.75,-6,1.38,4.0,1.33,5
Nordsjaelland,8,2,1,5,13,21,-8,7,Denmark - Superligaen,0.25,0.75,-8,1.62,4.0,1.33,5
Aalborg BK,8,1,3,4,8,15,-7,6,Denmark - Superligaen,0.12,0.88,-7,1.0,8.33,1.14,6
Vejle BK,8,1,1,6,7,18,-11,4,Denmark - Superligaen,0.12,0.88,-11,0.88,8.33,1.14,7
Lyngby,8,0,2,6,5,12,-7,2,Denmark - Superligaen,0.0,1.0,-7,0.62,0.0,1.0,8
Fredericia,8,6,0,2,21,8,13,18,Denmark - 1st Division,0.75,0.25,13,2.62,1.33,4.0,1
Odense BK,8,5,3,0,21,8,13,18,Denmark - 1st Division,0.62,0.38,13,2.62,1.61,2.63,1
Kolding IF,8,5,1,2,7,2,5,16,Denmark - 1st Division,0.62,0.38,5,0.88,1.61,2.63,2
Esbjerg,8,5,0,3,15,10,5,15,Denmark - 1st Division,0.62,0.38,5,1.88,1.61,2.63,3
Hillerod,8,3,4,1,14,8,6,13,Denmark - 1st Division,0.38,0.62,6,1.75,2.63,1.61,4
AC Horsens,8,4,1,3,15,15,0,13,Denmark - 1st Division,0.5,0.5,0,1.88,2.0,2.0,4
HB Koge,8,3,3,2,12,11,1,12,Denmark - 1st Division,0.38,0.62,1,1.5,2.63,1.61,5
Hobro,8,3,1,4,11,12,-1,10,Denmark - 1st Division,0.38,0.62,-1,1.38,2.63,1.61,6
B 93,8,3,1,4,13,17,-4,10,Denmark - 1st Division,0.38,0.62,-4,1.62,2.63,1.61,6
Hvidovre,8,2,1,5,6,11,-5,7,Denmark - 1st Division,0.25,0.75,-5,0.75,4.0,1.33,7
Roskilde,8,2,1,5,8,15,-7,7,Denmark - 1st Division,0.25,0.75,-7,1.0,4.0,1.33,7
Vendsyssel,8,1,3,4,7,12,-5,6,Denmark - 1st Division,0.12,0.88,-5,0.88,8.33,1.14,8
Fremad Amager,8,6,1,1,15,8,7,19,Denmark - 2nd Division,0.75,0.25,7,1.88,1.33,4.0,1
Middelfart,8,4,2,2,14,7,7,14,Denmark - 2nd Division,0.5,0.5,7,1.75,2.0,2.0,2
Ishoj,8,4,2,2,10,8,2,14,Denmark - 2nd Division,0.5,0.5,2,1.25,2.0,2.0,2
Hellerup IK,8,3,2,3,7,4,3,11,Denmark - 2nd Division,0.38,0.62,3,0.88,2.63,1.61,3
Naestved,8,3,2,3,6,7,-1,11,Denmark - 2nd Division,0.38,0.62,-1,0.75,2.63,1.61,3
Helsingor,8,3,2,3,9,11,-2,11,Denmark - 2nd Division,0.38,0.62,-2,1.12,2.63,1.61,3
Aarhus Fremad,8,3,1,4,10,9,1,10,Denmark - 2nd Division,0.38,0.62,1,1.25,2.63,1.61,4
Skive,8,3,1,4,10,14,-4,10,Denmark - 2nd Division,0.38,0.62,-4,1.25,2.63,1.61,4
AB Copenhagen,8,2,3,3,8,10,-2,9,Denmark - 2nd Division,0.25,0.75,-2,1.0,4.0,1.33,5
BK Frem,6,2,2,2,7,7,0,8,Denmark - 2nd Division,0.33,0.67,0,1.17,3.03,1.49,6
Thisted,7,0,4,3,6,10,-4,4,Denmark - 2nd Division,0.0,1.0,-4,0.86,0.0,1.0,7
Nykobing,8,1,0,7,4,15,-11,3,Denmark - 2nd Division,0.12,0.88,-11,0.5,8.33,1.14,8
Macara,2,1,1,0,2,1,1,4,Ecuador - Liga Pro 1st Stage,0.5,0.5,1,1.0,2.0,2.0,1
U. Catolica,1,1,0,0,4,0,4,3,Ecuador - Liga Pro 1st Stage,1.0,0.0,4,4.0,1.0,0.0,2
Barcelona SC,1,1,0,0,3,2,1,3,Ecuador - Liga Pro 1st Stage,1.0,0.0,1,3.0,1.0,0.0,2
D. Cuenca,1,1,0,0,1,0,1,3,Ecuador - Liga Pro 1st Stage,1.0,0.0,1,1.0,1.0,0.0,2
Libertad,1,0,1,0,2,2,0,1,Ecuador - Liga Pro 1st Stage,0.0,1.0,0,2.0,0.0,1.0,3
El Nacional,1,0,1,0,1,1,0,1,Ecuador - Liga Pro 1st Stage,0.0,1.0,0,1.0,0.0,1.0,3
LDU Quito,1,0,1,0,1,1,0,1,Ecuador - Liga Pro 1st Stage,0.0,1.0,0,1.0,0.0,1.0,3
Cuniburo,1,0,1,0,0,0,0,1,Ecuador - Liga Pro 1st Stage,0.0,1.0,0,0.0,0.0,1.0,3
Manta,1,0,0,1,1,2,-1,0,Ecuador - Liga Pro 1st Stage,0.0,1.0,-1,1.0,0.0,1.0,4
Mushuc Runa,1,0,0,1,0,1,-1,0,Ecuador - Liga Pro 1st Stage,0.0,1.0,-1,0.0,0.0,1.0,4
Orense,1,0,0,1,0,1,-1,0,Ecuador - Liga Pro 1st Stage,0.0,1.0,-1,0.0,0.0,1.0,4
Aucas,1,0,0,1,0,2,-2,0,Ecuador - Liga Pro 1st Stage,0.0,1.0,-2,0.0,0.0,1.0,4
Delfin,1,0,0,1,0,2,-2,0,Ecuador - Liga Pro 1st Stage,0.0,1.0,-2,0.0,0.0,1.0,4
Emelec,1,0,0,1,0,2,-2,0,Ecuador - Liga Pro 1st Stage,0.0,1.0,-2,0.0,0.0,1.0,4
I. del Valle,1,0,0,1,0,2,-2,0,Ecuador - Liga Pro 1st Stage,0.0,1.0,-2,0.0,0.0,1.0,4
Tecnico U.,1,0,0,1,1,4,-3,0,Ecuador - Liga Pro 1st Stage,0.0,1.0,-3,1.0,0.0,1.0,4
Guayaquil City,8,3,3,2,7,6,1,12,Ecuador - Serie B,0.38,0.62,1,0.88,2.63,1.61,1
Manta,8,3,3,2,7,8,-1,12,Ecuador - Serie B,0.38,0.62,-1,0.88,2.63,1.61,1
San Antonio,8,2,5,1,4,3,1,11,Ecuador - Serie B,0.25,0.75,1,0.5,4.0,1.33,2
I. Juniors,8,2,4,2,9,8,1,10,Ecuador - Serie B,0.25,0.75,1,1.12,4.0,1.33,3
Cuniburo,8,2,3,3,17,12,5,9,Ecuador - Serie B,0.25,0.75,5,2.12,4.0,1.33,4
Leones Norte,8,2,2,4,5,7,-2,8,Ecuador - Serie B,0.25,0.75,-2,0.62,4.0,1.33,5
Gualaceo,8,2,1,5,5,12,-7,7,Ecuador - Serie B,0.25,0.75,-7,0.62,4.0,1.33,6
Nueve Octubre,8,1,2,5,6,12,-6,5,Ecuador - Serie B,0.12,0.88,-6,0.75,8.33,1.14,7
Vargas Torres,8,0,3,5,3,16,-13,3,Ecuador - Serie B,0.0,1.0,-13,0.38,0.0,1.0,8
Chacaritas,8,0,2,6,5,18,-13,2,Ecuador - Serie B,0.0,1.0,-13,0.62,0.0,1.0,9
Al Ahly,8,5,3,0,12,2,10,18,Egypt - Premier League,0.62,0.38,10,1.5,1.61,2.63,1
National Bank,8,5,2,1,12,7,5,17,Egypt - Premier League,0.62,0.38,5,1.5,1.61,2.63,2
Pyramids FC,8,5,2,1,9,5,4,17,Egypt - Premier League,0.62,0.38,4,1.12,1.61,2.63,2
El Geish,7,4,1,2,8,8,0,13,Egypt - Premier League,0.57,0.43,0,1.14,1.75,2.33,3
Al Masry,8,3,3,2,9,6,3,12,Egypt - Premier League,0.38,0.62,3,1.12,2.63,1.61,4
Ceramica C.,8,3,3,2,8,10,-2,12,Egypt - Premier League,0.38,0.62,-2,1.0,2.63,1.61,4
Zamalek,7,3,2,2,10,7,3,11,Egypt - Premier League,0.43,0.57,3,1.43,2.33,1.75,5
Pharco,8,3,2,3,6,8,-2,11,Egypt - Premier League,0.38,0.62,-2,0.75,2.63,1.61,5
ZED FC,8,2,4,2,6,6,0,10,Egypt - Premier League,0.25,0.75,0,0.75,4.0,1.33,6
Smouha,8,3,1,4,6,7,-1,10,Egypt - Premier League,0.38,0.62,-1,0.75,2.63,1.61,6
Petrojet,8,2,3,3,8,10,-2,9,Egypt - Premier League,0.25,0.75,-2,1.0,4.0,1.33,7
Al Ittihad,8,1,5,2,6,8,-2,8,Egypt - Premier League,0.12,0.88,-2,0.75,8.33,1.14,8
Haras El Hodood,8,2,2,4,8,13,-5,8,Egypt - Premier League,0.25,0.75,-5,1.0,4.0,1.33,8
Ghazl El M.,7,2,1,4,7,11,-4,7,Egypt - Premier League,0.29,0.71,-4,1.0,3.45,1.41,9
El Gouna,8,1,3,4,4,10,-6,6,Egypt - Premier League,0.12,0.88,-6,0.5,8.33,1.14,10
Ismaily,8,1,1,6,3,8,-5,4,Egypt - Premier League,0.12,0.88,-5,0.38,8.33,1.14,11
Modern Sport,7,0,3,4,3,9,-6,3,Egypt - Premier League,0.0,1.0,-6,0.43,0.0,1.0,12
ENPPI,8,0,3,5,6,13,-7,3,Egypt - Premier League,0.0,1.0,-7,0.75,0.0,1.0,12
Crystal Palace,8,6,2,0,14,3,11,20,Premier League,0.75,0.25,11,1.75,1.33,4.0,2
Liverpool,8,5,3,0,22,8,14,18,Premier League,0.62,0.38,14,2.75,1.61,2.63,3
Arsenal,8,5,3,0,18,6,12,18,Premier League,0.62,0.38,12,2.25,1.61,2.63,3
Bournemouth,8,5,2,1,21,11,10,17,Premier League,0.62,0.38,10,2.62,1.61,2.63,4
Fulham,8,5,2,1,15,9,6,17,Premier League,0.62,0.38,6,1.88,1.61,2.63,4
Brentford,8,4,2,2,14,6,8,14,Premier League,0.5,0.5,8,1.75,2.0,2.0,5
Newcastle Utd,8,4,1,3,14,13,1,13,Premier League,0.5,0.5,1,1.75,2.0,2.0,6
Tottenham,8,4,0,4,18,8,10,12,Premier League,0.5,0.5,10,2.25,2.0,2.0,7
Brighton,8,3,3,2,15,16,-1,12,Premier League,0.38,0.62,-1,1.88,2.63,1.61,7
Nottm Forest,8,4,0,4,14,16,-2,12,Premier League,0.5,0.5,-2,1.75,2.0,2.0,7
Manchester City,8,3,2,3,15,13,2,11,Premier League,0.38,0.62,2,1.88,2.63,1.61,8
West Ham Utd,8,3,2,3,9,11,-2,11,Premier League,0.38,0.62,-2,1.12,2.63,1.61,8
Everton,8,2,4,2,5,8,-3,10,Premier League,0.25,0.75,-3,0.62,4.0,1.33,9
Manchester Utd,8,2,3,3,8,11,-3,9,Premier League,0.25,0.75,-3,1.0,4.0,1.33,10
Chelsea,8,2,2,4,12,15,-3,8,Premier League,0.25,0.75,-3,1.5,4.0,1.33,11
Ipswich Town,8,2,2,4,10,14,-4,8,Premier League,0.25,0.75,-4,1.25,4.0,1.33,11
Wolverhampton,8,2,1,5,9,16,-7,7,Premier League,0.25,0.75,-7,1.12,4.0,1.33,12
Southampton,8,1,2,5,7,15,-8,5,Premier League,0.12,0.88,-8,0.88,8.33,1.14,13
Aston Villa,8,1,1,6,5,18,-13,4,Premier League,0.12,0.88,-13,0.62,8.33,1.14,14
Leicester City,8,1,0,7,5,23,-18,3,Premier League,0.12,0.88,-18,0.62,8.33,1.14,15
Sheffield Utd,8,7,0,1,12,5,7,21,Premier League,0.88,0.12,7,1.5,1.14,8.33,1
Leeds Utd,8,5,3,0,16,5,11,18,Premier League,0.62,0.38,11,2.0,1.61,2.63,3
Burnley,8,5,3,0,12,1,11,18,Premier League,0.62,0.38,11,1.5,1.61,2.63,3
Sunderland,8,4,2,2,12,10,2,14,Premier League,0.5,0.5,2,1.5,2.0,2.0,5
Coventry City,8,4,1,3,12,12,0,13,Premier League,0.5,0.5,0,1.5,2.0,2.0,6
Hull City,8,4,0,4,7,6,1,12,Premier League,0.5,0.5,1,0.88,2.0,2.0,7
Millwall,8,3,3,2,8,10,-2,12,Premier League,0.38,0.62,-2,1.0,2.63,1.61,7
Preston,8,3,1,4,9,10,-1,10,Premier League,0.38,0.62,-1,1.12,2.63,1.61,9
Sheffield Wed,8,3,1,4,11,16,-5,10,Premier League,0.38,0.62,-5,1.38,2.63,1.61,9
Watford,8,2,3,3,9,10,-1,9,Premier League,0.25,0.75,-1,1.12,4.0,1.33,10
Norwich City,8,2,3,3,5,8,-3,9,Premier League,0.25,0.75,-3,0.62,4.0,1.33,10
QP Rangers,8,2,2,4,7,11,-4,8,Premier League,0.25,0.75,-4,0.88,4.0,1.33,11
Middlesbrough,8,2,1,5,12,16,-4,7,Premier League,0.25,0.75,-4,1.5,4.0,1.33,12
Blackburn,8,2,1,5,6,10,-4,7,Premier League,0.25,0.75,-4,0.75,4.0,1.33,12
Oxford Utd,8,1,4,3,3,9,-6,7,Premier League,0.12,0.88,-6,0.38,8.33,1.14,12
Cardiff City,8,1,4,3,11,19,-8,7,Premier League,0.12,0.88,-8,1.38,8.33,1.14,12
Swansea City,8,2,1,5,7,19,-12,7,Premier League,0.25,0.75,-12,0.88,4.0,1.33,12
Bristol City,8,0,5,3,7,13,-6,5,Premier League,0.0,1.0,-6,0.88,0.0,1.0,13
Stoke City,8,1,2,5,7,15,-8,5,Premier League,0.12,0.88,-8,0.88,8.33,1.14,13
West Brom,8,0,4,4,7,12,-5,4,Premier League,0.0,1.0,-5,0.88,0.0,1.0,14
Portsmouth,8,1,0,7,5,17,-12,3,Premier League,0.12,0.88,-12,0.62,8.33,1.14,15
Plymouth,8,0,3,5,3,17,-14,3,Premier League,0.0,1.0,-14,0.38,0.0,1.0,15
Derby County,8,0,2,6,5,15,-10,2,Premier League,0.0,1.0,-10,0.62,0.0,1.0,16
Luton Town,8,0,1,7,5,15,-10,1,Premier League,0.0,1.0,-10,0.62,0.0,1.0,17
Birmingham City,8,5,3,0,11,3,8,18,League One,0.62,0.38,8,1.38,1.61,2.63,1
Leyton Orient,8,5,1,2,18,9,9,16,League One,0.62,0.38,9,2.25,1.61,2.63,2
Huddersfield,8,5,1,2,15,9,6,16,League One,0.62,0.38,6,1.88,1.61,2.63,2
Barnsley,8,5,0,3,13,11,2,15,League One,0.62,0.38,2,1.62,1.61,2.63,3
Charlton,8,4,2,2,14,9,5,14,League One,0.5,0.5,5,1.75,2.0,2.0,4
Wrexham,8,4,1,3,10,8,2,13,League One,0.5,0.5,2,1.25,2.0,2.0,5
Wycombe,8,3,3,2,14,9,5,12,League One,0.38,0.62,5,1.75,2.63,1.61,6
Blackpool,8,3,3,2,12,7,5,12,League One,0.38,0.62,5,1.5,2.63,1.61,6
Burton Albion,8,3,3,2,7,8,-1,12,League One,0.38,0.62,-1,0.88,2.63,1.61,6
Stevenage,8,3,3,2,6,7,-1,12,League One,0.38,0.62,-1,0.75,2.63,1.61,6
Stockport,8,3,2,3,9,8,1,11,League One,0.38,0.62,1,1.12,2.63,1.61,7
Wigan Athletic,8,3,2,3,7,6,1,11,League One,0.38,0.62,1,0.88,2.63,1.61,7
Bolton,8,3,1,4,8,10,-2,10,League One,0.38,0.62,-2,1.0,2.63,1.61,8
Reading,8,2,3,3,8,10,-2,9,League One,0.25,0.75,-2,1.0,4.0,1.33,9
Northampton,8,2,3,3,6,12,-6,9,League One,0.25,0.75,-6,0.75,4.0,1.33,9
Mansfield,8,2,2,4,13,15,-2,8,League One,0.25,0.75,-2,1.62,4.0,1.33,10
Lincoln City,8,2,2,4,12,14,-2,8,League One,0.25,0.75,-2,1.5,4.0,1.33,10
Rotherham,8,2,2,4,8,11,-3,8,League One,0.25,0.75,-3,1.0,4.0,1.33,10
Exeter City,8,2,1,5,6,14,-8,7,League One,0.25,0.75,-8,0.75,4.0,1.33,11
Shrewsbury,8,1,3,4,7,11,-4,6,League One,0.12,0.88,-4,0.88,8.33,1.14,12
Cambridge Utd,8,1,3,4,9,15,-6,6,League One,0.12,0.88,-6,1.12,8.33,1.14,12
Peterborough,8,1,2,5,8,16,-8,5,League One,0.12,0.88,-8,1.0,8.33,1.14,13
Crawley Town,8,1,1,6,12,23,-11,4,League One,0.12,0.88,-11,1.5,8.33,1.14,14
Bristol Rovers,8,1,0,7,3,16,-13,3,League One,0.12,0.88,-13,0.38,8.33,1.14,15
Bromley,8,4,2,2,12,11,1,14,League Two,0.5,0.5,1,1.5,2.0,2.0,1
Notts County,8,4,1,3,16,13,3,13,League Two,0.5,0.5,3,2.0,2.0,2.0,2
Colchester Utd,8,3,4,1,8,5,3,13,League Two,0.38,0.62,3,1.0,2.63,1.61,2
Walsall,8,4,1,3,10,10,0,13,League Two,0.5,0.5,0,1.25,2.0,2.0,2
Doncaster,8,4,1,3,10,11,-1,13,League Two,0.5,0.5,-1,1.25,2.0,2.0,2
Bradford,8,3,3,2,7,8,-1,12,League Two,0.38,0.62,-1,0.88,2.63,1.61,3
AFC Wimbledon,8,2,5,1,7,4,3,11,League Two,0.25,0.75,3,0.88,4.0,1.33,4
Swindon Town,8,3,2,3,10,8,2,11,League Two,0.38,0.62,2,1.25,2.63,1.61,4
Salford City,8,3,1,4,9,8,1,10,League Two,0.38,0.62,1,1.12,2.63,1.61,5
Crewe Alexandra,8,2,4,2,7,8,-1,10,League Two,0.25,0.75,-1,0.88,4.0,1.33,5
Grimsby,8,3,1,4,12,14,-2,10,League Two,0.38,0.62,-2,1.5,2.63,1.61,5
Accrington,8,3,0,5,7,9,-2,9,League Two,0.38,0.62,-2,0.88,2.63,1.61,6
Port Vale,8,1,5,2,9,12,-3,8,League Two,0.12,0.88,-3,1.12,8.33,1.14,7
Cheltenham,8,1,4,3,9,11,-2,7,League Two,0.12,0.88,-2,1.12,8.33,1.14,8
Carlisle Utd,8,2,1,5,6,9,-3,7,League Two,0.25,0.75,-3,0.75,4.0,1.33,8
Fleetwood,8,2,1,5,8,12,-4,7,League Two,0.25,0.75,-4,1.0,4.0,1.33,8
Gillingham,8,1,4,3,4,9,-5,7,League Two,0.12,0.88,-5,0.5,8.33,1.14,8
Newport,8,1,3,4,10,16,-6,6,League Two,0.12,0.88,-6,1.25,8.33,1.14,9
Harrogate,8,1,1,6,6,11,-5,4,League Two,0.12,0.88,-5,0.75,8.33,1.14,10
Chesterfield,8,1,1,6,5,13,-8,4,League Two,0.12,0.88,-8,0.62,8.33,1.14,10
Milton Keynes,8,1,1,6,11,20,-9,4,League Two,0.12,0.88,-9,1.38,8.33,1.14,10
Morecambe,8,1,0,7,2,10,-8,3,League Two,0.12,0.88,-8,0.25,8.33,1.14,11
Barrow,8,0,2,6,4,15,-11,2,League Two,0.0,1.0,-11,0.5,0.0,1.0,12
Tranmere,8,0,0,8,4,22,-18,0,League Two,0.0,1.0,-18,0.5,0.0,1.0,13
Barnet,8,4,4,0,12,1,11,16,England - National League,0.5,0.5,11,1.5,2.0,2.0,1
Gateshead FC,8,4,3,1,19,6,13,15,England - National League,0.5,0.5,13,2.38,2.0,2.0,2
Halifax Town,8,4,3,1,15,11,4,15,England - National League,0.5,0.5,4,1.88,2.0,2.0,2
Oldham,8,4,3,1,12,8,4,15,England - National League,0.5,0.5,4,1.5,2.0,2.0,2
York City,8,4,1,3,11,11,0,13,England - National League,0.5,0.5,0,1.38,2.0,2.0,3
Altrincham,8,3,3,2,15,14,1,12,England - National League,0.38,0.62,1,1.88,2.63,1.61,4
Southend Utd,8,3,3,2,8,7,1,12,England - National League,0.38,0.62,1,1.0,2.63,1.61,4
Tamworth,8,3,3,2,12,12,0,12,England - National League,0.38,0.62,0,1.5,2.63,1.61,4
Forest Green,8,2,5,1,11,8,3,11,England - National League,0.25,0.75,3,1.38,4.0,1.33,5
Eastleigh,8,3,2,3,9,9,0,11,England - National League,0.38,0.62,0,1.12,2.63,1.61,5
Wealdstone,8,3,2,3,12,13,-1,11,England - National League,0.38,0.62,-1,1.5,2.63,1.61,5
Braintree Town,8,3,2,3,13,15,-2,11,England - National League,0.38,0.62,-2,1.62,2.63,1.61,5
Sutton Utd,8,2,3,3,10,11,-1,9,England - National League,0.25,0.75,-1,1.25,4.0,1.33,6
Rochdale,8,2,3,3,6,7,-1,9,England - National League,0.25,0.75,-1,0.75,4.0,1.33,6
Hartlepool,8,2,3,3,13,15,-2,9,England - National League,0.25,0.75,-2,1.62,4.0,1.33,6
Yeovil Town,8,2,2,4,8,14,-6,8,England - National League,0.25,0.75,-6,1.0,4.0,1.33,7
Boston Utd,8,2,1,5,5,12,-7,7,England - National League,0.25,0.75,-7,0.62,4.0,1.33,8
Woking,8,1,4,3,7,15,-8,7,England - National League,0.12,0.88,-8,0.88,8.33,1.14,8
Aldershot Town,8,1,3,4,11,14,-3,6,England - National League,0.12,0.88,-3,1.38,8.33,1.14,9
Dagenham & R.,8,1,3,4,7,13,-6,6,England - National League,0.12,0.88,-6,0.88,8.33,1.14,9
AFC Fylde,8,2,0,6,6,17,-11,6,England - National League,0.25,0.75,-11,0.75,4.0,1.33,9
Solihull Moors,8,1,2,5,5,11,-6,5,England - National League,0.12,0.88,-6,0.62,8.33,1.14,10
Maidenhead Utd,8,1,1,6,4,19,-15,4,England - National League,0.12,0.88,-15,0.5,8.33,1.14,11
Ebbsfleet Utd,8,0,3,5,6,19,-13,3,England - National League,0.0,1.0,-13,0.75,0.0,1.0,12
Chester,8,6,1,1,17,7,10,19,England - National L. North,0.75,0.25,10,2.12,1.33,4.0,1
Peterborough S.,8,4,3,1,12,7,5,15,England - National L. North,0.5,0.5,5,1.5,2.0,2.0,2
Scunthorpe,8,4,3,1,10,5,5,15,England - National L. North,0.5,0.5,5,1.25,2.0,2.0,2
Kidderminster,8,4,2,2,15,11,4,14,England - National L. North,0.5,0.5,4,1.88,2.0,2.0,3
Hereford Utd,8,4,1,3,10,7,3,13,England - National L. North,0.5,0.5,3,1.25,2.0,2.0,4
Darlington,8,4,1,3,9,7,2,13,England - National L. North,0.5,0.5,2,1.12,2.0,2.0,4
Marine,8,4,1,3,9,8,1,13,England - National L. North,0.5,0.5,1,1.12,2.0,2.0,4
Brackley Town,8,4,1,3,15,15,0,13,England - National L. North,0.5,0.5,0,1.88,2.0,2.0,4
Curzon,8,3,3,2,10,7,3,12,England - National L. North,0.38,0.62,3,1.25,2.63,1.61,5
Needham Market,8,3,2,3,13,10,3,11,England - National L. North,0.38,0.62,3,1.62,2.63,1.61,6
Spennymoor,8,3,2,3,13,13,0,11,England - National L. North,0.38,0.62,0,1.62,2.63,1.61,6
Chorley,8,3,2,3,8,9,-1,11,England - National L. North,0.38,0.62,-1,1.0,2.63,1.61,6
Scarborough,8,3,1,4,14,10,4,10,England - National L. North,0.38,0.62,4,1.75,2.63,1.61,7
Buxton,8,3,1,4,12,10,2,10,England - National L. North,0.38,0.62,2,1.5,2.63,1.61,7
Radcliffe,8,2,4,2,6,7,-1,10,England - National L. North,0.25,0.75,-1,0.75,4.0,1.33,7
Southport,8,2,2,4,7,10,-3,8,England - National L. North,0.25,0.75,-3,0.88,4.0,1.33,8
Kings Lynn,8,2,2,4,5,11,-6,8,England - National L. North,0.25,0.75,-6,0.62,4.0,1.33,8
Alfreton Town,8,2,1,5,10,13,-3,7,England - National L. North,0.25,0.75,-3,1.25,4.0,1.33,9
South Shields,8,2,1,5,11,16,-5,7,England - National L. North,0.25,0.75,-5,1.38,4.0,1.33,9
Rushall,8,2,1,5,8,24,-16,7,England - National L. North,0.25,0.75,-16,1.0,4.0,1.33,9
Oxford City,8,1,2,5,7,15,-8,5,England - National L. North,0.12,0.88,-8,0.88,8.33,1.14,10
Leamington,8,1,1,6,7,14,-7,4,England - National L. North,0.12,0.88,-7,0.88,8.33,1.14,11
Farsley Celtic,8,1,0,7,5,23,-18,3,England - National L. North,0.12,0.88,-18,0.62,8.33,1.14,12
Warrington,8,0,2,6,4,14,-10,2,England - National L. North,0.0,1.0,-10,0.5,0.0,1.0,13
Dorking,8,7,1,0,23,6,17,22,England - National L. South,0.88,0.12,17,2.88,1.14,8.33,1
Boreham Wood,8,6,0,2,17,11,6,18,England - National L. South,0.75,0.25,6,2.12,1.33,4.0,2
Chippenham,8,5,1,2,17,13,4,16,England - National L. South,0.62,0.38,4,2.12,1.61,2.63,3
Worthing,8,5,0,3,11,12,-1,15,England - National L. South,0.62,0.38,-1,1.38,1.61,2.63,4
Truro City,8,4,2,2,10,7,3,14,England - National L. South,0.5,0.5,3,1.25,2.0,2.0,5
Weston-s.-Mare,8,4,2,2,10,9,1,14,England - National L. South,0.5,0.5,1,1.25,2.0,2.0,5
Eastbourne,8,3,3,2,8,5,3,12,England - National L. South,0.38,0.62,3,1.0,2.63,1.61,6
Hornchurch,8,3,2,3,12,10,2,11,England - National L. South,0.38,0.62,2,1.5,2.63,1.61,7
Bath City,8,3,2,3,9,7,2,11,England - National L. South,0.38,0.62,2,1.12,2.63,1.61,7
Maidstone Utd,8,3,2,3,6,5,1,11,England - National L. South,0.38,0.62,1,0.75,2.63,1.61,7
Chelmsford City,8,3,1,4,13,13,0,10,England - National L. South,0.38,0.62,0,1.62,2.63,1.61,8
Salisbury,8,2,4,2,9,9,0,10,England - National L. South,0.25,0.75,0,1.12,4.0,1.33,8
Tonbridge,8,2,3,3,9,10,-1,9,England - National L. South,0.25,0.75,-1,1.12,4.0,1.33,9
Torquay Utd,8,1,5,2,14,13,1,8,England - National L. South,0.12,0.88,1,1.75,8.33,1.14,10
Hampton & R.,8,2,2,4,9,14,-5,8,England - National L. South,0.25,0.75,-5,1.12,4.0,1.33,10
Enfield Town,8,2,2,4,8,13,-5,8,England - National L. South,0.25,0.75,-5,1.0,4.0,1.33,10
Chesham Utd,8,1,4,3,7,10,-3,7,England - National L. South,0.12,0.88,-3,0.88,8.33,1.14,11
St Albans,8,1,4,3,5,9,-4,7,England - National L. South,0.12,0.88,-4,0.62,8.33,1.14,11
Farnborough,8,1,3,4,6,12,-6,6,England - National L. South,0.12,0.88,-6,0.75,8.33,1.14,12
Hemel Hempstead,8,1,3,4,5,13,-8,6,England - National L. South,0.12,0.88,-8,0.62,8.33,1.14,12
Welling Utd,8,1,1,6,8,18,-10,4,England - National L. South,0.12,0.88,-10,1.0,8.33,1.14,13
Weymouth,8,0,3,5,3,12,-9,3,England - National L. South,0.0,1.0,-9,0.38,0.0,1.0,14
Aveley,8,1,0,7,5,18,-13,3,England - National L. South,0.12,0.88,-13,0.62,8.33,1.14,14
Slough Town,8,0,1,7,7,23,-16,1,England - National L. South,0.0,1.0,-16,0.88,0.0,1.0,15
Dartford,8,7,0,1,15,8,7,21,England - Isthmian league,0.88,0.12,7,1.88,1.14,8.33,1
Horsham,8,6,0,2,18,7,11,18,England - Isthmian league,0.75,0.25,11,2.25,1.33,4.0,2
Dover Athletic,8,6,0,2,18,8,10,18,England - Isthmian league,0.75,0.25,10,2.25,1.33,4.0,2
Carshalton,8,4,1,3,13,9,4,13,England - Isthmian league,0.5,0.5,4,1.62,2.0,2.0,3
Chichester City,8,4,1,3,15,12,3,13,England - Isthmian league,0.5,0.5,3,1.88,2.0,2.0,3
Cheshunt,8,4,1,3,12,9,3,13,England - Isthmian league,0.5,0.5,3,1.5,2.0,2.0,3
Billericay Town,8,4,1,3,9,10,-1,13,England - Isthmian league,0.5,0.5,-1,1.12,2.0,2.0,3
Hashtag United,8,3,3,2,13,9,4,12,England - Isthmian league,0.38,0.62,4,1.62,2.63,1.61,4
Cray Valley PM,8,3,3,2,18,16,2,12,England - Isthmian league,0.38,0.62,2,2.25,2.63,1.61,4
Cray Wanderers,8,4,0,4,9,9,0,12,England - Isthmian league,0.5,0.5,0,1.12,2.0,2.0,4
Whitehawk,8,3,2,3,15,16,-1,11,England - Isthmian league,0.38,0.62,-1,1.88,2.63,1.61,5
Potters Bar,8,3,1,4,13,13,0,10,England - Isthmian league,0.38,0.62,0,1.62,2.63,1.61,6
Chatham Town,8,2,2,4,12,11,1,8,England - Isthmian league,0.25,0.75,1,1.5,4.0,1.33,7
Bognor Regis,8,2,2,4,13,19,-6,8,England - Isthmian league,0.25,0.75,-6,1.62,4.0,1.33,7
Wingate & F.,8,2,1,5,16,17,-1,7,England - Isthmian league,0.25,0.75,-1,2.0,4.0,1.33,8
Hastings Utd,8,2,1,5,8,20,-12,7,England - Isthmian league,0.25,0.75,-12,1.0,4.0,1.33,8
Lewes,8,1,3,4,8,13,-5,6,England - Isthmian league,0.12,0.88,-5,1.0,8.33,1.14,9
Canvey Island,8,2,0,6,8,18,-10,6,England - Isthmian league,0.25,0.75,-10,1.0,4.0,1.33,9
Folkestone,8,1,2,5,13,19,-6,5,England - Isthmian league,0.12,0.88,-6,1.62,8.33,1.14,10
Dulwich Hamlet,8,0,4,4,6,13,-7,4,England - Isthmian league,0.0,1.0,-7,0.75,0.0,1.0,11
Bowers & Pitsea,8,1,1,6,6,14,-8,4,England - Isthmian league,0.12,0.88,-8,0.75,8.33,1.14,11
Hendon,8,0,3,5,9,14,-5,3,England - Isthmian league,0.0,1.0,-5,1.12,0.0,1.0,12
Macclesfield,8,5,2,1,20,8,12,17,England - Northern league,0.62,0.38,12,2.5,1.61,2.63,1
Stockton Town,8,5,1,2,13,10,3,16,England - Northern league,0.62,0.38,3,1.62,1.61,2.63,2
Rylands,8,4,3,1,16,9,7,15,England - Northern league,0.5,0.5,7,2.0,2.0,2.0,3
Ashton Utd,8,4,2,2,15,9,6,14,England - Northern league,0.5,0.5,6,1.88,2.0,2.0,4
Guiseley,8,4,2,2,15,10,5,14,England - Northern league,0.5,0.5,5,1.88,2.0,2.0,4
Whitby Town,8,4,0,4,13,19,-6,12,England - Northern league,0.5,0.5,-6,1.62,2.0,2.0,5
Worksop Town,8,3,2,3,11,13,-2,11,England - Northern league,0.38,0.62,-2,1.38,2.63,1.61,6
Morpeth Town,8,3,2,3,13,16,-3,11,England - Northern league,0.38,0.62,-3,1.62,2.63,1.61,6
Workington,8,3,1,4,13,14,-1,10,England - Northern league,0.38,0.62,-1,1.62,2.63,1.61,7
Hyde Utd,8,2,3,3,7,8,-1,9,England - Northern league,0.25,0.75,-1,0.88,4.0,1.33,8
FC United,8,2,3,3,8,11,-3,9,England - Northern league,0.25,0.75,-3,1.0,4.0,1.33,8
Gainsborough,8,2,3,3,9,13,-4,9,England - Northern league,0.25,0.75,-4,1.12,4.0,1.33,8
Lancaster City,8,3,0,5,10,16,-6,9,England - Northern league,0.38,0.62,-6,1.25,2.63,1.61,8
Hebburn Town,8,1,5,2,10,11,-1,8,England - Northern league,0.12,0.88,-1,1.25,8.33,1.14,9
Leek Town,8,2,2,4,7,11,-4,8,England - Northern league,0.25,0.75,-4,0.88,4.0,1.33,9
Bamber Bridge,8,1,4,3,10,13,-3,7,England - Northern league,0.12,0.88,-3,1.25,8.33,1.14,10
Matlock,8,1,3,4,15,16,-1,6,England - Northern league,0.12,0.88,-1,1.88,8.33,1.14,11
Ilkeston Town,8,1,3,4,8,15,-7,6,England - Northern league,0.12,0.88,-7,1.0,8.33,1.14,11
Prescot Cables,8,0,2,6,6,17,-11,2,England - Northern league,0.0,1.0,-11,0.75,0.0,1.0,12
Mickleover,8,0,2,6,4,17,-13,2,England - Northern league,0.0,1.0,-13,0.5,0.0,1.0,12
Blyth Spartans,8,0,1,7,5,24,-19,1,England - Northern league,0.0,1.0,-19,0.62,0.0,1.0,13
Basford Utd,8,0,0,8,4,19,-15,0,England - Northern league,0.0,1.0,-15,0.5,0.0,1.0,14
Bromsgrove,8,5,1,2,13,10,3,16,England - Southern Central,0.62,0.38,3,1.62,1.61,2.63,1
Bedford Town,8,5,0,3,10,11,-1,15,England - Southern Central,0.62,0.38,-1,1.25,1.61,2.63,2
Stamford,8,4,2,2,10,6,4,14,England - Southern Central,0.5,0.5,4,1.25,2.0,2.0,3
Stratford Town,8,4,1,3,9,9,0,13,England - Southern Central,0.5,0.5,0,1.12,2.0,2.0,4
Leiston,8,4,1,3,11,12,-1,13,England - Southern Central,0.5,0.5,-1,1.38,2.0,2.0,4
Alvechurch,8,3,3,2,12,7,5,12,England - Southern Central,0.38,0.62,5,1.5,2.63,1.61,5
Stourbridge,8,4,0,4,13,12,1,12,England - Southern Central,0.5,0.5,1,1.62,2.0,2.0,5
Spalding United,8,3,2,3,11,9,2,11,England - Southern Central,0.38,0.62,2,1.38,2.63,1.61,6
Harborough Town,8,3,2,3,10,13,-3,11,England - Southern Central,0.38,0.62,-3,1.25,2.63,1.61,6
Royston,8,3,1,4,11,10,1,10,England - Southern Central,0.38,0.62,1,1.38,2.63,1.61,7
Banbury Utd,8,2,4,2,9,10,-1,10,England - Southern Central,0.25,0.75,-1,1.12,4.0,1.33,7
Telford Utd,8,2,4,2,15,18,-3,10,England - Southern Central,0.25,0.75,-3,1.88,4.0,1.33,7
Lowestoft,8,3,0,5,16,26,-10,9,England - Southern Central,0.38,0.62,-10,2.0,2.63,1.61,8
Kettering Town,8,2,2,4,12,14,-2,8,England - Southern Central,0.25,0.75,-2,1.5,4.0,1.33,9
B. Stortford,8,2,2,4,6,10,-4,8,England - Southern Central,0.25,0.75,-4,0.75,4.0,1.33,9
Biggleswade,8,1,3,4,10,15,-5,6,England - Southern Central,0.12,0.88,-5,1.25,8.33,1.14,10
Halesowen Town,8,1,2,5,6,10,-4,5,England - Southern Central,0.12,0.88,-4,0.75,8.33,1.14,11
St. Ives Town,8,0,4,4,6,12,-6,4,England - Southern Central,0.0,1.0,-6,0.75,0.0,1.0,12
Barwell,8,1,1,6,8,16,-8,4,England - Southern Central,0.12,0.88,-8,1.0,8.33,1.14,12
AFC Sudbury,8,1,1,6,6,16,-10,4,England - Southern Central,0.12,0.88,-10,0.75,8.33,1.14,12
Hitchin Town,8,0,2,6,6,15,-9,2,England - Southern Central,0.0,1.0,-9,0.75,0.0,1.0,13
Redditch Utd,8,0,1,7,6,15,-9,1,England - Southern Central,0.0,1.0,-9,0.75,0.0,1.0,14
Nomme Kalju,1,1,0,0,3,0,3,3,Estonia - Meistriliiga,1.0,0.0,3,3.0,1.0,0.0,1
Narva Trans,1,0,1,0,2,2,0,1,Estonia - Meistriliiga,0.0,1.0,0,2.0,0.0,1.0,2
Flora,0,0,0,0,0,0,0,0,Estonia - Meistriliiga,0.0,0.0,0,0.0,0.0,0.0,3
Kuressaare,0,0,0,0,0,0,0,0,Estonia - Meistriliiga,0.0,0.0,0,0.0,0.0,0.0,3
Levadia,0,0,0,0,0,0,0,0,Estonia - Meistriliiga,0.0,0.0,0,0.0,0.0,0.0,3
Paide,0,0,0,0,0,0,0,0,Estonia - Meistriliiga,0.0,0.0,0,0.0,0.0,0.0,3
Tallinna Kalev,0,0,0,0,0,0,0,0,Estonia - Meistriliiga,0.0,0.0,0,0.0,0.0,0.0,3
Tammeka,0,0,0,0,0,0,0,0,Estonia - Meistriliiga,0.0,0.0,0,0.0,0.0,0.0,3
Vaprus,0,0,0,0,0,0,0,0,Estonia - Meistriliiga,0.0,0.0,0,0.0,0.0,0.0,3
Harju JK,1,0,0,1,0,5,-5,0,Estonia - Meistriliiga,0.0,1.0,-5,0.0,0.0,1.0,3
Elva,0,0,0,0,0,0,0,0,Estonia - Esiliiga,0.0,0.0,0,0.0,0.0,0.0,1
FC Tallinn,0,0,0,0,0,0,0,0,Estonia - Esiliiga,0.0,0.0,0,0.0,0.0,0.0,1
Flora B,0,0,0,0,0,0,0,0,Estonia - Esiliiga,0.0,0.0,0,0.0,0.0,0.0,1
Levadia B,0,0,0,0,0,0,0,0,Estonia - Esiliiga,0.0,0.0,0,0.0,0.0,0.0,1
Nomme Kalju B,0,0,0,0,0,0,0,0,Estonia - Esiliiga,0.0,0.0,0,0.0,0.0,0.0,1
Nomme Utd,0,0,0,0,0,0,0,0,Estonia - Esiliiga,0.0,0.0,0,0.0,0.0,0.0,1
Tallinna K. B,0,0,0,0,0,0,0,0,Estonia - Esiliiga,0.0,0.0,0,0.0,0.0,0.0,1
Tammeka B,0,0,0,0,0,0,0,0,Estonia - Esiliiga,0.0,0.0,0,0.0,0.0,0.0,1
Tartu Welco,0,0,0,0,0,0,0,0,Estonia - Esiliiga,0.0,0.0,0,0.0,0.0,0.0,1
Viimsi,0,0,0,0,0,0,0,0,Estonia - Esiliiga,0.0,0.0,0,0.0,0.0,0.0,1
07 Vestur,0,0,0,0,0,0,0,0,FaroeIslands - Premier League,0.0,0.0,0,0.0,0.0,0.0,1
B36 Torshavn,0,0,0,0,0,0,0,0,FaroeIslands - Premier League,0.0,0.0,0,0.0,0.0,0.0,1
B68 Toftir,0,0,0,0,0,0,0,0,FaroeIslands - Premier League,0.0,0.0,0,0.0,0.0,0.0,1
HB Torshavn,0,0,0,0,0,0,0,0,FaroeIslands - Premier League,0.0,0.0,0,0.0,0.0,0.0,1
Klaksvik,0,0,0,0,0,0,0,0,FaroeIslands - Premier League,0.0,0.0,0,0.0,0.0,0.0,1
NSI Runavik,0,0,0,0,0,0,0,0,FaroeIslands - Premier League,0.0,0.0,0,0.0,0.0,0.0,1
Streymur,0,0,0,0,0,0,0,0,FaroeIslands - Premier League,0.0,0.0,0,0.0,0.0,0.0,1
Suduroy,0,0,0,0,0,0,0,0,FaroeIslands - Premier League,0.0,0.0,0,0.0,0.0,0.0,1
TB Tvoroyri,0,0,0,0,0,0,0,0,FaroeIslands - Premier League,0.0,0.0,0,0.0,0.0,0.0,1
Vikingur,0,0,0,0,0,0,0,0,FaroeIslands - Premier League,0.0,0.0,0,0.0,0.0,0.0,1
07 Vestur B,0,0,0,0,0,0,0,0,FaroeIslands - 1. Deild,0.0,0.0,0,0.0,0.0,0.0,1
AB Argir,0,0,0,0,0,0,0,0,FaroeIslands - 1. Deild,0.0,0.0,0,0.0,0.0,0.0,1
B36 Torshavn B,0,0,0,0,0,0,0,0,FaroeIslands - 1. Deild,0.0,0.0,0,0.0,0.0,0.0,1
B71 Sandur,0,0,0,0,0,0,0,0,FaroeIslands - 1. Deild,0.0,0.0,0,0.0,0.0,0.0,1
IF Fuglafjordur,0,0,0,0,0,0,0,0,FaroeIslands - 1. Deild,0.0,0.0,0,0.0,0.0,0.0,1
Klaksvik B,0,0,0,0,0,0,0,0,FaroeIslands - 1. Deild,0.0,0.0,0,0.0,0.0,0.0,1
NSI Runavik B,0,0,0,0,0,0,0,0,FaroeIslands - 1. Deild,0.0,0.0,0,0.0,0.0,0.0,1
Skala,0,0,0,0,0,0,0,0,FaroeIslands - 1. Deild,0.0,0.0,0,0.0,0.0,0.0,1
Streymur B,0,0,0,0,0,0,0,0,FaroeIslands - 1. Deild,0.0,0.0,0,0.0,0.0,0.0,1
Vikingur B,0,0,0,0,0,0,0,0,FaroeIslands - 1. Deild,0.0,0.0,0,0.0,0.0,0.0,1
Ilves,8,4,2,2,12,8,4,14,Finland - Veikkausliiga,0.5,0.5,4,1.5,2.0,2.0,1
Inter Turku,8,4,1,3,12,4,8,13,Finland - Veikkausliiga,0.5,0.5,8,1.5,2.0,2.0,2
HJK Helsinki,8,4,1,3,14,9,5,13,Finland - Veikkausliiga,0.5,0.5,5,1.75,2.0,2.0,2
KuPS,8,4,1,3,11,10,1,13,Finland - Veikkausliiga,0.5,0.5,1,1.38,2.0,2.0,2
Haka,8,4,0,4,11,11,0,12,Finland - Veikkausliiga,0.5,0.5,0,1.38,2.0,2.0,3
SJK,8,3,2,3,13,13,0,11,Finland - Veikkausliiga,0.38,0.62,0,1.62,2.63,1.61,4
Gnistan,8,2,2,4,12,16,-4,8,Finland - Veikkausliiga,0.25,0.75,-4,1.5,4.0,1.33,5
Ekenas IF,8,2,2,4,6,18,-12,8,Finland - Veikkausliiga,0.25,0.75,-12,0.75,4.0,1.33,5
VPS,8,2,1,5,12,18,-6,7,Finland - Veikkausliiga,0.25,0.75,-6,1.5,4.0,1.33,6
Oulu,8,1,2,5,6,15,-9,5,Finland - Veikkausliiga,0.12,0.88,-9,0.75,8.33,1.14,7
Lahti,8,0,4,4,9,18,-9,4,Finland - Veikkausliiga,0.0,1.0,-9,1.12,0.0,1.0,8
Mariehamn,8,1,0,7,6,17,-11,3,Finland - Veikkausliiga,0.12,0.88,-11,0.75,8.33,1.14,9
KTP,8,5,1,2,24,12,12,16,Finland - Ykkosliga,0.62,0.38,12,3.0,1.61,2.63,1
JIPPO,8,5,0,3,15,8,7,15,Finland - Ykkosliga,0.62,0.38,7,1.88,1.61,2.63,2
Jaro,8,4,1,3,13,13,0,13,Finland - Ykkosliga,0.5,0.5,0,1.62,2.0,2.0,3
JaPS,8,4,1,3,15,19,-4,13,Finland - Ykkosliga,0.5,0.5,-4,1.88,2.0,2.0,3
SalPa,8,4,0,4,8,16,-8,12,Finland - Ykkosliga,0.5,0.5,-8,1.0,2.0,2.0,4
TPS,8,2,5,1,7,5,2,11,Finland - Ykkosliga,0.25,0.75,2,0.88,4.0,1.33,5
PK-35,8,2,3,3,8,11,-3,9,Finland - Ykkosliga,0.25,0.75,-3,1.0,4.0,1.33,6
Mikkelin,8,2,2,4,11,16,-5,8,Finland - Ykkosliga,0.25,0.75,-5,1.38,4.0,1.33,7
KaPa,8,2,1,5,19,26,-7,7,Finland - Ykkosliga,0.25,0.75,-7,2.38,4.0,1.33,8
SJK Akatemia,8,1,3,4,10,15,-5,6,Finland - Ykkosliga,0.12,0.88,-5,1.25,8.33,1.14,9
PKKU,8,6,2,0,24,16,8,20,Finland - Ykkonen,0.75,0.25,8,3.0,1.33,4.0,1
KPV Kokkola,8,6,1,1,20,12,8,19,Finland - Ykkonen,0.75,0.25,8,2.5,1.33,4.0,2
JJK,8,4,2,2,14,13,1,14,Finland - Ykkonen,0.5,0.5,1,1.75,2.0,2.0,3
Klubi-04,8,4,1,3,13,10,3,13,Finland - Ykkonen,0.5,0.5,3,1.62,2.0,2.0,4
Atlantis,8,3,2,3,17,16,1,11,Finland - Ykkonen,0.38,0.62,1,2.12,2.63,1.61,5
VIFK,8,2,3,3,18,21,-3,9,Finland - Ykkonen,0.25,0.75,-3,2.25,4.0,1.33,6
Jazz Pori,8,3,0,5,16,20,-4,9,Finland - Ykkonen,0.38,0.62,-4,2.0,2.63,1.61,6
OLS Oulu,8,2,3,3,12,17,-5,9,Finland - Ykkonen,0.25,0.75,-5,1.5,4.0,1.33,6
EPS,8,1,4,3,8,10,-2,7,Finland - Ykkonen,0.12,0.88,-2,1.0,8.33,1.14,7
Rovaniemi,8,2,1,5,10,13,-3,7,Finland - Ykkonen,0.25,0.75,-3,1.25,4.0,1.33,7
KuPS Ak.,8,1,1,6,9,19,-10,4,Finland - Ykkonen,0.12,0.88,-10,1.12,8.33,1.14,8
Vaajakoski,8,0,1,7,8,23,-15,1,Finland - Ykkonen,0.0,1.0,-15,1.0,0.0,1.0,9
NJS,8,4,2,2,14,10,4,14,Finland - Kakkonen Group A,0.5,0.5,4,1.75,2.0,2.0,1
Reipas,8,3,2,3,12,11,1,11,Finland - Kakkonen Group A,0.38,0.62,1,1.5,2.63,1.61,2
PEPO,8,2,4,2,17,15,2,10,Finland - Kakkonen Group A,0.25,0.75,2,2.12,4.0,1.33,3
PPJ,8,3,1,4,13,12,1,10,Finland - Kakkonen Group A,0.38,0.62,1,1.62,2.63,1.61,3
Kiffen,8,3,1,4,9,12,-3,10,Finland - Kakkonen Group A,0.38,0.62,-3,1.12,2.63,1.61,3
GrIFK,8,2,3,3,8,11,-3,9,Finland - Kakkonen Group A,0.25,0.75,-3,1.0,4.0,1.33,4
Atlantis B,8,2,2,4,8,10,-2,8,Finland - Kakkonen Group A,0.25,0.75,-2,1.0,4.0,1.33,5
Futura,8,2,0,6,10,21,-11,6,Finland - Kakkonen Group A,0.25,0.75,-11,1.25,4.0,1.33,6
MYPA,8,1,2,5,12,24,-12,5,Finland - Kakkonen Group A,0.12,0.88,-12,1.5,8.33,1.14,7
JaPS B,8,1,1,6,8,25,-17,4,Finland - Kakkonen Group A,0.12,0.88,-17,1.0,8.33,1.14,8
Inter Turku B,8,5,1,2,18,10,8,16,Finland - Kakkonen Group B,0.62,0.38,8,2.25,1.61,2.63,1
Tampere Utd,8,4,2,2,18,10,8,14,Finland - Kakkonen Group B,0.5,0.5,8,2.25,2.0,2.0,2
HJS Akatemia,8,4,2,2,16,10,6,14,Finland - Kakkonen Group B,0.5,0.5,6,2.0,2.0,2.0,2
VJS,8,3,3,2,16,13,3,12,Finland - Kakkonen Group B,0.38,0.62,3,2.0,2.63,1.61,3
TPV,8,3,2,3,15,18,-3,11,Finland - Kakkonen Group B,0.38,0.62,-3,1.88,2.63,1.61,4
Honka,8,2,3,3,14,14,0,9,Finland - Kakkonen Group B,0.25,0.75,0,1.75,4.0,1.33,5
Ilves B,8,3,0,5,16,21,-5,9,Finland - Kakkonen Group B,0.38,0.62,-5,2.0,2.63,1.61,5
Poxyt,8,3,0,5,17,25,-8,9,Finland - Kakkonen Group B,0.38,0.62,-8,2.12,2.63,1.61,5
Ilves-Kissat,8,2,1,5,14,24,-10,7,Finland - Kakkonen Group B,0.25,0.75,-10,1.75,4.0,1.33,6
P-Iirot,8,2,0,6,8,16,-8,6,Finland - Kakkonen Group B,0.25,0.75,-8,1.0,4.0,1.33,7
EBK,8,1,0,7,6,41,-35,3,Finland - Kakkonen Group B,0.12,0.88,-35,0.75,8.33,1.14,8
JBK,8,6,2,0,19,7,12,20,Finland - Kakkonen Group C,0.75,0.25,12,2.38,1.33,4.0,1
GBK,8,6,0,2,22,13,9,18,Finland - Kakkonen Group C,0.75,0.25,9,2.75,1.33,4.0,2
Narpes Kraft,8,4,1,3,17,18,-1,13,Finland - Kakkonen Group C,0.5,0.5,-1,2.12,2.0,2.0,3
SJK Akatemia B,8,4,0,4,21,17,4,12,Finland - Kakkonen Group C,0.5,0.5,4,2.62,2.0,2.0,4
TP-47,8,3,2,3,20,13,7,11,Finland - Kakkonen Group C,0.38,0.62,7,2.5,2.63,1.61,5
JS Hercules,8,2,1,5,15,24,-9,7,Finland - Kakkonen Group C,0.25,0.75,-9,1.88,4.0,1.33,6
JPS,8,1,3,4,10,14,-4,6,Finland - Kakkonen Group C,0.12,0.88,-4,1.25,8.33,1.14,7
Kuopion Elo,8,0,4,4,13,21,-8,4,Finland - Kakkonen Group C,0.0,1.0,-8,1.62,0.0,1.0,8
OTP,8,1,1,6,6,23,-17,4,Finland - Kakkonen Group C,0.12,0.88,-17,0.75,8.33,1.14,8
OPS,8,1,0,7,10,31,-21,3,Finland - Kakkonen Group C,0.12,0.88,-21,1.25,8.33,1.14,9
Paris SG,8,7,1,0,22,9,13,22,France - Ligue 1,0.88,0.12,13,2.75,1.14,8.33,1
Marseille,8,6,0,2,16,8,8,18,France - Ligue 1,0.75,0.25,8,2.0,1.33,4.0,2
Toulouse,8,4,2,2,12,8,4,14,France - Ligue 1,0.5,0.5,4,1.5,2.0,2.0,3
Lens,8,4,1,3,11,9,2,13,France - Ligue 1,0.5,0.5,2,1.38,2.0,2.0,4
Angers,8,4,1,3,9,8,1,13,France - Ligue 1,0.5,0.5,1,1.12,2.0,2.0,4
Nice,8,3,3,2,14,13,1,12,France - Ligue 1,0.38,0.62,1,1.75,2.63,1.61,5
Lille,8,2,5,1,10,7,3,11,France - Ligue 1,0.25,0.75,3,1.25,4.0,1.33,6
Strasbourg,8,3,1,4,10,10,0,10,France - Ligue 1,0.38,0.62,0,1.25,2.63,1.61,7
Brest,8,3,1,4,9,12,-3,10,France - Ligue 1,0.38,0.62,-3,1.12,2.63,1.61,7
Lyon,8,2,3,3,14,12,2,9,France - Ligue 1,0.25,0.75,2,1.75,4.0,1.33,8
Le Havre,8,2,2,4,8,13,-5,8,France - Ligue 1,0.25,0.75,-5,1.0,4.0,1.33,9
Nantes,8,1,3,4,10,21,-11,6,France - Ligue 1,0.12,0.88,-11,1.25,8.33,1.14,10
Monaco,8,1,2,5,10,15,-5,5,France - Ligue 1,0.12,0.88,-5,1.25,8.33,1.14,11
Auxerre,8,1,2,5,11,19,-8,5,France - Ligue 1,0.12,0.88,-8,1.38,8.33,1.14,11
Reims,8,1,2,5,5,13,-8,5,France - Ligue 1,0.12,0.88,-8,0.62,8.33,1.14,11
Rennes,8,1,1,6,8,16,-8,4,France - Ligue 1,0.12,0.88,-8,1.0,8.33,1.14,12
Montpellier,8,1,0,7,4,14,-10,3,France - Ligue 1,0.12,0.88,-10,0.5,8.33,1.14,13
Saint-Etienne,8,0,1,7,7,24,-17,1,France - Ligue 1,0.0,1.0,-17,0.88,0.0,1.0,14
Lorient,8,4,2,2,10,9,1,14,France - Ligue 2,0.5,0.5,1,1.25,2.0,2.0,1
Metz,8,3,4,1,8,4,4,13,France - Ligue 2,0.38,0.62,4,1.0,2.63,1.61,2
Guingamp,8,4,1,3,13,11,2,13,France - Ligue 2,0.5,0.5,2,1.62,2.0,2.0,2
Martigues,8,4,1,3,6,8,-2,13,France - Ligue 2,0.5,0.5,-2,0.75,2.0,2.0,2
Troyes,8,4,0,4,10,7,3,12,France - Ligue 2,0.5,0.5,3,1.25,2.0,2.0,3
Laval,8,3,3,2,9,8,1,12,France - Ligue 2,0.38,0.62,1,1.12,2.63,1.61,3
USL Dunkerque,8,3,2,3,11,11,0,11,France - Ligue 2,0.38,0.62,0,1.38,2.63,1.61,4
Paris FC,8,3,2,3,7,8,-1,11,France - Ligue 2,0.38,0.62,-1,0.88,2.63,1.61,4
Annecy,8,3,2,3,5,9,-4,11,France - Ligue 2,0.38,0.62,-4,0.62,2.63,1.61,4
Rodez Aveyron,8,2,4,2,17,14,3,10,France - Ligue 2,0.25,0.75,3,2.12,4.0,1.33,5
AC Ajaccio,8,3,0,5,5,11,-6,9,France - Ligue 2,0.38,0.62,-6,0.62,2.63,1.61,6
Clermont,8,3,0,5,7,14,-7,9,France - Ligue 2,0.38,0.62,-7,0.88,2.63,1.61,6
Red Star,8,2,2,4,6,12,-6,8,France - Ligue 2,0.25,0.75,-6,0.75,4.0,1.33,7
SC Bastia,8,1,4,3,7,9,-2,7,France - Ligue 2,0.12,0.88,-2,0.88,8.33,1.14,8
Grenoble,8,2,1,5,7,13,-6,7,France - Ligue 2,0.25,0.75,-6,0.88,4.0,1.33,8
Amiens,8,2,1,5,7,14,-7,7,France - Ligue 2,0.25,0.75,-7,0.88,4.0,1.33,8
Caen,8,2,0,6,6,11,-5,6,France - Ligue 2,0.25,0.75,-5,0.75,4.0,1.33,9
Pau FC,8,1,3,4,7,13,-6,6,France - Ligue 2,0.12,0.88,-6,0.88,8.33,1.14,9
Nancy,8,6,0,2,13,5,8,18,France - National,0.75,0.25,8,1.62,1.33,4.0,1
Le Mans,8,5,2,1,16,6,10,17,France - National,0.62,0.38,10,2.0,1.61,2.63,2
Quevilly Rouen,8,3,3,2,10,9,1,12,France - National,0.38,0.62,1,1.25,2.63,1.61,3
Dijon,8,3,3,2,8,8,0,12,France - National,0.38,0.62,0,1.0,2.63,1.61,3
Bourg-en-Bresse,8,3,2,3,8,8,0,11,France - National,0.38,0.62,0,1.0,2.63,1.61,4
Paris 13 A.,8,2,4,2,12,12,0,10,France - National,0.25,0.75,0,1.5,4.0,1.33,5
Boulogne,8,3,1,4,8,12,-4,10,France - National,0.38,0.62,-4,1.0,2.63,1.61,5
Aubagne,8,3,0,5,11,10,1,9,France - National,0.38,0.62,1,1.38,2.63,1.61,6
Valenciennes,8,2,3,3,6,9,-3,9,France - National,0.25,0.75,-3,0.75,4.0,1.33,6
Rouen,8,2,2,4,6,7,-1,8,France - National,0.25,0.75,-1,0.75,4.0,1.33,7
Versailles,8,2,2,4,8,10,-2,8,France - National,0.25,0.75,-2,1.0,4.0,1.33,7
Villefranche,8,2,2,4,7,9,-2,8,France - National,0.25,0.75,-2,0.88,4.0,1.33,7
Orleans,8,2,2,4,5,9,-4,8,France - National,0.25,0.75,-4,0.62,4.0,1.33,7
Chateauroux,8,1,4,3,8,14,-6,7,France - National,0.12,0.88,-6,1.0,8.33,1.14,8
Sochaux,8,0,6,2,6,9,-3,6,France - National,0.0,1.0,-3,0.75,0.0,1.0,9
Concarneau,8,2,0,6,10,16,-6,6,France - National,0.25,0.75,-6,1.25,4.0,1.33,9
Nimes,8,0,3,5,5,11,-6,3,France - National,0.0,1.0,-6,0.62,0.0,1.0,10
Torpedo Kutaisi,1,1,0,0,2,1,1,3,Georgia - Erovnuli Liga,1.0,0.0,1,2.0,1.0,0.0,1
Dila Gori,0,0,0,0,0,0,0,0,Georgia - Erovnuli Liga,0.0,0.0,0,0.0,0.0,0.0,2
Dinamo Batumi,0,0,0,0,0,0,0,0,Georgia - Erovnuli Liga,0.0,0.0,0,0.0,0.0,0.0,2
Dinamo Tbilisi,0,0,0,0,0,0,0,0,Georgia - Erovnuli Liga,0.0,0.0,0,0.0,0.0,0.0,2
Gagra,0,0,0,0,0,0,0,0,Georgia - Erovnuli Liga,0.0,0.0,0,0.0,0.0,0.0,2
Gareji Sagarejo,0,0,0,0,0,0,0,0,Georgia - Erovnuli Liga,0.0,0.0,0,0.0,0.0,0.0,2
Iberia,0,0,0,0,0,0,0,0,Georgia - Erovnuli Liga,0.0,0.0,0,0.0,0.0,0.0,2
Kolkheti Poti,0,0,0,0,0,0,0,0,Georgia - Erovnuli Liga,0.0,0.0,0,0.0,0.0,0.0,2
Samgurali,0,0,0,0,0,0,0,0,Georgia - Erovnuli Liga,0.0,0.0,0,0.0,0.0,0.0,2
Telavi,1,0,0,1,0,2,-2,0,Georgia - Erovnuli Liga,0.0,1.0,-2,0.0,0.0,1.0,2
Bolnisi,0,0,0,0,0,0,0,0,Georgia - Erovnuli Liga 2,0.0,0.0,0,0.0,0.0,0.0,1
D. Tbilisi B,0,0,0,0,0,0,0,0,Georgia - Erovnuli Liga 2,0.0,0.0,0,0.0,0.0,0.0,1
Gonio,0,0,0,0,0,0,0,0,Georgia - Erovnuli Liga 2,0.0,0.0,0,0.0,0.0,0.0,1
Iberia B,0,0,0,0,0,0,0,0,Georgia - Erovnuli Liga 2,0.0,0.0,0,0.0,0.0,0.0,1
L. Tbilisi,0,0,0,0,0,0,0,0,Georgia - Erovnuli Liga 2,0.0,0.0,0,0.0,0.0,0.0,1
Merani Martvili,0,0,0,0,0,0,0,0,Georgia - Erovnuli Liga 2,0.0,0.0,0,0.0,0.0,0.0,1
Meshakhte,0,0,0,0,0,0,0,0,Georgia - Erovnuli Liga 2,0.0,0.0,0,0.0,0.0,0.0,1
Rustavi,0,0,0,0,0,0,0,0,Georgia - Erovnuli Liga 2,0.0,0.0,0,0.0,0.0,0.0,1
Samtredia,0,0,0,0,0,0,0,0,Georgia - Erovnuli Liga 2,0.0,0.0,0,0.0,0.0,0.0,1
Spaeri,0,0,0,0,0,0,0,0,Georgia - Erovnuli Liga 2,0.0,0.0,0,0.0,0.0,0.0,1
Bayern Munich,8,5,2,1,14,5,9,17,Germany - Bundesliga,0.62,0.38,9,1.75,1.61,2.63,1
Wolfsburg,8,5,1,2,18,11,7,16,Germany - Bundesliga,0.62,0.38,7,2.25,1.61,2.63,2
Leverkusen,8,4,4,0,14,8,6,16,Germany - Bundesliga,0.5,0.5,6,1.75,2.0,2.0,2
Monchengladbach,8,4,1,3,12,14,-2,13,Germany - Bundesliga,0.5,0.5,-2,1.5,2.0,2.0,3
FSV Mainz,8,4,0,4,14,10,4,12,Germany - Bundesliga,0.5,0.5,4,1.75,2.0,2.0,4
E. Frankfurt,8,3,3,2,13,12,1,12,Germany - Bundesliga,0.38,0.62,1,1.62,2.63,1.61,4
FC Augsburg,8,3,3,2,11,11,0,12,Germany - Bundesliga,0.38,0.62,0,1.38,2.63,1.61,4
Stuttgart,8,3,3,2,9,11,-2,12,Germany - Bundesliga,0.38,0.62,-2,1.12,2.63,1.61,4
Hoffenheim,8,3,2,3,9,13,-4,11,Germany - Bundesliga,0.38,0.62,-4,1.12,2.63,1.61,5
Dortmund,8,3,1,4,11,14,-3,10,Germany - Bundesliga,0.38,0.62,-3,1.38,2.63,1.61,6
Sankt Pauli,8,3,0,5,6,9,-3,9,Germany - Bundesliga,0.38,0.62,-3,0.75,2.63,1.61,7
Freiburg,8,2,2,4,5,18,-13,8,Germany - Bundesliga,0.25,0.75,-13,0.62,4.0,1.33,8
Werder Bremen,8,2,1,5,8,19,-11,7,Germany - Bundesliga,0.25,0.75,-11,1.0,4.0,1.33,9
RB Leipzig,8,1,3,4,11,16,-5,6,Germany - Bundesliga,0.12,0.88,-5,1.38,8.33,1.14,10
Bochum,8,0,3,5,6,19,-13,3,Germany - Bundesliga,0.0,1.0,-13,0.75,0.0,1.0,11
Union Berlin,8,1,0,7,7,22,-15,3,Germany - Bundesliga,0.12,0.88,-15,0.88,8.33,1.14,11
Heidenheim,8,0,2,6,10,20,-10,2,Germany - Bundesliga,0.0,1.0,-10,1.25,0.0,1.0,12
Holstein Kiel,8,0,1,7,12,23,-11,1,Germany - Bundesliga,0.0,1.0,-11,1.5,0.0,1.0,13
Magdeburg,8,5,1,2,22,15,7,16,Germany - 2. Bundesliga,0.62,0.38,7,2.75,1.61,2.63,1
Paderborn,8,4,3,1,11,8,3,15,Germany - 2. Bundesliga,0.5,0.5,3,1.38,2.0,2.0,2
FC Koln,8,5,0,3,7,10,-3,15,Germany - 2. Bundesliga,0.62,0.38,-3,0.88,1.61,2.63,2
Elversberg,8,4,2,2,13,4,9,14,Germany - 2. Bundesliga,0.5,0.5,9,1.62,2.0,2.0,3
Hamburger SV,8,4,2,2,16,13,3,14,Germany - 2. Bundesliga,0.5,0.5,3,2.0,2.0,2.0,3
Dusseldorf,8,3,4,1,13,9,4,13,Germany - 2. Bundesliga,0.38,0.62,4,1.62,2.63,1.61,4
Kaiserslautern,8,4,1,3,13,14,-1,13,Germany - 2. Bundesliga,0.5,0.5,-1,1.62,2.0,2.0,4
Hannover 96,8,3,3,2,11,9,2,12,Germany - 2. Bundesliga,0.38,0.62,2,1.38,2.63,1.61,5
Hertha Berlin,8,3,1,4,11,12,-1,10,Germany - 2. Bundesliga,0.38,0.62,-1,1.38,2.63,1.61,6
Karlsruher SC,8,3,1,4,12,14,-2,10,Germany - 2. Bundesliga,0.38,0.62,-2,1.5,2.63,1.61,6
Greuther Furth,8,3,1,4,10,16,-6,10,Germany - 2. Bundesliga,0.38,0.62,-6,1.25,2.63,1.61,6
Darmstadt,8,2,3,3,15,13,2,9,Germany - 2. Bundesliga,0.25,0.75,2,1.88,4.0,1.33,7
Schalke 04,8,2,3,3,10,9,1,9,Germany - 2. Bundesliga,0.25,0.75,1,1.25,4.0,1.33,7
FC Nurnberg,8,2,2,4,14,15,-1,8,Germany - 2. Bundesliga,0.25,0.75,-1,1.75,4.0,1.33,8
Preuss. Munster,8,1,4,3,7,10,-3,7,Germany - 2. Bundesliga,0.12,0.88,-3,0.88,8.33,1.14,9
Braunschweig,8,1,2,5,6,16,-10,5,Germany - 2. Bundesliga,0.12,0.88,-10,0.75,8.33,1.14,10
Ulm,8,0,4,4,8,13,-5,4,Germany - 2. Bundesliga,0.0,1.0,-5,1.0,0.0,1.0,11
Regensburg,8,0,1,7,7,26,-19,1,Germany - 2. Bundesliga,0.0,1.0,-19,0.88,0.0,1.0,12
Energie Cottbus,8,4,2,2,8,8,0,14,Germany - 3. Liga,0.5,0.5,0,1.0,2.0,2.0,1
Verl,8,4,1,3,16,12,4,13,Germany - 3. Liga,0.5,0.5,4,2.0,2.0,2.0,2
1860 Munchen,8,4,1,3,15,15,0,13,Germany - 3. Liga,0.5,0.5,0,1.88,2.0,2.0,2
Hansa Rostock,8,4,0,4,10,13,-3,12,Germany - 3. Liga,0.5,0.5,-3,1.25,2.0,2.0,3
Bielefeld,8,3,2,3,13,8,5,11,Germany - 3. Liga,0.38,0.62,5,1.62,2.63,1.61,4
Dynamo Dresden,8,3,2,3,13,8,5,11,Germany - 3. Liga,0.38,0.62,5,1.62,2.63,1.61,4
Dortmund B,8,3,2,3,18,17,1,11,Germany - 3. Liga,0.38,0.62,1,2.25,2.63,1.61,4
Osnabruck,8,3,2,3,13,13,0,11,Germany - 3. Liga,0.38,0.62,0,1.62,2.63,1.61,4
FC Ingolstadt,8,2,4,2,15,11,4,10,Germany - 3. Liga,0.25,0.75,4,1.88,4.0,1.33,5
Wehen Wiesbaden,8,2,4,2,12,11,1,10,Germany - 3. Liga,0.25,0.75,1,1.5,4.0,1.33,5
Saarbrucken,8,2,4,2,9,10,-1,10,Germany - 3. Liga,0.25,0.75,-1,1.12,4.0,1.33,5
Erzgebirge Aue,8,3,0,5,13,14,-1,9,Germany - 3. Liga,0.38,0.62,-1,1.62,2.63,1.61,6
Viktoria Koln,8,2,3,3,10,13,-3,9,Germany - 3. Liga,0.25,0.75,-3,1.25,4.0,1.33,6
RW Essen,8,3,0,5,7,13,-6,9,Germany - 3. Liga,0.38,0.62,-6,0.88,2.63,1.61,6
Alemannia A.,8,1,4,3,8,14,-6,7,Germany - 3. Liga,0.12,0.88,-6,1.0,8.33,1.14,7
VfB Stuttgart B,8,0,5,3,8,13,-5,5,Germany - 3. Liga,0.0,1.0,-5,1.0,0.0,1.0,8
Mannheim,8,1,2,5,5,12,-7,5,Germany - 3. Liga,0.12,0.88,-7,0.62,8.33,1.14,8
Hannover 96 B,8,1,1,6,6,16,-10,4,Germany - 3. Liga,0.12,0.88,-10,0.75,8.33,1.14,9
Sandhausen,8,0,3,5,7,13,-6,3,Germany - 3. Liga,0.0,1.0,-6,0.88,0.0,1.0,10
Unterhaching,8,0,2,6,8,18,-10,2,Germany - 3. Liga,0.0,1.0,-10,1.0,0.0,1.0,11
Hearts of Oak,8,4,3,1,8,4,4,15,Ghana - Premier League,0.5,0.5,4,1.0,2.0,2.0,1
Nations,8,4,1,3,6,5,1,13,Ghana - Premier League,0.5,0.5,1,0.75,2.0,2.0,2
Asante Kotoko,8,2,3,3,8,8,0,9,Ghana - Premier League,0.25,0.75,0,1.0,4.0,1.33,3
Bibiani GS,8,2,3,3,6,7,-1,9,Ghana - Premier League,0.25,0.75,-1,0.75,4.0,1.33,3
Bechem Utd,8,2,3,3,7,9,-2,9,Ghana - Premier League,0.25,0.75,-2,0.88,4.0,1.33,3
Heart of Lions,8,2,3,3,4,7,-3,9,Ghana - Premier League,0.25,0.75,-3,0.5,4.0,1.33,3
Aduana Stars,8,1,5,2,4,6,-2,8,Ghana - Premier League,0.12,0.88,-2,0.5,8.33,1.14,4
Young Apostles,8,2,2,4,4,9,-5,8,Ghana - Premier League,0.25,0.75,-5,0.5,4.0,1.33,4
Samartex,8,1,4,3,3,5,-2,7,Ghana - Premier League,0.12,0.88,-2,0.38,8.33,1.14,5
Dreams,8,1,4,3,3,8,-5,7,Ghana - Premier League,0.12,0.88,-5,0.38,8.33,1.14,5
Medeama,8,1,2,5,8,12,-4,5,Ghana - Premier League,0.12,0.88,-4,1.0,8.33,1.14,6
Berekum Chelsea,8,1,2,5,4,10,-6,5,Ghana - Premier League,0.12,0.88,-6,0.5,8.33,1.14,6
Karela,8,1,1,6,1,7,-6,4,Ghana - Premier League,0.12,0.88,-6,0.12,8.33,1.14,7
Accra Lions,8,0,3,5,3,8,-5,3,Ghana - Premier League,0.0,1.0,-5,0.38,0.0,1.0,8
Vision,8,0,3,5,3,13,-10,3,Ghana - Premier League,0.0,1.0,-10,0.38,0.0,1.0,8
Holy Stars,8,0,1,7,6,16,-10,1,Ghana - Premier League,0.0,1.0,-10,0.75,0.0,1.0,9
Nsoatreman,8,0,1,7,2,12,-10,1,Ghana - Premier League,0.0,1.0,-10,0.25,0.0,1.0,9
Legon Cities,8,0,1,7,3,16,-13,1,Ghana - Premier League,0.0,1.0,-13,0.38,0.0,1.0,9
Lincoln RI,8,6,2,0,25,1,24,20,Gibraltar - Premier Division,0.75,0.25,24,3.12,1.33,4.0,1
St Josephs,8,6,2,0,23,7,16,20,Gibraltar - Premier Division,0.75,0.25,16,2.88,1.33,4.0,1
Europa FC,8,5,2,1,20,10,10,17,Gibraltar - Premier Division,0.62,0.38,10,2.5,1.61,2.63,2
Manchester 62,8,4,1,3,15,10,5,13,Gibraltar - Premier Division,0.5,0.5,5,1.88,2.0,2.0,3
Magpies,8,4,0,4,22,10,12,12,Gibraltar - Premier Division,0.5,0.5,12,2.75,2.0,2.0,4
Lions FC,8,3,3,2,13,9,4,12,Gibraltar - Premier Division,0.38,0.62,4,1.62,2.63,1.61,4
College 1975,8,2,1,5,8,15,-7,7,Gibraltar - Premier Division,0.25,0.75,-7,1.0,4.0,1.33,5
Glacis Utd,8,2,0,6,10,23,-13,6,Gibraltar - Premier Division,0.25,0.75,-13,1.25,4.0,1.33,6
Mons Calpe,8,1,1,6,9,23,-14,4,Gibraltar - Premier Division,0.12,0.88,-14,1.12,8.33,1.14,7
Europa Point,8,0,1,7,5,20,-15,1,Gibraltar - Premier Division,0.0,1.0,-15,0.62,0.0,1.0,8
Lynx,8,0,1,7,7,23,-16,1,Gibraltar - Premier Division,0.0,1.0,-16,0.88,0.0,1.0,8
Olympiakos,8,6,1,1,15,5,10,19,Greece - Super League,0.75,0.25,10,1.88,1.33,4.0,1
AEK Athens,8,6,0,2,14,9,5,18,Greece - Super League,0.75,0.25,5,1.75,1.33,4.0,2
PAOK,8,5,1,2,16,7,9,16,Greece - Super League,0.62,0.38,9,2.0,1.61,2.63,3
Panathinaikos,8,4,2,2,9,9,0,14,Greece - Super League,0.5,0.5,0,1.12,2.0,2.0,4
Atromitos,8,4,1,3,11,10,1,13,Greece - Super League,0.5,0.5,1,1.38,2.0,2.0,5
Levadiakos,8,3,2,3,11,10,1,11,Greece - Super League,0.38,0.62,1,1.38,2.63,1.61,6
OFI Crete,8,3,2,3,10,10,0,11,Greece - Super League,0.38,0.62,0,1.25,2.63,1.61,6
Panaitolikos,8,2,3,3,5,7,-2,9,Greece - Super League,0.25,0.75,-2,0.62,4.0,1.33,7
Asteras T.,8,2,2,4,7,11,-4,8,Greece - Super League,0.25,0.75,-4,0.88,4.0,1.33,8
Aris,8,2,1,5,8,15,-7,7,Greece - Super League,0.25,0.75,-7,1.0,4.0,1.33,9
Volos,8,2,1,5,7,16,-9,7,Greece - Super League,0.25,0.75,-9,0.88,4.0,1.33,9
Panserraikos,8,2,0,6,6,14,-8,6,Greece - Super League,0.25,0.75,-8,0.75,4.0,1.33,10
A. Kallithea,8,1,2,5,6,13,-7,5,Greece - Super League,0.12,0.88,-7,0.75,8.33,1.14,11
Lamia,8,0,2,6,3,16,-13,2,Greece - Super League,0.0,1.0,-13,0.38,0.0,1.0,12
Comunicaciones,8,3,2,3,11,12,-1,11,Guatemala - Liga Nacional - Apertura,0.38,0.62,-1,1.38,2.63,1.61,1
Xelaju,8,2,4,2,8,5,3,10,Guatemala - Liga Nacional - Apertura,0.25,0.75,3,1.0,4.0,1.33,2
Coban Imperial,8,3,1,4,8,8,0,10,Guatemala - Liga Nacional - Apertura,0.38,0.62,0,1.0,2.63,1.61,2
Municipal,8,2,4,2,5,10,-5,10,Guatemala - Liga Nacional - Apertura,0.25,0.75,-5,0.62,4.0,1.33,2
Malacateco,8,2,3,3,7,10,-3,9,Guatemala - Liga Nacional - Apertura,0.25,0.75,-3,0.88,4.0,1.33,3
Xinabajul,8,2,3,3,11,15,-4,9,Guatemala - Liga Nacional - Apertura,0.25,0.75,-4,1.38,4.0,1.33,3
Achuapa,8,2,2,4,5,10,-5,8,Guatemala - Liga Nacional - Apertura,0.25,0.75,-5,0.62,4.0,1.33,4
Mixco,8,2,1,5,8,16,-8,7,Guatemala - Liga Nacional - Apertura,0.25,0.75,-8,1.0,4.0,1.33,5
Antigua GFC,8,1,3,4,9,15,-6,6,Guatemala - Liga Nacional - Apertura,0.12,0.88,-6,1.12,8.33,1.14,6
Guastatoya,8,0,4,4,3,11,-8,4,Guatemala - Liga Nacional - Apertura,0.0,1.0,-8,0.38,0.0,1.0,7
Marquense,8,0,2,6,3,19,-16,2,Guatemala - Liga Nacional - Apertura,0.0,1.0,-16,0.38,0.0,1.0,8
Zacapa Tellioz,8,0,2,6,3,21,-18,2,Guatemala - Liga Nacional - Apertura,0.0,1.0,-18,0.38,0.0,1.0,8
Municipal,5,2,2,1,6,3,3,8,guatemala2,0.4,0.6,3,1.2,2.5,1.67,1
Antigua GFC,4,2,1,1,5,7,-2,7,guatemala2,0.5,0.5,-2,1.25,2.0,2.0,2
Coban Imperial,4,2,0,2,4,7,-3,6,guatemala2,0.5,0.5,-3,1.0,2.0,2.0,3
Marquense,3,1,2,0,4,3,1,5,guatemala2,0.33,0.67,1,1.33,3.03,1.49,4
Mixco,5,1,2,2,4,6,-2,5,guatemala2,0.2,0.8,-2,0.8,5.0,1.25,4
Malacateco,6,1,1,4,7,11,-4,4,guatemala2,0.17,0.83,-4,1.17,5.88,1.2,5
Comunicaciones,4,0,3,1,2,3,-1,3,guatemala2,0.0,1.0,-1,0.5,0.0,1.0,6
Xinabajul,5,1,0,4,4,17,-13,3,guatemala2,0.2,0.8,-13,0.8,5.0,1.25,6
Xelaju,5,0,1,4,2,7,-5,1,guatemala2,0.0,1.0,-5,0.4,0.0,1.0,7
Achuapa,4,0,0,4,3,7,-4,0,guatemala2,0.0,1.0,-4,0.75,0.0,1.0,8
Guastatoya,4,0,0,4,2,11,-9,0,guatemala2,0.0,1.0,-9,0.5,0.0,1.0,8
Motagua,8,5,2,1,17,6,11,17,Honduras - Liga Nacional - Apertura,0.62,0.38,11,2.12,1.61,2.63,1
Olimpia,8,4,2,2,10,7,3,14,Honduras - Liga Nacional - Apertura,0.5,0.5,3,1.25,2.0,2.0,2
Real Espana,8,3,2,3,8,6,2,11,Honduras - Liga Nacional - Apertura,0.38,0.62,2,1.0,2.63,1.61,3
Marathon,8,3,2,3,8,10,-2,11,Honduras - Liga Nacional - Apertura,0.38,0.62,-2,1.0,2.63,1.61,3
Genesis,8,2,2,4,10,15,-5,8,Honduras - Liga Nacional - Apertura,0.25,0.75,-5,1.25,4.0,1.33,4
Olancho,8,1,4,3,6,12,-6,7,Honduras - Liga Nacional - Apertura,0.12,0.88,-6,0.75,8.33,1.14,5
Real Sociedad,8,1,3,4,11,19,-8,6,Honduras - Liga Nacional - Apertura,0.12,0.88,-8,1.38,8.33,1.14,6
UPNFM,8,1,2,5,4,16,-12,5,Honduras - Liga Nacional - Apertura,0.12,0.88,-12,0.5,8.33,1.14,7
Juticalpa,8,1,2,5,5,20,-15,5,Honduras - Liga Nacional - Apertura,0.12,0.88,-15,0.62,8.33,1.14,7
Victoria,8,0,2,6,8,18,-10,2,Honduras - Liga Nacional - Apertura,0.0,1.0,-10,1.0,0.0,1.0,8
Olimpia,4,3,0,1,7,2,5,9,honduras2,0.75,0.25,5,1.75,1.33,4.0,1
Real Espana,3,3,0,0,7,3,4,9,honduras2,1.0,0.0,4,2.33,1.0,0.0,1
Marathon,5,1,3,1,5,5,0,6,honduras2,0.2,0.8,0,1.0,5.0,1.25,2
Victoria,4,1,2,1,4,4,0,5,honduras2,0.25,0.75,0,1.0,4.0,1.33,3
Genesis,4,1,2,1,3,3,0,5,honduras2,0.25,0.75,0,0.75,4.0,1.33,3
Motagua,4,1,1,2,5,5,0,4,honduras2,0.25,0.75,0,1.25,4.0,1.33,4
Juticalpa,3,1,1,1,2,4,-2,4,honduras2,0.33,0.67,-2,0.67,3.03,1.49,4
Olancho,5,0,3,2,5,8,-3,3,honduras2,0.0,1.0,-3,1.0,0.0,1.0,5
Real Sociedad,4,0,2,2,2,6,-4,2,honduras2,0.0,1.0,-4,0.5,0.0,1.0,6
UPNFM,4,0,1,3,1,11,-10,1,honduras2,0.0,1.0,-10,0.25,0.0,1.0,7
Kitchee,8,4,3,1,16,8,8,15,Hong Kong - Premier League,0.5,0.5,8,2.0,2.0,2.0,1
Eastern,7,4,2,1,13,7,6,14,Hong Kong - Premier League,0.57,0.43,6,1.86,1.75,2.33,2
Tai Po,6,4,1,1,15,6,9,13,Hong Kong - Premier League,0.67,0.33,9,2.5,1.49,3.03,3
Kowloon City,8,3,2,3,12,13,-1,11,Hong Kong - Premier League,0.38,0.62,-1,1.5,2.63,1.61,4
LM Warriors,6,3,1,2,10,9,1,10,Hong Kong - Premier League,0.5,0.5,1,1.67,2.0,2.0,5
Southern D.,7,1,2,4,9,13,-4,5,Hong Kong - Premier League,0.14,0.86,-4,1.29,7.14,1.16,6
HK Rangers,8,1,2,5,11,25,-14,5,Hong Kong - Premier League,0.12,0.88,-14,1.38,8.33,1.14,6
Hong Kong FC,6,0,0,6,2,17,-15,0,Hong Kong - Premier League,0.0,1.0,-15,0.33,0.0,1.0,7
North District,8,0,0,8,8,26,-18,0,Hong Kong - Premier League,0.0,1.0,-18,1.0,0.0,1.0,7
Puskas A.,8,5,0,3,13,9,4,15,Hungary - NB I,0.62,0.38,4,1.62,1.61,2.63,1
Gyor,8,3,5,0,11,6,5,14,Hungary - NB I,0.38,0.62,5,1.38,2.63,1.61,2
Ferencvaros,8,3,3,2,12,10,2,12,Hungary - NB I,0.38,0.62,2,1.5,2.63,1.61,3
DVTK,8,3,3,2,15,16,-1,12,Hungary - NB I,0.38,0.62,-1,1.88,2.63,1.61,3
Ujpest,8,3,3,2,8,10,-2,12,Hungary - NB I,0.38,0.62,-2,1.0,2.63,1.61,3
Paks,8,3,1,4,14,13,1,10,Hungary - NB I,0.38,0.62,1,1.75,2.63,1.61,4
Nyiregyhaza,8,2,1,5,8,12,-4,7,Hungary - NB I,0.25,0.75,-4,1.0,4.0,1.33,5
MTK Budapest,8,2,1,5,7,15,-8,7,Hungary - NB I,0.25,0.75,-8,0.88,4.0,1.33,5
Zalaegerszegi,8,1,3,4,7,11,-4,6,Hungary - NB I,0.12,0.88,-4,0.88,8.33,1.14,6
Kecskemeti TE,8,1,3,4,9,18,-9,6,Hungary - NB I,0.12,0.88,-9,1.12,8.33,1.14,6
Debrecen,8,1,1,6,11,17,-6,4,Hungary - NB I,0.12,0.88,-6,1.38,8.33,1.14,7
Fehervar,8,1,1,6,7,17,-10,4,Hungary - NB I,0.12,0.88,-10,0.88,8.33,1.14,7
Mezokovesd,8,4,2,2,12,8,4,14,Hungary - NB II,0.5,0.5,4,1.5,2.0,2.0,1
BVSC,8,4,2,2,10,8,2,14,Hungary - NB II,0.5,0.5,2,1.25,2.0,2.0,1
Kazincbarcika,8,3,4,1,20,8,12,13,Hungary - NB II,0.38,0.62,12,2.5,2.63,1.61,2
Kisvarda,8,4,1,3,14,13,1,13,Hungary - NB II,0.5,0.5,1,1.75,2.0,2.0,2
Budafoki,8,3,3,2,13,13,0,12,Hungary - NB II,0.38,0.62,0,1.62,2.63,1.61,3
Kozarmisleny,8,3,3,2,9,12,-3,12,Hungary - NB II,0.38,0.62,-3,1.12,2.63,1.61,3
Ajka,8,3,1,4,11,15,-4,10,Hungary - NB II,0.38,0.62,-4,1.38,2.63,1.61,4
Szentlorinc,8,2,3,3,8,10,-2,9,Hungary - NB II,0.25,0.75,-2,1.0,4.0,1.33,5
Szeged,8,1,5,2,4,5,-1,8,Hungary - NB II,0.12,0.88,-1,0.5,8.33,1.14,6
Vasas,8,2,2,4,9,11,-2,8,Hungary - NB II,0.25,0.75,-2,1.12,4.0,1.33,6
Csakvari,8,2,1,5,10,14,-4,7,Hungary - NB II,0.25,0.75,-4,1.25,4.0,1.33,7
Bekescsaba,8,2,1,5,3,7,-4,7,Hungary - NB II,0.25,0.75,-4,0.38,4.0,1.33,7
Honved,8,1,2,5,9,16,-7,5,Hungary - NB II,0.12,0.88,-7,1.12,8.33,1.14,8
Soroksar,8,1,2,5,7,15,-8,5,Hungary - NB II,0.12,0.88,-8,0.88,8.33,1.14,8
Tatabanya,8,1,1,6,6,13,-7,4,Hungary - NB II,0.12,0.88,-7,0.75,8.33,1.14,9
Gyirmot,8,0,3,5,11,19,-8,3,Hungary - NB II,0.0,1.0,-8,1.38,0.0,1.0,10
Vikingur R.,8,6,1,1,25,10,15,19,Iceland - Besta deild,0.75,0.25,15,3.12,1.33,4.0,1
Breidablik,8,5,2,1,15,8,7,17,Iceland - Besta deild,0.62,0.38,7,1.88,1.61,2.63,2
KA Akureyri,8,4,3,1,15,8,7,15,Iceland - Besta deild,0.5,0.5,7,1.88,2.0,2.0,3
Stjarnan,8,2,4,2,14,11,3,10,Iceland - Besta deild,0.25,0.75,3,1.75,4.0,1.33,4
Fylkir,8,2,2,4,7,14,-7,8,Iceland - Besta deild,0.25,0.75,-7,0.88,4.0,1.33,5
KR Reykjavik,8,2,1,5,11,15,-4,7,Iceland - Besta deild,0.25,0.75,-4,1.38,4.0,1.33,6
Hafnarfjordur,8,2,1,5,13,20,-7,7,Iceland - Besta deild,0.25,0.75,-7,1.62,4.0,1.33,6
Valur,8,1,3,4,15,17,-2,6,Iceland - Besta deild,0.12,0.88,-2,1.88,8.33,1.14,7
Vestri,8,1,3,4,12,15,-3,6,Iceland - Besta deild,0.12,0.88,-3,1.5,8.33,1.14,7
IA Akranes,8,1,2,5,6,20,-14,5,Iceland - Besta deild,0.12,0.88,-14,0.75,8.33,1.14,8
Fram,8,1,1,6,7,17,-10,4,Iceland - Besta deild,0.12,0.88,-10,0.88,8.33,1.14,9
HK Kopavogur,8,0,1,7,10,32,-22,1,Iceland - Besta deild,0.0,1.0,-22,1.25,0.0,1.0,10
Goa,8,5,2,1,15,9,6,17,India - Super League,0.62,0.38,6,1.88,1.61,2.63,1
Mumbai City,8,4,4,0,10,5,5,16,India - Super League,0.5,0.5,5,1.25,2.0,2.0,2
Mohun Bagan,8,4,3,1,16,6,10,15,India - Super League,0.5,0.5,10,2.0,2.0,2.0,3
NorthEast Utd,8,4,3,1,16,8,8,15,India - Super League,0.5,0.5,8,2.0,2.0,2.0,3
Odisha FC,8,3,2,3,16,11,5,11,India - Super League,0.38,0.62,5,2.0,2.63,1.61,4
East Bengal,8,3,2,3,10,7,3,11,India - Super League,0.38,0.62,3,1.25,2.63,1.61,4
Bengaluru,8,3,1,4,14,14,0,10,India - Super League,0.38,0.62,0,1.75,2.63,1.61,5
Jamshedpur,8,3,1,4,10,12,-2,10,India - Super League,0.38,0.62,-2,1.25,2.63,1.61,5
Chennaiyin,8,2,1,5,10,11,-1,7,India - Super League,0.25,0.75,-1,1.25,4.0,1.33,6
Kerala Blasters,8,2,0,6,11,17,-6,6,India - Super League,0.25,0.75,-6,1.38,4.0,1.33,7
Punjab,8,1,2,5,10,15,-5,5,India - Super League,0.12,0.88,-5,1.25,8.33,1.14,8
Mohammedan,8,1,2,5,3,14,-11,5,India - Super League,0.12,0.88,-11,0.38,8.33,1.14,8
Hyderabad,8,1,1,6,5,16,-11,4,India - Super League,0.12,0.88,-11,0.62,8.33,1.14,9
Gokulam,8,4,2,2,15,9,6,14,India - I-League,0.5,0.5,6,1.88,2.0,2.0,1
Churchill B.,8,4,2,2,12,8,4,14,India - I-League,0.5,0.5,4,1.5,2.0,2.0,1
Dempo,8,4,1,3,8,8,0,13,India - I-League,0.5,0.5,0,1.0,2.0,2.0,2
Inter Kashi,8,3,3,2,9,10,-1,12,India - I-League,0.38,0.62,-1,1.12,2.63,1.61,3
Namdhari,7,3,2,2,9,6,3,11,India - I-League,0.43,0.57,3,1.29,2.33,1.75,4
Sreenidi Deccan,8,3,2,3,13,17,-4,11,India - I-League,0.38,0.62,-4,1.62,2.63,1.61,4
Rajasthan,8,2,3,3,11,17,-6,9,India - I-League,0.25,0.75,-6,1.38,4.0,1.33,5
Shillong Lajong,7,1,2,4,13,20,-7,5,India - I-League,0.14,0.86,-7,1.86,7.14,1.16,6
Real Kashmir,7,1,2,4,4,11,-7,5,India - I-League,0.14,0.86,-7,0.57,7.14,1.16,6
Delhi FC,8,1,2,5,12,22,-10,5,India - I-League,0.12,0.88,-10,1.5,8.33,1.14,6
SC Bengaluru,8,1,1,6,4,16,-12,4,India - I-League,0.12,0.88,-12,0.5,8.33,1.14,7
Aizawl,6,0,2,4,5,17,-12,2,India - I-League,0.0,1.0,-12,0.83,0.0,1.0,8
Persib,8,4,3,1,12,10,2,15,Indonesia - Liga 1,0.5,0.5,2,1.5,2.0,2.0,1
Dewa Utd,8,4,1,3,21,10,11,13,Indonesia - Liga 1,0.5,0.5,11,2.62,2.0,2.0,2
Malut United,8,3,3,2,12,10,2,12,Indonesia - Liga 1,0.38,0.62,2,1.5,2.63,1.61,3
Arema,8,4,0,4,14,14,0,12,Indonesia - Liga 1,0.5,0.5,0,1.75,2.0,2.0,3
Semen Padang,8,3,2,3,12,11,1,11,Indonesia - Liga 1,0.38,0.62,1,1.5,2.63,1.61,4
Persija,8,3,1,4,11,13,-2,10,Indonesia - Liga 1,0.38,0.62,-2,1.38,2.63,1.61,5
Persita,8,3,1,4,9,13,-4,10,Indonesia - Liga 1,0.38,0.62,-4,1.12,2.63,1.61,5
PSIS Semarang,8,2,3,3,8,9,-1,9,Indonesia - Liga 1,0.25,0.75,-1,1.0,4.0,1.33,6
PSBS Biak N.,8,1,5,2,10,9,1,8,Indonesia - Liga 1,0.12,0.88,1,1.25,8.33,1.14,7
Persik Kediri,8,2,2,4,11,12,-1,8,Indonesia - Liga 1,0.25,0.75,-1,1.38,4.0,1.33,7
Barito Putera,8,1,4,3,11,12,-1,7,Indonesia - Liga 1,0.12,0.88,-1,1.38,8.33,1.14,8
PSM,8,1,4,3,9,11,-2,7,Indonesia - Liga 1,0.12,0.88,-2,1.12,8.33,1.14,8
Persebaya S.,8,2,1,5,5,13,-8,7,Indonesia - Liga 1,0.25,0.75,-8,0.62,4.0,1.33,8
Bali Utd,8,2,0,6,10,13,-3,6,Indonesia - Liga 1,0.25,0.75,-3,1.25,4.0,1.33,9
PSS Sleman,8,1,2,5,7,14,-7,5,Indonesia - Liga 1,0.12,0.88,-7,0.88,8.33,1.14,10
Persis Solo,8,1,2,5,3,14,-11,5,Indonesia - Liga 1,0.12,0.88,-11,0.38,8.33,1.14,10
Madura Utd,8,1,2,5,3,17,-14,5,Indonesia - Liga 1,0.12,0.88,-14,0.38,8.33,1.14,10
Borneo,8,1,1,6,8,15,-7,4,Indonesia - Liga 1,0.12,0.88,-7,1.0,8.33,1.14,11
Tractor Sazi,8,6,1,1,11,4,7,19,Iran - Pro League,0.75,0.25,7,1.38,1.33,4.0,1
Gol Gohar,8,3,4,1,5,2,3,13,Iran - Pro League,0.38,0.62,3,0.62,2.63,1.61,2
Foolad,8,4,1,3,11,12,-1,13,Iran - Pro League,0.5,0.5,-1,1.38,2.0,2.0,2
Persepolis,8,3,3,2,11,6,5,12,Iran - Pro League,0.38,0.62,5,1.38,2.63,1.61,3
Sepahan,8,2,6,0,11,7,4,12,Iran - Pro League,0.25,0.75,4,1.38,4.0,1.33,3
Zob Ahan,8,3,2,3,7,7,0,11,Iran - Pro League,0.38,0.62,0,0.88,2.63,1.61,4
Mes Rafsanjan,8,3,2,3,9,11,-2,11,Iran - Pro League,0.38,0.62,-2,1.12,2.63,1.61,4
Malavan,8,3,1,4,8,8,0,10,Iran - Pro League,0.38,0.62,0,1.0,2.63,1.61,5
Esteghlal,8,2,4,2,7,7,0,10,Iran - Pro League,0.25,0.75,0,0.88,4.0,1.33,5
N. Mazandaran,8,2,3,3,4,5,-1,9,Iran - Pro League,0.25,0.75,-1,0.5,4.0,1.33,6
Shams A. Qazvin,8,3,0,5,3,10,-7,9,Iran - Pro League,0.38,0.62,-7,0.38,2.63,1.61,6
Aluminium Arak,8,2,2,4,9,9,0,8,Iran - Pro League,0.25,0.75,0,1.12,4.0,1.33,7
Havadar,8,1,3,4,4,16,-12,6,Iran - Pro League,0.12,0.88,-12,0.5,8.33,1.14,8
Chadormalu,8,1,2,5,3,8,-5,5,Iran - Pro League,0.12,0.88,-5,0.38,8.33,1.14,9
E. Khuzestan,8,1,2,5,2,11,-9,5,Iran - Pro League,0.12,0.88,-9,0.25,8.33,1.14,9
K. Khorramabad,8,0,2,6,3,11,-8,2,Iran - Pro League,0.0,1.0,-8,0.38,0.0,1.0,10
Waterford,2,2,0,0,5,3,2,6,Ireland - Premier Division,1.0,0.0,2,2.5,1.0,0.0,1
Shelbourne,1,1,0,0,1,0,1,3,Ireland - Premier Division,1.0,0.0,1,1.0,1.0,0.0,2
Galway Utd,2,0,2,0,3,3,0,2,Ireland - Premier Division,0.0,1.0,0,1.5,0.0,1.0,3
Drogheda Utd,1,0,1,0,0,0,0,1,Ireland - Premier Division,0.0,1.0,0,0.0,0.0,1.0,4
Shamrock Rovers,2,0,1,1,1,2,-1,1,Ireland - Premier Division,0.0,1.0,-1,0.5,0.0,1.0,4
Cork City,0,0,0,0,0,0,0,0,Ireland - Premier Division,0.0,0.0,0,0.0,0.0,0.0,5
St. Patricks,1,0,0,1,1,2,-1,0,Ireland - Premier Division,0.0,1.0,-1,1.0,0.0,1.0,5
Bohemians,2,0,0,2,1,3,-2,0,Ireland - Premier Division,0.0,1.0,-2,0.5,0.0,1.0,5
Derry City,1,0,0,1,1,3,-2,0,Ireland - Premier Division,0.0,1.0,-2,1.0,0.0,1.0,5
Sligo Rovers,2,0,0,2,3,7,-4,0,Ireland - Premier Division,0.0,1.0,-4,1.5,0.0,1.0,5
Dundalk,2,2,0,0,2,0,2,6,Ireland - First Division,1.0,0.0,2,1.0,1.0,0.0,1
Cobh Ramblers,2,1,1,0,4,3,1,4,Ireland - First Division,0.5,0.5,1,2.0,2.0,2.0,2
Treaty Utd,1,1,0,0,5,0,5,3,Ireland - First Division,1.0,0.0,5,5.0,1.0,0.0,3
Wexford,1,1,0,0,3,0,3,3,Ireland - First Division,1.0,0.0,3,3.0,1.0,0.0,3
Bray Wanderers,2,1,0,1,1,2,-1,3,Ireland - First Division,0.5,0.5,-1,0.5,2.0,2.0,3
Kerry,1,0,1,0,0,0,0,1,Ireland - First Division,0.0,1.0,0,0.0,0.0,1.0,4
Longford Town,0,0,0,0,0,0,0,0,Ireland - First Division,0.0,0.0,0,0.0,0.0,0.0,5
UC Dublin,0,0,0,0,0,0,0,0,Ireland - First Division,0.0,0.0,0,0.0,0.0,0.0,5
Athlone Town,1,0,0,1,0,1,-1,0,Ireland - First Division,0.0,1.0,-1,0.0,0.0,1.0,5
Finn Harps,2,0,0,2,1,5,-4,0,Ireland - First Division,0.0,1.0,-4,0.5,0.0,1.0,5
H. Beer Sheva,8,6,1,1,11,3,8,19,Israel - Ligat HaAl,0.75,0.25,8,1.38,1.33,4.0,1
M. Tel Aviv,8,5,3,0,19,9,10,18,Israel - Ligat HaAl,0.62,0.38,10,2.38,1.61,2.63,2
Maccabi Haifa,8,5,2,1,17,7,10,17,Israel - Ligat HaAl,0.62,0.38,10,2.12,1.61,2.63,3
Maccabi Netanya,8,5,0,3,13,12,1,15,Israel - Ligat HaAl,0.62,0.38,1,1.62,1.61,2.63,4
Hapoel Haifa,8,3,2,3,10,6,4,11,Israel - Ligat HaAl,0.38,0.62,4,1.25,2.63,1.61,5
B. Jerusalem,8,3,2,3,16,17,-1,11,Israel - Ligat HaAl,0.38,0.62,-1,2.0,2.63,1.61,5
M. Bnei Raina,8,3,1,4,8,10,-2,10,Israel - Ligat HaAl,0.38,0.62,-2,1.0,2.63,1.61,6
Kiryat Shmona,8,3,1,4,10,16,-6,10,Israel - Ligat HaAl,0.38,0.62,-6,1.25,2.63,1.61,6
M. Petah Tikva,8,3,0,5,9,18,-9,9,Israel - Ligat HaAl,0.38,0.62,-9,1.12,2.63,1.61,7
Hapoel Hadera,8,1,5,2,6,9,-3,8,Israel - Ligat HaAl,0.12,0.88,-3,0.75,8.33,1.14,8
Sakhnin,8,2,2,4,8,13,-5,8,Israel - Ligat HaAl,0.25,0.75,-5,1.0,4.0,1.33,8
Ironi Tiberias,8,1,3,4,3,12,-9,6,Israel - Ligat HaAl,0.12,0.88,-9,0.38,8.33,1.14,9
H. Jerusalem,8,0,5,3,7,12,-5,5,Israel - Ligat HaAl,0.0,1.0,-5,0.88,0.0,1.0,10
Ashdod,8,1,2,5,14,20,-6,5,Israel - Ligat HaAl,0.12,0.88,-6,1.75,8.33,1.14,10
Hapoel Tel Aviv,8,5,3,0,12,6,6,18,Israel - Leumit League,0.62,0.38,6,1.5,1.61,2.63,1
H. Petah Tikva,8,5,2,1,12,5,7,17,Israel - Leumit League,0.62,0.38,7,1.5,1.61,2.63,2
Kafr Qasim,8,4,1,3,6,6,0,13,Israel - Leumit League,0.5,0.5,0,0.75,2.0,2.0,3
H. Kfar Shalem,8,3,3,2,17,12,5,12,Israel - Leumit League,0.38,0.62,5,2.12,2.63,1.61,4
Bnei Yehuda,8,4,0,4,11,11,0,12,Israel - Leumit League,0.5,0.5,0,1.38,2.0,2.0,4
Hapoel Raanana,8,3,3,2,7,8,-1,12,Israel - Leumit League,0.38,0.62,-1,0.88,2.63,1.61,4
H. Ramat Gan,8,3,2,3,10,6,4,11,Israel - Leumit League,0.38,0.62,4,1.25,2.63,1.61,5
H. Ironi Rishon,8,3,2,3,8,12,-4,11,Israel - Leumit League,0.38,0.62,-4,1.0,2.63,1.61,5
M. Herziliya,8,3,1,4,9,17,-8,10,Israel - Leumit League,0.38,0.62,-8,1.12,2.63,1.61,6
Hapoel Akko,8,3,0,5,6,17,-11,9,Israel - Leumit League,0.38,0.62,-11,0.75,2.63,1.61,7
H. Kfar Saba,8,2,1,5,6,9,-3,7,Israel - Leumit League,0.25,0.75,-3,0.75,4.0,1.33,8
Maccabi Jaffa,8,1,3,4,8,12,-4,6,Israel - Leumit League,0.12,0.88,-4,1.0,8.33,1.14,9
Ramat Hasharon,8,2,0,6,12,21,-9,6,Israel - Leumit League,0.25,0.75,-9,1.5,4.0,1.33,9
Hapoel Afula,8,1,2,5,3,13,-10,5,Israel - Leumit League,0.12,0.88,-10,0.38,8.33,1.14,10
H. Nof Hagalil,8,1,1,6,7,17,-10,4,Israel - Leumit League,0.12,0.88,-10,0.88,8.33,1.14,11
H. Umm al-Fahm,8,0,1,7,5,18,-13,1,Israel - Leumit League,0.0,1.0,-13,0.62,0.0,1.0,12
Atalanta,8,6,2,0,19,3,16,20,Italy - Serie A,0.75,0.25,16,2.38,1.33,4.0,1
Napoli,8,5,2,1,16,9,7,17,Italy - Serie A,0.62,0.38,7,2.0,1.61,2.63,2
Inter Milan,8,5,1,2,20,5,15,16,Italy - Serie A,0.62,0.38,15,2.5,1.61,2.63,3
Lazio,8,5,1,2,10,7,3,16,Italy - Serie A,0.62,0.38,3,1.25,1.61,2.63,3
Juventus,8,3,4,1,9,7,2,13,Italy - Serie A,0.38,0.62,2,1.12,2.63,1.61,4
Udinese,8,3,3,2,9,10,-1,12,Italy - Serie A,0.38,0.62,-1,1.12,2.63,1.61,5
AS Roma,8,3,2,3,9,10,-1,11,Italy - Serie A,0.38,0.62,-1,1.12,2.63,1.61,6
Fiorentina,8,3,1,4,9,9,0,10,Italy - Serie A,0.38,0.62,0,1.12,2.63,1.61,7
AC Milan,8,3,1,4,11,12,-1,10,Italy - Serie A,0.38,0.62,-1,1.38,2.63,1.61,7
Bologna,8,2,4,2,10,12,-2,10,Italy - Serie A,0.25,0.75,-2,1.25,4.0,1.33,7
Hellas Verona,8,3,1,4,9,12,-3,10,Italy - Serie A,0.38,0.62,-3,1.12,2.63,1.61,7
Lecce,8,3,1,4,9,13,-4,10,Italy - Serie A,0.38,0.62,-4,1.12,2.63,1.61,7
Genoa,8,2,3,3,7,8,-1,9,Italy - Serie A,0.25,0.75,-1,0.88,4.0,1.33,8
Torino,8,1,4,3,7,10,-3,7,Italy - Serie A,0.12,0.88,-3,0.88,8.33,1.14,9
Cagliari,8,1,3,4,7,11,-4,6,Italy - Serie A,0.12,0.88,-4,0.88,8.33,1.14,10
Como,8,1,3,4,6,10,-4,6,Italy - Serie A,0.12,0.88,-4,0.75,8.33,1.14,10
Empoli,8,1,2,5,10,19,-9,5,Italy - Serie A,0.12,0.88,-9,1.25,8.33,1.14,11
Parma,8,1,2,5,8,17,-9,5,Italy - Serie A,0.12,0.88,-9,1.0,8.33,1.14,11
Venezia,8,0,3,5,5,13,-8,3,Italy - Serie A,0.0,1.0,-8,0.62,0.0,1.0,12
Monza,8,0,2,6,6,20,-14,2,Italy - Serie A,0.0,1.0,-14,0.75,0.0,1.0,13
Sassuolo,8,5,1,2,12,7,5,16,Italy - Serie B,0.62,0.38,5,1.5,1.61,2.63,1
Catanzaro,8,3,5,0,14,11,3,14,Italy - Serie B,0.38,0.62,3,1.75,2.63,1.61,2
Pisa,8,4,2,2,10,7,3,14,Italy - Serie B,0.5,0.5,3,1.25,2.0,2.0,2
Cittadella,8,4,1,3,7,10,-3,13,Italy - Serie B,0.5,0.5,-3,0.88,2.0,2.0,3
Cremonese,8,3,3,2,11,5,6,12,Italy - Serie B,0.38,0.62,6,1.38,2.63,1.61,4
Spezia,8,3,3,2,9,6,3,12,Italy - Serie B,0.38,0.62,3,1.12,2.63,1.61,4
Modena,8,2,4,2,9,9,0,10,Italy - Serie B,0.25,0.75,0,1.12,4.0,1.33,5
Brescia,8,2,4,2,7,8,-1,10,Italy - Serie B,0.25,0.75,-1,0.88,4.0,1.33,5
Reggiana,8,2,3,3,10,11,-1,9,Italy - Serie B,0.25,0.75,-1,1.25,4.0,1.33,6
Bari,8,2,3,3,6,8,-2,9,Italy - Serie B,0.25,0.75,-2,0.75,4.0,1.33,6
Cesena,8,3,0,5,9,13,-4,9,Italy - Serie B,0.38,0.62,-4,1.12,2.63,1.61,6
Mantova,8,1,5,2,13,15,-2,8,Italy - Serie B,0.12,0.88,-2,1.62,8.33,1.14,7
Sudtirol,8,2,2,4,9,13,-4,8,Italy - Serie B,0.25,0.75,-4,1.12,4.0,1.33,7
Frosinone,8,1,4,3,6,9,-3,7,Italy - Serie B,0.12,0.88,-3,0.75,8.33,1.14,8
Palermo,8,1,3,4,9,10,-1,6,Italy - Serie B,0.12,0.88,-1,1.12,8.33,1.14,9
Juve Stabia,8,1,3,4,7,12,-5,6,Italy - Serie B,0.12,0.88,-5,0.88,8.33,1.14,9
Sampdoria,8,0,5,3,7,15,-8,5,Italy - Serie B,0.0,1.0,-8,0.88,0.0,1.0,10
Cosenza,8,1,1,6,8,16,-8,4,Italy - Serie B,0.12,0.88,-8,1.0,8.33,1.14,11
Carrarese,8,0,3,5,6,14,-8,3,Italy - Serie B,0.0,1.0,-8,0.75,0.0,1.0,12
Salernitana,8,0,2,6,3,14,-11,2,Italy - Serie B,0.0,1.0,-11,0.38,0.0,1.0,13
Padova,8,6,1,1,13,4,9,19,Italy - Serie C - Group A,0.75,0.25,9,1.62,1.33,4.0,1
AlbinoLeffe,8,5,1,2,11,6,5,16,Italy - Serie C - Group A,0.62,0.38,5,1.38,1.61,2.63,2
Vicenza,8,5,1,2,9,5,4,16,Italy - Serie C - Group A,0.62,0.38,4,1.12,1.61,2.63,2
Pergolettese,8,4,3,1,8,6,2,15,Italy - Serie C - Group A,0.5,0.5,2,1.0,2.0,2.0,3
Arzignano,8,3,5,0,8,5,3,14,Italy - Serie C - Group A,0.38,0.62,3,1.0,2.63,1.61,4
Virtus Verona,8,4,1,3,13,10,3,13,Italy - Serie C - Group A,0.5,0.5,3,1.62,2.0,2.0,5
FeralpiSalo,8,4,1,3,13,11,2,13,Italy - Serie C - Group A,0.5,0.5,2,1.62,2.0,2.0,5
Giana Erminio,8,4,1,3,8,8,0,13,Italy - Serie C - Group A,0.5,0.5,0,1.0,2.0,2.0,5
Triestina,8,4,1,3,11,12,-1,13,Italy - Serie C - Group A,0.5,0.5,-1,1.38,2.0,2.0,5
Novara,8,3,3,2,11,8,3,12,Italy - Serie C - Group A,0.38,0.62,3,1.38,2.63,1.61,6
Alcione,8,3,2,3,8,9,-1,11,Italy - Serie C - Group A,0.38,0.62,-1,1.0,2.63,1.61,7
Trento,8,3,2,3,6,9,-3,11,Italy - Serie C - Group A,0.38,0.62,-3,0.75,2.63,1.61,7
Lumezzane,8,1,6,1,10,11,-1,9,Italy - Serie C - Group A,0.12,0.88,-1,1.25,8.33,1.14,8
Renate,8,2,1,5,6,10,-4,7,Italy - Serie C - Group A,0.25,0.75,-4,0.75,4.0,1.33,9
Pro Vercelli,8,1,2,5,5,11,-6,5,Italy - Serie C - Group A,0.12,0.88,-6,0.62,8.33,1.14,10
Clodiense,8,1,2,5,6,17,-11,5,Italy - Serie C - Group A,0.12,0.88,-11,0.75,8.33,1.14,10
Atalanta B,8,1,1,6,8,19,-11,4,Italy - Serie C - Group A,0.12,0.88,-11,1.0,8.33,1.14,11
Lecco,8,0,3,5,4,15,-11,3,Italy - Serie C - Group A,0.0,1.0,-11,0.5,0.0,1.0,12
Caldiero Terme,8,0,2,6,6,19,-13,2,Italy - Serie C - Group A,0.0,1.0,-13,0.75,0.0,1.0,13
Pro Patria,8,0,1,7,5,14,-9,1,Italy - Serie C - Group A,0.0,1.0,-9,0.62,0.0,1.0,14
Torres,8,5,2,1,15,7,8,17,Italy - Serie C - Group B,0.62,0.38,8,1.88,1.61,2.63,1
Entella,8,4,4,0,11,5,6,16,Italy - Serie C - Group B,0.5,0.5,6,1.38,2.0,2.0,2
Ternana,8,4,2,2,9,4,5,14,Italy - Serie C - Group B,0.5,0.5,5,1.12,2.0,2.0,3
Arezzo,8,4,2,2,10,7,3,14,Italy - Serie C - Group B,0.5,0.5,3,1.25,2.0,2.0,3
Vis Pesaro,8,4,2,2,6,5,1,14,Italy - Serie C - Group B,0.5,0.5,1,0.75,2.0,2.0,3
Athletic Carpi,8,4,1,3,13,7,6,13,Italy - Serie C - Group B,0.5,0.5,6,1.62,2.0,2.0,4
Pianese,8,4,1,3,11,11,0,13,Italy - Serie C - Group B,0.5,0.5,0,1.38,2.0,2.0,4
Rimini,8,3,3,2,10,5,5,12,Italy - Serie C - Group B,0.38,0.62,5,1.25,2.63,1.61,5
Pescara,8,3,3,2,11,10,1,12,Italy - Serie C - Group B,0.38,0.62,1,1.38,2.63,1.61,5
Ascoli,8,3,3,2,9,9,0,12,Italy - Serie C - Group B,0.38,0.62,0,1.12,2.63,1.61,5
Pontedera,8,3,2,3,10,11,-1,11,Italy - Serie C - Group B,0.38,0.62,-1,1.25,2.63,1.61,6
Legnago Salus,8,2,4,2,7,7,0,10,Italy - Serie C - Group B,0.25,0.75,0,0.88,4.0,1.33,7
Pineto,8,3,1,4,13,15,-2,10,Italy - Serie C - Group B,0.38,0.62,-2,1.62,2.63,1.61,7
SPAL,8,2,2,4,11,16,-5,8,Italy - Serie C - Group B,0.25,0.75,-5,1.38,4.0,1.33,8
Campobasso,8,1,3,4,5,10,-5,6,Italy - Serie C - Group B,0.12,0.88,-5,0.62,8.33,1.14,9
AC Milan B,8,1,3,4,7,14,-7,6,Italy - Serie C - Group B,0.12,0.88,-7,0.88,8.33,1.14,9
Lucchese,8,1,3,4,5,13,-8,6,Italy - Serie C - Group B,0.12,0.88,-8,0.62,8.33,1.14,9
Sestri Levante,8,0,4,4,5,11,-6,4,Italy - Serie C - Group B,0.0,1.0,-6,0.62,0.0,1.0,10
Perugia,8,0,3,5,7,13,-6,3,Italy - Serie C - Group B,0.0,1.0,-6,0.88,0.0,1.0,11
Gubbio,8,0,2,6,5,12,-7,2,Italy - Serie C - Group B,0.0,1.0,-7,0.62,0.0,1.0,12
A. Cerignola,8,6,2,0,13,5,8,20,Italy - Serie C - Group C,0.75,0.25,8,1.62,1.33,4.0,1
Crotone,8,5,1,2,20,6,14,16,Italy - Serie C - Group C,0.62,0.38,14,2.5,1.61,2.63,2
Potenza,8,4,2,2,13,12,1,14,Italy - Serie C - Group C,0.5,0.5,1,1.62,2.0,2.0,3
Monopoli,8,4,2,2,6,5,1,14,Italy - Serie C - Group C,0.5,0.5,1,0.75,2.0,2.0,3
Avellino,8,3,4,1,13,8,5,13,Italy - Serie C - Group C,0.38,0.62,5,1.62,2.63,1.61,4
Casertana,8,3,3,2,13,7,6,12,Italy - Serie C - Group C,0.38,0.62,6,1.62,2.63,1.61,5
Benevento,8,3,2,3,9,11,-2,11,Italy - Serie C - Group C,0.38,0.62,-2,1.12,2.63,1.61,6
Giugliano,8,3,2,3,6,8,-2,11,Italy - Serie C - Group C,0.38,0.62,-2,0.75,2.63,1.61,6
Sorrento,8,3,2,3,5,8,-3,11,Italy - Serie C - Group C,0.38,0.62,-3,0.62,2.63,1.61,6
Foggia,8,3,1,4,11,8,3,10,Italy - Serie C - Group C,0.38,0.62,3,1.38,2.63,1.61,7
Trapani,8,3,1,4,9,8,1,10,Italy - Serie C - Group C,0.38,0.62,1,1.12,2.63,1.61,7
Catania,8,2,3,3,15,14,1,9,Italy - Serie C - Group C,0.25,0.75,1,1.88,4.0,1.33,8
Altamura,8,1,6,1,8,8,0,9,Italy - Serie C - Group C,0.12,0.88,0,1.0,8.33,1.14,8
Juventus U23,8,2,3,3,9,11,-2,9,Italy - Serie C - Group C,0.25,0.75,-2,1.12,4.0,1.33,8
ACR Messina,8,2,3,3,6,8,-2,9,Italy - Serie C - Group C,0.25,0.75,-2,0.75,4.0,1.33,8
Cavese,8,2,2,4,10,13,-3,8,Italy - Serie C - Group C,0.25,0.75,-3,1.25,4.0,1.33,9
Picerno,8,1,4,3,3,6,-3,7,Italy - Serie C - Group C,0.12,0.88,-3,0.38,8.33,1.14,10
Latina,8,2,1,5,7,17,-10,7,Italy - Serie C - Group C,0.25,0.75,-10,0.88,4.0,1.33,10
Turris,8,0,1,7,5,22,-17,1,Italy - Serie C - Group C,0.0,1.0,-17,0.62,0.0,1.0,11
Taranto,8,0,0,8,3,33,-30,0,Italy - Serie C - Group C,0.0,1.0,-30,0.38,0.0,1.0,12
NovaRomentin,8,8,0,0,24,4,20,24,Italy - Serie D - Group A,1.0,0.0,20,3.0,1.0,0.0,1
Bra,8,6,2,0,10,2,8,20,Italy - Serie D - Group A,0.75,0.25,8,1.25,1.33,4.0,2
Vado,8,5,3,0,12,6,6,18,Italy - Serie D - Group A,0.62,0.38,6,1.5,1.61,2.63,3
Gozzano,8,5,1,2,14,8,6,16,Italy - Serie D - Group A,0.62,0.38,6,1.75,1.61,2.63,4
Ligorna,8,5,1,2,11,5,6,16,Italy - Serie D - Group A,0.62,0.38,6,1.38,1.61,2.63,4
Chisola,8,4,2,2,10,5,5,14,Italy - Serie D - Group A,0.5,0.5,5,1.25,2.0,2.0,5
Citta di Varese,8,4,2,2,6,5,1,14,Italy - Serie D - Group A,0.5,0.5,1,0.75,2.0,2.0,5
Lavagnese,8,3,4,1,12,7,5,13,Italy - Serie D - Group A,0.38,0.62,5,1.5,2.63,1.61,6
Cairese,8,3,2,3,6,11,-5,11,Italy - Serie D - Group A,0.38,0.62,-5,0.75,2.63,1.61,7
Derthona,8,2,2,4,7,8,-1,8,Italy - Serie D - Group A,0.25,0.75,-1,0.88,4.0,1.33,8
Oltrepo,8,2,2,4,5,13,-8,8,Italy - Serie D - Group A,0.25,0.75,-8,0.62,4.0,1.33,8
Sanremese,8,1,4,3,7,11,-4,7,Italy - Serie D - Group A,0.12,0.88,-4,0.88,8.33,1.14,9
Pro Imperia,8,2,1,5,10,15,-5,7,Italy - Serie D - Group A,0.25,0.75,-5,1.25,4.0,1.33,9
Fossano,8,1,3,4,8,14,-6,6,Italy - Serie D - Group A,0.12,0.88,-6,1.0,8.33,1.14,10
Chieri,8,1,3,4,5,13,-8,6,Italy - Serie D - Group A,0.12,0.88,-8,0.62,8.33,1.14,10
Saluzzo,8,0,5,3,4,9,-5,5,Italy - Serie D - Group A,0.0,1.0,-5,0.5,0.0,1.0,11
Asti,8,1,2,5,10,18,-8,5,Italy - Serie D - Group A,0.12,0.88,-8,1.25,8.33,1.14,11
Vogherese,8,0,2,6,4,15,-11,2,Italy - Serie D - Group A,0.0,1.0,-11,0.5,0.0,1.0,12
Borgaro Nobis,8,0,1,7,6,21,-15,1,Italy - Serie D - Group A,0.0,1.0,-15,0.75,0.0,1.0,13
Albenga,0,0,0,0,0,0,0,0,Italy - Serie D - Group A,0.0,0.0,0,0.0,0.0,0.0,14
Ospitaletto,8,7,0,1,16,4,12,21,Italy - Serie D - Group B,0.88,0.12,12,2.0,1.14,8.33,1
F. Caratese,8,5,3,0,12,4,8,18,Italy - Serie D - Group B,0.62,0.38,8,1.5,1.61,2.63,2
Chievo,8,4,3,1,10,6,4,15,Italy - Serie D - Group B,0.5,0.5,4,1.25,2.0,2.0,3
USD Casatese,8,3,4,1,14,9,5,13,Italy - Serie D - Group B,0.38,0.62,5,1.75,2.63,1.61,4
Pro Palazzolo,8,3,3,2,12,8,4,12,Italy - Serie D - Group B,0.38,0.62,4,1.5,2.63,1.61,5
Club Milano,8,3,3,2,7,8,-1,12,Italy - Serie D - Group B,0.38,0.62,-1,0.88,2.63,1.61,5
Crema,8,3,2,3,9,12,-3,11,Italy - Serie D - Group B,0.38,0.62,-3,1.12,2.63,1.61,6
Desenxano,8,2,3,3,11,10,1,9,Italy - Serie D - Group B,0.25,0.75,1,1.38,4.0,1.33,7
SantAngelo,8,2,3,3,9,9,0,9,Italy - Serie D - Group B,0.25,0.75,0,1.12,4.0,1.33,7
Pro Sesto,8,2,3,3,9,11,-2,9,Italy - Serie D - Group B,0.25,0.75,-2,1.12,4.0,1.33,7
Varesina,8,1,5,2,7,9,-2,8,Italy - Serie D - Group B,0.12,0.88,-2,0.88,8.33,1.14,8
Arconatese,8,2,2,4,8,11,-3,8,Italy - Serie D - Group B,0.25,0.75,-3,1.0,4.0,1.33,8
Sondrio,8,2,2,4,7,16,-9,8,Italy - Serie D - Group B,0.25,0.75,-9,0.88,4.0,1.33,8
Vigasio,8,1,4,3,4,7,-3,7,Italy - Serie D - Group B,0.12,0.88,-3,0.5,8.33,1.14,9
Sangiuliano C.,8,2,1,5,5,9,-4,7,Italy - Serie D - Group B,0.25,0.75,-4,0.62,4.0,1.33,9
Castellanzese,8,1,3,4,8,14,-6,6,Italy - Serie D - Group B,0.12,0.88,-6,1.0,8.33,1.14,10
Magenta,8,1,2,5,11,14,-3,5,Italy - Serie D - Group B,0.12,0.88,-3,1.38,8.33,1.14,11
Breno,8,0,5,3,6,11,-5,5,Italy - Serie D - Group B,0.0,1.0,-5,0.75,0.0,1.0,11
Fanfulla,8,1,2,5,5,16,-11,5,Italy - Serie D - Group B,0.12,0.88,-11,0.62,8.33,1.14,11
Ciliverghe,8,0,2,6,5,19,-14,2,Italy - Serie D - Group B,0.0,1.0,-14,0.62,0.0,1.0,12
Cjarlins Muzane,8,5,2,1,11,5,6,17,Italy - Serie D - Group C,0.62,0.38,6,1.38,1.61,2.63,1
Mestre,8,5,1,2,8,4,4,16,Italy - Serie D - Group C,0.62,0.38,4,1.0,1.61,2.63,2
Real Calepina,8,4,3,1,11,8,3,15,Italy - Serie D - Group C,0.5,0.5,3,1.38,2.0,2.0,3
Treviso,8,4,2,2,14,8,6,14,Italy - Serie D - Group C,0.5,0.5,6,1.75,2.0,2.0,4
Brusaporto,8,3,3,2,7,6,1,12,Italy - Serie D - Group C,0.38,0.62,1,0.88,2.63,1.61,5
Adriese,8,3,3,2,8,8,0,12,Italy - Serie D - Group C,0.38,0.62,0,1.0,2.63,1.61,5
Villa Alme,8,2,5,1,11,9,2,11,Italy - Serie D - Group C,0.25,0.75,2,1.38,4.0,1.33,6
Campodarsego,8,2,5,1,6,4,2,11,Italy - Serie D - Group C,0.25,0.75,2,0.75,4.0,1.33,6
D. Bellunesi,8,3,2,3,9,11,-2,11,Italy - Serie D - Group C,0.38,0.62,-2,1.12,2.63,1.61,6
Portogruaro,8,2,4,2,12,10,2,10,Italy - Serie D - Group C,0.25,0.75,2,1.5,4.0,1.33,7
Luparense,8,2,2,4,9,10,-1,8,Italy - Serie D - Group C,0.25,0.75,-1,1.12,4.0,1.33,8
Este,8,2,2,4,9,11,-2,8,Italy - Serie D - Group C,0.25,0.75,-2,1.12,4.0,1.33,8
Montecchio M.,8,2,2,4,8,12,-4,8,Italy - Serie D - Group C,0.25,0.75,-4,1.0,4.0,1.33,8
Bassano Virtus,8,2,2,4,11,16,-5,8,Italy - Serie D - Group C,0.25,0.75,-5,1.38,4.0,1.33,8
Calvi Noale,8,1,4,3,6,8,-2,7,Italy - Serie D - Group C,0.12,0.88,-2,0.75,8.33,1.14,9
Caravaggio,8,1,2,5,11,14,-3,5,Italy - Serie D - Group C,0.12,0.88,-3,1.38,8.33,1.14,10
Ciserano,8,1,2,5,7,14,-7,5,Italy - Serie D - Group C,0.12,0.88,-7,0.88,8.33,1.14,10
Brian Lignano,8,0,3,5,7,16,-9,3,Italy - Serie D - Group C,0.0,1.0,-9,0.88,0.0,1.0,11
Chions,8,0,2,6,6,17,-11,2,Italy - Serie D - Group C,0.0,1.0,-11,0.75,0.0,1.0,12
Lavis,8,0,0,8,3,21,-18,0,Italy - Serie D - Group C,0.0,1.0,-18,0.38,0.0,1.0,13
Forli,8,7,0,1,14,3,11,21,Italy - Serie D - Group D,0.88,0.12,11,1.75,1.14,8.33,1
Ravenna,8,6,2,0,16,4,12,20,Italy - Serie D - Group D,0.75,0.25,12,2.0,1.33,4.0,2
Zenith Prato,8,5,1,2,15,7,8,16,Italy - Serie D - Group D,0.62,0.38,8,1.88,1.61,2.63,3
Lentigione,8,4,2,2,10,10,0,14,Italy - Serie D - Group D,0.5,0.5,0,1.25,2.0,2.0,4
Progresso,8,4,1,3,6,8,-2,13,Italy - Serie D - Group D,0.5,0.5,-2,0.75,2.0,2.0,5
Tuttocuoio,8,4,1,3,9,15,-6,13,Italy - Serie D - Group D,0.5,0.5,-6,1.12,2.0,2.0,5
Tau Altopascio,8,3,3,2,13,4,9,12,Italy - Serie D - Group D,0.38,0.62,9,1.62,2.63,1.61,6
Pistoiese,8,3,3,2,9,6,3,12,Italy - Serie D - Group D,0.38,0.62,3,1.12,2.63,1.61,6
Sasso Marconi,8,3,1,4,8,10,-2,10,Italy - Serie D - Group D,0.38,0.62,-2,1.0,2.63,1.61,7
San Marino C.,8,2,3,3,8,8,0,9,Italy - Serie D - Group D,0.25,0.75,0,1.0,4.0,1.33,8
Imolese,8,2,3,3,6,12,-6,9,Italy - Serie D - Group D,0.25,0.75,-6,0.75,4.0,1.33,8
Prato,8,2,2,4,6,7,-1,8,Italy - Serie D - Group D,0.25,0.75,-1,0.75,4.0,1.33,9
Cittadella Vis,8,2,2,4,7,11,-4,8,Italy - Serie D - Group D,0.25,0.75,-4,0.88,4.0,1.33,9
Sammaurese,8,1,4,3,3,6,-3,7,Italy - Serie D - Group D,0.12,0.88,-3,0.38,8.33,1.14,10
Corticella,8,1,3,4,5,10,-5,6,Italy - Serie D - Group D,0.12,0.88,-5,0.62,8.33,1.14,11
Fiorenzuola,8,2,0,6,5,13,-8,6,Italy - Serie D - Group D,0.25,0.75,-8,0.62,4.0,1.33,11
Piacenza,8,1,1,6,6,17,-11,4,Italy - Serie D - Group D,0.12,0.88,-11,0.75,8.33,1.14,12
United Riccione,8,1,1,6,3,19,-16,4,Italy - Serie D - Group D,0.12,0.88,-16,0.38,8.33,1.14,12
Livorno,8,6,2,0,15,5,10,20,Italy - Serie D - Group E,0.75,0.25,10,1.88,1.33,4.0,1
Seravezza,8,3,5,0,8,4,4,14,Italy - Serie D - Group E,0.38,0.62,4,1.0,2.63,1.61,2
Fulgens Foligno,8,4,2,2,11,8,3,14,Italy - Serie D - Group E,0.5,0.5,3,1.38,2.0,2.0,2
FC Siena,8,4,2,2,6,6,0,14,Italy - Serie D - Group E,0.5,0.5,0,0.75,2.0,2.0,2
San Donato,8,4,1,3,7,6,1,13,Italy - Serie D - Group E,0.5,0.5,1,0.88,2.0,2.0,3
Ghiviborgo,8,4,1,3,14,15,-1,13,Italy - Serie D - Group E,0.5,0.5,-1,1.75,2.0,2.0,3
Grosseto,8,4,1,3,8,9,-1,13,Italy - Serie D - Group E,0.5,0.5,-1,1.0,2.0,2.0,3
Orvietana,8,3,3,2,10,10,0,12,Italy - Serie D - Group E,0.38,0.62,0,1.25,2.63,1.61,4
Poggibonsi,8,3,2,3,7,7,0,11,Italy - Serie D - Group E,0.38,0.62,0,0.88,2.63,1.61,5
Sangiovannese,8,2,4,2,8,8,0,10,Italy - Serie D - Group E,0.25,0.75,0,1.0,4.0,1.33,6
Montevarchi,8,2,4,2,8,9,-1,10,Italy - Serie D - Group E,0.25,0.75,-1,1.0,4.0,1.33,6
Gavorrano,8,3,1,4,8,11,-3,10,Italy - Serie D - Group E,0.38,0.62,-3,1.0,2.63,1.61,6
Flaminia,8,2,3,3,9,8,1,9,Italy - Serie D - Group E,0.25,0.75,1,1.12,4.0,1.33,7
Ostia Mare,8,2,3,3,12,12,0,9,Italy - Serie D - Group E,0.25,0.75,0,1.5,4.0,1.33,7
S. Trestina,8,3,0,5,10,12,-2,9,Italy - Serie D - Group E,0.38,0.62,-2,1.25,2.63,1.61,7
Fezzanese,8,2,3,3,9,13,-4,9,Italy - Serie D - Group E,0.25,0.75,-4,1.12,4.0,1.33,7
Figline,8,2,1,5,8,11,-3,7,Italy - Serie D - Group E,0.25,0.75,-3,1.0,4.0,1.33,8
T. Traiana,8,2,1,5,9,20,-11,7,Italy - Serie D - Group E,0.25,0.75,-11,1.12,4.0,1.33,8
Chieti,8,5,3,0,16,9,7,18,Italy - Serie D - Group F,0.62,0.38,7,2.0,1.61,2.63,1
Sambenedettese,8,5,2,1,15,5,10,17,Italy - Serie D - Group F,0.62,0.38,10,1.88,1.61,2.63,2
Teramo,8,5,2,1,12,6,6,17,Italy - Serie D - Group F,0.62,0.38,6,1.5,1.61,2.63,2
LAquila,8,4,3,1,8,3,5,15,Italy - Serie D - Group F,0.5,0.5,5,1.0,2.0,2.0,3
Ancona 1905,8,4,3,1,11,7,4,15,Italy - Serie D - Group F,0.5,0.5,4,1.38,2.0,2.0,3
Castelfidardo,8,3,3,2,10,8,2,12,Italy - Serie D - Group F,0.38,0.62,2,1.25,2.63,1.61,4
Avezzano,8,3,2,3,8,7,1,11,Italy - Serie D - Group F,0.38,0.62,1,1.0,2.63,1.61,5
Recanatese,8,2,5,1,5,6,-1,11,Italy - Serie D - Group F,0.25,0.75,-1,0.62,4.0,1.33,5
Termoli Calcio,8,2,4,2,8,11,-3,10,Italy - Serie D - Group F,0.25,0.75,-3,1.0,4.0,1.33,6
Roma City,8,2,3,3,7,6,1,9,Italy - Serie D - Group F,0.25,0.75,1,0.88,4.0,1.33,7
V. Senigallia,8,2,3,3,10,12,-2,9,Italy - Serie D - Group F,0.25,0.75,-2,1.25,4.0,1.33,7
Fossombrone,8,2,3,3,6,8,-2,9,Italy - Serie D - Group F,0.25,0.75,-2,0.75,4.0,1.33,7
Civitanovese,8,2,3,3,8,11,-3,9,Italy - Serie D - Group F,0.25,0.75,-3,1.0,4.0,1.33,7
Fermana,8,2,2,4,4,9,-5,8,Italy - Serie D - Group F,0.25,0.75,-5,0.5,4.0,1.33,8
San Nicolo,8,2,1,5,13,14,-1,7,Italy - Serie D - Group F,0.25,0.75,-1,1.62,4.0,1.33,9
Atletico Ascoli,8,1,3,4,4,12,-8,6,Italy - Serie D - Group F,0.12,0.88,-8,0.5,8.33,1.14,10
Sora,8,1,3,4,2,10,-8,6,Italy - Serie D - Group F,0.12,0.88,-8,0.25,8.33,1.14,10
Isernia,8,0,5,3,8,17,-9,5,Italy - Serie D - Group F,0.0,1.0,-9,1.0,0.0,1.0,11
Gelbison,8,4,3,1,12,10,2,15,Italy - Serie D - Group G,0.5,0.5,2,1.5,2.0,2.0,1
Sarnese,8,4,1,3,13,8,5,13,Italy - Serie D - Group G,0.5,0.5,5,1.62,2.0,2.0,2
Guidonia,8,4,1,3,12,11,1,13,Italy - Serie D - Group G,0.5,0.5,1,1.5,2.0,2.0,2
Cassino,8,2,5,1,5,4,1,11,Italy - Serie D - Group G,0.25,0.75,1,0.62,4.0,1.33,3
S. Ogliastra,8,3,2,3,7,10,-3,11,Italy - Serie D - Group G,0.38,0.62,-3,0.88,2.63,1.61,3
CynthiAlbalonga,8,3,1,4,10,12,-2,10,Italy - Serie D - Group G,0.38,0.62,-2,1.25,2.63,1.61,4
Atletico Uri,8,2,3,3,8,15,-7,9,Italy - Serie D - Group G,0.25,0.75,-7,1.0,4.0,1.33,5
Puteolana,8,2,1,5,9,11,-2,7,Italy - Serie D - Group G,0.25,0.75,-2,1.12,4.0,1.33,6
Paganese,8,1,4,3,9,13,-4,7,Italy - Serie D - Group G,0.12,0.88,-4,1.12,8.33,1.14,6
Olbia,8,2,1,5,10,15,-5,7,Italy - Serie D - Group G,0.25,0.75,-5,1.25,4.0,1.33,6
Savoia,8,1,4,3,6,12,-6,7,Italy - Serie D - Group G,0.12,0.88,-6,0.75,8.33,1.14,6
Terracina,8,2,1,5,7,15,-8,7,Italy - Serie D - Group G,0.25,0.75,-8,0.88,4.0,1.33,6
R. Monterotondo,8,1,2,5,5,10,-5,5,Italy - Serie D - Group G,0.12,0.88,-5,0.62,8.33,1.14,7
Ilvamaddalena,8,1,2,5,6,13,-7,5,Italy - Serie D - Group G,0.12,0.88,-7,0.75,8.33,1.14,7
A. Lodigiani,8,1,2,5,7,16,-9,5,Italy - Serie D - Group G,0.12,0.88,-9,0.88,8.33,1.14,7
Anzio,8,0,4,4,7,14,-7,4,Italy - Serie D - Group G,0.0,1.0,-7,0.88,0.0,1.0,8
Trastevere,8,0,1,7,6,21,-15,1,Italy - Serie D - Group G,0.0,1.0,-15,0.75,0.0,1.0,9
Latte Dolce,8,0,0,8,8,23,-15,0,Italy - Serie D - Group G,0.0,1.0,-15,1.0,0.0,1.0,10
Martina Franca,8,5,2,1,11,7,4,17,Italy - Serie D - Group H,0.62,0.38,4,1.38,1.61,2.63,1
Nocerina,8,5,1,2,16,10,6,16,Italy - Serie D - Group H,0.62,0.38,6,2.0,1.61,2.63,2
Casarano,8,4,3,1,23,9,14,15,Italy - Serie D - Group H,0.5,0.5,14,2.88,2.0,2.0,3
Fidelis Andria,8,4,1,3,14,9,5,13,Italy - Serie D - Group H,0.5,0.5,5,1.75,2.0,2.0,4
Ischia,8,3,1,4,7,8,-1,10,Italy - Serie D - Group H,0.38,0.62,-1,0.88,2.63,1.61,5
Citta di Fasano,8,2,3,3,6,6,0,9,Italy - Serie D - Group H,0.25,0.75,0,0.75,4.0,1.33,6
Francavilla,8,2,3,3,5,6,-1,9,Italy - Serie D - Group H,0.25,0.75,-1,0.62,4.0,1.33,6
Nardo,8,2,3,3,9,11,-2,9,Italy - Serie D - Group H,0.25,0.75,-2,1.12,4.0,1.33,6
V. Francavilla,8,2,2,4,4,7,-3,8,Italy - Serie D - Group H,0.25,0.75,-3,0.5,4.0,1.33,7
Matera,8,2,2,4,9,16,-7,8,Italy - Serie D - Group H,0.25,0.75,-7,1.12,4.0,1.33,7
Manfredonia,8,2,2,4,6,15,-9,8,Italy - Serie D - Group H,0.25,0.75,-9,0.75,4.0,1.33,7
Real Acerrana,8,2,1,5,4,13,-9,7,Italy - Serie D - Group H,0.25,0.75,-9,0.5,4.0,1.33,8
Brindisi,8,1,3,4,10,13,-3,6,Italy - Serie D - Group H,0.12,0.88,-3,1.25,8.33,1.14,9
USD Palmese,8,1,3,4,8,13,-5,6,Italy - Serie D - Group H,0.12,0.88,-5,1.0,8.33,1.14,9
Gravina,8,1,3,4,9,17,-8,6,Italy - Serie D - Group H,0.12,0.88,-8,1.12,8.33,1.14,9
Angri Calcio,8,1,1,6,7,21,-14,4,Italy - Serie D - Group H,0.12,0.88,-14,0.88,8.33,1.14,10
Ugento,8,1,1,6,4,20,-16,4,Italy - Serie D - Group H,0.12,0.88,-16,0.5,8.33,1.14,10
Costa DAmalfi,8,0,1,7,6,19,-13,1,Italy - Serie D - Group H,0.0,1.0,-13,0.75,0.0,1.0,11
Reggina,8,5,3,0,15,3,12,18,Italy - Serie D - Group I,0.62,0.38,12,1.88,1.61,2.63,1
Scafatese,8,5,2,1,11,3,8,17,Italy - Serie D - Group I,0.62,0.38,8,1.38,1.61,2.63,2
Sambiase,8,5,2,1,13,6,7,17,Italy - Serie D - Group I,0.62,0.38,7,1.62,1.61,2.63,2
Siracusa,8,5,2,1,10,6,4,17,Italy - Serie D - Group I,0.62,0.38,4,1.25,1.61,2.63,2
Vibonese,8,4,1,3,10,6,4,13,Italy - Serie D - Group I,0.5,0.5,4,1.25,2.0,2.0,3
Ragusa,8,3,3,2,14,11,3,12,Italy - Serie D - Group I,0.38,0.62,3,1.75,2.63,1.61,4
CastrumFavara,8,1,6,1,4,7,-3,9,Italy - Serie D - Group I,0.12,0.88,-3,0.5,8.33,1.14,5
Nissa,8,2,3,3,11,18,-7,9,Italy - Serie D - Group I,0.25,0.75,-7,1.38,4.0,1.33,5
Igea Virtus,8,2,2,4,8,15,-7,8,Italy - Serie D - Group I,0.25,0.75,-7,1.0,4.0,1.33,6
Enna,8,2,2,4,2,10,-8,8,Italy - Serie D - Group I,0.25,0.75,-8,0.25,4.0,1.33,6
Pompei,8,1,4,3,4,9,-5,7,Italy - Serie D - Group I,0.12,0.88,-5,0.5,8.33,1.14,7
Paterno,8,1,3,4,7,15,-8,6,Italy - Serie D - Group I,0.12,0.88,-8,0.88,8.33,1.14,8
Licata,8,1,2,5,7,14,-7,5,Italy - Serie D - Group I,0.12,0.88,-7,0.88,8.33,1.14,9
CD S. Agata,8,1,1,6,7,17,-10,4,Italy - Serie D - Group I,0.12,0.88,-10,0.88,8.33,1.14,10
Locri 1909,8,1,1,6,9,21,-12,4,Italy - Serie D - Group I,0.12,0.88,-12,1.12,8.33,1.14,10
Akragas,8,1,1,6,4,18,-14,4,Italy - Serie D - Group I,0.12,0.88,-14,0.5,8.33,1.14,10
Acireale,8,0,3,5,7,15,-8,3,Italy - Serie D - Group I,0.0,1.0,-8,0.88,0.0,1.0,11
Sancataldese,8,0,2,6,4,15,-11,2,Italy - Serie D - Group I,0.0,1.0,-11,0.5,0.0,1.0,12
Roma U20,8,8,0,0,28,9,19,24,Italy - Primavera 1,1.0,0.0,19,3.5,1.0,0.0,1
H. Verona U20,8,7,1,0,17,4,13,22,Italy - Primavera 1,0.88,0.12,13,2.12,1.14,8.33,2
Inter Milan U20,8,5,0,3,18,11,7,15,Italy - Primavera 1,0.62,0.38,7,2.25,1.61,2.63,3
Milan U20,8,4,3,1,15,9,6,15,Italy - Primavera 1,0.5,0.5,6,1.88,2.0,2.0,3
Fiorentina U20,8,5,0,3,14,8,6,15,Italy - Primavera 1,0.62,0.38,6,1.75,1.61,2.63,3
Sassuolo U20,8,5,0,3,14,12,2,15,Italy - Primavera 1,0.62,0.38,2,1.75,1.61,2.63,3
Genoa U20,8,4,1,3,11,10,1,13,Italy - Primavera 1,0.5,0.5,1,1.38,2.0,2.0,4
Juventus U20,8,3,2,3,15,16,-1,11,Italy - Primavera 1,0.38,0.62,-1,1.88,2.63,1.61,5
Monza U20,8,3,1,4,14,17,-3,10,Italy - Primavera 1,0.38,0.62,-3,1.75,2.63,1.61,6
Atalanta U20,8,2,2,4,8,11,-3,8,Italy - Primavera 1,0.25,0.75,-3,1.0,4.0,1.33,7
Cremonese U20,8,1,4,3,3,8,-5,7,Italy - Primavera 1,0.12,0.88,-5,0.38,8.33,1.14,8
Lazio U20,8,1,4,3,4,10,-6,7,Italy - Primavera 1,0.12,0.88,-6,0.5,8.33,1.14,8
Empoli U20,8,1,3,4,11,16,-5,6,Italy - Primavera 1,0.12,0.88,-5,1.38,8.33,1.14,9
Cesena U20,8,1,2,5,13,16,-3,5,Italy - Primavera 1,0.12,0.88,-3,1.62,8.33,1.14,10
Sampdoria U20,8,1,2,5,7,15,-8,5,Italy - Primavera 1,0.12,0.88,-8,0.88,8.33,1.14,10
Cagliari U20,8,1,2,5,5,13,-8,5,Italy - Primavera 1,0.12,0.88,-8,0.62,8.33,1.14,10
Bologna U20,8,1,2,5,5,15,-10,5,Italy - Primavera 1,0.12,0.88,-10,0.62,8.33,1.14,10
Torino U20,8,1,1,6,10,15,-5,4,Italy - Primavera 1,0.12,0.88,-5,1.25,8.33,1.14,11
Lecce U20,8,1,1,6,8,19,-11,4,Italy - Primavera 1,0.12,0.88,-11,1.0,8.33,1.14,11
Udinese U20,8,0,1,7,6,19,-13,1,Italy - Primavera 1,0.0,1.0,-13,0.75,0.0,1.0,12
Mount Pleasant,8,6,1,1,25,8,17,19,jamaica,0.75,0.25,17,3.12,1.33,4.0,1
Arnett Gardens,8,6,1,1,14,7,7,19,jamaica,0.75,0.25,7,1.75,1.33,4.0,1
Cavalier,8,5,2,1,13,8,5,17,jamaica,0.62,0.38,5,1.62,1.61,2.63,2
Montego Bay,8,3,3,2,9,7,2,12,jamaica,0.38,0.62,2,1.12,2.63,1.61,3
Racing United,8,2,5,1,11,8,3,11,jamaica,0.25,0.75,3,1.38,4.0,1.33,4
Tivoli Gardens,8,3,2,3,10,11,-1,11,jamaica,0.38,0.62,-1,1.25,2.63,1.61,4
Portmore Utd,8,2,4,2,5,4,1,10,jamaica,0.25,0.75,1,0.62,4.0,1.33,5
Molynes Utd,8,2,3,3,11,14,-3,9,jamaica,0.25,0.75,-3,1.38,4.0,1.33,6
Chapelton,8,2,2,4,10,9,1,8,jamaica,0.25,0.75,1,1.25,4.0,1.33,7
Waterhouse,8,2,2,4,11,12,-1,8,jamaica,0.25,0.75,-1,1.38,4.0,1.33,7
Dunbeholden,8,2,2,4,7,14,-7,8,jamaica,0.25,0.75,-7,0.88,4.0,1.33,7
Vere Utd,8,1,3,4,5,12,-7,6,jamaica,0.12,0.88,-7,0.62,8.33,1.14,8
Harbour View,8,1,1,6,4,18,-14,4,jamaica,0.12,0.88,-14,0.5,8.33,1.14,9
Humble Lions,8,0,1,7,8,27,-19,1,jamaica,0.0,1.0,-19,1.0,0.0,1.0,10
K. Frontale,2,1,1,0,3,2,1,4,japan,0.5,0.5,1,1.5,2.0,2.0,1
S. Hiroshima,2,1,1,0,3,2,1,4,japan,0.5,0.5,1,1.5,2.0,2.0,1
Shonan Bellmare,2,1,1,0,3,2,1,4,japan,0.5,0.5,1,1.5,2.0,2.0,1
Kyoto Sanga,3,1,1,1,2,3,-1,4,japan,0.33,0.67,-1,0.67,3.03,1.49,1
Cerezo Osaka,2,1,0,1,6,4,2,3,japan,0.5,0.5,2,3.0,2.0,2.0,2
Kashiwa Reysol,1,1,0,0,1,0,1,3,japan,1.0,0.0,1,1.0,1.0,0.0,2
Machida Zelvia,1,1,0,0,1,0,1,3,japan,1.0,0.0,1,1.0,1.0,0.0,2
Shimizu S-Pulse,1,1,0,0,1,0,1,3,japan,1.0,0.0,1,1.0,1.0,0.0,2
Avispa Fukuoka,2,1,0,1,2,2,0,3,japan,0.5,0.5,0,1.0,2.0,2.0,2
FC Tokyo,2,1,0,1,1,2,-1,3,japan,0.5,0.5,-1,0.5,2.0,2.0,2
Tokyo Verdy,2,1,0,1,1,4,-3,3,japan,0.5,0.5,-3,0.5,2.0,2.0,2
Urawa RD,3,0,2,1,2,3,-1,2,japan,0.0,1.0,-1,0.67,0.0,1.0,3
Vissel Kobe,1,0,1,0,2,2,0,1,japan,0.0,1.0,0,2.0,0.0,1.0,4
Yokohama FC,1,0,1,0,0,0,0,1,japan,0.0,1.0,0,0.0,0.0,1.0,4
Albirex Niigata,3,0,1,2,2,5,-3,1,japan,0.0,1.0,-3,0.67,0.0,1.0,4
Fagiano Okayama,1,0,0,1,0,1,-1,0,japan,0.0,1.0,-1,0.0,0.0,1.0,5
Kashima Antlers,1,0,0,1,0,1,-1,0,japan,0.0,1.0,-1,0.0,0.0,1.0,5
Yokohama M.,1,0,0,1,0,1,-1,0,japan,0.0,1.0,-1,0.0,0.0,1.0,5
Gamba Osaka,1,0,0,1,0,2,-2,0,japan,0.0,1.0,-2,0.0,0.0,1.0,5
Nagoya G.,2,0,0,2,1,7,-6,0,japan,0.0,1.0,-6,0.5,0.0,1.0,5
Blaublitz Akita,3,2,0,1,4,3,1,6,japan2,0.67,0.33,1,1.33,1.49,3.03,1
FC Imabari,1,1,0,0,4,1,3,3,japan2,1.0,0.0,3,4.0,1.0,0.0,2
JEF Utd Chiba,1,1,0,0,2,0,2,3,japan2,1.0,0.0,2,2.0,1.0,0.0,2
Tokushima V.,1,1,0,0,2,0,2,3,japan2,1.0,0.0,2,2.0,1.0,0.0,2
Vegalta Sendai,2,1,0,1,1,1,0,3,japan2,0.5,0.5,0,0.5,2.0,2.0,2
Kataller Toyama,2,1,0,1,1,2,-1,3,japan2,0.5,0.5,-1,0.5,2.0,2.0,2
V-V. Nagasaki,1,0,1,0,2,2,0,1,japan2,0.0,1.0,0,2.0,0.0,1.0,3
Fujieda MYFC,1,0,1,0,0,0,0,1,japan2,0.0,1.0,0,0.0,0.0,1.0,3
Iwaki,1,0,1,0,0,0,0,1,japan2,0.0,1.0,0,0.0,0.0,1.0,3
Ehime FC,0,0,0,0,0,0,0,0,japan2,0.0,0.0,0,0.0,0.0,0.0,4
Omiya Ardija,0,0,0,0,0,0,0,0,japan2,0.0,0.0,0,0.0,0.0,0.0,4
Mito Hollyhock,1,0,0,1,2,3,-1,0,japan2,0.0,1.0,-1,2.0,0.0,1.0,4
R. Kumamoto,1,0,0,1,2,3,-1,0,japan2,0.0,1.0,-1,2.0,0.0,1.0,4
Jubilo Iwata,1,0,0,1,0,1,-1,0,japan2,0.0,1.0,-1,0.0,0.0,1.0,4
R. Yamaguchi,1,0,0,1,0,1,-1,0,japan2,0.0,1.0,-1,0.0,0.0,1.0,4
Sagan Tosu,1,0,0,1,0,1,-1,0,japan2,0.0,1.0,-1,0.0,0.0,1.0,4
Ventforet Kofu,1,0,0,1,0,1,-1,0,japan2,0.0,1.0,-1,0.0,0.0,1.0,4
Oita Trinita,1,0,0,1,0,2,-2,0,japan2,0.0,1.0,-2,0.0,0.0,1.0,4
M. Yamagata,3,0,0,3,3,6,-3,0,japan2,0.0,1.0,-3,1.0,0.0,1.0,4
C. Sapporo,2,0,0,2,0,5,-5,0,japan2,0.0,1.0,-5,0.0,0.0,1.0,4
Fukushima Utd,3,1,1,1,4,5,-1,4,japan3,0.33,0.67,-1,1.33,3.03,1.49,1
Kagoshima Utd,1,1,0,0,2,0,2,3,japan3,1.0,0.0,2,2.0,1.0,0.0,2
Z. Kanazawa,1,1,0,0,2,1,1,3,japan3,1.0,0.0,1,2.0,1.0,0.0,2
Osaka,1,1,0,0,1,0,1,3,japan3,1.0,0.0,1,1.0,1.0,0.0,2
V. Hachinohe,1,1,0,0,1,0,1,3,japan3,1.0,0.0,1,1.0,1.0,0.0,2
Nagano Parceiro,2,1,0,1,1,2,-1,3,japan3,0.5,0.5,-1,0.5,2.0,2.0,2
Gifu,1,0,1,0,1,1,0,1,japan3,0.0,1.0,0,1.0,0.0,1.0,3
Kamatamare S.,1,0,1,0,1,1,0,1,japan3,0.0,1.0,0,1.0,0.0,1.0,3
AC Numazu,1,0,1,0,0,0,0,1,japan3,0.0,1.0,0,0.0,0.0,1.0,3
FC Ryukyu,1,0,1,0,0,0,0,1,japan3,0.0,1.0,0,0.0,0.0,1.0,3
Matsumoto Y.,2,0,1,1,2,3,-1,1,japan3,0.0,1.0,-1,1.0,0.0,1.0,3
Gainare Tottori,2,0,1,1,0,3,-3,1,japan3,0.0,1.0,-3,0.0,0.0,1.0,3
T. Miyazaki,0,0,0,0,0,0,0,0,japan3,0.0,0.0,0,0.0,0.0,0.0,4
Kusatsu,1,0,0,1,2,3,-1,0,japan3,0.0,1.0,-1,2.0,0.0,1.0,4
G. Kitakyushu,1,0,0,1,1,2,-1,0,japan3,0.0,1.0,-1,1.0,0.0,1.0,4
SC Sagamihara,1,0,0,1,1,2,-1,0,japan3,0.0,1.0,-1,1.0,0.0,1.0,4
Kochi United,1,0,0,1,0,1,-1,0,japan3,0.0,1.0,-1,0.0,0.0,1.0,4
Tochigi SC,1,0,0,1,0,1,-1,0,japan3,0.0,1.0,-1,0.0,0.0,1.0,4
Nara Club,1,0,0,1,0,2,-2,0,japan3,0.0,1.0,-2,0.0,0.0,1.0,4
Tochigi City,1,0,0,1,0,2,-2,0,japan3,0.0,1.0,-2,0.0,0.0,1.0,4
Aktobe,1,0,1,0,0,0,0,1,kazakhstan,0.0,1.0,0,0.0,0.0,1.0,1
Atyrau,0,0,0,0,0,0,0,0,kazakhstan,0.0,0.0,0,0.0,0.0,0.0,2
FC Astana,0,0,0,0,0,0,0,0,kazakhstan,0.0,0.0,0,0.0,0.0,0.0,2
Kairat Almaty,0,0,0,0,0,0,0,0,kazakhstan,0.0,0.0,0,0.0,0.0,0.0,2
Kaisar K.,0,0,0,0,0,0,0,0,kazakhstan,0.0,0.0,0,0.0,0.0,0.0,2
Kyzylzhar,0,0,0,0,0,0,0,0,kazakhstan,0.0,0.0,0,0.0,0.0,0.0,2
Okzhetpes,0,0,0,0,0,0,0,0,kazakhstan,0.0,0.0,0,0.0,0.0,0.0,2
Ordabasy,0,0,0,0,0,0,0,0,kazakhstan,0.0,0.0,0,0.0,0.0,0.0,2
Tobol,0,0,0,0,0,0,0,0,kazakhstan,0.0,0.0,0,0.0,0.0,0.0,2
Turan,0,0,0,0,0,0,0,0,kazakhstan,0.0,0.0,0,0.0,0.0,0.0,2
Ulytau,0,0,0,0,0,0,0,0,kazakhstan,0.0,0.0,0,0.0,0.0,0.0,2
Zhenys,0,0,0,0,0,0,0,0,kazakhstan,0.0,0.0,0,0.0,0.0,0.0,2
Zhetysu,0,0,0,0,0,0,0,0,kazakhstan,0.0,0.0,0,0.0,0.0,0.0,2
Yelimay Semey,1,0,0,1,1,2,-1,0,kazakhstan,0.0,1.0,-1,1.0,0.0,1.0,2
Drita,8,3,4,1,11,9,2,13,kosovo,0.38,0.62,2,1.38,2.63,1.61,1
Ballkani,8,2,4,2,9,6,3,10,kosovo,0.25,0.75,3,1.12,4.0,1.33,2
Gjilani,8,2,3,3,14,14,0,9,kosovo,0.25,0.75,0,1.75,4.0,1.33,3
Malisheva,8,2,3,3,7,8,-1,9,kosovo,0.25,0.75,-1,0.88,4.0,1.33,3
Ferizaj,8,2,2,4,6,11,-5,8,kosovo,0.25,0.75,-5,0.75,4.0,1.33,4
Prishtina,8,2,1,5,7,11,-4,7,kosovo,0.25,0.75,-4,0.88,4.0,1.33,5
Dukagjini,8,2,1,5,6,12,-6,7,kosovo,0.25,0.75,-6,0.75,4.0,1.33,5
Llapi,8,2,0,6,8,14,-6,6,kosovo,0.25,0.75,-6,1.0,4.0,1.33,6
Suhareka,8,1,3,4,10,17,-7,6,kosovo,0.12,0.88,-7,1.25,8.33,1.14,6
Feronikeli,8,0,2,6,5,14,-9,2,kosovo,0.0,1.0,-9,0.62,0.0,1.0,7
Al Arabi SC,8,6,1,1,17,6,11,19,kuwait,0.75,0.25,11,2.12,1.33,4.0,1
Al Kuwait,8,5,2,1,19,9,10,17,kuwait,0.62,0.38,10,2.38,1.61,2.63,2
Al Salmiyah,8,3,3,2,13,12,1,12,kuwait,0.38,0.62,1,1.62,2.63,1.61,3
Al Qadsia,8,3,2,3,10,10,0,11,kuwait,0.38,0.62,0,1.25,2.63,1.61,4
Al Fahaheel,7,2,3,2,13,13,0,9,kuwait,0.29,0.71,0,1.86,3.45,1.41,5
Al Tadhamon,8,2,1,5,12,17,-5,7,kuwait,0.25,0.75,-5,1.5,4.0,1.33,6
Al Nasar,8,2,1,5,9,15,-6,7,kuwait,0.25,0.75,-6,1.12,4.0,1.33,6
Kazma,8,1,1,6,7,15,-8,4,kuwait,0.12,0.88,-8,0.88,8.33,1.14,7
Yarmouk,8,0,2,6,7,21,-14,2,kuwait,0.0,1.0,-14,0.88,0.0,1.0,8
Khaitan,8,0,1,7,2,15,-13,1,kuwait,0.0,1.0,-13,0.25,0.0,1.0,9
Auda,0,0,0,0,0,0,0,0,latvia,0.0,0.0,0,0.0,0.0,0.0,1
Daugavpils,0,0,0,0,0,0,0,0,latvia,0.0,0.0,0,0.0,0.0,0.0,1
FS Jelgava,0,0,0,0,0,0,0,0,latvia,0.0,0.0,0,0.0,0.0,0.0,1
Grobina,0,0,0,0,0,0,0,0,latvia,0.0,0.0,0,0.0,0.0,0.0,1
Liepaja,0,0,0,0,0,0,0,0,latvia,0.0,0.0,0,0.0,0.0,0.0,1
Metta,0,0,0,0,0,0,0,0,latvia,0.0,0.0,0,0.0,0.0,0.0,1
RFS,0,0,0,0,0,0,0,0,latvia,0.0,0.0,0,0.0,0.0,0.0,1
Riga FC,0,0,0,0,0,0,0,0,latvia,0.0,0.0,0,0.0,0.0,0.0,1
Super Nova,0,0,0,0,0,0,0,0,latvia,0.0,0.0,0,0.0,0.0,0.0,1
Tukums,0,0,0,0,0,0,0,0,latvia,0.0,0.0,0,0.0,0.0,0.0,1
Kauno Zalgiris,1,1,0,0,3,1,2,3,lithuania,1.0,0.0,2,3.0,1.0,0.0,1
Banga,0,0,0,0,0,0,0,0,lithuania,0.0,0.0,0,0.0,0.0,0.0,2
Dainava,0,0,0,0,0,0,0,0,lithuania,0.0,0.0,0,0.0,0.0,0.0,2
Dziugas Telsiai,0,0,0,0,0,0,0,0,lithuania,0.0,0.0,0,0.0,0.0,0.0,2
Hegelmann L.,0,0,0,0,0,0,0,0,lithuania,0.0,0.0,0,0.0,0.0,0.0,2
Panevezys,0,0,0,0,0,0,0,0,lithuania,0.0,0.0,0,0.0,0.0,0.0,2
Riteriai,0,0,0,0,0,0,0,0,lithuania,0.0,0.0,0,0.0,0.0,0.0,2
Siauliai,0,0,0,0,0,0,0,0,lithuania,0.0,0.0,0,0.0,0.0,0.0,2
Suduva,0,0,0,0,0,0,0,0,lithuania,0.0,0.0,0,0.0,0.0,0.0,2
Zalgiris,0,0,0,0,0,0,0,0,lithuania,0.0,0.0,0,0.0,0.0,0.0,2
Riteriai,8,7,0,1,14,4,10,21,lithuania2,0.88,0.12,10,1.75,1.14,8.33,1
Siauliai B,8,5,0,3,21,15,6,15,lithuania2,0.62,0.38,6,2.62,1.61,2.63,2
Babrungas,8,4,2,2,17,8,9,14,lithuania2,0.5,0.5,9,2.12,2.0,2.0,3
Tauras,8,4,2,2,16,11,5,14,lithuania2,0.5,0.5,5,2.0,2.0,2.0,3
Nevezis,8,4,2,2,11,7,4,14,lithuania2,0.5,0.5,4,1.38,2.0,2.0,3
Atmosfera,8,3,4,1,6,5,1,13,lithuania2,0.38,0.62,1,0.75,2.63,1.61,4
Ekranas,8,3,3,2,11,13,-2,12,lithuania2,0.38,0.62,-2,1.38,2.63,1.61,5
Neptuna K.,8,3,1,4,12,13,-1,10,lithuania2,0.38,0.62,-1,1.5,2.63,1.61,6
Panevezys B,8,3,1,4,10,15,-5,10,lithuania2,0.38,0.62,-5,1.25,2.63,1.61,6
BFA Vilnius,8,2,3,3,11,13,-2,9,lithuania2,0.25,0.75,-2,1.38,4.0,1.33,7
Be1 NFA,8,2,3,3,8,11,-3,9,lithuania2,0.25,0.75,-3,1.0,4.0,1.33,7
Kauno Z. B,8,3,0,5,10,20,-10,9,lithuania2,0.38,0.62,-10,1.25,2.63,1.61,7
Garliava,8,2,1,5,8,18,-10,7,lithuania2,0.25,0.75,-10,1.0,4.0,1.33,8
Hegelmann B,8,1,0,7,6,18,-12,3,lithuania2,0.12,0.88,-12,0.75,8.33,1.14,9
Minija,8,0,2,6,6,18,-12,2,lithuania2,0.0,1.0,-12,0.75,0.0,1.0,10
Banga B,8,0,0,8,2,23,-21,0,lithuania2,0.0,1.0,-21,0.25,0.0,1.0,11
Differdange,8,7,0,1,19,4,15,21,luxembourg,0.88,0.12,15,2.38,1.14,8.33,1
UNA Strassen,8,5,3,0,14,4,10,18,luxembourg,0.62,0.38,10,1.75,1.61,2.63,2
Dudelange,8,5,2,1,17,8,9,17,luxembourg,0.62,0.38,9,2.12,1.61,2.63,3
Petange,8,3,3,2,8,5,3,12,luxembourg,0.38,0.62,3,1.0,2.63,1.61,4
Hostert,8,4,0,4,17,16,1,12,luxembourg,0.5,0.5,1,2.12,2.0,2.0,4
Mondorf,8,3,2,3,12,10,2,11,luxembourg,0.38,0.62,2,1.5,2.63,1.61,5
Hesperange,8,2,4,2,11,12,-1,10,luxembourg,0.25,0.75,-1,1.38,4.0,1.33,6
Bettembourg,8,3,1,4,8,10,-2,10,luxembourg,0.38,0.62,-2,1.0,2.63,1.61,6
Niedercorn,8,2,3,3,7,8,-1,9,luxembourg,0.25,0.75,-1,0.88,4.0,1.33,7
Jeunesse Esch,8,2,3,3,7,15,-8,9,luxembourg,0.25,0.75,-8,0.88,4.0,1.33,7
Racing,8,2,2,4,8,8,0,8,luxembourg,0.25,0.75,0,1.0,4.0,1.33,8
V. Rosport,8,2,2,4,11,19,-8,8,luxembourg,0.25,0.75,-8,1.38,4.0,1.33,8
Wiltz,8,2,0,6,7,15,-8,6,luxembourg,0.25,0.75,-8,0.88,4.0,1.33,9
Mondercange,8,1,1,6,7,16,-9,4,luxembourg,0.12,0.88,-9,0.88,8.33,1.14,10
Rodange,8,1,0,7,14,24,-10,3,luxembourg,0.12,0.88,-10,1.75,8.33,1.14,11
Fola Esch,8,0,0,8,8,30,-22,0,luxembourg,0.0,1.0,-22,1.0,0.0,1.0,12
Johor Darul,8,7,1,0,26,4,22,22,malaysia,0.88,0.12,22,3.25,1.14,8.33,1
Selangor,8,5,3,0,13,5,8,18,malaysia,0.62,0.38,8,1.62,1.61,2.63,2
Sabah,8,5,1,2,15,11,4,16,malaysia,0.62,0.38,4,1.88,1.61,2.63,3
Terengganu,8,4,2,2,14,10,4,14,malaysia,0.5,0.5,4,1.75,2.0,2.0,4
Perak,8,3,3,2,13,10,3,12,malaysia,0.38,0.62,3,1.62,2.63,1.61,5
Kuching,8,3,3,2,12,11,1,12,malaysia,0.38,0.62,1,1.5,2.63,1.61,5
Pahang,8,1,5,2,8,10,-2,8,malaysia,0.12,0.88,-2,1.0,8.33,1.14,6
Kuala Lumpur,8,2,2,4,8,12,-4,8,malaysia,0.25,0.75,-4,1.0,4.0,1.33,6
Pulau Pinang,8,2,1,5,13,18,-5,7,malaysia,0.25,0.75,-5,1.62,4.0,1.33,7
Kedah,8,2,1,5,5,20,-15,7,malaysia,0.25,0.75,-15,0.62,4.0,1.33,7
Negeri Sembilan,8,1,3,4,10,16,-6,6,malaysia,0.12,0.88,-6,1.25,8.33,1.14,8
PDRM,8,1,2,5,6,18,-12,5,malaysia,0.12,0.88,-12,0.75,8.33,1.14,9
Kelantan United,8,1,0,7,4,27,-23,3,malaysia,0.12,0.88,-23,0.5,8.33,1.14,10
Birkirkara,8,6,1,1,13,2,11,19,malta,0.75,0.25,11,1.62,1.33,4.0,1
Hamrun Spartans,8,5,2,1,15,6,9,17,malta,0.62,0.38,9,1.88,1.61,2.63,2
Floriana,8,5,2,1,11,5,6,17,malta,0.62,0.38,6,1.38,1.61,2.63,2
Marsaxlokk,8,5,1,2,13,7,6,16,malta,0.62,0.38,6,1.62,1.61,2.63,3
Hibernians,8,5,1,2,15,11,4,16,malta,0.62,0.38,4,1.88,1.61,2.63,3
Zabbar,8,4,1,3,14,9,5,13,malta,0.5,0.5,5,1.75,2.0,2.0,4
Sliema,8,3,2,3,9,6,3,11,malta,0.38,0.62,3,1.12,2.63,1.61,5
Melita,8,2,4,2,11,10,1,10,malta,0.25,0.75,1,1.38,4.0,1.33,6
Gzira Utd,8,2,2,4,9,12,-3,8,malta,0.25,0.75,-3,1.12,4.0,1.33,7
Naxxar Lions,8,1,2,5,8,16,-8,5,malta,0.12,0.88,-8,1.0,8.33,1.14,8
Balzan,8,1,1,6,9,16,-7,4,malta,0.12,0.88,-7,1.12,8.33,1.14,9
Mosta,8,1,0,7,7,17,-10,3,malta,0.12,0.88,-10,0.88,8.33,1.14,10
Cruz Azul,8,6,1,1,19,9,10,19,mexico,0.75,0.25,10,2.38,1.33,4.0,1
Monterrey,8,4,2,2,10,7,3,14,mexico,0.5,0.5,3,1.25,2.0,2.0,2
Tigres,8,4,1,3,13,9,4,13,mexico,0.5,0.5,4,1.62,2.0,2.0,3
Toluca,8,3,3,2,10,9,1,12,mexico,0.38,0.62,1,1.25,2.63,1.61,4
Pumas UNAM,8,3,3,2,6,6,0,12,mexico,0.38,0.62,0,0.75,2.63,1.61,4
Juarez,8,4,0,4,10,18,-8,12,mexico,0.5,0.5,-8,1.25,2.0,2.0,4
Guadalajara,8,3,1,4,9,8,1,10,mexico,0.38,0.62,1,1.12,2.63,1.61,5
CF America,8,2,3,3,12,14,-2,9,mexico,0.25,0.75,-2,1.5,4.0,1.33,6
Tijuana,8,2,3,3,6,12,-6,9,mexico,0.25,0.75,-6,0.75,4.0,1.33,6
Atlas,8,2,2,4,7,16,-9,8,mexico,0.25,0.75,-9,0.88,4.0,1.33,7
A. San Luis,8,2,1,5,7,12,-5,7,mexico,0.25,0.75,-5,0.88,4.0,1.33,8
Club Leon,8,1,3,4,12,18,-6,6,mexico,0.12,0.88,-6,1.5,8.33,1.14,9
Queretaro,8,1,2,5,6,17,-11,5,mexico,0.12,0.88,-11,0.75,8.33,1.14,10
Mazatlan,8,0,4,4,0,7,-7,4,mexico,0.0,1.0,-7,0.0,0.0,1.0,11
Pachuca,8,1,1,6,7,16,-9,4,mexico,0.12,0.88,-9,0.88,8.33,1.14,11
Puebla,8,1,1,6,4,16,-12,4,mexico,0.12,0.88,-12,0.5,8.33,1.14,11
Necaxa,8,0,3,5,7,17,-10,3,mexico,0.0,1.0,-10,0.88,0.0,1.0,12
Santos Laguna,8,0,1,7,5,17,-12,1,mexico,0.0,1.0,-12,0.62,0.0,1.0,13
Club Leon,5,4,1,0,9,5,4,13,mexico2,0.8,0.2,4,1.8,1.25,5.0,1
CF America,4,4,0,0,9,2,7,12,mexico2,1.0,0.0,7,2.25,1.0,0.0,2
Cruz Azul,6,3,1,2,9,7,2,10,mexico2,0.5,0.5,2,1.5,2.0,2.0,3
Necaxa,5,3,0,2,11,5,6,9,mexico2,0.6,0.4,6,2.2,1.67,2.5,4
Toluca,5,2,2,1,13,8,5,8,mexico2,0.4,0.6,5,2.6,2.5,1.67,5
Juarez,5,2,1,2,4,7,-3,7,mexico2,0.4,0.6,-3,0.8,2.5,1.67,6
Pachuca,4,2,0,2,6,6,0,6,mexico2,0.5,0.5,0,1.5,2.0,2.0,7
Monterrey,5,1,2,2,9,9,0,5,mexico2,0.2,0.8,0,1.8,5.0,1.25,8
Puebla,5,1,2,2,7,7,0,5,mexico2,0.2,0.8,0,1.4,5.0,1.25,8
Tigres,4,1,1,2,4,4,0,4,mexico2,0.25,0.75,0,1.0,4.0,1.33,9
Pumas UNAM,4,1,0,3,8,11,-3,3,mexico2,0.25,0.75,-3,2.0,4.0,1.33,10
Mazatlan,4,1,0,3,3,6,-3,3,mexico2,0.25,0.75,-3,0.75,4.0,1.33,10
Atlas,5,0,3,2,2,5,-3,3,mexico2,0.0,1.0,-3,0.4,0.0,1.0,10
A. San Luis,4,1,0,3,3,8,-5,3,mexico2,0.25,0.75,-5,0.75,4.0,1.33,10
Santos Laguna,5,0,1,4,4,8,-4,1,mexico2,0.0,1.0,-4,0.8,0.0,1.0,11
Queretaro,4,0,1,3,2,9,-7,1,mexico2,0.0,1.0,-7,0.5,0.0,1.0,11
Tijuana,4,0,1,3,2,9,-7,1,mexico2,0.0,1.0,-7,0.5,0.0,1.0,11
Guadalajara,4,0,0,4,5,10,-5,0,mexico2,0.0,1.0,-5,1.25,0.0,1.0,12
Khangarid,5,4,0,1,10,4,6,12,mongolia,0.8,0.2,6,2.0,1.25,5.0,1
Erchim,5,3,1,1,14,6,8,10,mongolia,0.6,0.4,8,2.8,1.67,2.5,2
SP Falcons,4,3,0,1,10,1,9,9,mongolia,0.75,0.25,9,2.5,1.33,4.0,3
Deren,4,2,1,1,27,4,23,7,mongolia,0.5,0.5,23,6.75,2.0,2.0,4
FC Ulaanbaatar,4,2,1,1,16,5,11,7,mongolia,0.5,0.5,11,4.0,2.0,2.0,4
Hunters,5,2,1,2,6,10,-4,7,mongolia,0.4,0.6,-4,1.2,2.5,1.67,4
Bayanzurkh S.,6,2,0,4,25,11,14,6,mongolia,0.33,0.67,14,4.17,3.03,1.49,5
Khoromkhon,3,2,0,1,7,6,1,6,mongolia,0.67,0.33,1,2.33,1.49,3.03,5
Khovd,4,1,1,2,13,9,4,4,mongolia,0.25,0.75,4,3.25,4.0,1.33,6
Tuv Buganuud,4,0,0,4,0,48,-48,0,mongolia,0.0,1.0,-48,0.0,0.0,1.0,7
Buducnost,8,7,0,1,20,4,16,21,montenegro,0.88,0.12,16,2.5,1.14,8.33,1
Petrovac,8,5,0,3,11,7,4,15,montenegro,0.62,0.38,4,1.38,1.61,2.63,2
Bokelj,8,4,3,1,9,5,4,15,montenegro,0.5,0.5,4,1.12,2.0,2.0,2
Mornar Bar,8,4,1,3,11,15,-4,13,montenegro,0.5,0.5,-4,1.38,2.0,2.0,3
Arsenal Tivat,8,3,3,2,10,7,3,12,montenegro,0.38,0.62,3,1.25,2.63,1.61,4
Sutjeska,8,3,1,4,6,8,-2,10,montenegro,0.38,0.62,-2,0.75,2.63,1.61,5
Decic,8,1,6,1,8,9,-1,9,montenegro,0.12,0.88,-1,1.0,8.33,1.14,6
Jezero,8,1,2,5,5,10,-5,5,montenegro,0.12,0.88,-5,0.62,8.33,1.14,7
Jedinstvo,8,1,2,5,6,19,-13,5,montenegro,0.12,0.88,-13,0.75,8.33,1.14,7
Otrant,8,0,4,4,2,6,-4,4,montenegro,0.0,1.0,-4,0.25,0.0,1.0,8
Berkane,8,7,1,0,16,3,13,22,morocco,0.88,0.12,13,2.0,1.14,8.33,1
Wydad,8,4,4,0,13,5,8,16,morocco,0.5,0.5,8,1.62,2.0,2.0,2
Maghreb de Fes,8,3,4,1,13,7,6,13,morocco,0.38,0.62,6,1.62,2.63,1.61,3
R. Zemamra,8,4,1,3,6,5,1,13,morocco,0.5,0.5,1,0.75,2.0,2.0,3
FUS Rabat,8,3,2,3,7,6,1,11,morocco,0.38,0.62,1,0.88,2.63,1.61,4
FAR Rabat,8,2,3,3,9,9,0,9,morocco,0.25,0.75,0,1.12,4.0,1.33,5
Difaa El Jadida,8,2,3,3,11,12,-1,9,morocco,0.25,0.75,-1,1.38,4.0,1.33,5
Raja Casablanca,8,2,3,3,6,8,-2,9,morocco,0.25,0.75,-2,0.75,4.0,1.33,5
Moghreb Tetouan,8,2,1,5,6,10,-4,7,morocco,0.25,0.75,-4,0.75,4.0,1.33,6
Olympic Safi,8,1,3,4,8,14,-6,6,morocco,0.12,0.88,-6,1.0,8.33,1.14,7
Meknes,8,1,3,4,7,16,-9,6,morocco,0.12,0.88,-9,0.88,8.33,1.14,7
Ittihad Tanger,8,1,2,5,10,16,-6,5,morocco,0.12,0.88,-6,1.25,8.33,1.14,8
Union Touarga,8,0,3,5,5,11,-6,3,morocco,0.0,1.0,-6,0.62,0.0,1.0,9
C. Mohammedia,8,0,3,5,5,13,-8,3,morocco,0.0,1.0,-8,0.62,0.0,1.0,9
Hassania Agadir,8,0,1,7,3,12,-9,1,morocco,0.0,1.0,-9,0.38,0.0,1.0,10
JS Sousalem,8,0,1,7,2,14,-12,1,morocco,0.0,1.0,-12,0.25,0.0,1.0,10
Shan Utd,8,7,1,0,27,5,22,22,myanmar,0.88,0.12,22,3.38,1.14,8.33,1
Yangon Utd,8,6,2,0,28,7,21,20,myanmar,0.75,0.25,21,3.5,1.33,4.0,2
Dagon,8,5,1,2,16,8,8,16,myanmar,0.62,0.38,8,2.0,1.61,2.63,3
Hantharwady,8,4,2,2,10,8,2,14,myanmar,0.5,0.5,2,1.25,2.0,2.0,4
Thitsar Arman,8,4,1,3,16,14,2,13,myanmar,0.5,0.5,2,2.0,2.0,2.0,5
Ayeyawady,8,3,1,4,12,13,-1,10,myanmar,0.38,0.62,-1,1.5,2.63,1.61,6
Ispe FC,8,2,3,3,10,9,1,9,myanmar,0.25,0.75,1,1.25,4.0,1.33,7
Yadanarbon,8,2,3,3,10,13,-3,9,myanmar,0.25,0.75,-3,1.25,4.0,1.33,7
Sagaing Utd,8,2,1,5,10,16,-6,7,myanmar,0.25,0.75,-6,1.25,4.0,1.33,8
Rakhine Utd,8,2,1,5,13,20,-7,7,myanmar,0.25,0.75,-7,1.62,4.0,1.33,8
Dagon Port,8,0,4,4,13,29,-16,4,myanmar,0.0,1.0,-16,1.62,0.0,1.0,9
Myawady,8,0,1,7,6,18,-12,1,myanmar,0.0,1.0,-12,0.75,0.0,1.0,10
Ajax Amsterdam,8,6,1,1,17,8,9,19,netherlands,0.75,0.25,9,2.12,1.33,4.0,1
FC Utrecht,8,4,4,0,19,12,7,16,netherlands,0.5,0.5,7,2.38,2.0,2.0,2
Feyenoord,8,4,2,2,16,10,6,14,netherlands,0.5,0.5,6,2.0,2.0,2.0,3
AZ Alkmaar,8,4,2,2,12,9,3,14,netherlands,0.5,0.5,3,1.5,2.0,2.0,3
PSV Eindhoven,8,4,1,3,18,13,5,13,netherlands,0.5,0.5,5,2.25,2.0,2.0,4
Willem II,8,3,1,4,7,13,-6,10,netherlands,0.38,0.62,-6,0.88,2.63,1.61,5
Fortuna Sittard,8,2,3,3,14,16,-2,9,netherlands,0.25,0.75,-2,1.75,4.0,1.33,6
FC Twente,8,2,3,3,12,17,-5,9,netherlands,0.25,0.75,-5,1.5,4.0,1.33,6
Go Ahead Eagles,8,2,2,4,13,15,-2,8,netherlands,0.25,0.75,-2,1.62,4.0,1.33,7
NAC Breda,8,2,1,5,9,16,-7,7,netherlands,0.25,0.75,-7,1.12,4.0,1.33,8
PEC Zwolle,8,1,4,3,8,15,-7,7,netherlands,0.12,0.88,-7,1.0,8.33,1.14,8
Heerenveen,8,2,1,5,7,17,-10,7,netherlands,0.25,0.75,-10,0.88,4.0,1.33,8
RKC Waalwijk,8,1,3,4,12,16,-4,6,netherlands,0.12,0.88,-4,1.5,8.33,1.14,9
NEC Nijmegen,8,2,0,6,6,15,-9,6,netherlands,0.25,0.75,-9,0.75,4.0,1.33,9
Sparta,8,1,2,5,4,11,-7,5,netherlands,0.12,0.88,-7,0.5,8.33,1.14,10
Almere City,8,1,2,5,4,13,-9,5,netherlands,0.12,0.88,-9,0.5,8.33,1.14,10
FC Groningen,8,1,1,6,5,19,-14,4,netherlands,0.12,0.88,-14,0.62,8.33,1.14,11
Heracles Almelo,8,1,1,6,6,21,-15,4,netherlands,0.12,0.88,-15,0.75,8.33,1.14,11
Cambuur,8,5,2,1,21,10,11,17,netherlands2,0.62,0.38,11,2.62,1.61,2.63,1
FC Volendam,8,4,3,1,15,10,5,15,netherlands2,0.5,0.5,5,1.88,2.0,2.0,2
FC Dordrecht,8,5,0,3,12,10,2,15,netherlands2,0.62,0.38,2,1.5,1.61,2.63,2
ADO Den Haag,8,4,1,3,17,11,6,13,netherlands2,0.5,0.5,6,2.12,2.0,2.0,3
Excelsior,8,3,3,2,11,7,4,12,netherlands2,0.38,0.62,4,1.38,2.63,1.61,4
VVV,8,4,0,4,11,18,-7,12,netherlands2,0.5,0.5,-7,1.38,2.0,2.0,4
FC Den Bosch,8,3,2,3,7,9,-2,11,netherlands2,0.38,0.62,-2,0.88,2.63,1.61,5
Roda JC,8,3,1,4,14,14,0,10,netherlands2,0.38,0.62,0,1.75,2.63,1.61,6
FC Eindhoven,8,3,1,4,15,17,-2,10,netherlands2,0.38,0.62,-2,1.88,2.63,1.61,6
FC Emmen,8,3,1,4,10,13,-3,10,netherlands2,0.38,0.62,-3,1.25,2.63,1.61,6
Jong AZ,8,2,2,4,10,15,-5,8,netherlands2,0.25,0.75,-5,1.25,4.0,1.33,7
De Graafschap,8,1,3,4,5,12,-7,6,netherlands2,0.12,0.88,-7,0.62,8.33,1.14,8
Telstar,8,2,0,6,6,15,-9,6,netherlands2,0.25,0.75,-9,0.75,4.0,1.33,8
MVV Maastricht,8,1,2,5,10,16,-6,5,netherlands2,0.12,0.88,-6,1.25,8.33,1.14,9
Vitesse Arnhem,8,1,2,5,11,23,-12,5,netherlands2,0.12,0.88,-12,1.38,8.33,1.14,9
Jong PSV,8,1,1,6,7,16,-9,4,netherlands2,0.12,0.88,-9,0.88,8.33,1.14,10
TOP Oss,8,0,4,4,3,12,-9,4,netherlands2,0.0,1.0,-9,0.38,0.0,1.0,10
Jong Utrecht,8,1,1,6,5,20,-15,4,netherlands2,0.12,0.88,-15,0.62,8.33,1.14,10
Jong Ajax,8,1,0,7,6,18,-12,3,netherlands2,0.12,0.88,-12,0.75,8.33,1.14,11
Helmond Sport,8,0,2,6,6,20,-14,2,netherlands2,0.0,1.0,-14,0.75,0.0,1.0,12
Diriangen,8,4,4,0,21,7,14,16,nicaragua,0.5,0.5,14,2.62,2.0,2.0,1
Real Esteli,8,5,1,2,14,9,5,16,nicaragua,0.62,0.38,5,1.75,1.61,2.63,1
Walter Ferreti,8,4,2,2,8,5,3,14,nicaragua,0.5,0.5,3,1.0,2.0,2.0,2
Matagalpa,8,3,3,2,9,7,2,12,nicaragua,0.38,0.62,2,1.12,2.63,1.61,3
Export Sebaco,8,1,4,3,7,10,-3,7,nicaragua,0.12,0.88,-3,0.88,8.33,1.14,4
Managua FC,8,1,3,4,9,15,-6,6,nicaragua,0.12,0.88,-6,1.12,8.33,1.14,5
Jalapa,8,1,2,5,8,21,-13,5,nicaragua,0.12,0.88,-13,1.0,8.33,1.14,6
UNAN Managua,8,1,1,6,7,17,-10,4,nicaragua,0.12,0.88,-10,0.88,8.33,1.14,7
Rancho Santana,8,1,1,6,5,15,-10,4,nicaragua,0.12,0.88,-10,0.62,8.33,1.14,7
D. Ocotal,8,0,2,6,3,24,-21,2,nicaragua,0.0,1.0,-21,0.38,0.0,1.0,8
Diriangen,4,4,0,0,9,0,9,12,nicaragua2,1.0,0.0,9,2.25,1.0,0.0,1
Managua FC,5,2,2,1,6,4,2,8,nicaragua2,0.4,0.6,2,1.2,2.5,1.67,2
Export Sebaco,5,2,1,2,6,6,0,7,nicaragua2,0.4,0.6,0,1.2,2.5,1.67,3
Real Esteli,3,2,0,1,7,4,3,6,nicaragua2,0.67,0.33,3,2.33,1.49,3.03,4
Matagalpa,4,1,1,2,2,4,-2,4,nicaragua2,0.25,0.75,-2,0.5,4.0,1.33,5
Walter Ferreti,5,1,1,3,1,5,-4,4,nicaragua2,0.2,0.8,-4,0.2,5.0,1.25,5
Jalapa,4,1,1,2,6,12,-6,4,nicaragua2,0.25,0.75,-6,1.5,4.0,1.33,5
UNAN Managua,6,0,3,3,4,11,-7,3,nicaragua2,0.0,1.0,-7,0.67,0.0,1.0,6
Rancho Santana,4,0,1,3,1,4,-3,1,nicaragua2,0.0,1.0,-3,0.25,0.0,1.0,7
D. Ocotal,4,0,0,4,3,15,-12,0,nicaragua2,0.0,1.0,-12,0.75,0.0,1.0,8
Linfield,8,5,2,1,13,6,7,17,northernireland,0.62,0.38,7,1.62,1.61,2.63,1
Glentoran,8,5,2,1,14,9,5,17,northernireland,0.62,0.38,5,1.75,1.61,2.63,1
Larne,8,5,0,3,13,8,5,15,northernireland,0.62,0.38,5,1.62,1.61,2.63,2
Coleraine,8,4,2,2,15,10,5,14,northernireland,0.5,0.5,5,1.88,2.0,2.0,3
Dungannon,8,4,1,3,11,10,1,13,northernireland,0.5,0.5,1,1.38,2.0,2.0,4
Crusaders,8,4,1,3,8,7,1,13,northernireland,0.5,0.5,1,1.0,2.0,2.0,4
Portadown,8,2,2,4,9,12,-3,8,northernireland,0.25,0.75,-3,1.12,4.0,1.33,5
Ballymena Utd,8,2,2,4,8,12,-4,8,northernireland,0.25,0.75,-4,1.0,4.0,1.33,5
Glenavon,8,2,2,4,6,10,-4,8,northernireland,0.25,0.75,-4,0.75,4.0,1.33,5
Carrick Rangers,8,1,3,4,6,14,-8,6,northernireland,0.12,0.88,-8,0.75,8.33,1.14,6
Cliftonville,8,1,2,5,7,13,-6,5,northernireland,0.12,0.88,-6,0.88,8.33,1.14,7
Loughgall,8,1,2,5,5,13,-8,5,northernireland,0.12,0.88,-8,0.62,8.33,1.14,7
Annagh Utd,8,4,1,3,16,8,8,13,northernireland2,0.5,0.5,8,2.0,2.0,2.0,1
Bangor,8,4,1,3,14,9,5,13,northernireland2,0.5,0.5,5,1.75,2.0,2.0,1
Dundela,8,4,1,3,15,16,-1,13,northernireland2,0.5,0.5,-1,1.88,2.0,2.0,1
Ards,8,3,3,2,10,11,-1,12,northernireland2,0.38,0.62,-1,1.25,2.63,1.61,2
Armagh City,8,2,5,1,11,9,2,11,northernireland2,0.25,0.75,2,1.38,4.0,1.33,3
Limavady,8,2,4,2,12,10,2,10,northernireland2,0.25,0.75,2,1.5,4.0,1.33,4
HW Welders,8,2,4,2,10,13,-3,10,northernireland2,0.25,0.75,-3,1.25,4.0,1.33,4
Ballyclare,8,3,0,5,9,19,-10,9,northernireland2,0.38,0.62,-10,1.12,2.63,1.61,5
Institute,8,2,2,4,15,17,-2,8,northernireland2,0.25,0.75,-2,1.88,4.0,1.33,6
Ballinamallard,8,2,0,6,10,18,-8,6,northernireland2,0.25,0.75,-8,1.25,4.0,1.33,7
Newington,8,1,2,5,7,15,-8,5,northernireland2,0.12,0.88,-8,0.88,8.33,1.14,8
Newry City,8,1,1,6,5,20,-15,4,northernireland2,0.12,0.88,-15,0.62,8.33,1.14,9
Sileks,8,5,2,1,13,5,8,17,northmacedonia,0.62,0.38,8,1.62,1.61,2.63,1
Gostivar,8,3,4,1,7,4,3,13,northmacedonia,0.38,0.62,3,0.88,2.63,1.61,2
Shkendija,8,3,4,1,6,5,1,13,northmacedonia,0.38,0.62,1,0.75,2.63,1.61,2
Rabotnicki,8,3,3,2,8,5,3,12,northmacedonia,0.38,0.62,3,1.0,2.63,1.61,3
Struga,8,3,3,2,11,9,2,12,northmacedonia,0.38,0.62,2,1.38,2.63,1.61,3
Shkupi,8,3,1,4,10,11,-1,10,northmacedonia,0.38,0.62,-1,1.25,2.63,1.61,4
Vardar,8,2,2,4,5,9,-4,8,northmacedonia,0.25,0.75,-4,0.62,4.0,1.33,5
Brera Strumica,8,2,2,4,8,14,-6,8,northmacedonia,0.25,0.75,-6,1.0,4.0,1.33,5
Pelister,8,2,2,4,6,13,-7,8,northmacedonia,0.25,0.75,-7,0.75,4.0,1.33,5
Tikves,8,0,5,3,4,9,-5,5,northmacedonia,0.0,1.0,-5,0.5,0.0,1.0,6
Voska Sport,8,1,1,6,7,19,-12,4,northmacedonia,0.12,0.88,-12,0.88,8.33,1.14,7
Besa,8,0,3,5,4,13,-9,3,northmacedonia,0.0,1.0,-9,0.5,0.0,1.0,8
Bodo.Glimt,0,0,0,0,0,0,0,0,norway,0.0,0.0,0,0.0,0.0,0.0,1
Brann,0,0,0,0,0,0,0,0,norway,0.0,0.0,0,0.0,0.0,0.0,1
Bryne,0,0,0,0,0,0,0,0,norway,0.0,0.0,0,0.0,0.0,0.0,1
Fredrikstad,0,0,0,0,0,0,0,0,norway,0.0,0.0,0,0.0,0.0,0.0,1
HamKam,0,0,0,0,0,0,0,0,norway,0.0,0.0,0,0.0,0.0,0.0,1
Haugesund,0,0,0,0,0,0,0,0,norway,0.0,0.0,0,0.0,0.0,0.0,1
KFUM Oslo,0,0,0,0,0,0,0,0,norway,0.0,0.0,0,0.0,0.0,0.0,1
Kristiansund,0,0,0,0,0,0,0,0,norway,0.0,0.0,0,0.0,0.0,0.0,1
Molde,0,0,0,0,0,0,0,0,norway,0.0,0.0,0,0.0,0.0,0.0,1
Rosenborg,0,0,0,0,0,0,0,0,norway,0.0,0.0,0,0.0,0.0,0.0,1
Sandefjord,0,0,0,0,0,0,0,0,norway,0.0,0.0,0,0.0,0.0,0.0,1
Sarpsborg 08,0,0,0,0,0,0,0,0,norway,0.0,0.0,0,0.0,0.0,0.0,1
Stromsgodset,0,0,0,0,0,0,0,0,norway,0.0,0.0,0,0.0,0.0,0.0,1
Tromso,0,0,0,0,0,0,0,0,norway,0.0,0.0,0,0.0,0.0,0.0,1
Valerenga,0,0,0,0,0,0,0,0,norway,0.0,0.0,0,0.0,0.0,0.0,1
Viking,0,0,0,0,0,0,0,0,norway,0.0,0.0,0,0.0,0.0,0.0,1
Aalesund,0,0,0,0,0,0,0,0,norway2,0.0,0.0,0,0.0,0.0,0.0,1
Asane,0,0,0,0,0,0,0,0,norway2,0.0,0.0,0,0.0,0.0,0.0,1
Egersund,0,0,0,0,0,0,0,0,norway2,0.0,0.0,0,0.0,0.0,0.0,1
Hodd,0,0,0,0,0,0,0,0,norway2,0.0,0.0,0,0.0,0.0,0.0,1
Kongsvinger,0,0,0,0,0,0,0,0,norway2,0.0,0.0,0,0.0,0.0,0.0,1
Lillestrom,0,0,0,0,0,0,0,0,norway2,0.0,0.0,0,0.0,0.0,0.0,1
Lyn,0,0,0,0,0,0,0,0,norway2,0.0,0.0,0,0.0,0.0,0.0,1
Mjondalen,0,0,0,0,0,0,0,0,norway2,0.0,0.0,0,0.0,0.0,0.0,1
Moss,0,0,0,0,0,0,0,0,norway2,0.0,0.0,0,0.0,0.0,0.0,1
Odd,0,0,0,0,0,0,0,0,norway2,0.0,0.0,0,0.0,0.0,0.0,1
Ranheim,0,0,0,0,0,0,0,0,norway2,0.0,0.0,0,0.0,0.0,0.0,1
Raufoss,0,0,0,0,0,0,0,0,norway2,0.0,0.0,0,0.0,0.0,0.0,1
Skeid,0,0,0,0,0,0,0,0,norway2,0.0,0.0,0,0.0,0.0,0.0,1
Sogndal,0,0,0,0,0,0,0,0,norway2,0.0,0.0,0,0.0,0.0,0.0,1
Stabaek,0,0,0,0,0,0,0,0,norway2,0.0,0.0,0,0.0,0.0,0.0,1
Start,0,0,0,0,0,0,0,0,norway2,0.0,0.0,0,0.0,0.0,0.0,1
Arendal,0,0,0,0,0,0,0,0,norway3,0.0,0.0,0,0.0,0.0,0.0,1
Brann B,0,0,0,0,0,0,0,0,norway3,0.0,0.0,0,0.0,0.0,0.0,1
Brattvag,0,0,0,0,0,0,0,0,norway3,0.0,0.0,0,0.0,0.0,0.0,1
Eik Tonsberg,0,0,0,0,0,0,0,0,norway3,0.0,0.0,0,0.0,0.0,0.0,1
Flekkeroy,0,0,0,0,0,0,0,0,norway3,0.0,0.0,0,0.0,0.0,0.0,1
Jerv,0,0,0,0,0,0,0,0,norway3,0.0,0.0,0,0.0,0.0,0.0,1
Lysekloster,0,0,0,0,0,0,0,0,norway3,0.0,0.0,0,0.0,0.0,0.0,1
Notodden,0,0,0,0,0,0,0,0,norway3,0.0,0.0,0,0.0,0.0,0.0,1
Pors Grenland,0,0,0,0,0,0,0,0,norway3,0.0,0.0,0,0.0,0.0,0.0,1
Sandnes Ulf,0,0,0,0,0,0,0,0,norway3,0.0,0.0,0,0.0,0.0,0.0,1
Sandviken,0,0,0,0,0,0,0,0,norway3,0.0,0.0,0,0.0,0.0,0.0,1
Sotra,0,0,0,0,0,0,0,0,norway3,0.0,0.0,0,0.0,0.0,0.0,1
Traef,0,0,0,0,0,0,0,0,norway3,0.0,0.0,0,0.0,0.0,0.0,1
V. Haugesund,0,0,0,0,0,0,0,0,norway3,0.0,0.0,0,0.0,0.0,0.0,1
Alta,0,0,0,0,0,0,0,0,norway4,0.0,0.0,0,0.0,0.0,0.0,1
Asker,0,0,0,0,0,0,0,0,norway4,0.0,0.0,0,0.0,0.0,0.0,1
Eidsvold,0,0,0,0,0,0,0,0,norway4,0.0,0.0,0,0.0,0.0,0.0,1
Follo,0,0,0,0,0,0,0,0,norway4,0.0,0.0,0,0.0,0.0,0.0,1
Grorud,0,0,0,0,0,0,0,0,norway4,0.0,0.0,0,0.0,0.0,0.0,1
Honefoss,0,0,0,0,0,0,0,0,norway4,0.0,0.0,0,0.0,0.0,0.0,1
Kjelsas,0,0,0,0,0,0,0,0,norway4,0.0,0.0,0,0.0,0.0,0.0,1
Levanger,0,0,0,0,0,0,0,0,norway4,0.0,0.0,0,0.0,0.0,0.0,1
Rana,0,0,0,0,0,0,0,0,norway4,0.0,0.0,0,0.0,0.0,0.0,1
Stjordals-Blink,0,0,0,0,0,0,0,0,norway4,0.0,0.0,0,0.0,0.0,0.0,1
Strindheim,0,0,0,0,0,0,0,0,norway4,0.0,0.0,0,0.0,0.0,0.0,1
Strommen,0,0,0,0,0,0,0,0,norway4,0.0,0.0,0,0.0,0.0,0.0,1
Tromsdalen,0,0,0,0,0,0,0,0,norway4,0.0,0.0,0,0.0,0.0,0.0,1
Ull/Kisa,0,0,0,0,0,0,0,0,norway4,0.0,0.0,0,0.0,0.0,0.0,1
Alta B,0,0,0,0,0,0,0,0,norway5,0.0,0.0,0,0.0,0.0,0.0,1
Baerum,0,0,0,0,0,0,0,0,norway5,0.0,0.0,0,0.0,0.0,0.0,1
Floya,0,0,0,0,0,0,0,0,norway5,0.0,0.0,0,0.0,0.0,0.0,1
Frigg,0,0,0,0,0,0,0,0,norway5,0.0,0.0,0,0.0,0.0,0.0,1
Funnefoss/V.,0,0,0,0,0,0,0,0,norway5,0.0,0.0,0,0.0,0.0,0.0,1
Gamle Oslo,0,0,0,0,0,0,0,0,norway5,0.0,0.0,0,0.0,0.0,0.0,1
Harstad,0,0,0,0,0,0,0,0,norway5,0.0,0.0,0,0.0,0.0,0.0,1
Junkeren,0,0,0,0,0,0,0,0,norway5,0.0,0.0,0,0.0,0.0,0.0,1
KFUM B,0,0,0,0,0,0,0,0,norway5,0.0,0.0,0,0.0,0.0,0.0,1
Skjervoy,0,0,0,0,0,0,0,0,norway5,0.0,0.0,0,0.0,0.0,0.0,1
Sortland,0,0,0,0,0,0,0,0,norway5,0.0,0.0,0,0.0,0.0,0.0,1
Tromso B,0,0,0,0,0,0,0,0,norway5,0.0,0.0,0,0.0,0.0,0.0,1
Ulfstind,0,0,0,0,0,0,0,0,norway5,0.0,0.0,0,0.0,0.0,0.0,1
Ullern,0,0,0,0,0,0,0,0,norway5,0.0,0.0,0,0.0,0.0,0.0,1
Aalesund B,0,0,0,0,0,0,0,0,norway6,0.0,0.0,0,0.0,0.0,0.0,1
Byasen,0,0,0,0,0,0,0,0,norway6,0.0,0.0,0,0.0,0.0,0.0,1
Kristiansund B,0,0,0,0,0,0,0,0,norway6,0.0,0.0,0,0.0,0.0,0.0,1
Kvik Trondheim,0,0,0,0,0,0,0,0,norway6,0.0,0.0,0,0.0,0.0,0.0,1
Melhus,0,0,0,0,0,0,0,0,norway6,0.0,0.0,0,0.0,0.0,0.0,1
Molde B,0,0,0,0,0,0,0,0,norway6,0.0,0.0,0,0.0,0.0,0.0,1
Nardo,0,0,0,0,0,0,0,0,norway6,0.0,0.0,0,0.0,0.0,0.0,1
Ranheim B,0,0,0,0,0,0,0,0,norway6,0.0,0.0,0,0.0,0.0,0.0,1
Rosenborg B,0,0,0,0,0,0,0,0,norway6,0.0,0.0,0,0.0,0.0,0.0,1
Spjelkavik,0,0,0,0,0,0,0,0,norway6,0.0,0.0,0,0.0,0.0,0.0,1
Surnadal,0,0,0,0,0,0,0,0,norway6,0.0,0.0,0,0.0,0.0,0.0,1
Tiller,0,0,0,0,0,0,0,0,norway6,0.0,0.0,0,0.0,0.0,0.0,1
Trygg.Lade,0,0,0,0,0,0,0,0,norway6,0.0,0.0,0,0.0,0.0,0.0,1
Volda,0,0,0,0,0,0,0,0,norway6,0.0,0.0,0,0.0,0.0,0.0,1
Assiden IF,0,0,0,0,0,0,0,0,norway7,0.0,0.0,0,0.0,0.0,0.0,1
Bjorkelangen,0,0,0,0,0,0,0,0,norway7,0.0,0.0,0,0.0,0.0,0.0,1
Elverum,0,0,0,0,0,0,0,0,norway7,0.0,0.0,0,0.0,0.0,0.0,1
Gjovik-Lyn,0,0,0,0,0,0,0,0,norway7,0.0,0.0,0,0.0,0.0,0.0,1
HamKam B,0,0,0,0,0,0,0,0,norway7,0.0,0.0,0,0.0,0.0,0.0,1
Kongsvinger B,0,0,0,0,0,0,0,0,norway7,0.0,0.0,0,0.0,0.0,0.0,1
Lillehammer,0,0,0,0,0,0,0,0,norway7,0.0,0.0,0,0.0,0.0,0.0,1
Lillestrom B,0,0,0,0,0,0,0,0,norway7,0.0,0.0,0,0.0,0.0,0.0,1
Lorenskog,0,0,0,0,0,0,0,0,norway7,0.0,0.0,0,0.0,0.0,0.0,1
Nordstrand,0,0,0,0,0,0,0,0,norway7,0.0,0.0,0,0.0,0.0,0.0,1
Skedsmo,0,0,0,0,0,0,0,0,norway7,0.0,0.0,0,0.0,0.0,0.0,1
Skjetten,0,0,0,0,0,0,0,0,norway7,0.0,0.0,0,0.0,0.0,0.0,1
Stromsgodset B,0,0,0,0,0,0,0,0,norway7,0.0,0.0,0,0.0,0.0,0.0,1
Ull/Kisa B,0,0,0,0,0,0,0,0,norway7,0.0,0.0,0,0.0,0.0,0.0,1
Asane B,0,0,0,0,0,0,0,0,norway8,0.0,0.0,0,0.0,0.0,0.0,1
Askoy,0,0,0,0,0,0,0,0,norway8,0.0,0.0,0,0.0,0.0,0.0,1
Bjarg,0,0,0,0,0,0,0,0,norway8,0.0,0.0,0,0.0,0.0,0.0,1
Fana,0,0,0,0,0,0,0,0,norway8,0.0,0.0,0,0.0,0.0,0.0,1
Fjora,0,0,0,0,0,0,0,0,norway8,0.0,0.0,0,0.0,0.0,0.0,1
Forde,0,0,0,0,0,0,0,0,norway8,0.0,0.0,0,0.0,0.0,0.0,1
Fyllingsdalen,0,0,0,0,0,0,0,0,norway8,0.0,0.0,0,0.0,0.0,0.0,1
Gneist,0,0,0,0,0,0,0,0,norway8,0.0,0.0,0,0.0,0.0,0.0,1
Loddefjord,0,0,0,0,0,0,0,0,norway8,0.0,0.0,0,0.0,0.0,0.0,1
Lyn B,0,0,0,0,0,0,0,0,norway8,0.0,0.0,0,0.0,0.0,0.0,1
Lyngbo,0,0,0,0,0,0,0,0,norway8,0.0,0.0,0,0.0,0.0,0.0,1
OS,0,0,0,0,0,0,0,0,norway8,0.0,0.0,0,0.0,0.0,0.0,1
Sandefjord B,0,0,0,0,0,0,0,0,norway8,0.0,0.0,0,0.0,0.0,0.0,1
Valerenga B,0,0,0,0,0,0,0,0,norway8,0.0,0.0,0,0.0,0.0,0.0,1
Brodd,0,0,0,0,0,0,0,0,norway9,0.0,0.0,0,0.0,0.0,0.0,1
Djerv,0,0,0,0,0,0,0,0,norway9,0.0,0.0,0,0.0,0.0,0.0,1
Haugesund B,0,0,0,0,0,0,0,0,norway9,0.0,0.0,0,0.0,0.0,0.0,1
Hinna,0,0,0,0,0,0,0,0,norway9,0.0,0.0,0,0.0,0.0,0.0,1
Madla,0,0,0,0,0,0,0,0,norway9,0.0,0.0,0,0.0,0.0,0.0,1
Sandnes Ulf B,0,0,0,0,0,0,0,0,norway9,0.0,0.0,0,0.0,0.0,0.0,1
Sola,0,0,0,0,0,0,0,0,norway9,0.0,0.0,0,0.0,0.0,0.0,1
Staal Jorpeland,0,0,0,0,0,0,0,0,norway9,0.0,0.0,0,0.0,0.0,0.0,1
Stord,0,0,0,0,0,0,0,0,norway9,0.0,0.0,0,0.0,0.0,0.0,1
Torvastad,0,0,0,0,0,0,0,0,norway9,0.0,0.0,0,0.0,0.0,0.0,1
Vag,0,0,0,0,0,0,0,0,norway9,0.0,0.0,0,0.0,0.0,0.0,1
Vidar,0,0,0,0,0,0,0,0,norway9,0.0,0.0,0,0.0,0.0,0.0,1
Viking B,0,0,0,0,0,0,0,0,norway9,0.0,0.0,0,0.0,0.0,0.0,1
Vindbjart,0,0,0,0,0,0,0,0,norway9,0.0,0.0,0,0.0,0.0,0.0,1
Drobak-Frogn,0,0,0,0,0,0,0,0,norway10,0.0,0.0,0,0.0,0.0,0.0,1
Flint,0,0,0,0,0,0,0,0,norway10,0.0,0.0,0,0.0,0.0,0.0,1
Fram,0,0,0,0,0,0,0,0,norway10,0.0,0.0,0,0.0,0.0,0.0,1
Fredrikstad B,0,0,0,0,0,0,0,0,norway10,0.0,0.0,0,0.0,0.0,0.0,1
Grei,0,0,0,0,0,0,0,0,norway10,0.0,0.0,0,0.0,0.0,0.0,1
IF Ready,0,0,0,0,0,0,0,0,norway10,0.0,0.0,0,0.0,0.0,0.0,1
Kvik Halden,0,0,0,0,0,0,0,0,norway10,0.0,0.0,0,0.0,0.0,0.0,1
Lokomotiv Oslo,0,0,0,0,0,0,0,0,norway10,0.0,0.0,0,0.0,0.0,0.0,1
Odd B,0,0,0,0,0,0,0,0,norway10,0.0,0.0,0,0.0,0.0,0.0,1
Oppsal,0,0,0,0,0,0,0,0,norway10,0.0,0.0,0,0.0,0.0,0.0,1
Orn Horten,0,0,0,0,0,0,0,0,norway10,0.0,0.0,0,0.0,0.0,0.0,1
Pors Grenland B,0,0,0,0,0,0,0,0,norway10,0.0,0.0,0,0.0,0.0,0.0,1
Sarpsborg 08 B,0,0,0,0,0,0,0,0,norway10,0.0,0.0,0,0.0,0.0,0.0,1
Stabaek B,0,0,0,0,0,0,0,0,norway10,0.0,0.0,0,0.0,0.0,0.0,1
Plaza Amador,4,2,1,1,5,6,-1,7,panama,0.5,0.5,-1,1.25,2.0,2.0,1
San Miguelito,3,2,0,1,4,3,1,6,panama,0.67,0.33,1,1.33,1.49,3.03,2
Alianza,3,1,2,0,5,4,1,5,panama,0.33,0.67,1,1.67,3.03,1.49,3
UMECIT,4,1,2,1,5,4,1,5,panama,0.25,0.75,1,1.25,4.0,1.33,3
San Francisco,4,1,2,1,2,2,0,5,panama,0.25,0.75,0,0.5,4.0,1.33,3
Independiente,4,1,1,2,5,6,-1,4,panama,0.25,0.75,-1,1.25,4.0,1.33,4
Universitario,2,0,2,0,0,0,0,2,panama,0.0,1.0,0,0.0,0.0,1.0,5
Costa del Este,3,0,2,1,3,4,-1,2,panama,0.0,1.0,-1,1.0,0.0,1.0,5
Arabe Unido,3,0,2,1,2,3,-1,2,panama,0.0,1.0,-1,0.67,0.0,1.0,5
Veraguas,4,0,2,2,3,9,-6,2,panama,0.0,1.0,-6,0.75,0.0,1.0,5
Tauro,4,0,1,3,2,5,-3,1,panama,0.0,1.0,-3,0.5,0.0,1.0,6
Herrera,4,0,1,3,2,6,-4,1,panama,0.0,1.0,-4,0.5,0.0,1.0,6
Independiente,8,4,2,2,12,9,3,14,panama2,0.5,0.5,3,1.5,2.0,2.0,1
San Miguelito,8,3,3,2,5,4,1,12,panama2,0.38,0.62,1,0.62,2.63,1.61,2
Plaza Amador,8,2,5,1,8,7,1,11,panama2,0.25,0.75,1,1.0,4.0,1.33,3
Veraguas,7,3,1,3,11,12,-1,10,panama2,0.43,0.57,-1,1.57,2.33,1.75,4
Tauro,8,3,1,4,7,10,-3,10,panama2,0.38,0.62,-3,0.88,2.63,1.61,4
Universitario,8,3,1,4,6,9,-3,10,panama2,0.38,0.62,-3,0.75,2.63,1.61,4
Arabe Unido,8,2,3,3,6,5,1,9,panama2,0.25,0.75,1,0.75,4.0,1.33,5
UMECIT,8,2,3,3,6,7,-1,9,panama2,0.25,0.75,-1,0.75,4.0,1.33,5
Alianza,7,2,1,4,7,10,-3,7,panama2,0.29,0.71,-3,1.0,3.45,1.41,6
San Francisco,8,1,3,4,8,11,-3,6,panama2,0.12,0.88,-3,1.0,8.33,1.14,7
Costa del Este,8,0,4,4,3,11,-8,4,panama2,0.0,1.0,-8,0.38,0.0,1.0,8
Herrera,8,0,2,6,5,12,-7,2,panama2,0.0,1.0,-7,0.62,0.0,1.0,9
Libertad,4,3,1,0,8,3,5,10,paraguay,0.75,0.25,5,2.0,1.33,4.0,1
Guarani,3,3,0,0,5,1,4,9,paraguay,1.0,0.0,4,1.67,1.0,0.0,2
2 de Mayo,3,1,2,0,3,1,2,5,paraguay,0.33,0.67,2,1.0,3.03,1.49,3
Olimpia,2,1,1,0,3,2,1,4,paraguay,0.5,0.5,1,1.5,2.0,2.0,4
D. Recoleta,4,1,1,2,8,10,-2,4,paraguay,0.25,0.75,-2,2.0,4.0,1.33,4
S. Ameliano,4,1,1,2,3,5,-2,4,paraguay,0.25,0.75,-2,0.75,4.0,1.33,4
A. Tembetary,3,0,2,1,2,5,-3,2,paraguay,0.0,1.0,-3,0.67,0.0,1.0,5
S. Trinidense,2,0,1,1,4,6,-2,1,paraguay,0.0,1.0,-2,2.0,0.0,1.0,6
Cerro Porteno,3,0,1,2,2,4,-2,1,paraguay,0.0,1.0,-2,0.67,0.0,1.0,6
G. Caballero,3,0,1,2,1,3,-2,1,paraguay,0.0,1.0,-2,0.33,0.0,1.0,6
Nacional,4,0,1,3,2,6,-4,1,paraguay,0.0,1.0,-4,0.5,0.0,1.0,6
S. Luqueno,3,0,0,3,0,7,-7,0,paraguay,0.0,1.0,-7,0.0,0.0,1.0,7
Guarani,8,4,3,1,9,5,4,15,paraguay2,0.5,0.5,4,1.12,2.0,2.0,1
S. Ameliano,8,4,2,2,12,5,7,14,paraguay2,0.5,0.5,7,1.5,2.0,2.0,2
Olimpia,8,4,2,2,5,4,1,14,paraguay2,0.5,0.5,1,0.62,2.0,2.0,2
2 de Mayo,8,3,3,2,10,7,3,12,paraguay2,0.38,0.62,3,1.25,2.63,1.61,3
G. Caballero,8,3,2,3,7,6,1,11,paraguay2,0.38,0.62,1,0.88,2.63,1.61,4
Sol de America,8,2,3,3,9,8,1,9,paraguay2,0.25,0.75,1,1.12,4.0,1.33,5
S. Luqueno,8,2,3,3,14,14,0,9,paraguay2,0.25,0.75,0,1.75,4.0,1.33,5
Libertad,8,2,2,4,8,12,-4,8,paraguay2,0.25,0.75,-4,1.0,4.0,1.33,6
Cerro Porteno,8,2,1,5,7,12,-5,7,paraguay2,0.25,0.75,-5,0.88,4.0,1.33,7
Nacional,8,1,3,4,8,10,-2,6,paraguay2,0.12,0.88,-2,1.0,8.33,1.14,8
Tacuary,8,1,2,5,7,12,-5,5,paraguay2,0.12,0.88,-5,0.88,8.33,1.14,9
S. Trinidense,8,0,4,4,5,9,-4,4,paraguay2,0.0,1.0,-4,0.62,0.0,1.0,10
ADT,2,1,1,0,5,4,1,4,peru,0.5,0.5,1,2.5,2.0,2.0,1
D. Garcilaso,2,1,1,0,5,4,1,4,peru,0.5,0.5,1,2.5,2.0,2.0,1
S. Cristal,2,1,1,0,3,2,1,4,peru,0.5,0.5,1,1.5,2.0,2.0,1
Binacional,1,1,0,0,4,0,4,3,peru,1.0,0.0,4,4.0,1.0,0.0,2
FBC Melgar,1,1,0,0,1,0,1,3,peru,1.0,0.0,1,1.0,1.0,0.0,2
Sport Huancayo,1,1,0,0,1,0,1,3,peru,1.0,0.0,1,1.0,1.0,0.0,2
Cusco,2,1,0,1,2,4,-2,3,peru,0.5,0.5,-2,1.0,2.0,2.0,2
Los Chankas,1,0,1,0,1,1,0,1,peru,0.0,1.0,0,1.0,0.0,1.0,3
Universitario,1,0,1,0,1,1,0,1,peru,0.0,1.0,0,1.0,0.0,1.0,3
Sport Boys,2,0,1,1,3,4,-1,1,peru,0.0,1.0,-1,1.5,0.0,1.0,3
A. Huanuco,1,0,0,1,2,3,-1,0,peru,0.0,1.0,-1,2.0,0.0,1.0,4
Cienciano,1,0,0,1,2,3,-1,0,peru,0.0,1.0,-1,2.0,0.0,1.0,4
Comerciantes U.,1,0,0,1,1,2,-1,0,peru,0.0,1.0,-1,1.0,0.0,1.0,4
Alianza A.,2,0,0,2,2,4,-2,0,peru,0.0,1.0,-2,1.0,0.0,1.0,4
Alianza Lima,1,0,0,1,1,3,-2,0,peru,0.0,1.0,-2,1.0,0.0,1.0,4
Ayacucho,2,0,0,2,1,3,-2,0,peru,0.0,1.0,-2,0.5,0.0,1.0,4
Juan Pablo II C,2,0,0,2,0,2,-2,0,peru,0.0,1.0,-2,0.0,0.0,1.0,4
Atletico Grau,2,0,0,2,3,6,-3,0,peru,0.0,1.0,-3,1.5,0.0,1.0,4
Cajamarca,1,0,0,1,0,3,-3,0,peru,0.0,1.0,-3,0.0,0.0,1.0,4
Alianza Lima,8,5,1,2,11,5,6,16,peru2,0.62,0.38,6,1.38,1.61,2.63,1
Atletico Grau,8,4,3,1,9,5,4,15,peru2,0.5,0.5,4,1.12,2.0,2.0,2
Cusco,8,4,2,2,14,13,1,14,peru2,0.5,0.5,1,1.75,2.0,2.0,3
Alianza A.,8,3,3,2,7,9,-2,12,peru2,0.38,0.62,-2,0.88,2.63,1.61,4
Universitario,8,2,4,2,9,6,3,10,peru2,0.25,0.75,3,1.12,4.0,1.33,5
S. Cristal,8,2,3,3,20,12,8,9,peru2,0.25,0.75,8,2.5,4.0,1.33,6
FBC Melgar,8,2,3,3,12,13,-1,9,peru2,0.25,0.75,-1,1.5,4.0,1.33,6
Sport Huancayo,8,2,2,4,8,13,-5,8,peru2,0.25,0.75,-5,1.0,4.0,1.33,7
ADT,8,1,4,3,5,7,-2,7,peru2,0.12,0.88,-2,0.62,8.33,1.14,8
Carlos Manucci,8,2,1,5,10,13,-3,7,peru2,0.25,0.75,-3,1.25,4.0,1.33,8
Cienciano,8,2,1,5,8,18,-10,7,peru2,0.25,0.75,-10,1.0,4.0,1.33,8
D. Garcilaso,8,1,2,5,7,11,-4,5,peru2,0.12,0.88,-4,0.88,8.33,1.14,9
Sport Boys,8,1,2,5,5,13,-8,5,peru2,0.12,0.88,-8,0.62,8.33,1.14,9
Cajamarca,8,0,3,5,3,15,-12,3,peru2,0.0,1.0,-12,0.38,0.0,1.0,10
Los Chankas,8,0,2,6,5,13,-8,2,peru2,0.0,1.0,-8,0.62,0.0,1.0,11
Comerciantes U.,8,0,1,7,5,19,-14,1,peru2,0.0,1.0,-14,0.62,0.0,1.0,12
Union Comercio,8,0,1,7,2,18,-16,1,peru2,0.0,1.0,-16,0.25,0.0,1.0,12
Cesar Vallejo,8,0,0,8,6,20,-14,0,peru2,0.0,1.0,-14,0.75,0.0,1.0,13
Manila Digger,6,6,0,0,27,2,25,18,philippines,1.0,0.0,25,4.5,1.0,0.0,1
Stallion,5,5,0,0,16,3,13,15,philippines,1.0,0.0,13,3.2,1.0,0.0,2
Davao Aguilas,6,5,0,1,11,3,8,15,philippines,0.83,0.17,8,1.83,1.2,5.88,2
One Taguig,5,4,1,0,12,3,9,13,philippines,0.8,0.2,9,2.4,1.25,5.0,3
Kaya FC,5,4,1,0,11,4,7,13,philippines,0.8,0.2,7,2.2,1.25,5.0,3
Loyola,6,4,0,2,10,9,1,12,philippines,0.67,0.33,1,1.67,1.49,3.03,4
DH Cebu,6,3,1,2,15,9,6,10,philippines,0.5,0.5,6,2.5,2.0,2.0,5
Maharlika,5,2,1,2,7,6,1,7,philippines,0.4,0.6,1,1.4,2.5,1.67,6
Mendiola,8,1,1,6,8,36,-28,4,philippines,0.12,0.88,-28,1.0,8.33,1.14,7
PFF Development,8,0,1,7,2,27,-25,1,philippines,0.0,1.0,-25,0.25,0.0,1.0,8
Rakow C.,8,5,3,0,11,5,6,18,poland,0.62,0.38,6,1.38,1.61,2.63,1
Jagiellonia,8,4,3,1,13,7,6,15,poland,0.5,0.5,6,1.62,2.0,2.0,2
Cracovia Krakow,8,4,2,2,13,10,3,14,poland,0.5,0.5,3,1.62,2.0,2.0,3
Lech Poznan,8,4,1,3,9,7,2,13,poland,0.5,0.5,2,1.12,2.0,2.0,4
Piast Gliwice,8,3,2,3,7,5,2,11,poland,0.38,0.62,2,0.88,2.63,1.61,5
Pogon Szczecin,8,3,1,4,13,11,2,10,poland,0.38,0.62,2,1.62,2.63,1.61,6
Katowice,8,3,1,4,16,17,-1,10,poland,0.38,0.62,-1,2.0,2.63,1.61,6
Gornik Zabrze,8,3,1,4,10,11,-1,10,poland,0.38,0.62,-1,1.25,2.63,1.61,6
Korona Kielce,8,2,4,2,7,11,-4,10,poland,0.25,0.75,-4,0.88,4.0,1.33,6
Motor Lublin,8,3,1,4,11,17,-6,10,poland,0.38,0.62,-6,1.38,2.63,1.61,6
Lechia Gdansk,8,2,3,3,13,14,-1,9,poland,0.25,0.75,-1,1.62,4.0,1.33,7
Legia Warsaw,8,2,2,4,11,13,-2,8,poland,0.25,0.75,-2,1.38,4.0,1.33,8
Zaglebie Lubin,8,2,2,4,8,15,-7,8,poland,0.25,0.75,-7,1.0,4.0,1.33,8
Puszcza Niepolo,8,2,1,5,5,11,-6,7,poland,0.25,0.75,-6,0.62,4.0,1.33,9
Widzew Lodz,8,1,3,4,10,18,-8,6,poland,0.12,0.88,-8,1.25,8.33,1.14,10
Radomiak Radom,8,2,0,6,6,14,-8,6,poland,0.25,0.75,-8,0.75,4.0,1.33,10
Stal Mielec,8,1,2,5,8,13,-5,5,poland,0.12,0.88,-5,1.0,8.33,1.14,11
Slask Wroclaw,8,0,3,5,4,12,-8,3,poland,0.0,1.0,-8,0.5,0.0,1.0,12
Miedz Legnica,8,6,2,0,14,4,10,20,poland2,0.75,0.25,10,1.75,1.33,4.0,1
T. Nieciecza,8,6,1,1,15,5,10,19,poland2,0.75,0.25,10,1.88,1.33,4.0,2
Arka Gdynia,8,5,2,1,16,6,10,17,poland2,0.62,0.38,10,2.0,1.61,2.63,3
Wisla Krakow,8,5,1,2,21,8,13,16,poland2,0.62,0.38,13,2.62,1.61,2.63,4
LKS Lodz,8,4,3,1,19,12,7,15,poland2,0.5,0.5,7,2.38,2.0,2.0,5
Ruch Chorzow,8,4,1,3,8,9,-1,13,poland2,0.5,0.5,-1,1.0,2.0,2.0,6
Wisla Plock,8,3,3,2,11,10,1,12,poland2,0.38,0.62,1,1.38,2.63,1.61,7
Tychy,8,3,3,2,11,11,0,12,poland2,0.38,0.62,0,1.38,2.63,1.61,7
Gornik Leczna,8,2,4,2,13,11,2,10,poland2,0.25,0.75,2,1.62,4.0,1.33,8
Znicz Pruszkow,8,2,4,2,8,11,-3,10,poland2,0.25,0.75,-3,1.0,4.0,1.33,8
Polonia Warszaw,8,2,3,3,9,11,-2,9,poland2,0.25,0.75,-2,1.12,4.0,1.33,9
Warta Poznan,8,2,3,3,4,9,-5,9,poland2,0.25,0.75,-5,0.5,4.0,1.33,9
Stal Rzeszow,8,1,5,2,12,12,0,8,poland2,0.12,0.88,0,1.5,8.33,1.14,10
Odra Opole,8,2,2,4,6,19,-13,8,poland2,0.25,0.75,-13,0.75,4.0,1.33,10
Stalowa Wola,8,1,3,4,4,13,-9,6,poland2,0.12,0.88,-9,0.5,8.33,1.14,11
Pogon Siedlce,8,1,1,6,7,14,-7,4,poland2,0.12,0.88,-7,0.88,8.33,1.14,12
Chrobry Glogow,8,1,0,7,6,20,-14,3,poland2,0.12,0.88,-14,0.75,8.33,1.14,13
K. Kolobrzeg,8,0,1,7,4,21,-17,1,poland2,0.0,1.0,-17,0.5,0.0,1.0,14
Pogon Grodzisk,8,6,2,0,18,5,13,20,poland3,0.75,0.25,13,2.25,1.33,4.0,1
Wieczysta K.,8,6,1,1,20,5,15,19,poland3,0.75,0.25,15,2.5,1.33,4.0,2
Polonia Bytom,8,4,2,2,13,10,3,14,poland3,0.5,0.5,3,1.62,2.0,2.0,3
LKS Lodz B,8,4,1,3,11,12,-1,13,poland3,0.5,0.5,-1,1.38,2.0,2.0,4
Podbeskidzie,8,3,2,3,14,12,2,11,poland3,0.38,0.62,2,1.75,2.63,1.61,5
Rekord Bielsko,8,3,2,3,18,18,0,11,poland3,0.38,0.62,0,2.25,2.63,1.61,5
Chojniczanka,8,3,2,3,7,8,-1,11,poland3,0.38,0.62,-1,0.88,2.63,1.61,5
Kalisz,8,3,2,3,5,7,-2,11,poland3,0.38,0.62,-2,0.62,2.63,1.61,5
Z. Sosnowiec,8,2,3,3,7,9,-2,9,poland3,0.25,0.75,-2,0.88,4.0,1.33,6
Hutnik Krakow,8,2,3,3,9,17,-8,9,poland3,0.25,0.75,-8,1.12,4.0,1.33,6
Jastrzebie,8,2,2,4,7,8,-1,8,poland3,0.25,0.75,-1,0.88,4.0,1.33,7
O. Grudziadz,8,2,2,4,10,12,-2,8,poland3,0.25,0.75,-2,1.25,4.0,1.33,7
Resovia Rzeszow,8,2,1,5,10,15,-5,7,poland3,0.25,0.75,-5,1.25,4.0,1.33,8
Swit Skolwin,8,1,3,4,7,14,-7,6,poland3,0.12,0.88,-7,0.88,8.33,1.14,9
Wisla Pulawy,8,2,0,6,10,21,-11,6,poland3,0.25,0.75,-11,1.25,4.0,1.33,9
SKRA Czestochow,8,1,1,6,5,18,-13,4,poland3,0.12,0.88,-13,0.62,8.33,1.14,10
Zaglebie L. B,8,0,3,5,11,19,-8,3,poland3,0.0,1.0,-8,1.38,0.0,1.0,11
Olimpia Elblag,8,0,1,7,6,22,-16,1,poland3,0.0,1.0,-16,0.75,0.0,1.0,12
Sporting Braga,8,6,1,1,11,5,6,19,portugal,0.75,0.25,6,1.38,1.33,4.0,1
Benfica,8,5,1,2,12,8,4,16,portugal,0.62,0.38,4,1.5,1.61,2.63,2
Sporting CP,8,3,4,1,18,11,7,13,portugal,0.38,0.62,7,2.25,2.63,1.61,3
Famalicao,8,3,3,2,13,13,0,12,portugal,0.38,0.62,0,1.62,2.63,1.61,4
FC Porto,8,3,2,3,14,12,2,11,portugal,0.38,0.62,2,1.75,2.63,1.61,5
Santa Clara,8,3,2,3,6,7,-1,11,portugal,0.38,0.62,-1,0.75,2.63,1.61,5
Estoril,8,3,2,3,13,17,-4,11,portugal,0.38,0.62,-4,1.62,2.63,1.61,5
Casa Pia,8,3,1,4,12,14,-2,10,portugal,0.38,0.62,-2,1.5,2.63,1.61,6
Arouca,8,2,3,3,12,15,-3,9,portugal,0.25,0.75,-3,1.5,4.0,1.33,7
Farense,8,1,5,2,7,10,-3,8,portugal,0.12,0.88,-3,0.88,8.33,1.14,8
Rio Ave,8,2,2,4,7,12,-5,8,portugal,0.25,0.75,-5,0.88,4.0,1.33,8
AVS,8,0,6,2,5,9,-4,6,portugal,0.0,1.0,-4,0.62,0.0,1.0,9
Guimaraes,8,0,5,3,7,10,-3,5,portugal,0.0,1.0,-3,0.88,0.0,1.0,10
Estrela Amadora,8,1,2,5,3,13,-10,5,portugal,0.12,0.88,-10,0.38,8.33,1.14,10
Boavista,8,1,2,5,7,18,-11,5,portugal,0.12,0.88,-11,0.88,8.33,1.14,10
Moreirense,8,1,1,6,8,13,-5,4,portugal,0.12,0.88,-5,1.0,8.33,1.14,11
Nacional,8,1,1,6,6,12,-6,4,portugal,0.12,0.88,-6,0.75,8.33,1.14,11
Gil Vicente,8,1,1,6,5,14,-9,4,portugal,0.12,0.88,-9,0.62,8.33,1.14,11
Chaves,8,4,3,1,10,6,4,15,portugal2,0.5,0.5,4,1.25,2.0,2.0,1
Torreense,8,3,4,1,10,6,4,13,portugal2,0.38,0.62,4,1.25,2.63,1.61,2
Uniao de Leiria,8,4,0,4,16,10,6,12,portugal2,0.5,0.5,6,2.0,2.0,2.0,3
Alverca,8,3,2,3,12,9,3,11,portugal2,0.38,0.62,3,1.5,2.63,1.61,4
Pacos Ferreira,8,3,2,3,9,8,1,11,portugal2,0.38,0.62,1,1.12,2.63,1.61,4
Penafiel,8,3,2,3,10,13,-3,11,portugal2,0.38,0.62,-3,1.25,2.63,1.61,4
Vizela,8,2,4,2,14,12,2,10,portugal2,0.25,0.75,2,1.75,4.0,1.33,5
Portimonense,8,3,1,4,6,10,-4,10,portugal2,0.38,0.62,-4,0.75,2.63,1.61,5
Tondela,8,1,6,1,11,10,1,9,portugal2,0.12,0.88,1,1.38,8.33,1.14,6
Benfica B,8,2,3,3,9,10,-1,9,portugal2,0.25,0.75,-1,1.12,4.0,1.33,6
Feirense,8,2,3,3,4,5,-1,9,portugal2,0.25,0.75,-1,0.5,4.0,1.33,6
Academico Viseu,8,2,2,4,11,13,-2,8,portugal2,0.25,0.75,-2,1.38,4.0,1.33,7
Oliveirense,8,2,2,4,7,11,-4,8,portugal2,0.25,0.75,-4,0.88,4.0,1.33,7
Maritimo,8,2,2,4,10,15,-5,8,portugal2,0.25,0.75,-5,1.25,4.0,1.33,7
Felgueiras,8,1,2,5,10,14,-4,5,portugal2,0.12,0.88,-4,1.25,8.33,1.14,8
Mafra,8,0,2,6,5,12,-7,2,portugal2,0.0,1.0,-7,0.62,0.0,1.0,9
FC Porto B,8,0,2,6,5,14,-9,2,portugal2,0.0,1.0,-9,0.62,0.0,1.0,9
Leixoes,8,0,2,6,2,13,-11,2,portugal2,0.0,1.0,-11,0.25,0.0,1.0,9
Al Sadd,8,6,1,1,24,11,13,19,qatar,0.75,0.25,13,3.0,1.33,4.0,1
Al Duhail,8,5,1,2,17,7,10,16,qatar,0.62,0.38,10,2.12,1.61,2.63,2
Al Ahli Doha,8,4,2,2,15,12,3,14,qatar,0.5,0.5,3,1.88,2.0,2.0,3
Qatar SC,8,4,1,3,13,15,-2,13,qatar,0.5,0.5,-2,1.62,2.0,2.0,4
Al Rayyan,8,4,0,4,18,12,6,12,qatar,0.5,0.5,6,2.25,2.0,2.0,5
Al Gharafa,8,3,3,2,14,12,2,12,qatar,0.38,0.62,2,1.75,2.63,1.61,5
Al Shamal,8,3,2,3,10,9,1,11,qatar,0.38,0.62,1,1.25,2.63,1.61,6
Al Wakrah,8,3,1,4,12,15,-3,10,qatar,0.38,0.62,-3,1.5,2.63,1.61,7
Umm Salal,8,2,1,5,11,17,-6,7,qatar,0.25,0.75,-6,1.38,4.0,1.33,8
Al Shahaniya,8,2,0,6,13,20,-7,6,qatar,0.25,0.75,-7,1.62,4.0,1.33,9
Al Khor,8,1,2,5,7,14,-7,5,qatar,0.12,0.88,-7,0.88,8.33,1.14,10
Al Arabi,8,1,2,5,14,25,-11,5,qatar,0.12,0.88,-11,1.75,8.33,1.14,10
FCSB,8,5,2,1,12,4,8,17,romania,0.62,0.38,8,1.5,1.61,2.63,1
Din. Bucharest,8,4,3,1,11,6,5,15,romania,0.5,0.5,5,1.38,2.0,2.0,2
Hermannstadt,8,4,1,3,11,10,1,13,romania,0.5,0.5,1,1.38,2.0,2.0,3
Univ. Craiova,8,3,3,2,11,9,2,12,romania,0.38,0.62,2,1.38,2.63,1.61,4
UTA Arad,8,3,3,2,5,5,0,12,romania,0.38,0.62,0,0.62,2.63,1.61,4
CFR Cluj,8,2,5,1,13,9,4,11,romania,0.25,0.75,4,1.62,4.0,1.33,5
Farul Constanta,8,2,4,2,7,7,0,10,romania,0.25,0.75,0,0.88,4.0,1.33,6
U. Cluj,8,2,3,3,6,7,-1,9,romania,0.25,0.75,-1,0.75,4.0,1.33,7
Sepsi OSK,8,2,3,3,11,14,-3,9,romania,0.25,0.75,-3,1.38,4.0,1.33,7
Rapid Bucharest,8,1,4,3,6,9,-3,7,romania,0.12,0.88,-3,0.75,8.33,1.14,8
Petrolul,8,1,4,3,6,11,-5,7,romania,0.12,0.88,-5,0.75,8.33,1.14,8
Otelul,8,2,0,6,6,11,-5,6,romania,0.25,0.75,-5,0.75,4.0,1.33,9
Unirea Slobozia,8,2,0,6,10,17,-7,6,romania,0.25,0.75,-7,1.25,4.0,1.33,9
Botosani,8,1,2,5,4,9,-5,5,romania,0.12,0.88,-5,0.5,8.33,1.14,10
P. Iasi,8,0,3,5,6,16,-10,3,romania,0.0,1.0,-10,0.75,0.0,1.0,11
FC Buzau,8,0,0,8,5,15,-10,0,romania,0.0,1.0,-10,0.62,0.0,1.0,12
Zenit,8,6,1,1,17,4,13,19,russia,0.75,0.25,13,2.12,1.33,4.0,1
CSKA Moscow,8,6,1,1,13,5,8,19,russia,0.75,0.25,8,1.62,1.33,4.0,1
FC Krasnodar,8,5,3,0,17,6,11,18,russia,0.62,0.38,11,2.12,1.61,2.63,2
Spartak Moscow,8,4,2,2,12,7,5,14,russia,0.5,0.5,5,1.5,2.0,2.0,3
Dinamo Moscow,8,3,4,1,15,10,5,13,russia,0.38,0.62,5,1.88,2.63,1.61,4
Rubin Kazan,8,3,3,2,10,9,1,12,russia,0.38,0.62,1,1.25,2.63,1.61,5
Lokomotiv M.,8,3,3,2,12,12,0,12,russia,0.38,0.62,0,1.5,2.63,1.61,5
Krylya Sovetov,8,2,2,4,9,12,-3,8,russia,0.25,0.75,-3,1.12,4.0,1.33,6
Rostov,8,2,2,4,9,17,-8,8,russia,0.25,0.75,-8,1.12,4.0,1.33,6
Nizhny Novgorod,8,2,2,4,8,16,-8,8,russia,0.25,0.75,-8,1.0,4.0,1.33,6
Akron,8,2,2,4,6,15,-9,8,russia,0.25,0.75,-9,0.75,4.0,1.33,6
Makhachkala,8,1,4,3,3,7,-4,7,russia,0.12,0.88,-4,0.38,8.33,1.14,7
Khimki,8,1,3,4,9,19,-10,6,russia,0.12,0.88,-10,1.12,8.33,1.14,8
Akhmat Grozny,8,1,2,5,6,14,-8,5,russia,0.12,0.88,-8,0.75,8.33,1.14,9
Fakel Voronezh,8,1,2,5,6,16,-10,5,russia,0.12,0.88,-10,0.75,8.33,1.14,9
Orenburg,8,0,1,7,3,13,-10,1,russia,0.0,1.0,-10,0.38,0.0,1.0,10
Baltika,8,6,0,2,12,7,5,18,russia2,0.75,0.25,5,1.5,1.33,4.0,1
Chernomorets,8,5,1,2,13,11,2,16,russia2,0.62,0.38,2,1.62,1.61,2.63,2
Torpedo Moscow,8,3,4,1,11,8,3,13,russia2,0.38,0.62,3,1.38,2.63,1.61,3
Rotor Volgograd,8,3,3,2,8,8,0,12,russia2,0.38,0.62,0,1.0,2.63,1.61,4
PFC Sochi,8,2,5,1,11,10,1,11,russia2,0.25,0.75,1,1.38,4.0,1.33,5
Ural,8,3,2,3,10,10,0,11,russia2,0.38,0.62,0,1.25,2.63,1.61,5
Shinnik,8,1,5,2,5,8,-3,8,russia2,0.12,0.88,-3,0.62,8.33,1.14,6
Chayka,8,2,2,4,4,12,-8,8,russia2,0.25,0.75,-8,0.5,4.0,1.33,6
SKA Khabarovsk,8,1,4,3,7,12,-5,7,russia2,0.12,0.88,-5,0.88,8.33,1.14,7
Neftekhimik,8,1,3,4,6,8,-2,6,russia2,0.12,0.88,-2,0.75,8.33,1.14,8
Arsenal Tula,8,0,6,2,7,10,-3,6,russia2,0.0,1.0,-3,0.88,0.0,1.0,8
Rodina Moskva,8,1,3,4,6,10,-4,6,russia2,0.12,0.88,-4,0.75,8.33,1.14,8
Kamaz,8,1,2,5,5,9,-4,5,russia2,0.12,0.88,-4,0.62,8.33,1.14,9
Ufa,8,1,2,5,5,12,-7,5,russia2,0.12,0.88,-7,0.62,8.33,1.14,9
A. Vladikavkaz,8,1,2,5,2,11,-9,5,russia2,0.12,0.88,-9,0.25,8.33,1.14,9
Sokol Saratov,8,1,2,5,4,17,-13,5,russia2,0.12,0.88,-13,0.5,8.33,1.14,9
Yenisey,8,1,1,6,7,17,-10,4,russia2,0.12,0.88,-10,0.88,8.33,1.14,10
Tyumen,8,1,0,7,5,15,-10,3,russia2,0.12,0.88,-10,0.62,8.33,1.14,11
Al Quadisiya,8,6,1,1,17,8,9,19,saudiarabia,0.75,0.25,9,2.12,1.33,4.0,1
Al Ahli Jeddah,8,6,0,2,14,7,7,18,saudiarabia,0.75,0.25,7,1.75,1.33,4.0,2
Al Ittihad,8,5,2,1,16,6,10,17,saudiarabia,0.62,0.38,10,2.0,1.61,2.63,3
Al Nassr,8,5,1,2,14,9,5,16,saudiarabia,0.62,0.38,5,1.75,1.61,2.63,4
Al Ittifaq,8,4,3,1,14,9,5,15,saudiarabia,0.5,0.5,5,1.75,2.0,2.0,5
Al Hilal,8,3,2,3,16,14,2,11,saudiarabia,0.38,0.62,2,2.0,2.63,1.61,6
Al Shabab,8,3,2,3,14,12,2,11,saudiarabia,0.38,0.62,2,1.75,2.63,1.61,6
Al Khaleej,8,3,2,3,11,15,-4,11,saudiarabia,0.38,0.62,-4,1.38,2.63,1.61,6
Al Riyadh,8,3,2,3,10,14,-4,11,saudiarabia,0.38,0.62,-4,1.25,2.63,1.61,6
Al Taawon,8,3,1,4,5,5,0,10,saudiarabia,0.38,0.62,0,0.62,2.63,1.61,7
Al Akhdoud,8,3,1,4,11,15,-4,10,saudiarabia,0.38,0.62,-4,1.38,2.63,1.61,7
Al Orubah,8,3,1,4,7,14,-7,10,saudiarabia,0.38,0.62,-7,0.88,2.63,1.61,7
Al Feiha,8,2,3,3,8,11,-3,9,saudiarabia,0.25,0.75,-3,1.0,4.0,1.33,8
Damak,8,2,2,4,8,11,-3,8,saudiarabia,0.25,0.75,-3,1.0,4.0,1.33,9
Al Kholood,8,2,1,5,11,18,-7,7,saudiarabia,0.25,0.75,-7,1.38,4.0,1.33,10
Al Fateh,8,2,1,5,9,22,-13,7,saudiarabia,0.25,0.75,-13,1.12,4.0,1.33,10
Al Raed,8,2,0,6,8,18,-10,6,saudiarabia,0.25,0.75,-10,1.0,4.0,1.33,11
Al Wahda,8,1,1,6,8,17,-9,4,saudiarabia,0.12,0.88,-9,1.0,8.33,1.14,12
Al Bukayriyah,8,5,1,2,14,5,9,16,saudiarabia2,0.62,0.38,9,1.75,1.61,2.63,1
Al Adalha,8,4,3,1,14,10,4,15,saudiarabia2,0.5,0.5,4,1.75,2.0,2.0,2
Neom SC,8,5,0,3,10,7,3,15,saudiarabia2,0.62,0.38,3,1.25,1.61,2.63,2
Al Tai,8,3,4,1,12,10,2,13,saudiarabia2,0.38,0.62,2,1.5,2.63,1.61,3
Al Jabalain,8,3,3,2,7,6,1,12,saudiarabia2,0.38,0.62,1,0.88,2.63,1.61,4
Al Arabi,8,3,2,3,13,12,1,11,saudiarabia2,0.38,0.62,1,1.62,2.63,1.61,5
Al Hazm,8,3,1,4,12,14,-2,10,saudiarabia2,0.38,0.62,-2,1.5,2.63,1.61,6
Al Najma,8,3,1,4,9,11,-2,10,saudiarabia2,0.38,0.62,-2,1.12,2.63,1.61,6
Al Jandal,8,2,3,3,8,8,0,9,saudiarabia2,0.25,0.75,0,1.0,4.0,1.33,7
Al Jubail,8,2,2,4,9,12,-3,8,saudiarabia2,0.25,0.75,-3,1.12,4.0,1.33,8
Jeddah,8,2,2,4,7,10,-3,8,saudiarabia2,0.25,0.75,-3,0.88,4.0,1.33,8
Abha,8,2,2,4,7,14,-7,8,saudiarabia2,0.25,0.75,-7,0.88,4.0,1.33,8
Al Faisaly,8,1,3,4,10,16,-6,6,saudiarabia2,0.12,0.88,-6,1.25,8.33,1.14,9
Al Zulfi,8,0,5,3,7,11,-4,5,saudiarabia2,0.0,1.0,-4,0.88,0.0,1.0,10
Al Ain,8,1,2,5,6,14,-8,5,saudiarabia2,0.12,0.88,-8,0.75,8.33,1.14,10
Ohod,8,1,1,6,2,10,-8,4,saudiarabia2,0.12,0.88,-8,0.25,8.33,1.14,11
Al Safa,8,1,1,6,7,17,-10,4,saudiarabia2,0.12,0.88,-10,0.88,8.33,1.14,11
Al Batin,8,0,3,5,6,19,-13,3,saudiarabia2,0.0,1.0,-13,0.75,0.0,1.0,12
Rangers,8,4,3,1,20,12,8,15,scotland,0.5,0.5,8,2.5,2.0,2.0,1
Hibernian,8,4,3,1,13,8,5,15,scotland,0.5,0.5,5,1.62,2.0,2.0,1
Hearts,8,4,2,2,13,6,7,14,scotland,0.5,0.5,7,1.62,2.0,2.0,2
Celtic,8,4,2,2,16,11,5,14,scotland,0.5,0.5,5,2.0,2.0,2.0,2
St. Mirren,8,4,0,4,11,13,-2,12,scotland,0.5,0.5,-2,1.38,2.0,2.0,3
Ross County,8,4,0,4,10,14,-4,12,scotland,0.5,0.5,-4,1.25,2.0,2.0,3
Dundee Utd,8,3,1,4,9,13,-4,10,scotland,0.38,0.62,-4,1.12,2.63,1.61,4
Motherwell,8,2,1,5,5,12,-7,7,scotland,0.25,0.75,-7,0.62,4.0,1.33,5
Dundee FC,8,2,1,5,8,17,-9,7,scotland,0.25,0.75,-9,1.0,4.0,1.33,5
St. Johnstone,8,1,2,5,7,16,-9,5,scotland,0.12,0.88,-9,0.88,8.33,1.14,6
Aberdeen,8,1,1,6,4,19,-15,4,scotland,0.12,0.88,-15,0.5,8.33,1.14,7
Kilmarnock,8,0,2,6,4,15,-11,2,scotland,0.0,1.0,-11,0.5,0.0,1.0,8
Livingston,8,4,2,2,12,8,4,14,scotland2,0.5,0.5,4,1.5,2.0,2.0,1
Falkirk,8,4,2,2,14,11,3,14,scotland2,0.5,0.5,3,1.75,2.0,2.0,1
Ayr Utd,8,4,2,2,9,6,3,14,scotland2,0.5,0.5,3,1.12,2.0,2.0,1
Partick Thistle,8,3,0,5,9,15,-6,9,scotland2,0.38,0.62,-6,1.12,2.63,1.61,2
Greenock Morton,8,2,3,3,11,19,-8,9,scotland2,0.25,0.75,-8,1.38,4.0,1.33,2
Raith Rovers,8,2,1,5,8,14,-6,7,scotland2,0.25,0.75,-6,1.0,4.0,1.33,3
Queens Park,8,1,3,4,7,10,-3,6,scotland2,0.12,0.88,-3,0.88,8.33,1.14,4
Hamilton,8,2,0,6,9,17,-8,6,scotland2,0.25,0.75,-8,1.12,4.0,1.33,4
Dunfermline,8,1,1,6,5,12,-7,4,scotland2,0.12,0.88,-7,0.62,8.33,1.14,5
Airdrieonians,8,0,2,6,6,14,-8,2,scotland2,0.0,1.0,-8,0.75,0.0,1.0,6
Inverness,8,6,0,2,14,10,4,18,scotland3,0.75,0.25,4,1.75,1.33,4.0,1
Cove Rangers,8,5,1,2,17,5,12,16,scotland3,0.62,0.38,12,2.12,1.61,2.63,2
Stenhousemuir,8,4,2,2,14,6,8,14,scotland3,0.5,0.5,8,1.75,2.0,2.0,3
Arbroath,8,4,1,3,14,8,6,13,scotland3,0.5,0.5,6,1.75,2.0,2.0,4
Alloa Athletic,8,3,3,2,13,11,2,12,scotland3,0.38,0.62,2,1.62,2.63,1.61,5
Montrose,8,3,2,3,10,11,-1,11,scotland3,0.38,0.62,-1,1.25,2.63,1.61,6
Annan Athletic,8,2,2,4,12,15,-3,8,scotland3,0.25,0.75,-3,1.5,4.0,1.33,7
Kelty Hearts,8,1,3,4,5,9,-4,6,scotland3,0.12,0.88,-4,0.62,8.33,1.14,8
Queen of South,8,1,1,6,7,11,-4,4,scotland3,0.12,0.88,-4,0.88,8.33,1.14,9
Dumbarton,8,1,1,6,7,18,-11,4,scotland3,0.12,0.88,-11,0.88,8.33,1.14,9
Edinburgh City,8,5,1,2,12,8,4,16,scotland4,0.62,0.38,4,1.5,1.61,2.63,1
East Fife,8,3,2,3,9,8,1,11,scotland4,0.38,0.62,1,1.12,2.63,1.61,2
Peterhead,8,3,2,3,11,12,-1,11,scotland4,0.38,0.62,-1,1.38,2.63,1.61,2
Stranraer,8,3,1,4,8,10,-2,10,scotland4,0.38,0.62,-2,1.0,2.63,1.61,3
Spartans,8,3,1,4,12,17,-5,10,scotland4,0.38,0.62,-5,1.5,2.63,1.61,3
Elgin City,8,1,2,5,6,11,-5,5,scotland4,0.12,0.88,-5,0.75,8.33,1.14,4
Forfar Athletic,8,1,2,5,7,13,-6,5,scotland4,0.12,0.88,-6,0.88,8.33,1.14,4
Bonnyrigg Rose,8,1,2,5,6,19,-13,5,scotland4,0.12,0.88,-13,0.75,8.33,1.14,4
Stirling Albion,8,1,1,6,12,21,-9,4,scotland4,0.12,0.88,-9,1.5,8.33,1.14,5
Clyde,8,0,2,6,9,19,-10,2,scotland4,0.0,1.0,-10,1.12,0.0,1.0,6
Red Star,8,8,0,0,28,4,24,24,serbia,1.0,0.0,24,3.5,1.0,0.0,1
Partizan,8,5,2,1,15,10,5,17,serbia,0.62,0.38,5,1.88,1.61,2.63,2
Vojvodina,8,4,3,1,18,8,10,15,serbia,0.5,0.5,10,2.25,2.0,2.0,3
Novi Pazar,8,3,3,2,9,8,1,12,serbia,0.38,0.62,1,1.12,2.63,1.61,4
Cukaricki,8,3,2,3,10,13,-3,11,serbia,0.38,0.62,-3,1.25,2.63,1.61,5
Radnicki 1923,8,3,2,3,10,15,-5,11,serbia,0.38,0.62,-5,1.25,2.63,1.61,5
Napredak,8,2,3,3,6,5,1,9,serbia,0.25,0.75,1,0.75,4.0,1.33,6
Backa Topola,8,2,3,3,13,14,-1,9,serbia,0.25,0.75,-1,1.62,4.0,1.33,6
S. Subotica,8,2,3,3,9,12,-3,9,serbia,0.25,0.75,-3,1.12,4.0,1.33,6
Z. Pancevo,8,2,2,4,7,10,-3,8,serbia,0.25,0.75,-3,0.88,4.0,1.33,7
OFK Beograd,8,2,2,4,6,12,-6,8,serbia,0.25,0.75,-6,0.75,4.0,1.33,7
Tekstilac Odzac,8,2,2,4,6,15,-9,8,serbia,0.25,0.75,-9,0.75,4.0,1.33,7
Mladost Lucani,8,1,4,3,3,6,-3,7,serbia,0.12,0.88,-3,0.38,8.33,1.14,8
IMT N. Beograd,8,2,1,5,9,15,-6,7,serbia,0.25,0.75,-6,1.12,4.0,1.33,8
Radnicki Nis,8,1,3,4,11,19,-8,6,serbia,0.12,0.88,-8,1.38,8.33,1.14,9
Jedinstvo U.,8,1,0,7,5,21,-16,3,serbia,0.12,0.88,-16,0.62,8.33,1.14,10
Javor Ivanjica,8,4,4,0,11,5,6,16,serbia2,0.5,0.5,6,1.38,2.0,2.0,1
R. Surdulica,8,4,3,1,9,2,7,15,serbia2,0.5,0.5,7,1.12,2.0,2.0,2
Vrsac,8,4,2,2,9,7,2,14,serbia2,0.5,0.5,2,1.12,2.0,2.0,3
Mladost,8,2,5,1,5,4,1,11,serbia2,0.25,0.75,1,0.62,4.0,1.33,4
Zemun,8,2,4,2,14,9,5,10,serbia2,0.25,0.75,5,1.75,4.0,1.33,5
Trajal Krusevac,8,3,1,4,10,10,0,10,serbia2,0.38,0.62,0,1.25,2.63,1.61,5
Vozdovac,8,3,1,4,5,9,-4,10,serbia2,0.38,0.62,-4,0.62,2.63,1.61,5
Borac Cacak,8,2,2,4,7,14,-7,8,serbia2,0.25,0.75,-7,0.88,4.0,1.33,6
Indija,8,1,4,3,5,11,-6,7,serbia2,0.12,0.88,-6,0.62,8.33,1.14,7
Dubocica,8,1,3,4,6,10,-4,6,serbia2,0.12,0.88,-4,0.75,8.33,1.14,8
Macva Sabac,8,1,3,4,4,9,-5,6,serbia2,0.12,0.88,-5,0.5,8.33,1.14,8
Sloboda Uzice,8,1,2,5,5,10,-5,5,serbia2,0.12,0.88,-5,0.62,8.33,1.14,9
S. Mitrovica,8,0,5,3,3,9,-6,5,serbia2,0.0,1.0,-6,0.38,0.0,1.0,9
Smederevo,8,1,2,5,5,15,-10,5,serbia2,0.12,0.88,-10,0.62,8.33,1.14,9
Sloven Ruma,8,0,3,5,4,12,-8,3,serbia2,0.0,1.0,-8,0.5,0.0,1.0,10
Graficar,8,0,2,6,6,18,-12,2,serbia2,0.0,1.0,-12,0.75,0.0,1.0,11
Lion City,8,6,1,1,30,11,19,19,singapore,0.75,0.25,19,3.75,1.33,4.0,1
Geylang,8,5,3,0,24,10,14,18,singapore,0.62,0.38,14,3.0,1.61,2.63,2
Tampines Rovers,8,4,2,2,20,10,10,14,singapore,0.5,0.5,10,2.5,2.0,2.0,3
Young Lions,8,4,2,2,18,15,3,14,singapore,0.5,0.5,3,2.25,2.0,2.0,3
A. Niigata (S),8,4,1,3,10,17,-7,13,singapore,0.5,0.5,-7,1.25,2.0,2.0,4
Khalsa,8,3,1,4,20,19,1,10,singapore,0.38,0.62,1,2.5,2.63,1.61,5
Hougang,8,2,1,5,14,23,-9,7,singapore,0.25,0.75,-9,1.75,4.0,1.33,6
DPMM FC,8,2,1,5,11,20,-9,7,singapore,0.25,0.75,-9,1.38,4.0,1.33,6
Tanjong Pagar,8,0,2,6,5,31,-26,2,singapore,0.0,1.0,-26,0.62,0.0,1.0,7
S. Bratislava,8,5,2,1,19,10,9,17,slovakia,0.62,0.38,9,2.38,1.61,2.63,1
Spartak Trnava,8,5,2,1,17,8,9,17,slovakia,0.62,0.38,9,2.12,1.61,2.63,1
Zilina,8,4,2,2,15,6,9,14,slovakia,0.5,0.5,9,1.88,2.0,2.0,2
DAC Streda,8,3,4,1,11,6,5,13,slovakia,0.38,0.62,5,1.38,2.63,1.61,3
Podbrezova,8,3,4,1,12,11,1,13,slovakia,0.38,0.62,1,1.5,2.63,1.61,3
FC Kosice,8,3,2,3,12,10,2,11,slovakia,0.38,0.62,2,1.5,2.63,1.61,4
Z. Michalovce,8,2,3,3,9,12,-3,9,slovakia,0.25,0.75,-3,1.12,4.0,1.33,5
Komarno,8,2,1,5,9,18,-9,7,slovakia,0.25,0.75,-9,1.12,4.0,1.33,6
Skalica,8,1,2,5,7,14,-7,5,slovakia,0.12,0.88,-7,0.88,8.33,1.14,7
Ruzomberok,8,1,1,6,7,15,-8,4,slovakia,0.12,0.88,-8,0.88,8.33,1.14,8
Trencin,8,0,4,4,9,19,-10,4,slovakia,0.0,1.0,-10,1.12,0.0,1.0,8
Banska Bystrica,8,0,1,7,1,15,-14,1,slovakia,0.0,1.0,-14,0.12,0.0,1.0,9
Presov,7,5,1,1,13,8,5,16,slovakia2,0.71,0.29,5,1.86,1.41,3.45,1
Zlate Moravce,7,5,0,2,6,3,3,15,slovakia2,0.71,0.29,3,0.86,1.41,3.45,2
L. Mikulas,7,3,3,1,13,10,3,12,slovakia2,0.43,0.57,3,1.86,2.33,1.75,3
Petrzalka,8,3,2,3,8,8,0,11,slovakia2,0.38,0.62,0,1.0,2.63,1.61,4
Malzenice,5,2,1,2,8,7,1,7,slovakia2,0.4,0.6,1,1.6,2.5,1.67,5
S. Bratislava B,8,2,0,6,9,14,-5,6,slovakia2,0.25,0.75,-5,1.12,4.0,1.33,6
Puchov,7,1,3,3,7,12,-5,6,slovakia2,0.14,0.86,-5,1.0,7.14,1.16,6
Zilina B,7,2,0,5,7,15,-8,6,slovakia2,0.29,0.71,-8,1.0,3.45,1.41,6
Samorin,8,2,0,6,10,19,-9,6,slovakia2,0.25,0.75,-9,1.25,4.0,1.33,6
Humenne,7,1,2,4,6,10,-4,5,slovakia2,0.14,0.86,-4,0.86,7.14,1.16,7
P. Bystrica,7,1,2,4,6,12,-6,5,slovakia2,0.14,0.86,-6,0.86,7.14,1.16,7
Pohronie,7,1,2,4,7,15,-8,5,slovakia2,0.14,0.86,-8,1.0,7.14,1.16,7
Zvolen,7,1,1,5,3,15,-12,4,slovakia2,0.14,0.86,-12,0.43,7.14,1.16,8
S. Lubovna,7,1,0,6,5,9,-4,3,slovakia2,0.14,0.86,-4,0.71,7.14,1.16,9
NK Olimpija,8,6,2,0,11,3,8,20,slovenia,0.75,0.25,8,1.38,1.33,4.0,1
Maribor,8,4,3,1,11,5,6,15,slovenia,0.5,0.5,6,1.38,2.0,2.0,2
Koper,8,5,0,3,12,8,4,15,slovenia,0.62,0.38,4,1.5,1.61,2.63,2
Bravo,8,4,2,2,14,12,2,14,slovenia,0.5,0.5,2,1.75,2.0,2.0,3
NK Celje,8,3,3,2,12,9,3,12,slovenia,0.38,0.62,3,1.5,2.63,1.61,4
Mura,8,2,2,4,9,11,-2,8,slovenia,0.25,0.75,-2,1.12,4.0,1.33,5
Radomlje,8,2,1,5,7,16,-9,7,slovenia,0.25,0.75,-9,0.88,4.0,1.33,6
Primorje,8,1,3,4,9,22,-13,6,slovenia,0.12,0.88,-13,1.12,8.33,1.14,7
Domzale,8,1,2,5,6,17,-11,5,slovenia,0.12,0.88,-11,0.75,8.33,1.14,8
Nafta,8,0,2,6,3,17,-14,2,slovenia,0.0,1.0,-14,0.38,0.0,1.0,9
Mamelodi S.,8,7,0,1,16,5,11,21,southafrica,0.88,0.12,11,2.0,1.14,8.33,1
Stellenbosch,8,4,3,1,14,6,8,15,southafrica,0.5,0.5,8,1.75,2.0,2.0,2
Orlando Pirates,6,4,0,2,7,6,1,12,southafrica,0.67,0.33,1,1.17,1.49,3.03,3
Sekhukhune,8,3,2,3,8,8,0,11,southafrica,0.38,0.62,0,1.0,2.63,1.61,4
Golden Arrows,8,3,2,3,7,11,-4,11,southafrica,0.38,0.62,-4,0.88,2.63,1.61,4
TS Galaxy,8,2,4,2,12,12,0,10,southafrica,0.25,0.75,0,1.5,4.0,1.33,5
AmaZulu,8,3,1,4,10,11,-1,10,southafrica,0.38,0.62,-1,1.25,2.63,1.61,5
SuperSport Utd,8,2,3,3,7,7,0,9,southafrica,0.25,0.75,0,0.88,4.0,1.33,6
Kaizer Chiefs,8,2,2,4,7,9,-2,8,southafrica,0.25,0.75,-2,0.88,4.0,1.33,7
Chippa Utd,8,2,1,5,8,9,-1,7,southafrica,0.25,0.75,-1,1.0,4.0,1.33,8
Polokwane,8,1,4,3,2,6,-4,7,southafrica,0.12,0.88,-4,0.25,8.33,1.14,8
Richards Bay,8,1,3,4,4,8,-4,6,southafrica,0.12,0.88,-4,0.5,8.33,1.14,9
Magesi,8,1,2,5,3,11,-8,5,southafrica,0.12,0.88,-8,0.38,8.33,1.14,10
Marumo G.,8,1,1,6,5,17,-12,4,southafrica,0.12,0.88,-12,0.62,8.33,1.14,11
Royal AM,5,0,3,2,4,6,-2,3,southafrica,0.0,1.0,-2,0.8,0.0,1.0,12
Cape Town City,8,1,0,7,4,14,-10,3,southafrica,0.12,0.88,-10,0.5,8.33,1.14,12
Orbit College,8,5,1,2,11,8,3,16,southafrica2,0.62,0.38,3,1.38,1.61,2.63,1
Upington City,8,3,4,1,10,7,3,13,southafrica2,0.38,0.62,3,1.25,2.63,1.61,2
JDR Stars,8,3,2,3,8,9,-1,11,southafrica2,0.38,0.62,-1,1.0,2.63,1.61,3
Durban City,8,2,3,3,8,8,0,9,southafrica2,0.25,0.75,0,1.0,4.0,1.33,4
Highbury,8,2,3,3,8,8,0,9,southafrica2,0.25,0.75,0,1.0,4.0,1.33,4
Baroka,8,2,3,3,8,12,-4,9,southafrica2,0.25,0.75,-4,1.0,4.0,1.33,4
Milford,8,2,3,3,12,17,-5,9,southafrica2,0.25,0.75,-5,1.5,4.0,1.33,4
Kruger United,8,2,2,4,10,10,0,8,southafrica2,0.25,0.75,0,1.25,4.0,1.33,5
Casric Stars,8,1,4,3,6,10,-4,7,southafrica2,0.12,0.88,-4,0.75,8.33,1.14,6
Pretoria C.,8,1,3,4,3,7,-4,6,southafrica2,0.12,0.88,-4,0.38,8.33,1.14,7
Pretoria U.,8,1,3,4,2,7,-5,6,southafrica2,0.12,0.88,-5,0.25,8.33,1.14,7
Black Leopards,8,2,0,6,10,17,-7,6,southafrica2,0.25,0.75,-7,1.25,4.0,1.33,7
Leruma United,8,2,0,6,4,14,-10,6,southafrica2,0.25,0.75,-10,0.5,4.0,1.33,7
Hungry Lions,8,1,2,5,9,14,-5,5,southafrica2,0.12,0.88,-5,1.12,8.33,1.14,8
Venda FC,8,1,1,6,8,15,-7,4,southafrica2,0.12,0.88,-7,1.0,8.33,1.14,9
Cape Town Spurs,8,0,2,6,3,13,-10,2,southafrica2,0.0,1.0,-10,0.38,0.0,1.0,10
Daejeon Citizen,1,1,0,0,3,0,3,3,southkorea,1.0,0.0,3,3.0,1.0,0.0,1
Ulsan,1,1,0,0,2,0,2,3,southkorea,1.0,0.0,2,2.0,1.0,0.0,1
Gimcheon Sangmu,2,1,0,1,4,4,0,3,southkorea,0.5,0.5,0,2.0,2.0,2.0,1
Anyang,3,1,0,2,3,4,-1,3,southkorea,0.33,0.67,-1,1.0,3.03,1.49,1
Gwangju,1,0,1,0,2,2,0,1,southkorea,0.0,1.0,0,2.0,0.0,1.0,2
Daegu,1,0,1,0,0,0,0,1,southkorea,0.0,1.0,0,0.0,0.0,1.0,2
Suwon City,2,0,1,1,1,3,-2,1,southkorea,0.0,1.0,-2,0.5,0.0,1.0,2
Jeju Utd,0,0,0,0,0,0,0,0,southkorea,0.0,0.0,0,0.0,0.0,0.0,3
Gangwon,1,0,0,1,1,2,-1,0,southkorea,0.0,1.0,-1,1.0,0.0,1.0,3
Pohang Steelers,1,0,0,1,1,2,-1,0,southkorea,0.0,1.0,-1,1.0,0.0,1.0,3
Jeonbuk Motors,1,0,0,1,0,1,-1,0,southkorea,0.0,1.0,-1,0.0,0.0,1.0,3
Seoul,1,0,0,1,0,2,-2,0,southkorea,0.0,1.0,-2,0.0,0.0,1.0,3
Jeonnam,2,1,1,0,3,1,2,4,southkorea2,0.5,0.5,2,1.5,2.0,2.0,1
Gimpo,2,1,1,0,2,0,2,4,southkorea2,0.5,0.5,2,1.0,2.0,2.0,1
Suwon Bluewings,2,1,0,1,1,2,-1,3,southkorea2,0.5,0.5,-1,0.5,2.0,2.0,2
Ansan Greeners,0,0,0,0,0,0,0,0,southkorea2,0.0,0.0,0,0.0,0.0,0.0,3
Bucheon FC,0,0,0,0,0,0,0,0,southkorea2,0.0,0.0,0,0.0,0.0,0.0,3
Busan IPark,0,0,0,0,0,0,0,0,southkorea2,0.0,0.0,0,0.0,0.0,0.0,3
Cheonan City,0,0,0,0,0,0,0,0,southkorea2,0.0,0.0,0,0.0,0.0,0.0,3
Incheon Utd,0,0,0,0,0,0,0,0,southkorea2,0.0,0.0,0,0.0,0.0,0.0,3
Seongnam,0,0,0,0,0,0,0,0,southkorea2,0.0,0.0,0,0.0,0.0,0.0,3
Seoul E-Land,0,0,0,0,0,0,0,0,southkorea2,0.0,0.0,0,0.0,0.0,0.0,3
Asan,1,0,0,1,1,2,-1,0,southkorea2,0.0,1.0,-1,1.0,0.0,1.0,3
Cheongju,1,0,0,1,1,3,-2,0,southkorea2,0.0,1.0,-2,1.0,0.0,1.0,3
Gyeongnam,1,0,0,1,0,2,-2,0,southkorea2,0.0,1.0,-2,0.0,0.0,1.0,3
Hwaseong,1,0,0,1,0,2,-2,0,southkorea2,0.0,1.0,-2,0.0,0.0,1.0,3
FC Barcelona,8,4,3,1,20,8,12,15,spain,0.5,0.5,12,2.5,2.0,2.0,1
Real Madrid,8,4,2,2,16,8,8,14,spain,0.5,0.5,8,2.0,2.0,2.0,2
Atletico Madrid,8,4,2,2,13,5,8,14,spain,0.5,0.5,8,1.62,2.0,2.0,2
Villarreal,8,4,2,2,13,10,3,14,spain,0.5,0.5,3,1.62,2.0,2.0,2
Athletic Bilbao,8,3,5,0,11,8,3,14,spain,0.38,0.62,3,1.38,2.63,1.61,2
Getafe,8,4,1,3,9,7,2,13,spain,0.5,0.5,2,1.12,2.0,2.0,3
Sevilla FC,8,3,2,3,14,11,3,11,spain,0.38,0.62,3,1.75,2.63,1.61,4
Real Betis,8,3,1,4,10,13,-3,10,spain,0.38,0.62,-3,1.25,2.63,1.61,5
Rayo Vallecano,8,2,3,3,5,6,-1,9,spain,0.25,0.75,-1,0.62,4.0,1.33,6
Real Sociedad,8,3,0,5,7,9,-2,9,spain,0.38,0.62,-2,0.88,2.63,1.61,6
Las Palmas,8,2,2,4,9,14,-5,8,spain,0.25,0.75,-5,1.12,4.0,1.33,7
Osasuna,8,1,4,3,5,9,-4,7,spain,0.12,0.88,-4,0.62,8.33,1.14,8
Girona,8,2,1,5,6,12,-6,7,spain,0.25,0.75,-6,0.75,4.0,1.33,8
Mallorca,8,2,1,5,6,14,-8,7,spain,0.25,0.75,-8,0.75,4.0,1.33,8
Alaves,8,1,3,4,11,15,-4,6,spain,0.12,0.88,-4,1.38,8.33,1.14,9
Leganes,8,1,3,4,7,14,-7,6,spain,0.12,0.88,-7,0.88,8.33,1.14,9
Valencia,8,0,5,3,6,14,-8,5,spain,0.0,1.0,-8,0.75,0.0,1.0,10
Celta Vigo,8,0,4,4,9,14,-5,4,spain,0.0,1.0,-5,1.12,0.0,1.0,11
Espanyol,8,1,1,6,6,16,-10,4,spain,0.12,0.88,-10,0.75,8.33,1.14,11
Valladolid,8,0,0,8,4,23,-19,0,spain,0.0,1.0,-19,0.5,0.0,1.0,12
Cordoba,8,5,1,2,12,13,-1,16,spain2,0.62,0.38,-1,1.5,1.61,2.63,1
Huesca,8,4,3,1,9,4,5,15,spain2,0.5,0.5,5,1.12,2.0,2.0,2
Almeria,8,4,2,2,15,10,5,14,spain2,0.5,0.5,5,1.88,2.0,2.0,3
Deportivo,8,4,2,2,13,8,5,14,spain2,0.5,0.5,5,1.62,2.0,2.0,3
Real Oviedo,8,4,2,2,14,13,1,14,spain2,0.5,0.5,1,1.75,2.0,2.0,3
Levante,8,3,4,1,9,5,4,13,spain2,0.38,0.62,4,1.12,2.63,1.61,4
Elche,8,2,5,1,8,7,1,11,spain2,0.25,0.75,1,1.0,4.0,1.33,5
Mirandes,8,3,1,4,9,7,2,10,spain2,0.38,0.62,2,1.12,2.63,1.61,6
Cadiz,8,2,4,2,11,10,1,10,spain2,0.25,0.75,1,1.38,4.0,1.33,6
Racing,8,2,3,3,9,14,-5,9,spain2,0.25,0.75,-5,1.12,4.0,1.33,7
Sporting Gijon,8,1,5,2,9,10,-1,8,spain2,0.12,0.88,-1,1.12,8.33,1.14,8
Granada,8,2,2,4,10,12,-2,8,spain2,0.25,0.75,-2,1.25,4.0,1.33,8
Malaga,8,2,2,4,9,12,-3,8,spain2,0.25,0.75,-3,1.12,4.0,1.33,8
Eldense,8,2,2,4,6,10,-4,8,spain2,0.25,0.75,-4,0.75,4.0,1.33,8
Racing Ferrol,8,2,2,4,5,14,-9,8,spain2,0.25,0.75,-9,0.62,4.0,1.33,8
Real Zaragoza,8,1,4,3,10,12,-2,7,spain2,0.12,0.88,-2,1.25,8.33,1.14,9
Eibar,8,2,1,5,7,10,-3,7,spain2,0.25,0.75,-3,0.88,4.0,1.33,9
Castellon,8,1,4,3,7,12,-5,7,spain2,0.12,0.88,-5,0.88,8.33,1.14,9
Albacete,8,1,3,4,4,9,-5,6,spain2,0.12,0.88,-5,0.5,8.33,1.14,10
Burgos,8,1,2,5,4,12,-8,5,spain2,0.12,0.88,-8,0.5,8.33,1.14,11
Tenerife,8,0,1,7,4,15,-11,1,spain2,0.0,1.0,-11,0.5,0.0,1.0,12
Cartagena,8,0,1,7,5,21,-16,1,spain2,0.0,1.0,-16,0.62,0.0,1.0,12
Athletic B. B,8,5,1,2,13,7,6,16,spain3,0.62,0.38,6,1.62,1.61,2.63,1
Leonesa,8,4,3,1,15,11,4,15,spain3,0.5,0.5,4,1.88,2.0,2.0,2
Barakaldo,8,3,3,2,9,7,2,12,spain3,0.38,0.62,2,1.12,2.63,1.61,3
Gimnastic T.,8,3,2,3,9,8,1,11,spain3,0.38,0.62,1,1.12,2.63,1.61,4
Ponferradina,8,3,2,3,10,10,0,11,spain3,0.38,0.62,0,1.25,2.63,1.61,4
Sestao River,8,3,2,3,7,9,-2,11,spain3,0.38,0.62,-2,0.88,2.63,1.61,4
Arenteiro,8,3,1,4,8,13,-5,10,spain3,0.38,0.62,-5,1.0,2.63,1.61,5
Ourense CF,8,2,3,3,7,7,0,9,spain3,0.25,0.75,0,0.88,4.0,1.33,6
Real Sociedad B,8,2,3,3,7,8,-1,9,spain3,0.25,0.75,-1,0.88,4.0,1.33,6
FC Barcelona B,8,2,3,3,9,12,-3,9,spain3,0.25,0.75,-3,1.12,4.0,1.33,6
Tarazona,8,2,2,4,10,13,-3,8,spain3,0.25,0.75,-3,1.25,4.0,1.33,7
Osasuna B,8,2,2,4,11,17,-6,8,spain3,0.25,0.75,-6,1.38,4.0,1.33,7
Zamora,8,1,3,4,7,11,-4,6,spain3,0.12,0.88,-4,0.88,8.33,1.14,8
Lugo,8,1,3,4,5,10,-5,6,spain3,0.12,0.88,-5,0.62,8.33,1.14,8
Real Union,8,2,0,6,6,20,-14,6,spain3,0.25,0.75,-14,0.75,4.0,1.33,8
FC Andorra,8,1,2,5,6,15,-9,5,spain3,0.12,0.88,-9,0.75,8.33,1.14,9
Gimnastica,8,1,2,5,9,28,-19,5,spain3,0.12,0.88,-19,1.12,8.33,1.14,9
Unionistas,8,0,4,4,8,13,-5,4,spain3,0.0,1.0,-5,1.0,0.0,1.0,10
Celta Vigo B,8,1,1,6,7,14,-7,4,spain3,0.12,0.88,-7,0.88,8.33,1.14,10
Amorebieta,8,0,2,6,5,17,-12,2,spain3,0.0,1.0,-12,0.62,0.0,1.0,11
Real Murcia,8,4,2,2,15,10,5,14,spain4,0.5,0.5,5,1.88,2.0,2.0,1
Antequera,8,3,4,1,12,11,1,13,spain4,0.38,0.62,1,1.5,2.63,1.61,2
UD Ibiza,8,4,0,4,9,10,-1,12,spain4,0.5,0.5,-1,1.12,2.0,2.0,3
Yeclano,8,3,2,3,11,7,4,11,spain4,0.38,0.62,4,1.38,2.63,1.61,4
Villarreal B,8,2,5,1,12,9,3,11,spain4,0.25,0.75,3,1.5,4.0,1.33,4
Sevilla FC B,8,3,1,4,7,8,-1,10,spain4,0.38,0.62,-1,0.88,2.63,1.61,5
Alcorcon,8,3,1,4,12,14,-2,10,spain4,0.38,0.62,-2,1.5,2.63,1.61,5
Real Madrid B,8,2,3,3,13,12,1,9,spain4,0.25,0.75,1,1.62,4.0,1.33,6
Sanluqueno,8,2,3,3,8,10,-2,9,spain4,0.25,0.75,-2,1.0,4.0,1.33,6
Real Betis B,8,2,3,3,10,16,-6,9,spain4,0.25,0.75,-6,1.25,4.0,1.33,6
Atletico M. B,8,2,2,4,9,10,-1,8,spain4,0.25,0.75,-1,1.12,4.0,1.33,7
Fuenlabrada,8,2,1,5,11,13,-2,7,spain4,0.25,0.75,-2,1.38,4.0,1.33,8
Ceuta,8,0,7,1,5,7,-2,7,spain4,0.0,1.0,-2,0.62,0.0,1.0,8
Alcoyano,8,2,1,5,5,14,-9,7,spain4,0.25,0.75,-9,0.62,4.0,1.33,8
Marbella,8,1,3,4,10,14,-4,6,spain4,0.12,0.88,-4,1.25,8.33,1.14,9
Algeciras,8,1,3,4,8,13,-5,6,spain4,0.12,0.88,-5,1.0,8.33,1.14,9
Recreativo H.,8,0,5,3,3,7,-4,5,spain4,0.0,1.0,-4,0.38,0.0,1.0,10
Merida,8,1,2,5,8,17,-9,5,spain4,0.12,0.88,-9,1.0,8.33,1.14,10
Hercules,8,1,1,6,6,11,-5,4,spain4,0.12,0.88,-5,0.75,8.33,1.14,11
Intercity,8,1,1,6,5,14,-9,4,spain4,0.12,0.88,-9,0.62,8.33,1.14,11
Pontevedra,8,4,3,1,7,4,3,15,spain5,0.5,0.5,3,0.88,2.0,2.0,1
Numancia,8,3,4,1,10,5,5,13,spain5,0.38,0.62,5,1.25,2.63,1.61,2
Langreo,8,3,3,2,5,5,0,12,spain5,0.38,0.62,0,0.62,2.63,1.61,3
Escobedo,8,3,3,2,5,7,-2,12,spain5,0.38,0.62,-2,0.62,2.63,1.61,3
Guijuelo,8,2,5,1,11,13,-2,11,spain5,0.25,0.75,-2,1.38,4.0,1.33,4
D. Fabril,8,3,1,4,11,10,1,10,spain5,0.38,0.62,1,1.38,2.63,1.61,5
Salamanca CF,8,3,1,4,9,12,-3,10,spain5,0.38,0.62,-3,1.12,2.63,1.61,5
Real Aviles,8,1,6,1,10,9,1,9,spain5,0.12,0.88,1,1.25,8.33,1.14,6
Torrelavega,8,2,3,3,11,12,-1,9,spain5,0.25,0.75,-1,1.38,4.0,1.33,6
Valladolid B,8,2,3,3,7,12,-5,9,spain5,0.25,0.75,-5,0.88,4.0,1.33,6
Rayo Cantabria,8,2,2,4,16,17,-1,8,spain5,0.25,0.75,-1,2.0,4.0,1.33,7
Real Avila,8,2,2,4,5,8,-3,8,spain5,0.25,0.75,-3,0.62,4.0,1.33,7
Coruxo,8,2,2,4,3,7,-4,8,spain5,0.25,0.75,-4,0.38,4.0,1.33,7
Llanera,8,2,1,5,9,12,-3,7,spain5,0.25,0.75,-3,1.12,4.0,1.33,8
Bergantinos,8,2,1,5,6,9,-3,7,spain5,0.25,0.75,-3,0.75,4.0,1.33,8
Compostela,8,1,3,4,8,11,-3,6,spain5,0.12,0.88,-3,1.0,8.33,1.14,9
Marino de L.,8,1,2,5,7,14,-7,5,spain5,0.12,0.88,-7,0.88,8.33,1.14,10
Laredo,8,0,4,4,5,14,-9,4,spain5,0.0,1.0,-9,0.62,0.0,1.0,11
SD Logrones,8,5,1,2,13,8,5,16,spain6,0.62,0.38,5,1.62,1.61,2.63,1
Teruel,8,5,1,2,8,7,1,16,spain6,0.62,0.38,1,1.0,1.61,2.63,1
Eibar B,8,4,2,2,13,7,6,14,spain6,0.5,0.5,6,1.62,2.0,2.0,2
Arenas Club,8,4,2,2,8,5,3,14,spain6,0.5,0.5,3,1.0,2.0,2.0,2
Alaves B,8,3,4,1,8,6,2,13,spain6,0.38,0.62,2,1.0,2.63,1.61,3
Alfaro,8,3,3,2,9,8,1,12,spain6,0.38,0.62,1,1.12,2.63,1.61,4
Tudelano,8,2,5,1,12,10,2,11,spain6,0.25,0.75,2,1.5,4.0,1.33,5
Utebo,8,2,4,2,5,4,1,10,spain6,0.25,0.75,1,0.62,4.0,1.33,6
Gernika,8,3,1,4,7,11,-4,10,spain6,0.38,0.62,-4,0.88,2.63,1.61,6
Ejea,8,2,3,3,11,9,2,9,spain6,0.25,0.75,2,1.38,4.0,1.33,7
Anguiano,8,3,0,5,7,12,-5,9,spain6,0.38,0.62,-5,0.88,2.63,1.61,7
Barbastro,8,2,2,4,9,12,-3,8,spain6,0.25,0.75,-3,1.12,4.0,1.33,8
UD Logrones,8,1,4,3,7,9,-2,7,spain6,0.12,0.88,-2,0.88,8.33,1.14,9
Calahorra,8,1,4,3,6,8,-2,7,spain6,0.12,0.88,-2,0.75,8.33,1.14,9
Real Zaragoza B,8,2,1,5,6,11,-5,7,spain6,0.25,0.75,-5,0.75,4.0,1.33,9
Izarra,8,2,1,5,10,19,-9,7,spain6,0.25,0.75,-9,1.25,4.0,1.33,9
Real Sociedad C,8,1,2,5,3,11,-8,5,spain6,0.12,0.88,-8,0.38,8.33,1.14,10
Subiza,8,1,1,6,6,16,-10,4,spain6,0.12,0.88,-10,0.75,8.33,1.14,11
Terrassa,8,5,2,1,8,3,5,17,spain7,0.62,0.38,5,1.0,1.61,2.63,1
Sant Andreu,8,4,4,0,19,11,8,16,spain7,0.5,0.5,8,2.38,2.0,2.0,2
Torrent,8,4,3,1,8,8,0,15,spain7,0.5,0.5,0,1.0,2.0,2.0,3
Europa,8,4,2,2,12,8,4,14,spain7,0.5,0.5,4,1.5,2.0,2.0,4
A. Baleares,8,4,2,2,10,7,3,14,spain7,0.5,0.5,3,1.25,2.0,2.0,4
Andratx,8,4,1,3,7,8,-1,13,spain7,0.5,0.5,-1,0.88,2.0,2.0,5
Espanyol B,8,3,3,2,9,8,1,12,spain7,0.38,0.62,1,1.12,2.63,1.61,6
Valencia B,8,3,3,2,8,8,0,12,spain7,0.38,0.62,0,1.0,2.63,1.61,6
Lleida,8,2,5,1,12,7,5,11,spain7,0.25,0.75,5,1.5,4.0,1.33,7
Elche B,8,3,2,3,11,10,1,11,spain7,0.38,0.62,1,1.38,2.63,1.61,7
Olot,8,3,2,3,6,7,-1,11,spain7,0.38,0.62,-1,0.75,2.63,1.61,7
Cornella,8,3,2,3,8,13,-5,11,spain7,0.38,0.62,-5,1.0,2.63,1.61,7
Sabadell,8,2,4,2,9,8,1,10,spain7,0.25,0.75,1,1.12,4.0,1.33,8
Alzira,8,2,4,2,13,15,-2,10,spain7,0.25,0.75,-2,1.62,4.0,1.33,8
SD Ibiza,8,2,4,2,7,9,-2,10,spain7,0.25,0.75,-2,0.88,4.0,1.33,8
Badalona,8,1,4,3,6,12,-6,7,spain7,0.12,0.88,-6,0.75,8.33,1.14,9
Pena Deportiva,8,2,0,6,4,11,-7,6,spain7,0.25,0.75,-7,0.5,4.0,1.33,10
Mallorca B,8,1,1,6,4,16,-12,4,spain7,0.12,0.88,-12,0.5,8.33,1.14,11
Torremolinos,8,4,4,0,9,2,7,16,spain8,0.5,0.5,7,1.12,2.0,2.0,1
Xerez CD,8,4,3,1,9,4,5,15,spain8,0.5,0.5,5,1.12,2.0,2.0,2
La Union,8,4,2,2,7,3,4,14,spain8,0.5,0.5,4,0.88,2.0,2.0,3
Linense,8,4,1,3,7,7,0,13,spain8,0.5,0.5,0,0.88,2.0,2.0,4
Aguilas CF,8,3,3,2,8,6,2,12,spain8,0.38,0.62,2,1.0,2.63,1.61,5
Almeria B,8,3,2,3,6,5,1,11,spain8,0.38,0.62,1,0.75,2.63,1.61,6
CD Estepona,8,3,2,3,5,5,0,11,spain8,0.38,0.62,0,0.62,2.63,1.61,6
D. Minera,8,3,2,3,8,9,-1,11,spain8,0.38,0.62,-1,1.0,2.63,1.61,6
UCAM Murcia,8,2,4,2,7,6,1,10,spain8,0.25,0.75,1,0.88,4.0,1.33,7
Antoniano,8,3,1,4,9,10,-1,10,spain8,0.38,0.62,-1,1.12,2.63,1.61,7
Orihuela,8,2,2,4,4,6,-2,8,spain8,0.25,0.75,-2,0.5,4.0,1.33,8
Linares,8,1,4,3,7,10,-3,7,spain8,0.12,0.88,-3,0.88,8.33,1.14,9
Cadiz B,8,2,1,5,4,15,-11,7,spain8,0.25,0.75,-11,0.5,4.0,1.33,9
Xerez D. FC,8,1,3,4,7,10,-3,6,spain8,0.12,0.88,-3,0.88,8.33,1.14,10
San Fernando,8,1,3,4,6,9,-3,6,spain8,0.12,0.88,-3,0.75,8.33,1.14,10
Granada B,8,1,0,7,6,18,-12,3,spain8,0.12,0.88,-12,0.75,8.33,1.14,11
Villanovense,8,0,2,6,6,15,-9,2,spain8,0.0,1.0,-9,0.75,0.0,1.0,12
Don Benito,8,0,0,8,4,16,-12,0,spain8,0.0,1.0,-12,0.5,0.0,1.0,13
Guadalajara,8,5,3,0,15,6,9,18,spain9,0.62,0.38,9,1.88,1.61,2.63,1
Talavera CF,8,5,3,0,13,6,7,18,spain9,0.62,0.38,7,1.62,1.61,2.63,1
Cacereno,8,4,3,1,11,6,5,15,spain9,0.5,0.5,5,1.38,2.0,2.0,2
CD Coria,8,4,2,2,11,8,3,14,spain9,0.5,0.5,3,1.38,2.0,2.0,3
Melilla,8,4,2,2,11,8,3,14,spain9,0.5,0.5,3,1.38,2.0,2.0,3
R. Majadahonda,8,3,2,3,13,11,2,11,spain9,0.38,0.62,2,1.62,2.63,1.61,4
Conquense,8,3,1,4,6,8,-2,10,spain9,0.38,0.62,-2,0.75,2.63,1.61,5
Colonia M.,8,2,3,3,9,12,-3,9,spain9,0.25,0.75,-3,1.12,4.0,1.33,6
Navalcarnero,8,2,3,3,6,9,-3,9,spain9,0.25,0.75,-3,0.75,4.0,1.33,6
Getafe B,8,2,2,4,9,13,-4,8,spain9,0.25,0.75,-4,1.12,4.0,1.33,7
Real Madrid C,8,2,1,5,6,11,-5,7,spain9,0.25,0.75,-5,0.75,4.0,1.33,8
Tenerife B,8,2,0,6,11,17,-6,6,spain9,0.25,0.75,-6,1.38,4.0,1.33,9
CD Mostoles,8,2,0,6,6,16,-10,6,spain9,0.25,0.75,-10,0.75,4.0,1.33,9
Union Adarve,8,1,2,5,4,11,-7,5,spain9,0.12,0.88,-7,0.5,8.33,1.14,10
S. Sebastian R.,8,0,3,5,4,13,-9,3,spain9,0.0,1.0,-9,0.5,0.0,1.0,11
Illescas,8,0,2,6,6,13,-7,2,spain9,0.0,1.0,-7,0.75,0.0,1.0,12
Yaiza,8,0,2,6,11,23,-12,2,spain9,0.0,1.0,-12,1.38,0.0,1.0,12
Atletico Paso,8,0,1,7,8,20,-12,1,spain9,0.0,1.0,-12,1.0,0.0,1.0,13
AIK,0,0,0,0,0,0,0,0,sweden,0.0,0.0,0,0.0,0.0,0.0,1
Brommapojkarna,0,0,0,0,0,0,0,0,sweden,0.0,0.0,0,0.0,0.0,0.0,1
Degerfors,0,0,0,0,0,0,0,0,sweden,0.0,0.0,0,0.0,0.0,0.0,1
Djurgarden,0,0,0,0,0,0,0,0,sweden,0.0,0.0,0,0.0,0.0,0.0,1
Elfsborg,0,0,0,0,0,0,0,0,sweden,0.0,0.0,0,0.0,0.0,0.0,1
GAIS,0,0,0,0,0,0,0,0,sweden,0.0,0.0,0,0.0,0.0,0.0,1
Hacken,0,0,0,0,0,0,0,0,sweden,0.0,0.0,0,0.0,0.0,0.0,1
Halmstad,0,0,0,0,0,0,0,0,sweden,0.0,0.0,0,0.0,0.0,0.0,1
Hammarby,0,0,0,0,0,0,0,0,sweden,0.0,0.0,0,0.0,0.0,0.0,1
IFK Goteborg,0,0,0,0,0,0,0,0,sweden,0.0,0.0,0,0.0,0.0,0.0,1
Malmo FF,0,0,0,0,0,0,0,0,sweden,0.0,0.0,0,0.0,0.0,0.0,1
Mjallby,0,0,0,0,0,0,0,0,sweden,0.0,0.0,0,0.0,0.0,0.0,1
Norrkoping,0,0,0,0,0,0,0,0,sweden,0.0,0.0,0,0.0,0.0,0.0,1
Oster,0,0,0,0,0,0,0,0,sweden,0.0,0.0,0,0.0,0.0,0.0,1
Sirius,0,0,0,0,0,0,0,0,sweden,0.0,0.0,0,0.0,0.0,0.0,1
Varnamo,0,0,0,0,0,0,0,0,sweden,0.0,0.0,0,0.0,0.0,0.0,1
Brage,0,0,0,0,0,0,0,0,sweden2,0.0,0.0,0,0.0,0.0,0.0,1
Falkenberg,0,0,0,0,0,0,0,0,sweden2,0.0,0.0,0,0.0,0.0,0.0,1
GIF Sundsvall,0,0,0,0,0,0,0,0,sweden2,0.0,0.0,0,0.0,0.0,0.0,1
Helsingborg,0,0,0,0,0,0,0,0,sweden2,0.0,0.0,0,0.0,0.0,0.0,1
Kalmar,0,0,0,0,0,0,0,0,sweden2,0.0,0.0,0,0.0,0.0,0.0,1
Landskrona,0,0,0,0,0,0,0,0,sweden2,0.0,0.0,0,0.0,0.0,0.0,1
Oddevold,0,0,0,0,0,0,0,0,sweden2,0.0,0.0,0,0.0,0.0,0.0,1
Orebro,0,0,0,0,0,0,0,0,sweden2,0.0,0.0,0,0.0,0.0,0.0,1
Orgryte,0,0,0,0,0,0,0,0,sweden2,0.0,0.0,0,0.0,0.0,0.0,1
Ostersunds,0,0,0,0,0,0,0,0,sweden2,0.0,0.0,0,0.0,0.0,0.0,1
Sandviken,0,0,0,0,0,0,0,0,sweden2,0.0,0.0,0,0.0,0.0,0.0,1
Trelleborg,0,0,0,0,0,0,0,0,sweden2,0.0,0.0,0,0.0,0.0,0.0,1
Umea,0,0,0,0,0,0,0,0,sweden2,0.0,0.0,0,0.0,0.0,0.0,1
Utsikten,0,0,0,0,0,0,0,0,sweden2,0.0,0.0,0,0.0,0.0,0.0,1
Varberg BoIS,0,0,0,0,0,0,0,0,sweden2,0.0,0.0,0,0.0,0.0,0.0,1
Vasteras,0,0,0,0,0,0,0,0,sweden2,0.0,0.0,0,0.0,0.0,0.0,1
FC Basel,8,3,3,2,19,12,7,12,switzerland,0.38,0.62,7,2.38,2.63,1.61,1
St. Gallen,8,3,2,3,10,11,-1,11,switzerland,0.38,0.62,-1,1.25,2.63,1.61,2
Lausanne Sport,8,2,4,2,15,11,4,10,switzerland,0.25,0.75,4,1.88,4.0,1.33,3
Grasshopper,8,2,4,2,7,10,-3,10,switzerland,0.25,0.75,-3,0.88,4.0,1.33,3
FC Zurich,8,3,1,4,10,14,-4,10,switzerland,0.38,0.62,-4,1.25,2.63,1.61,3
Servette,8,2,3,3,11,12,-1,9,switzerland,0.25,0.75,-1,1.38,4.0,1.33,4
Luzern,8,2,2,4,11,15,-4,8,switzerland,0.25,0.75,-4,1.38,4.0,1.33,5
Lugano,8,2,1,5,10,14,-4,7,switzerland,0.25,0.75,-4,1.25,4.0,1.33,6
Sion,8,2,1,5,10,17,-7,7,switzerland,0.25,0.75,-7,1.25,4.0,1.33,6
BSC Young Boys,8,1,3,4,4,9,-5,6,switzerland,0.12,0.88,-5,0.5,8.33,1.14,7
Yverdon,8,1,2,5,7,18,-11,5,switzerland,0.12,0.88,-11,0.88,8.33,1.14,8
Winterthur,8,0,4,4,7,18,-11,4,switzerland,0.0,1.0,-11,0.88,0.0,1.0,9
Bangkok Utd,8,6,0,2,15,8,7,18,thailand,0.75,0.25,7,1.88,1.33,4.0,1
Buriram Utd,8,5,2,1,18,8,10,17,thailand,0.62,0.38,10,2.25,1.61,2.63,2
Ratchaburi,8,3,2,3,17,21,-4,11,thailand,0.38,0.62,-4,2.12,2.63,1.61,3
Muang Thong Utd,8,2,3,3,11,9,2,9,thailand,0.25,0.75,2,1.38,4.0,1.33,4
Lamphun Warrior,8,2,3,3,9,12,-3,9,thailand,0.25,0.75,-3,1.12,4.0,1.33,4
Pathum Utd,8,1,5,2,9,10,-1,8,thailand,0.12,0.88,-1,1.12,8.33,1.14,5
Port FC,8,2,2,4,7,10,-3,8,thailand,0.25,0.75,-3,0.88,4.0,1.33,5
Prachuap,8,2,2,4,9,13,-4,8,thailand,0.25,0.75,-4,1.12,4.0,1.33,5
Nakhon Pathom,8,1,3,4,9,14,-5,6,thailand,0.12,0.88,-5,1.12,8.33,1.14,6
Uthai Thani,8,2,0,6,9,15,-6,6,thailand,0.25,0.75,-6,1.12,4.0,1.33,6
N. Ratchasima,8,1,3,4,6,13,-7,6,thailand,0.12,0.88,-7,0.75,8.33,1.14,6
Rayong,8,1,2,5,9,21,-12,5,thailand,0.12,0.88,-12,1.12,8.33,1.14,7
Sukhothai,8,0,4,4,6,15,-9,4,thailand,0.0,1.0,-9,0.75,0.0,1.0,8
Khon Kaen Utd,8,1,1,6,5,25,-20,4,thailand,0.12,0.88,-20,0.62,8.33,1.14,8
Chiangrai Utd,8,1,0,7,4,18,-14,3,thailand,0.12,0.88,-14,0.5,8.33,1.14,9
N. Bua Pitchaya,8,0,1,7,7,19,-12,1,thailand,0.0,1.0,-12,0.88,0.0,1.0,10
Ayutthaya Utd,8,5,2,1,17,8,9,17,thailand2,0.62,0.38,9,2.12,1.61,2.63,1
Kanchanaburi,8,5,2,1,16,11,5,17,thailand2,0.62,0.38,5,2.0,1.61,2.63,1
Pattaya United,8,4,1,3,12,5,7,13,thailand2,0.5,0.5,7,1.5,2.0,2.0,2
Mahasarakham,8,3,4,1,10,7,3,13,thailand2,0.38,0.62,3,1.25,2.63,1.61,2
Bangkok FC,8,4,0,4,13,14,-1,12,thailand2,0.5,0.5,-1,1.62,2.0,2.0,3
Lampang,8,3,2,3,10,10,0,11,thailand2,0.38,0.62,0,1.25,2.63,1.61,4
Phrae Utd,8,3,1,4,9,11,-2,10,thailand2,0.38,0.62,-2,1.12,2.63,1.61,5
Chonburi,8,2,3,3,8,9,-1,9,thailand2,0.25,0.75,-1,1.0,4.0,1.33,6
Kasetsart,8,2,2,4,6,11,-5,8,thailand2,0.25,0.75,-5,0.75,4.0,1.33,7
Chanthaburi,8,2,2,4,11,17,-6,8,thailand2,0.25,0.75,-6,1.38,4.0,1.33,7
Nakhon Si,8,2,1,5,11,17,-6,7,thailand2,0.25,0.75,-6,1.38,4.0,1.33,8
Police Tero,8,2,1,5,8,16,-8,7,thailand2,0.25,0.75,-8,1.0,4.0,1.33,8
Sisaket Utd,8,1,4,3,6,16,-10,7,thailand2,0.12,0.88,-10,0.75,8.33,1.14,8
Suphanburi,8,2,0,6,9,17,-8,6,thailand2,0.25,0.75,-8,1.12,4.0,1.33,9
Chiangmai Utd,8,1,2,5,7,17,-10,5,thailand2,0.12,0.88,-10,0.88,8.33,1.14,10
Chainat,8,0,1,7,4,11,-7,1,thailand2,0.0,1.0,-7,0.5,0.0,1.0,11
Trat FC,8,0,1,7,4,18,-14,1,thailand2,0.0,1.0,-14,0.5,0.0,1.0,11
Samut Prakan,0,0,0,0,0,0,0,0,thailand2,0.0,0.0,0,0.0,0.0,0.0,12
Galatasaray,8,7,1,0,18,6,12,22,turkey,0.88,0.12,12,2.25,1.14,8.33,1
Fenerbahce,8,5,2,1,19,8,11,17,turkey,0.62,0.38,11,2.38,1.61,2.63,2
Eyupspor,8,3,2,3,10,9,1,11,turkey,0.38,0.62,1,1.25,2.63,1.61,3
Samsunspor,8,3,2,3,8,11,-3,11,turkey,0.38,0.62,-3,1.0,2.63,1.61,3
Besiktas,8,2,4,2,10,8,2,10,turkey,0.25,0.75,2,1.25,4.0,1.33,4
Rizespor,8,3,0,5,11,16,-5,9,turkey,0.38,0.62,-5,1.38,2.63,1.61,5
Kayserispor,8,2,3,3,8,14,-6,9,turkey,0.25,0.75,-6,1.0,4.0,1.33,5
Antalyaspor,8,2,2,4,7,15,-8,8,turkey,0.25,0.75,-8,0.88,4.0,1.33,6
Alanyaspor,8,1,4,3,4,9,-5,7,turkey,0.12,0.88,-5,0.5,8.33,1.14,7
Kasimpasa,8,1,4,3,14,20,-6,7,turkey,0.12,0.88,-6,1.75,8.33,1.14,7
Basaksehir,8,2,1,5,10,16,-6,7,turkey,0.25,0.75,-6,1.25,4.0,1.33,7
Goztepe,8,1,2,5,10,15,-5,5,turkey,0.12,0.88,-5,1.25,8.33,1.14,8
Konyaspor,8,1,2,5,7,13,-6,5,turkey,0.12,0.88,-6,0.88,8.33,1.14,8
Bodrumspor,8,1,1,6,5,15,-10,4,turkey,0.12,0.88,-10,0.62,8.33,1.14,9
Adana Demirspor,8,1,1,6,8,19,-11,4,turkey,0.12,0.88,-11,1.0,8.33,1.14,9
Sivasspor,8,1,0,7,8,20,-12,3,turkey,0.12,0.88,-12,1.0,8.33,1.14,10
Trabzonspor,8,0,2,6,9,16,-7,2,turkey,0.0,1.0,-7,1.12,0.0,1.0,11
Gaziantep,8,0,2,6,11,21,-10,2,turkey,0.0,1.0,-10,1.38,0.0,1.0,11
Hatayspor,8,0,1,7,8,19,-11,1,turkey,0.0,1.0,-11,1.0,0.0,1.0,12
Kocaelispor,8,5,2,1,11,4,7,17,turkey2,0.62,0.38,7,1.38,1.61,2.63,1
Erzurum BB,8,4,2,2,14,7,7,14,turkey2,0.5,0.5,7,1.75,2.0,2.0,2
F. Karagumruk,8,4,2,2,9,7,2,14,turkey2,0.5,0.5,2,1.12,2.0,2.0,2
Manisa BB,8,4,0,4,15,15,0,12,turkey2,0.5,0.5,0,1.88,2.0,2.0,3
Boluspor,8,3,2,3,11,10,1,11,turkey2,0.38,0.62,1,1.38,2.63,1.61,4
Sakaryaspor,8,2,5,1,8,9,-1,11,turkey2,0.25,0.75,-1,1.0,4.0,1.33,4
Erokspor,8,3,2,3,7,11,-4,11,turkey2,0.38,0.62,-4,0.88,2.63,1.61,4
Keciorengucu,8,3,2,3,7,12,-5,11,turkey2,0.38,0.62,-5,0.88,2.63,1.61,4
Genclerbirligi,8,2,4,2,13,13,0,10,turkey2,0.25,0.75,0,1.62,4.0,1.33,5
Ankaragucu,8,2,2,4,8,10,-2,8,turkey2,0.25,0.75,-2,1.0,4.0,1.33,6
Umraniyespor,8,2,2,4,8,12,-4,8,turkey2,0.25,0.75,-4,1.0,4.0,1.33,6
Corum,8,2,2,4,7,11,-4,8,turkey2,0.25,0.75,-4,0.88,4.0,1.33,6
Sanliurfaspor,8,2,1,5,10,11,-1,7,turkey2,0.25,0.75,-1,1.25,4.0,1.33,7
Istanbulspor,8,2,1,5,9,11,-2,7,turkey2,0.25,0.75,-2,1.12,4.0,1.33,7
Pendikspor,8,2,1,5,5,11,-6,7,turkey2,0.25,0.75,-6,0.62,4.0,1.33,7
Bandirmaspor,8,1,3,4,6,16,-10,6,turkey2,0.12,0.88,-10,0.75,8.33,1.14,8
Amed SK,8,0,5,3,3,7,-4,5,turkey2,0.0,1.0,-4,0.38,0.0,1.0,9
Igdir,8,1,2,5,3,14,-11,5,turkey2,0.12,0.88,-11,0.38,8.33,1.14,9
Adanaspor,8,1,1,6,4,12,-8,4,turkey2,0.12,0.88,-8,0.5,8.33,1.14,10
Y. Malatyaspor,8,0,0,8,1,28,-27,0,turkey2,0.0,1.0,-27,0.12,0.0,1.0,11
Altinordu,8,5,2,1,20,6,14,17,turkey3,0.62,0.38,14,2.5,1.61,2.63,1
Sariyer,8,5,2,1,17,8,9,17,turkey3,0.62,0.38,9,2.12,1.61,2.63,1
B. Petrolspor,8,5,0,3,7,11,-4,15,turkey3,0.62,0.38,-4,0.88,1.61,2.63,2
Adana,8,3,4,1,8,6,2,13,turkey3,0.38,0.62,2,1.0,2.63,1.61,3
Kastamonuspor,8,3,3,2,13,9,4,12,turkey3,0.38,0.62,4,1.62,2.63,1.61,4
Fethiyespor,8,3,3,2,11,7,4,12,turkey3,0.38,0.62,4,1.38,2.63,1.61,4
Trabzon FK,8,2,3,3,13,12,1,9,turkey3,0.25,0.75,1,1.62,4.0,1.33,5
Iskenderun,8,2,2,4,8,13,-5,8,turkey3,0.25,0.75,-5,1.0,4.0,1.33,6
Kepez Belediyes,8,2,2,4,8,14,-6,8,turkey3,0.25,0.75,-6,1.0,4.0,1.33,6
24 Erzincanspor,8,1,4,3,12,15,-3,7,turkey3,0.12,0.88,-3,1.5,8.33,1.14,7
Isparta Davrazs,8,1,4,3,4,8,-4,7,turkey3,0.12,0.88,-4,0.5,8.33,1.14,7
Inegolspor,8,2,1,5,9,15,-6,7,turkey3,0.25,0.75,-6,1.12,4.0,1.33,7
Kirklarelispor,8,1,3,4,9,13,-4,6,turkey3,0.12,0.88,-4,1.12,8.33,1.14,8
Karakopru,8,1,2,5,5,12,-7,5,turkey3,0.12,0.88,-7,0.62,8.33,1.14,9
Altay,8,1,1,6,4,16,-12,4,turkey3,0.12,0.88,-12,0.5,8.33,1.14,10
Ankaraspor,8,0,3,5,6,14,-8,3,turkey3,0.0,1.0,-8,0.75,0.0,1.0,11
B. Anadolu,8,0,3,5,6,15,-9,3,turkey3,0.0,1.0,-9,0.75,0.0,1.0,11
Afyonspor,8,0,0,8,2,30,-28,0,turkey3,0.0,1.0,-28,0.25,0.0,1.0,12
Serik Belediyes,8,7,0,1,21,5,16,21,turkey4,0.88,0.12,16,2.62,1.14,8.33,1
Van Spor,8,5,1,2,15,8,7,16,turkey4,0.62,0.38,7,1.88,1.61,2.63,2
Arnavutkoy B.,8,4,3,1,17,8,9,15,turkey4,0.5,0.5,9,2.12,2.0,2.0,3
Aksaray B.,8,4,2,2,12,7,5,14,turkey4,0.5,0.5,5,1.5,2.0,2.0,4
Beyoglu Yeni C.,8,3,4,1,12,7,5,13,turkey4,0.38,0.62,5,1.5,2.63,1.61,5
Elazigspor,8,3,3,2,18,13,5,12,turkey4,0.38,0.62,5,2.25,2.63,1.61,6
Karaman,8,2,4,2,11,11,0,10,turkey4,0.25,0.75,0,1.38,4.0,1.33,7
Menemen B.,8,2,3,3,14,11,3,9,turkey4,0.25,0.75,3,1.75,4.0,1.33,8
A. Demirspor,8,2,2,4,15,16,-1,8,turkey4,0.25,0.75,-1,1.88,4.0,1.33,9
Karacabey,8,2,2,4,12,13,-1,8,turkey4,0.25,0.75,-1,1.5,4.0,1.33,9
Somaspor,8,2,2,4,6,8,-2,8,turkey4,0.25,0.75,-2,0.75,4.0,1.33,9
Bucaspor,8,2,2,4,5,7,-2,8,turkey4,0.25,0.75,-2,0.62,4.0,1.33,9
Erbaaspor,8,2,2,4,10,13,-3,8,turkey4,0.25,0.75,-3,1.25,4.0,1.33,9
Yeni Mersin,8,1,2,5,4,16,-12,5,turkey4,0.12,0.88,-12,0.5,8.33,1.14,10
Diyarbekirspor,8,0,4,4,4,9,-5,4,turkey4,0.0,1.0,-5,0.5,0.0,1.0,11
Derince,8,0,3,5,6,13,-7,3,turkey4,0.0,1.0,-7,0.75,0.0,1.0,12
Nazillispor,8,1,0,7,8,19,-11,3,turkey4,0.12,0.88,-11,1.0,8.33,1.14,12
Giresunspor,8,0,2,6,5,21,-16,2,turkey4,0.0,1.0,-16,0.62,0.0,1.0,13
Bursaspor,8,6,2,0,17,4,13,20,turkey5,0.75,0.25,13,2.12,1.33,4.0,1
Anadolu U.,8,5,1,2,14,6,8,16,turkey5,0.62,0.38,8,1.75,1.61,2.63,2
Kirsehir B.,8,4,2,2,13,10,3,14,turkey5,0.5,0.5,3,1.62,2.0,2.0,3
Duzcespor,8,3,4,1,10,10,0,13,turkey5,0.38,0.62,0,1.25,2.63,1.61,4
Elaziz K.,8,3,2,3,7,4,3,11,turkey5,0.38,0.62,3,0.88,2.63,1.61,5
Silifke,8,3,2,3,14,12,2,11,turkey5,0.38,0.62,2,1.75,2.63,1.61,5
Karsiyaka,8,3,2,3,13,12,1,11,turkey5,0.38,0.62,1,1.62,2.63,1.61,5
Kutahyaspor,8,2,3,3,12,12,0,9,turkey5,0.25,0.75,0,1.5,4.0,1.33,6
Artvin Hopaspor,8,2,3,3,5,5,0,9,turkey5,0.25,0.75,0,0.62,4.0,1.33,6
Kusadasispor,8,3,0,5,12,15,-3,9,turkey5,0.38,0.62,-3,1.5,2.63,1.61,6
Musspor,8,2,2,4,9,10,-1,8,turkey5,0.25,0.75,-1,1.12,4.0,1.33,7
Viven Bornova,8,1,4,3,9,11,-2,7,turkey5,0.12,0.88,-2,1.12,8.33,1.14,8
Tokat,8,1,3,4,3,7,-4,6,turkey5,0.12,0.88,-4,0.38,8.33,1.14,9
Kahramanmar.,8,1,3,4,7,15,-8,6,turkey5,0.12,0.88,-8,0.88,8.33,1.14,9
K. Bulvarspor,8,1,3,4,6,15,-9,6,turkey5,0.12,0.88,-9,0.75,8.33,1.14,9
Ergene Velimese,8,1,1,6,3,15,-12,4,turkey5,0.12,0.88,-12,0.38,8.33,1.14,10
Fatsa B.,8,5,2,1,11,4,7,17,turkey6,0.62,0.38,7,1.38,1.61,2.63,1
Silivrispor,8,5,1,2,16,13,3,16,turkey6,0.62,0.38,3,2.0,1.61,2.63,2
Usakspor,8,5,0,3,10,6,4,15,turkey6,0.62,0.38,4,1.25,1.61,2.63,3
Balikesirspor,8,4,2,2,16,9,7,14,turkey6,0.5,0.5,7,2.0,2.0,2.0,4
Tire 2021 FK,8,4,2,2,10,4,6,14,turkey6,0.5,0.5,6,1.25,2.0,2.0,4
Cayelispor,8,4,1,3,11,10,1,13,turkey6,0.5,0.5,1,1.38,2.0,2.0,5
Muglaspor,8,4,1,3,10,10,0,13,turkey6,0.5,0.5,0,1.25,2.0,2.0,5
Amasyaspor,8,3,3,2,12,12,0,12,turkey6,0.38,0.62,0,1.5,2.63,1.61,6
Etimesgut,8,3,3,2,6,6,0,12,turkey6,0.38,0.62,0,0.75,2.63,1.61,6
Mazidagi,8,2,5,1,5,4,1,11,turkey6,0.25,0.75,1,0.62,4.0,1.33,7
Kelkit,8,1,5,2,4,5,-1,8,turkey6,0.12,0.88,-1,0.5,8.33,1.14,8
Inegol Kafkas,8,2,2,4,7,14,-7,8,turkey6,0.25,0.75,-7,0.88,4.0,1.33,8
Beykoz Ishaklis,8,1,4,3,8,9,-1,7,turkey6,0.12,0.88,-1,1.0,8.33,1.14,9
Nevsehirspor,8,1,2,5,6,12,-6,5,turkey6,0.12,0.88,-6,0.75,8.33,1.14,10
Turk Metal 1963,8,0,4,4,6,15,-9,4,turkey6,0.0,1.0,-9,0.75,0.0,1.0,11
Adiyaman,8,0,2,6,5,25,-20,2,turkey6,0.0,1.0,-20,0.62,0.0,1.0,12
Orduspor,8,5,2,1,9,3,6,17,turkey7,0.62,0.38,6,1.12,1.61,2.63,1
Kucukcekmece,8,5,1,2,19,7,12,16,turkey7,0.62,0.38,12,2.38,1.61,2.63,2
Pazarspor,8,3,3,2,7,5,2,12,turkey7,0.38,0.62,2,0.88,2.63,1.61,3
Corluspor,8,3,2,3,8,9,-1,11,turkey7,0.38,0.62,-1,1.0,2.63,1.61,4
Aliaga FAS,8,1,7,0,4,2,2,10,turkey7,0.12,0.88,2,0.5,8.33,1.14,5
Ayvalikgucu,8,2,4,2,4,4,0,10,turkey7,0.25,0.75,0,0.5,4.0,1.33,5
1922 Konyaspor,8,2,4,2,7,8,-1,10,turkey7,0.25,0.75,-1,0.88,4.0,1.33,5
Osmaniyespor,8,2,1,5,8,13,-5,7,turkey7,0.25,0.75,-5,1.0,4.0,1.33,6
Efeler 09,8,2,1,5,4,9,-5,7,turkey7,0.25,0.75,-5,0.5,4.0,1.33,6
Bayburt,8,0,4,4,11,16,-5,4,turkey7,0.0,1.0,-5,1.38,0.0,1.0,7
K. Idmanyurdu,8,0,4,4,7,16,-9,4,turkey7,0.0,1.0,-9,0.88,0.0,1.0,7
Yozgat Bld Bozo,8,1,1,6,6,15,-9,4,turkey7,0.12,0.88,-9,0.75,8.33,1.14,7
Cankaya FK,8,1,1,6,6,18,-12,4,turkey7,0.12,0.88,-12,0.75,8.33,1.14,7
Bursa,8,1,1,6,4,17,-13,4,turkey7,0.12,0.88,-13,0.5,8.33,1.14,7
Alanya 1221,8,0,2,6,7,14,-7,2,turkey7,0.0,1.0,-7,0.88,0.0,1.0,8
Viransehir,8,0,1,7,1,15,-14,1,turkey7,0.0,1.0,-14,0.12,0.0,1.0,9
Mardin BB,8,5,1,2,12,7,5,16,turkey8,0.62,0.38,5,1.5,1.61,2.63,1
Agri 1970,8,4,2,2,17,12,5,14,turkey8,0.5,0.5,5,2.12,2.0,2.0,2
Sebat G.,8,4,2,2,13,10,3,14,turkey8,0.5,0.5,3,1.62,2.0,2.0,2
Orduspor 1967,8,4,0,4,12,9,3,12,turkey8,0.5,0.5,3,1.5,2.0,2.0,3
Nilufer B.,8,2,4,2,12,7,5,10,turkey8,0.25,0.75,5,1.5,4.0,1.33,4
Kirikkale B.,8,3,1,4,9,8,1,10,turkey8,0.38,0.62,1,1.12,2.63,1.61,4
K. Istiklalspor,8,2,3,3,11,7,4,9,turkey8,0.25,0.75,4,1.38,4.0,1.33,5
Z. Komurspor,8,2,1,5,8,12,-4,7,turkey8,0.25,0.75,-4,1.0,4.0,1.33,6
Tepecik,8,2,1,5,8,16,-8,7,turkey8,0.25,0.75,-8,1.0,4.0,1.33,6
Nigde Belediyes,8,1,3,4,6,11,-5,6,turkey8,0.12,0.88,-5,0.75,8.33,1.14,7
Erciyes,8,1,2,5,7,11,-4,5,turkey8,0.12,0.88,-4,0.88,8.33,1.14,8
Turgutluspor,8,1,2,5,6,12,-6,5,turkey8,0.12,0.88,-6,0.75,8.33,1.14,8
Edirnespor,8,1,2,5,3,15,-12,5,turkey8,0.12,0.88,-12,0.38,8.33,1.14,8
Denizlispor,8,1,2,5,4,21,-17,5,turkey8,0.12,0.88,-17,0.5,8.33,1.14,8
Bergama B.,8,0,3,5,11,20,-9,3,turkey8,0.0,1.0,-9,1.38,0.0,1.0,9
Polatli B.,8,0,2,6,7,23,-16,2,turkey8,0.0,1.0,-16,0.88,0.0,1.0,10
Shabab Al Ahli,7,6,1,0,19,5,14,19,uae,0.86,0.14,14,2.71,1.16,7.14,1
Al Sharjah,8,5,1,2,11,5,6,16,uae,0.62,0.38,6,1.38,1.61,2.63,2
Al Jazira,8,4,2,2,21,16,5,14,uae,0.5,0.5,5,2.62,2.0,2.0,3
Khorfakkan,8,4,0,4,14,16,-2,12,uae,0.5,0.5,-2,1.75,2.0,2.0,4
Al Wahda,8,3,2,3,13,12,1,11,uae,0.38,0.62,1,1.62,2.63,1.61,5
Al Bataeh,8,3,1,4,9,12,-3,10,uae,0.38,0.62,-3,1.12,2.63,1.61,6
Al Ain,8,2,3,3,18,18,0,9,uae,0.25,0.75,0,2.25,4.0,1.33,7
Al Wasl,8,2,3,3,9,13,-4,9,uae,0.25,0.75,-4,1.12,4.0,1.33,7
Ajman,8,3,0,5,10,16,-6,9,uae,0.38,0.62,-6,1.25,2.63,1.61,7
Bani Yas,8,3,0,5,7,15,-8,9,uae,0.38,0.62,-8,0.88,2.63,1.61,7
Ittihad Kalba,8,1,4,3,9,12,-3,7,uae,0.12,0.88,-3,1.12,8.33,1.14,8
Dibba Al Hisn,8,1,3,4,9,14,-5,6,uae,0.12,0.88,-5,1.12,8.33,1.14,9
Al Nasr,8,1,1,6,8,20,-12,4,uae,0.12,0.88,-12,1.0,8.33,1.14,10
Al Urooba,8,0,0,8,2,22,-20,0,uae,0.0,1.0,-20,0.25,0.0,1.0,11
Dynamo Kyiv,8,5,3,0,17,5,12,18,ukraine,0.62,0.38,12,2.12,1.61,2.63,1
Kryvbas KR,8,5,1,2,10,7,3,16,ukraine,0.62,0.38,3,1.25,1.61,2.63,2
Shakhtar,7,3,2,2,12,7,5,11,ukraine,0.43,0.57,5,1.71,2.33,1.75,3
Polessya,8,3,2,3,11,9,2,11,ukraine,0.38,0.62,2,1.38,2.63,1.61,3
Oleksandria,6,3,2,1,6,5,1,11,ukraine,0.5,0.5,1,1.0,2.0,2.0,3
Veres,8,3,2,3,8,10,-2,11,ukraine,0.38,0.62,-2,1.0,2.63,1.61,3
Kolos Kovalivka,8,2,3,3,7,7,0,9,ukraine,0.25,0.75,0,0.88,4.0,1.33,4
Rukh Lviv,8,1,5,2,5,8,-3,8,ukraine,0.12,0.88,-3,0.62,8.33,1.14,5
Livyi Bereh,8,2,2,4,4,8,-4,8,ukraine,0.25,0.75,-4,0.5,4.0,1.33,5
Obolon,8,2,2,4,5,12,-7,8,ukraine,0.25,0.75,-7,0.62,4.0,1.33,5
Zorya Luhansk,8,2,1,5,8,12,-4,7,ukraine,0.25,0.75,-4,1.0,4.0,1.33,6
LNZ Cherkasy,8,2,1,5,7,16,-9,7,ukraine,0.25,0.75,-9,0.88,4.0,1.33,6
Karpaty Lviv,8,2,0,6,6,16,-10,6,ukraine,0.25,0.75,-10,0.75,4.0,1.33,7
Vorskla Poltava,8,1,2,5,6,12,-6,5,ukraine,0.12,0.88,-6,0.75,8.33,1.14,8
Chornomorets,8,1,2,5,7,14,-7,5,ukraine,0.12,0.88,-7,0.88,8.33,1.14,8
Inhulets,8,1,2,5,7,17,-10,5,ukraine,0.12,0.88,-10,0.88,8.33,1.14,8
Dnipro-1,0,0,0,0,0,0,0,0,ukraine,0.0,0.0,0,0.0,0.0,0.0,9
Defensor S.,4,3,0,1,5,2,3,9,uruguay2,0.75,0.25,3,1.25,1.33,4.0,1
Danubio,4,2,2,0,7,5,2,8,uruguay2,0.5,0.5,2,1.75,2.0,2.0,2
Cerro Largo,3,2,1,0,3,0,3,7,uruguay2,0.67,0.33,3,1.0,1.49,3.03,3
Nacional,3,2,0,1,10,3,7,6,uruguay2,0.67,0.33,7,3.33,1.49,3.03,4
Penarol,3,2,0,1,5,3,2,6,uruguay2,0.67,0.33,2,1.67,1.49,3.03,4
River Plate,4,2,0,2,4,3,1,6,uruguay2,0.5,0.5,1,1.0,2.0,2.0,4
Miramar Misione,4,2,0,2,4,7,-3,6,uruguay2,0.5,0.5,-3,1.0,2.0,2.0,4
D. Maldonado,4,1,2,1,3,3,0,5,uruguay2,0.25,0.75,0,0.75,4.0,1.33,5
Wanderers,3,1,1,1,3,4,-1,4,uruguay2,0.33,0.67,-1,1.0,3.03,1.49,6
Rampla Juniors,4,1,1,2,3,7,-4,4,uruguay2,0.25,0.75,-4,0.75,4.0,1.33,6
Racing CM,4,0,3,1,6,7,-1,3,uruguay2,0.0,1.0,-1,1.5,0.0,1.0,7
Fenix,3,1,0,2,4,5,-1,3,uruguay2,0.33,0.67,-1,1.33,3.03,1.49,7
Cerro,3,1,0,2,1,3,-2,3,uruguay2,0.33,0.67,-2,0.33,3.03,1.49,7
Progreso,3,0,2,1,4,6,-2,2,uruguay2,0.0,1.0,-2,1.33,0.0,1.0,8
Boston River,3,0,1,2,1,3,-2,1,uruguay2,0.0,1.0,-2,0.33,0.0,1.0,9
Liverpool M.,4,0,0,4,3,8,-5,0,uruguay2,0.0,1.0,-5,0.75,0.0,1.0,10
Vancouver,1,1,0,0,4,1,3,3,usa,1.0,0.0,3,4.0,1.0,0.0,1
Philadelphia,1,1,0,0,4,2,2,3,usa,1.0,0.0,2,4.0,1.0,0.0,1
San Diego,1,1,0,0,2,0,2,3,usa,1.0,0.0,2,2.0,1.0,0.0,1
Dallas,1,1,0,0,2,1,1,3,usa,1.0,0.0,1,2.0,1.0,0.0,1
Charlotte,1,0,1,0,2,2,0,1,usa,0.0,1.0,0,2.0,0.0,1.0,2
New York City,1,0,1,0,2,2,0,1,usa,0.0,1.0,0,2.0,0.0,1.0,2
Toronto,1,0,1,0,2,2,0,1,usa,0.0,1.0,0,2.0,0.0,1.0,2
Colorado Rapids,1,0,1,0,0,0,0,1,usa,0.0,1.0,0,0.0,0.0,1.0,2
New England,1,0,1,0,0,0,0,1,usa,0.0,1.0,0,0.0,0.0,1.0,2
Atlanta Utd,0,0,0,0,0,0,0,0,usa,0.0,0.0,0,0.0,0.0,0.0,3
Austin,0,0,0,0,0,0,0,0,usa,0.0,0.0,0,0.0,0.0,0.0,3
Cincinnati,0,0,0,0,0,0,0,0,usa,0.0,0.0,0,0.0,0.0,0.0,3
Columbus Crew,0,0,0,0,0,0,0,0,usa,0.0,0.0,0,0.0,0.0,0.0,3
DC United,0,0,0,0,0,0,0,0,usa,0.0,0.0,0,0.0,0.0,0.0,3
Houston Dynamo,0,0,0,0,0,0,0,0,usa,0.0,0.0,0,0.0,0.0,0.0,3
Inter Miami,0,0,0,0,0,0,0,0,usa,0.0,0.0,0,0.0,0.0,0.0,3
LA Galaxy,0,0,0,0,0,0,0,0,usa,0.0,0.0,0,0.0,0.0,0.0,3
Los Angeles FC,0,0,0,0,0,0,0,0,usa,0.0,0.0,0,0.0,0.0,0.0,3
Nashville SC,0,0,0,0,0,0,0,0,usa,0.0,0.0,0,0.0,0.0,0.0,3
Orlando City,0,0,0,0,0,0,0,0,usa,0.0,0.0,0,0.0,0.0,0.0,3
Portland,0,0,0,0,0,0,0,0,usa,0.0,0.0,0,0.0,0.0,0.0,3
Seattle,0,0,0,0,0,0,0,0,usa,0.0,0.0,0,0.0,0.0,0.0,3
SJ Earthquakes,0,0,0,0,0,0,0,0,usa,0.0,0.0,0,0.0,0.0,0.0,3
St. Louis City,0,0,0,0,0,0,0,0,usa,0.0,0.0,0,0.0,0.0,0.0,3
CF Montreal,1,0,0,1,2,3,-1,0,usa,0.0,1.0,-1,2.0,0.0,1.0,3
Minnesota Utd,1,0,0,1,0,1,-1,0,usa,0.0,1.0,-1,0.0,0.0,1.0,3
New York RB,1,0,0,1,0,1,-1,0,usa,0.0,1.0,-1,0.0,0.0,1.0,3
Sporting KC,1,0,0,1,0,1,-1,0,usa,0.0,1.0,-1,0.0,0.0,1.0,3
Chicago Fire,1,0,0,1,2,4,-2,0,usa,0.0,1.0,-2,2.0,0.0,1.0,3
Birmingham L.,0,0,0,0,0,0,0,0,usa2,0.0,0.0,0,0.0,0.0,0.0,1
Charleston,0,0,0,0,0,0,0,0,usa2,0.0,0.0,0,0.0,0.0,0.0,1
Colorado S.,0,0,0,0,0,0,0,0,usa2,0.0,0.0,0,0.0,0.0,0.0,1
Detroit City,0,0,0,0,0,0,0,0,usa2,0.0,0.0,0,0.0,0.0,0.0,1
El Paso,0,0,0,0,0,0,0,0,usa2,0.0,0.0,0,0.0,0.0,0.0,1
FC Tulsa,0,0,0,0,0,0,0,0,usa2,0.0,0.0,0,0.0,0.0,0.0,1
Hartford A.,0,0,0,0,0,0,0,0,usa2,0.0,0.0,0,0.0,0.0,0.0,1
Indy Eleven,0,0,0,0,0,0,0,0,usa2,0.0,0.0,0,0.0,0.0,0.0,1
Las Vegas L.,0,0,0,0,0,0,0,0,usa2,0.0,0.0,0,0.0,0.0,0.0,1
Lexington,0,0,0,0,0,0,0,0,usa2,0.0,0.0,0,0.0,0.0,0.0,1
Loudoun Utd,0,0,0,0,0,0,0,0,usa2,0.0,0.0,0,0.0,0.0,0.0,1
Louisville City,0,0,0,0,0,0,0,0,usa2,0.0,0.0,0,0.0,0.0,0.0,1
Miami FC,0,0,0,0,0,0,0,0,usa2,0.0,0.0,0,0.0,0.0,0.0,1
Monterey Bay,0,0,0,0,0,0,0,0,usa2,0.0,0.0,0,0.0,0.0,0.0,1
New Mexico,0,0,0,0,0,0,0,0,usa2,0.0,0.0,0,0.0,0.0,0.0,1
North Carolina,0,0,0,0,0,0,0,0,usa2,0.0,0.0,0,0.0,0.0,0.0,1
Oakland Roots,0,0,0,0,0,0,0,0,usa2,0.0,0.0,0,0.0,0.0,0.0,1
Orange County,0,0,0,0,0,0,0,0,usa2,0.0,0.0,0,0.0,0.0,0.0,1
Phoenix Rising,0,0,0,0,0,0,0,0,usa2,0.0,0.0,0,0.0,0.0,0.0,1
Pittsburgh,0,0,0,0,0,0,0,0,usa2,0.0,0.0,0,0.0,0.0,0.0,1
Rhode Island,0,0,0,0,0,0,0,0,usa2,0.0,0.0,0,0.0,0.0,0.0,1
Sacramento R.,0,0,0,0,0,0,0,0,usa2,0.0,0.0,0,0.0,0.0,0.0,1
San Antonio,0,0,0,0,0,0,0,0,usa2,0.0,0.0,0,0.0,0.0,0.0,1
Tampa Bay,0,0,0,0,0,0,0,0,usa2,0.0,0.0,0,0.0,0.0,0.0,1
Alta,0,0,0,0,0,0,0,0,usa3,0.0,0.0,0,0.0,0.0,0.0,1
Charlotte I.,0,0,0,0,0,0,0,0,usa3,0.0,0.0,0,0.0,0.0,0.0,1
Chattanooga RW,0,0,0,0,0,0,0,0,usa3,0.0,0.0,0,0.0,0.0,0.0,1
Forward Madison,0,0,0,0,0,0,0,0,usa3,0.0,0.0,0,0.0,0.0,0.0,1
Greenville,0,0,0,0,0,0,0,0,usa3,0.0,0.0,0,0.0,0.0,0.0,1
Naples,0,0,0,0,0,0,0,0,usa3,0.0,0.0,0,0.0,0.0,0.0,1
One Knoxville,0,0,0,0,0,0,0,0,usa3,0.0,0.0,0,0.0,0.0,0.0,1
Portland Hearts,0,0,0,0,0,0,0,0,usa3,0.0,0.0,0,0.0,0.0,0.0,1
Richmond K.,0,0,0,0,0,0,0,0,usa3,0.0,0.0,0,0.0,0.0,0.0,1
Spokane V.,0,0,0,0,0,0,0,0,usa3,0.0,0.0,0,0.0,0.0,0.0,1
Texoma,0,0,0,0,0,0,0,0,usa3,0.0,0.0,0,0.0,0.0,0.0,1
Tormenta,0,0,0,0,0,0,0,0,usa3,0.0,0.0,0,0.0,0.0,0.0,1
Union Omaha,0,0,0,0,0,0,0,0,usa3,0.0,0.0,0,0.0,0.0,0.0,1
Westchester SC,0,0,0,0,0,0,0,0,usa3,0.0,0.0,0,0.0,0.0,0.0,1
AGMK,0,0,0,0,0,0,0,0,uzbekistan,0.0,0.0,0,0.0,0.0,0.0,1
Andijan,0,0,0,0,0,0,0,0,uzbekistan,0.0,0.0,0,0.0,0.0,0.0,1
Bunyodkor,0,0,0,0,0,0,0,0,uzbekistan,0.0,0.0,0,0.0,0.0,0.0,1
Buxoro,0,0,0,0,0,0,0,0,uzbekistan,0.0,0.0,0,0.0,0.0,0.0,1
D. Samarqand,0,0,0,0,0,0,0,0,uzbekistan,0.0,0.0,0,0.0,0.0,0.0,1
Kokand-1912,0,0,0,0,0,0,0,0,uzbekistan,0.0,0.0,0,0.0,0.0,0.0,1
Mashal,0,0,0,0,0,0,0,0,uzbekistan,0.0,0.0,0,0.0,0.0,0.0,1
Nasaf Qarshi,0,0,0,0,0,0,0,0,uzbekistan,0.0,0.0,0,0.0,0.0,0.0,1
Navbahor,0,0,0,0,0,0,0,0,uzbekistan,0.0,0.0,0,0.0,0.0,0.0,1
Neftchi,0,0,0,0,0,0,0,0,uzbekistan,0.0,0.0,0,0.0,0.0,0.0,1
Pakhtakor,0,0,0,0,0,0,0,0,uzbekistan,0.0,0.0,0,0.0,0.0,0.0,1
Qizilqum,0,0,0,0,0,0,0,0,uzbekistan,0.0,0.0,0,0.0,0.0,0.0,1
Shurtan,0,0,0,0,0,0,0,0,uzbekistan,0.0,0.0,0,0.0,0.0,0.0,1
Sogdiana,0,0,0,0,0,0,0,0,uzbekistan,0.0,0.0,0,0.0,0.0,0.0,1
Termez Surkhon,0,0,0,0,0,0,0,0,uzbekistan,0.0,0.0,0,0.0,0.0,0.0,1
Xorazm,0,0,0,0,0,0,0,0,uzbekistan,0.0,0.0,0,0.0,0.0,0.0,1
Nam Dinh,8,4,3,1,12,4,8,15,vietnam,0.5,0.5,8,1.5,2.0,2.0,1
Thanh Hoa,8,4,3,1,11,6,5,15,vietnam,0.5,0.5,5,1.38,2.0,2.0,1
Viettel,7,3,3,1,11,5,6,12,vietnam,0.43,0.57,6,1.57,2.33,1.75,2
Ha Noi,7,3,2,2,11,6,5,11,vietnam,0.43,0.57,5,1.57,2.33,1.75,3
Hong Linh Ha T.,7,1,5,1,9,8,1,8,vietnam,0.14,0.86,1,1.29,7.14,1.16,4
Quang Nam,7,1,4,2,6,7,-1,7,vietnam,0.14,0.86,-1,0.86,7.14,1.16,5
Gia Lai,7,2,1,4,8,10,-2,7,vietnam,0.29,0.71,-2,1.14,3.45,1.41,5
Binh Duong,7,2,1,4,5,7,-2,7,vietnam,0.29,0.71,-2,0.71,3.45,1.41,5
Hai Phong,8,1,4,3,7,10,-3,7,vietnam,0.12,0.88,-3,0.88,8.33,1.14,5
Ho Chi Minh,7,1,4,2,6,10,-4,7,vietnam,0.14,0.86,-4,0.86,7.14,1.16,5
Cong An Nhan,7,1,3,3,7,7,0,6,vietnam,0.14,0.86,0,1.0,7.14,1.16,6
Binh Dinh,7,1,2,4,4,10,-6,5,vietnam,0.14,0.86,-6,0.57,7.14,1.16,7
Da Nang,7,1,1,5,4,14,-10,4,vietnam,0.14,0.86,-10,0.57,7.14,1.16,8
Song Lam Nghe,7,0,3,4,6,15,-9,3,vietnam,0.0,1.0,-9,0.86,0.0,1.0,9
Phu Dong,5,5,0,0,10,0,10,15,vietnam2,1.0,0.0,10,2.0,1.0,0.0,1
Binh Phuoc,5,4,1,0,5,1,4,13,vietnam2,0.8,0.2,4,1.0,1.25,5.0,2
PVF-CAND,4,2,2,0,4,0,4,8,vietnam2,0.5,0.5,4,1.0,2.0,2.0,3
Ba Ria Vung Tau,5,2,0,3,6,7,-1,6,vietnam2,0.4,0.6,-1,1.2,2.5,1.67,4
Hue,5,2,0,3,6,7,-1,6,vietnam2,0.4,0.6,-1,1.2,2.5,1.67,4
Dong Thap,5,0,3,2,2,4,-2,3,vietnam2,0.0,1.0,-2,0.4,0.0,1.0,5
Long An,4,0,3,1,1,3,-2,3,vietnam2,0.0,1.0,-2,0.25,0.0,1.0,5
S. Khanh Hoa,5,0,3,2,4,8,-4,3,vietnam2,0.0,1.0,-4,0.8,0.0,1.0,5
Ho Chi Minh B,5,0,3,2,2,6,-4,3,vietnam2,0.0,1.0,-4,0.4,0.0,1.0,5
Dong Nai,5,0,2,3,3,8,-5,2,vietnam2,0.0,1.0,-5,0.6,0.0,1.0,6
Hoa Binh,4,0,0,4,1,6,-5,0,vietnam2,0.0,1.0,-5,0.25,0.0,1.0,7
The New Saints,8,6,0,2,17,8,9,18,wales,0.75,0.25,9,2.12,1.33,4.0,1
Caernarfon,8,5,2,1,12,7,5,17,wales,0.62,0.38,5,1.5,1.61,2.63,2
Haverfordwest,8,3,3,2,9,6,3,12,wales,0.38,0.62,3,1.12,2.63,1.61,3
Barry,8,3,2,3,13,15,-2,11,wales,0.38,0.62,-2,1.62,2.63,1.61,4
Penybont,8,3,1,4,15,16,-1,10,wales,0.38,0.62,-1,1.88,2.63,1.61,5
Briton Ferry,8,3,1,4,17,19,-2,10,wales,0.38,0.62,-2,2.12,2.63,1.61,5
Connahs Quay,8,2,2,4,9,8,1,8,wales,0.25,0.75,1,1.12,4.0,1.33,6
Bala Town,8,1,5,2,9,9,0,8,wales,0.12,0.88,0,1.12,8.33,1.14,6
Newtown,8,2,0,6,7,13,-6,6,wales,0.25,0.75,-6,0.88,4.0,1.33,7
Aberystwyth,8,2,0,6,7,19,-12,6,wales,0.25,0.75,-12,0.88,4.0,1.33,7
Cardiff MU,8,1,1,6,6,14,-8,4,wales,0.12,0.88,-8,0.75,8.33,1.14,8
Flint,8,1,0,7,9,29,-20,3,wales,0.12,0.88,-20,1.12,8.33,1.14,9
