Team_Home_Overall,GP,W,D,L,GF,GA,GD,Pts_Overall,Liga,PIO,PIO_HA,GD_Overall,GF_AVG_Overall,PPG_Overall,Odd_Justa_MO,Odd_Justa_HA,Rank_Overall
AF Elbasani,8,4,3,1,8,6,2,15,Albania - Abissnet Superiore,0.5,0.88,2,1.0,1.88,2.0,1.14,1
Partizani T.,8,4,1,3,6,6,0,13,Albania - Abissnet Superiore,0.5,0.62,0,0.75,1.62,2.0,1.61,2
Skenderbeu K.,8,3,2,3,11,9,2,11,Albania - Abissnet Superiore,0.38,0.62,2,1.38,1.38,2.63,1.61,3
Bylis,8,3,2,3,7,9,-2,11,Albania - Abissnet Superiore,0.38,0.62,-2,0.88,1.38,2.63,1.61,3
KF Tirana,8,2,4,2,10,7,3,10,Albania - Abissnet Superiore,0.25,0.75,3,1.25,1.25,4.0,1.33,4
Vllaznia S.,8,1,5,2,8,7,1,8,Albania - Abissnet Superiore,0.12,0.75,1,1.0,1.0,8.33,1.33,5
Dinamo Tirana,8,2,2,4,7,13,-6,8,Albania - Abissnet Superiore,0.25,0.5,-6,0.88,1.0,4.0,2.0,5
Egnatia R.,8,1,4,3,8,9,-1,7,Albania - Abissnet Superiore,0.12,0.62,-1,1.0,0.88,8.33,1.61,6
Laci,8,1,3,4,4,7,-3,6,Albania - Abissnet Superiore,0.12,0.5,-3,0.5,0.75,8.33,2.0,7
Boca Juniors,8,6,0,2,15,5,10,18,Argentina - Liga Profesional,0.75,0.75,10,1.88,2.25,1.33,1.33,1
Huracan,8,5,3,0,13,5,8,18,Argentina - Liga Profesional,0.62,1.0,8,1.62,2.25,1.61,1.0,1
Independiente,8,4,4,0,12,3,9,16,Argentina - Liga Profesional,0.5,1.0,9,1.5,2.0,2.0,1.0,2
Argentinos Jrs,8,4,3,1,13,6,7,15,Argentina - Liga Profesional,0.5,0.88,7,1.62,1.88,2.0,1.14,3
Rosario Central,8,4,3,1,10,5,5,15,Argentina - Liga Profesional,0.5,0.88,5,1.25,1.88,2.0,1.14,3
Racing Club,8,4,1,3,12,8,4,13,Argentina - Liga Profesional,0.5,0.62,4,1.5,1.62,2.0,1.61,4
River Plate,8,3,4,1,10,7,3,13,Argentina - Liga Profesional,0.38,0.88,3,1.25,1.62,2.63,1.14,4
Newells,8,3,4,1,8,5,3,13,Argentina - Liga Profesional,0.38,0.88,3,1.0,1.62,2.63,1.14,4
I. Rivadavia,8,3,4,1,8,6,2,13,Argentina - Liga Profesional,0.38,0.88,2,1.0,1.62,2.63,1.14,4
Tigre,8,4,1,3,8,7,1,13,Argentina - Liga Profesional,0.5,0.62,1,1.0,1.62,2.0,1.61,4
Lanus,8,2,6,0,9,5,4,12,Argentina - Liga Profesional,0.25,1.0,4,1.12,1.5,4.0,1.0,5
Platense,8,3,3,2,6,4,2,12,Argentina - Liga Profesional,0.38,0.75,2,0.75,1.5,2.63,1.33,5
San Lorenzo,8,3,3,2,7,6,1,12,Argentina - Liga Profesional,0.38,0.75,1,0.88,1.5,2.63,1.33,5
Union Santa Fe,8,3,2,3,7,7,0,11,Argentina - Liga Profesional,0.38,0.62,0,0.88,1.38,2.63,1.61,6
Aldosivi,8,3,2,3,11,12,-1,11,Argentina - Liga Profesional,0.38,0.62,-1,1.38,1.38,2.63,1.61,6
Barracas C.,8,3,2,3,8,9,-1,11,Argentina - Liga Profesional,0.38,0.62,-1,1.0,1.38,2.63,1.61,6
D. Riestra,8,2,5,1,3,4,-1,11,Argentina - Liga Profesional,0.25,0.88,-1,0.38,1.38,4.0,1.14,6
Velez Sarsfield,8,3,1,4,5,7,-2,10,Argentina - Liga Profesional,0.38,0.5,-2,0.62,1.25,2.63,2.0,7
Sarmiento,8,1,6,1,6,6,0,9,Argentina - Liga Profesional,0.12,0.88,0,0.75,1.12,8.33,1.14,8
T. de Cordoba,8,1,5,2,5,5,0,8,Argentina - Liga Profesional,0.12,0.75,0,0.62,1.0,8.33,1.33,9
Estudiantes,8,2,2,4,8,10,-2,8,Argentina - Liga Profesional,0.25,0.5,-2,1.0,1.0,4.0,2.0,9
Belgrano,8,1,5,2,6,9,-3,8,Argentina - Liga Profesional,0.12,0.75,-3,0.75,1.0,8.33,1.33,9
Godoy Cruz,8,1,5,2,4,8,-4,8,Argentina - Liga Profesional,0.12,0.75,-4,0.5,1.0,8.33,1.33,9
Instituto,8,2,2,4,9,14,-5,8,Argentina - Liga Profesional,0.25,0.5,-5,1.12,1.0,4.0,2.0,9
Defensa y J.,8,2,2,4,5,13,-8,8,Argentina - Liga Profesional,0.25,0.5,-8,0.62,1.0,4.0,2.0,9
SM San Juan,8,2,0,6,4,9,-5,6,Argentina - Liga Profesional,0.25,0.25,-5,0.5,0.75,4.0,4.0,10
Gimnasia,8,1,3,4,4,10,-6,6,Argentina - Liga Profesional,0.12,0.5,-6,0.5,0.75,8.33,2.0,10
Central Cordoba,8,1,2,5,6,12,-6,5,Argentina - Liga Profesional,0.12,0.38,-6,0.75,0.62,8.33,2.63,11
A. Tucuman,8,1,1,6,7,12,-5,4,Argentina - Liga Profesional,0.12,0.25,-5,0.88,0.5,8.33,4.0,12
Atlanta,8,5,3,0,9,3,6,18,Argentina - Primera Nacional,0.62,1.0,6,1.12,2.25,1.61,1.0,1
Chacarita J.,8,5,2,1,13,5,8,17,Argentina - Primera Nacional,0.62,0.88,8,1.62,2.12,1.61,1.14,2
G. Mendoza,8,4,4,0,11,4,7,16,Argentina - Primera Nacional,0.5,1.0,7,1.38,2.0,2.0,1.0,3
Atletico Mitre,8,4,4,0,8,1,7,16,Argentina - Primera Nacional,0.5,1.0,7,1.0,2.0,2.0,1.0,3
Quilmes,8,5,1,2,12,6,6,16,Argentina - Primera Nacional,0.62,0.75,6,1.5,2.0,1.61,1.33,3
Gimnasia Jujuy,8,5,1,2,10,4,6,16,Argentina - Primera Nacional,0.62,0.75,6,1.25,2.0,1.61,1.33,3
SM Tucuman,8,4,4,0,7,2,5,16,Argentina - Primera Nacional,0.5,1.0,5,0.88,2.0,2.0,1.0,3
San Telmo,8,4,3,1,8,7,1,15,Argentina - Primera Nacional,0.5,0.88,1,1.0,1.88,2.0,1.14,4
Deportivo Moron,8,4,2,2,9,5,4,14,Argentina - Primera Nacional,0.5,0.75,4,1.12,1.75,2.0,1.33,5
E. Rio Cuarto,8,4,2,2,8,4,4,14,Argentina - Primera Nacional,0.5,0.75,4,1.0,1.75,2.0,1.33,5
Racing Cordoba,8,3,4,1,12,7,5,13,Argentina - Primera Nacional,0.38,0.88,5,1.5,1.62,2.63,1.14,6
Agropecuario,8,4,1,3,9,7,2,13,Argentina - Primera Nacional,0.5,0.62,2,1.12,1.62,2.0,1.61,6
Almagro,8,3,4,1,7,5,2,13,Argentina - Primera Nacional,0.38,0.88,2,0.88,1.62,2.63,1.14,6
Tristan Suarez,8,3,4,1,7,5,2,13,Argentina - Primera Nacional,0.38,0.88,2,0.88,1.62,2.63,1.14,6
D. de Belgrano,8,3,4,1,6,4,2,13,Argentina - Primera Nacional,0.38,0.88,2,0.75,1.62,2.63,1.14,6
CA Estudiantes,8,4,0,4,6,7,-1,12,Argentina - Primera Nacional,0.5,0.5,-1,0.75,1.5,2.0,2.0,7
San Miguel,8,2,5,1,8,6,2,11,Argentina - Primera Nacional,0.25,0.88,2,1.0,1.38,4.0,1.14,8
D. Madryn,8,2,5,1,4,3,1,11,Argentina - Primera Nacional,0.25,0.88,1,0.5,1.38,4.0,1.14,8
Colegiales,8,3,2,3,3,3,0,11,Argentina - Primera Nacional,0.38,0.62,0,0.38,1.38,2.63,1.61,8
All Boys,8,3,1,4,12,11,1,10,Argentina - Primera Nacional,0.38,0.5,1,1.5,1.25,2.63,2.0,9
Patronato,8,2,4,2,7,7,0,10,Argentina - Primera Nacional,0.25,0.75,0,0.88,1.25,4.0,1.33,9
Ferro Carril,8,3,1,4,5,7,-2,10,Argentina - Primera Nacional,0.38,0.5,-2,0.62,1.25,2.63,2.0,9
Chaco For Ever,8,3,1,4,6,9,-3,10,Argentina - Primera Nacional,0.38,0.5,-3,0.75,1.25,2.63,2.0,9
Temperley,8,3,1,4,5,9,-4,10,Argentina - Primera Nacional,0.38,0.5,-4,0.62,1.25,2.63,2.0,9
Los Andes,8,2,3,3,8,7,1,9,Argentina - Primera Nacional,0.25,0.62,1,1.0,1.12,4.0,1.61,10
Nueva Chicago,8,2,3,3,8,8,0,9,Argentina - Primera Nacional,0.25,0.62,0,1.0,1.12,4.0,1.61,10
Alvarado,8,2,3,3,8,10,-2,9,Argentina - Primera Nacional,0.25,0.62,-2,1.0,1.12,4.0,1.61,10
Gimnasia y Tiro,8,1,4,3,4,6,-2,7,Argentina - Primera Nacional,0.12,0.62,-2,0.5,0.88,8.33,1.61,11
Central Norte,8,2,1,5,6,10,-4,7,Argentina - Primera Nacional,0.25,0.38,-4,0.75,0.88,4.0,2.63,11
Argentino Merlo,8,6,1,1,15,6,9,19,Argentina - Primera B,0.75,0.88,9,1.88,2.38,1.33,1.14,1
A. Quilmes,8,5,2,1,12,4,8,17,Argentina - Primera B,0.62,0.88,8,1.5,2.12,1.61,1.14,2
Comunicaciones,8,5,2,1,12,6,6,17,Argentina - Primera B,0.62,0.88,6,1.5,2.12,1.61,1.14,2
Villa Dalmine,8,5,2,1,7,2,5,17,Argentina - Primera B,0.62,0.88,5,0.88,2.12,1.61,1.14,2
Deportivo Merlo,8,4,3,1,8,4,4,15,Argentina - Primera B,0.5,0.88,4,1.0,1.88,2.0,1.14,3
Excursionistas,8,4,2,2,16,9,7,14,Argentina - Primera B,0.5,0.75,7,2.0,1.75,2.0,1.33,4
D. Armenio,8,4,1,3,13,8,5,13,Argentina - Primera B,0.5,0.62,5,1.62,1.62,2.0,1.61,5
Colegiales,8,4,1,3,9,7,2,13,Argentina - Primera B,0.5,0.62,2,1.12,1.62,2.0,1.61,5
Midland,8,3,3,2,10,7,3,12,Argentina - Primera B,0.38,0.75,3,1.25,1.5,2.63,1.33,6
Sacachispas,8,3,2,3,4,6,-2,11,Argentina - Primera B,0.38,0.62,-2,0.5,1.38,2.63,1.61,7
Liniers,8,2,4,2,5,5,0,10,Argentina - Primera B,0.25,0.75,0,0.62,1.25,4.0,1.33,8
S. Italiano,8,2,3,3,9,9,0,9,Argentina - Primera B,0.25,0.62,0,1.12,1.12,4.0,1.61,9
Flandria,8,2,3,3,7,9,-2,9,Argentina - Primera B,0.25,0.62,-2,0.88,1.12,4.0,1.61,9
SM Burzaco,8,3,0,5,5,9,-4,9,Argentina - Primera B,0.38,0.38,-4,0.62,1.12,2.63,2.63,9
Dock Sud,8,2,2,4,5,8,-3,8,Argentina - Primera B,0.25,0.5,-3,0.62,1.0,4.0,2.0,10
Los Andes,8,2,2,4,5,9,-4,8,Argentina - Primera B,0.25,0.5,-4,0.62,1.0,4.0,2.0,10
Acassuso,8,2,2,4,5,12,-7,8,Argentina - Primera B,0.25,0.5,-7,0.62,1.0,4.0,2.0,10
UAI Urquiza,8,2,2,4,10,18,-8,8,Argentina - Primera B,0.25,0.5,-8,1.25,1.0,4.0,2.0,10
V. San Carlos,8,2,1,5,5,9,-4,7,Argentina - Primera B,0.25,0.38,-4,0.62,0.88,4.0,2.63,11
D. Laferrere,8,1,4,3,4,9,-5,7,Argentina - Primera B,0.12,0.62,-5,0.5,0.88,8.33,1.61,11
Canuelas,8,2,0,6,6,11,-5,6,Argentina - Primera B,0.25,0.25,-5,0.75,0.75,4.0,4.0,12
Fenix,8,1,1,6,5,12,-7,4,Argentina - Primera B,0.12,0.25,-7,0.62,0.5,8.33,4.0,13
Ciudad Bolivar,6,4,2,0,12,2,10,14,Argentina - Torneo Federal,0.67,1.0,10,2.0,2.33,1.49,1.0,1
Villa Mitre,7,4,2,1,10,4,6,14,Argentina - Torneo Federal,0.57,0.86,6,1.43,2.0,1.75,1.16,1
G. Chivilcoy,6,4,2,0,7,3,4,14,Argentina - Torneo Federal,0.67,1.0,4,1.17,2.33,1.49,1.0,1
Douglas Haig,7,3,4,0,7,3,4,13,Argentina - Torneo Federal,0.43,1.0,4,1.0,1.86,2.33,1.0,2
Circulo D.,7,4,1,2,10,7,3,13,Argentina - Torneo Federal,0.57,0.71,3,1.43,1.86,1.75,1.41,2
A. Rafaela,7,4,1,2,10,8,2,13,Argentina - Torneo Federal,0.57,0.71,2,1.43,1.86,1.75,1.41,2
Cipolletti,7,4,0,3,13,5,8,12,Argentina - Torneo Federal,0.57,0.57,8,1.86,1.71,1.75,1.75,3
I. Chivilcoy,7,3,3,1,10,5,5,12,Argentina - Torneo Federal,0.43,0.86,5,1.43,1.71,2.33,1.16,3
Sarmiento DLB,6,4,0,2,10,5,5,12,Argentina - Torneo Federal,0.67,0.67,5,1.67,2.0,1.49,1.49,3
D. Rincon,7,4,0,3,10,7,3,12,Argentina - Torneo Federal,0.57,0.57,3,1.43,1.71,1.75,1.75,3
Olimpo Bahia B.,7,3,3,1,7,5,2,12,Argentina - Torneo Federal,0.43,0.86,2,1.0,1.71,2.33,1.16,3
SM Mendoza,6,3,2,1,11,6,5,11,Argentina - Torneo Federal,0.5,0.83,5,1.83,1.83,2.0,1.2,4
S. Belgrano,7,3,2,2,10,6,4,11,Argentina - Torneo Federal,0.43,0.71,4,1.43,1.57,2.33,1.41,4
Huracan Las H.,7,3,2,2,7,10,-3,11,Argentina - Torneo Federal,0.43,0.71,-3,1.0,1.57,2.33,1.41,4
Costa Brava,7,2,4,1,7,5,2,10,Argentina - Torneo Federal,0.29,0.86,2,1.0,1.43,3.45,1.16,5
Kimberley,7,3,1,3,5,5,0,10,Argentina - Torneo Federal,0.43,0.57,0,0.71,1.43,2.33,1.75,5
D. Belgrano VR,7,2,4,1,4,4,0,10,Argentina - Torneo Federal,0.29,0.86,0,0.57,1.43,3.45,1.16,5
SM Formosa,6,2,3,1,6,3,3,9,Argentina - Torneo Federal,0.33,0.83,3,1.0,1.5,3.03,1.2,6
S. Las Parejas,7,2,3,2,6,6,0,9,Argentina - Torneo Federal,0.29,0.71,0,0.86,1.29,3.45,1.41,6
Guillermo Brown,7,3,0,4,10,13,-3,9,Argentina - Torneo Federal,0.43,0.43,-3,1.43,1.29,2.33,2.33,6
Sol de America,6,2,2,2,10,7,3,8,Argentina - Torneo Federal,0.33,0.67,3,1.67,1.33,3.03,1.49,7
J. Antoniana,6,2,2,2,6,4,2,8,Argentina - Torneo Federal,0.33,0.67,2,1.0,1.33,3.03,1.49,7
S. Estudiantes,6,2,2,2,5,3,2,8,Argentina - Torneo Federal,0.33,0.67,2,0.83,1.33,3.03,1.49,7
Argentino MM,6,2,2,2,5,5,0,8,Argentina - Torneo Federal,0.33,0.67,0,0.83,1.33,3.03,1.49,7
Gimnasia E.,7,2,2,3,4,7,-3,8,Argentina - Torneo Federal,0.29,0.57,-3,0.57,1.14,3.45,1.75,7
Bartolomé Mitre,6,2,1,3,5,5,0,7,Argentina - Torneo Federal,0.33,0.5,0,0.83,1.17,3.03,2.0,8
Juventud U. U.,6,1,4,1,5,6,-1,7,Argentina - Torneo Federal,0.17,0.83,-1,0.83,1.17,5.88,1.2,8
Ben Hur,7,2,1,4,7,9,-2,7,Argentina - Torneo Federal,0.29,0.43,-2,1.0,1.0,3.45,2.33,8
Boca Unidos,6,2,1,3,6,9,-3,7,Argentina - Torneo Federal,0.33,0.5,-3,1.0,1.17,3.03,2.0,8
Noah,8,8,0,0,26,3,23,24,Armenia - Premier League,1.0,1.0,23,3.25,3.0,1.0,1.0,1
Ararat-Armenia,8,6,1,1,20,8,12,19,Armenia - Premier League,0.75,0.88,12,2.5,2.38,1.33,1.14,2
Urartu,8,5,2,1,14,8,6,17,Armenia - Premier League,0.62,0.88,6,1.75,2.12,1.61,1.14,3
Van,8,3,4,1,12,8,4,13,Armenia - Premier League,0.38,0.88,4,1.5,1.62,2.63,1.14,4
Ararat Yerevan,8,3,2,3,11,12,-1,11,Armenia - Premier League,0.38,0.62,-1,1.38,1.38,2.63,1.61,5
Pyunik,8,3,1,4,15,15,0,10,Armenia - Premier League,0.38,0.5,0,1.88,1.25,2.63,2.0,6
BKMA,8,2,3,3,9,13,-4,9,Armenia - Premier League,0.25,0.62,-4,1.12,1.12,4.0,1.61,7
West Armenia,8,2,0,6,5,23,-18,6,Armenia - Premier League,0.25,0.25,-18,0.62,0.75,4.0,4.0,8
Shirak,8,1,2,5,8,17,-9,5,Armenia - Premier League,0.12,0.38,-9,1.0,0.62,8.33,2.63,9
Alashkert,8,0,4,4,7,14,-7,4,Armenia - Premier League,0.0,0.5,-7,0.88,0.5,0.0,2.0,10
Gandzasar,8,0,1,7,3,23,-20,1,Armenia - Premier League,0.0,0.12,-20,0.38,0.12,0.0,8.33,11
Western United,8,6,0,2,21,9,12,18,Australia - A-League,0.75,0.75,12,2.62,2.25,1.33,1.33,1
WS Wanderers,8,5,3,0,20,8,12,18,Australia - A-League,0.62,1.0,12,2.5,2.25,1.61,1.0,1
Melbourne City,8,5,2,1,12,7,5,17,Australia - A-League,0.62,0.88,5,1.5,2.12,1.61,1.14,2
Auckland,8,3,5,0,15,10,5,14,Australia - A-League,0.38,1.0,5,1.88,1.75,2.63,1.0,3
Melbourne V.,8,4,2,2,18,15,3,14,Australia - A-League,0.5,0.75,3,2.25,1.75,2.0,1.33,3
Sydney FC,8,3,3,2,13,11,2,12,Australia - A-League,0.38,0.75,2,1.62,1.5,2.63,1.33,4
Brisbane Roar,8,3,2,3,11,14,-3,11,Australia - A-League,0.38,0.62,-3,1.38,1.38,2.63,1.61,5
Newcastle Jets,8,2,2,4,16,16,0,8,Australia - A-League,0.25,0.5,0,2.0,1.0,4.0,2.0,6
Macarthur FC,8,2,2,4,17,18,-1,8,Australia - A-League,0.25,0.5,-1,2.12,1.0,4.0,2.0,6
Adelaide Utd,8,1,3,4,15,21,-6,6,Australia - A-League,0.12,0.5,-6,1.88,0.75,8.33,2.0,7
Wellington,8,1,2,5,10,16,-6,5,Australia - A-League,0.12,0.38,-6,1.25,0.62,8.33,2.63,8
Central Coast,8,1,2,5,8,22,-14,5,Australia - A-League,0.12,0.38,-14,1.0,0.62,8.33,2.63,8
Perth Glory,8,1,1,6,8,16,-8,4,Australia - A-League,0.12,0.25,-8,1.0,0.5,8.33,4.0,9
Oakleigh C.,8,7,0,1,21,6,15,21,Australia - NPL Victoria,0.88,0.88,15,2.62,2.62,1.14,1.14,1
Dandenong T.,8,7,0,1,20,10,10,21,Australia - NPL Victoria,0.88,0.88,10,2.5,2.62,1.14,1.14,1
Heidelberg Utd,8,6,1,1,23,8,15,19,Australia - NPL Victoria,0.75,0.88,15,2.88,2.38,1.33,1.14,2
Avondale,8,6,0,2,22,8,14,18,Australia - NPL Victoria,0.75,0.75,14,2.75,2.25,1.33,1.33,3
Hume City,8,4,1,3,12,14,-2,13,Australia - NPL Victoria,0.5,0.62,-2,1.5,1.62,2.0,1.61,4
Green Gully,8,4,1,3,9,12,-3,13,Australia - NPL Victoria,0.5,0.62,-3,1.12,1.62,2.0,1.61,4
Preston Lions,8,3,2,3,11,11,0,11,Australia - NPL Victoria,0.38,0.62,0,1.38,1.38,2.63,1.61,5
Dandenong City,8,3,1,4,14,14,0,10,Australia - NPL Victoria,0.38,0.5,0,1.75,1.25,2.63,2.0,6
M. Victory B,8,3,1,4,13,16,-3,10,Australia - NPL Victoria,0.38,0.5,-3,1.62,1.25,2.63,2.0,6
St. Albans,8,3,0,5,14,15,-1,9,Australia - NPL Victoria,0.38,0.38,-1,1.75,1.12,2.63,2.63,7
Melbourne K.,8,2,0,6,8,15,-7,6,Australia - NPL Victoria,0.25,0.25,-7,1.0,0.75,4.0,4.0,8
Port Melbourne,8,2,0,6,8,24,-16,6,Australia - NPL Victoria,0.25,0.25,-16,1.0,0.75,4.0,4.0,8
Altona Magic,8,0,3,5,2,12,-10,3,Australia - NPL Victoria,0.0,0.38,-10,0.25,0.38,0.0,2.63,9
South Melbourne,8,0,2,6,2,14,-12,2,Australia - NPL Victoria,0.0,0.25,-12,0.25,0.25,0.0,4.0,10
Moreton City E.,4,4,0,0,10,4,6,12,Australia - NPL Queensland,1.0,1.0,6,2.5,3.0,1.0,1.0,1
Gold C. Knights,4,3,0,1,6,3,3,9,Australia - NPL Queensland,0.75,0.75,3,1.5,2.25,1.33,1.33,2
Gold C. Utd,4,3,0,1,6,4,2,9,Australia - NPL Queensland,0.75,0.75,2,1.5,2.25,1.33,1.33,2
Peninsula,4,2,1,1,8,3,5,7,Australia - NPL Queensland,0.5,0.75,5,2.0,1.75,2.0,1.33,3
Q. Lions,5,2,1,2,9,7,2,7,Australia - NPL Queensland,0.4,0.6,2,1.8,1.4,2.5,1.67,3
Olympic FC,4,2,0,2,7,4,3,6,Australia - NPL Queensland,0.5,0.5,3,1.75,1.5,2.0,2.0,4
Eastern Suburbs,3,1,2,0,6,4,2,5,Australia - NPL Queensland,0.33,1.0,2,2.0,1.67,3.03,1.0,5
SC Wanderers,4,1,1,2,4,6,-2,4,Australia - NPL Queensland,0.25,0.5,-2,1.0,1.0,4.0,2.0,6
Wynnum Wolves,5,1,1,3,6,10,-4,4,Australia - NPL Queensland,0.2,0.4,-4,1.2,0.8,5.0,2.5,6
Brisbane City,4,1,0,3,5,9,-4,3,Australia - NPL Queensland,0.25,0.25,-4,1.25,0.75,4.0,4.0,7
Brisbane Roar B,4,1,0,3,3,10,-7,3,Australia - NPL Queensland,0.25,0.25,-7,0.75,0.75,4.0,4.0,7
St George W.,5,0,2,3,4,10,-6,2,Australia - NPL Queensland,0.0,0.4,-6,0.8,0.4,0.0,2.5,8
Austria Wien,8,6,1,1,16,6,10,19,Austria - Bundesliga,0.75,0.88,10,2.0,2.38,1.33,1.14,1
Wolfsberger AC,8,5,1,2,19,11,8,16,Austria - Bundesliga,0.62,0.75,8,2.38,2.0,1.61,1.33,2
Salzburg,8,4,4,0,12,5,7,16,Austria - Bundesliga,0.5,1.0,7,1.5,2.0,2.0,1.0,2
BW Linz,8,5,1,2,13,9,4,16,Austria - Bundesliga,0.62,0.75,4,1.62,2.0,1.61,1.33,2
Sturm Graz,8,4,2,2,15,13,2,14,Austria - Bundesliga,0.5,0.75,2,1.88,1.75,2.0,1.33,3
LASK Linz,8,3,2,3,10,12,-2,11,Austria - Bundesliga,0.38,0.62,-2,1.25,1.38,2.63,1.61,4
Hartberg,8,2,3,3,7,13,-6,9,Austria - Bundesliga,0.25,0.62,-6,0.88,1.12,4.0,1.61,5
Rapid Wien,8,2,1,5,14,12,2,7,Austria - Bundesliga,0.25,0.38,2,1.75,0.88,4.0,2.63,6
Altach,8,1,4,3,8,15,-7,7,Austria - Bundesliga,0.12,0.62,-7,1.0,0.88,8.33,1.61,6
Tirol,8,1,3,4,9,13,-4,6,Austria - Bundesliga,0.12,0.5,-4,1.12,0.75,8.33,2.0,7
A. Klagenfurt,8,1,3,4,9,14,-5,6,Austria - Bundesliga,0.12,0.5,-5,1.12,0.75,8.33,2.0,7
Grazer AK,8,1,1,6,9,19,-10,4,Austria - Bundesliga,0.12,0.25,-10,1.12,0.5,8.33,4.0,8
Kapfenberger,8,6,0,2,19,13,6,18,Austria - 2. Liga,0.75,0.75,6,2.38,2.25,1.33,1.33,1
First Vienna,8,5,1,2,14,9,5,16,Austria - 2. Liga,0.62,0.75,5,1.75,2.0,1.61,1.33,2
Liefering,8,5,0,3,13,9,4,15,Austria - 2. Liga,0.62,0.62,4,1.62,1.88,1.61,1.61,3
St. Polten,8,4,2,2,20,12,8,14,Austria - 2. Liga,0.5,0.75,8,2.5,1.75,2.0,1.33,4
Ried,8,4,2,2,16,8,8,14,Austria - 2. Liga,0.5,0.75,8,2.0,1.75,2.0,1.33,4
Admira Wacker,8,4,2,2,16,12,4,14,Austria - 2. Liga,0.5,0.75,4,2.0,1.75,2.0,1.33,4
Floridsdorfer,8,4,2,2,9,8,1,14,Austria - 2. Liga,0.5,0.75,1,1.12,1.75,2.0,1.33,4
Stripfing,8,3,4,1,13,11,2,13,Austria - 2. Liga,0.38,0.88,2,1.62,1.62,2.63,1.14,5
A. Lustenau,8,3,2,3,7,7,0,11,Austria - 2. Liga,0.38,0.62,0,0.88,1.38,2.63,1.61,6
Sturm Graz B,8,3,2,3,10,11,-1,11,Austria - 2. Liga,0.38,0.62,-1,1.25,1.38,2.63,1.61,6
SV Horn,8,2,2,4,8,11,-3,8,Austria - 2. Liga,0.25,0.5,-3,1.0,1.0,4.0,2.0,7
Voitsberg,8,2,2,4,8,12,-4,8,Austria - 2. Liga,0.25,0.5,-4,1.0,1.0,4.0,2.0,7
Bregenz,8,2,0,6,13,16,-3,6,Austria - 2. Liga,0.25,0.25,-3,1.62,0.75,4.0,4.0,8
Amstetten,8,1,3,4,10,13,-3,6,Austria - 2. Liga,0.12,0.5,-3,1.25,0.75,8.33,2.0,8
Lafnitz,8,1,2,5,13,23,-10,5,Austria - 2. Liga,0.12,0.38,-10,1.62,0.62,8.33,2.63,9
Rapid Wien B,8,1,1,6,4,20,-16,4,Austria - 2. Liga,0.12,0.25,-16,0.5,0.5,8.33,4.0,10
Qarabag,8,6,2,0,18,4,14,20,Azerbaijan - Premier League,0.75,1.0,14,2.25,2.5,1.33,1.0,1
Zira,8,6,1,1,15,5,10,19,Azerbaijan - Premier League,0.75,0.88,10,1.88,2.38,1.33,1.14,2
Shamakhi,8,4,2,2,9,9,0,14,Azerbaijan - Premier League,0.5,0.75,0,1.12,1.75,2.0,1.33,3
Neftci,8,3,2,3,9,11,-2,11,Azerbaijan - Premier League,0.38,0.62,-2,1.12,1.38,2.63,1.61,4
Araz,8,1,6,1,9,9,0,9,Azerbaijan - Premier League,0.12,0.88,0,1.12,1.12,8.33,1.14,5
Kapaz,8,2,3,3,4,7,-3,9,Azerbaijan - Premier League,0.25,0.62,-3,0.5,1.12,4.0,1.61,5
Sabah,8,1,4,3,11,13,-2,7,Azerbaijan - Premier League,0.12,0.62,-2,1.38,0.88,8.33,1.61,6
Sumqayit,8,2,1,5,10,14,-4,7,Azerbaijan - Premier League,0.25,0.38,-4,1.25,0.88,4.0,2.63,6
Turan,8,1,4,3,7,12,-5,7,Azerbaijan - Premier League,0.12,0.62,-5,0.88,0.88,8.33,1.61,6
Sebail,8,0,3,5,6,14,-8,3,Azerbaijan - Premier League,0.0,0.38,-8,0.75,0.38,0.0,2.63,7
Al-Muharraq,8,8,0,0,22,5,17,24,Bahrain - Premier League,1.0,1.0,17,2.75,3.0,1.0,1.0,1
Al Riffa,8,4,2,2,18,12,6,14,Bahrain - Premier League,0.5,0.75,6,2.25,1.75,2.0,1.33,2
Khalidiya,8,4,2,2,15,12,3,14,Bahrain - Premier League,0.5,0.75,3,1.88,1.75,2.0,1.33,2
Sitra,8,3,4,1,11,7,4,13,Bahrain - Premier League,0.38,0.88,4,1.38,1.62,2.63,1.14,3
East Riffa,8,2,5,1,10,10,0,11,Bahrain - Premier League,0.25,0.88,0,1.25,1.38,4.0,1.14,4
Al Shabbab,8,2,3,3,7,8,-1,9,Bahrain - Premier League,0.25,0.62,-1,0.88,1.12,4.0,1.61,5
Malkiya,8,1,6,1,7,8,-1,9,Bahrain - Premier League,0.12,0.88,-1,0.88,1.12,8.33,1.14,5
Bahrain SC,8,2,3,3,10,14,-4,9,Bahrain - Premier League,0.25,0.62,-4,1.25,1.12,4.0,1.61,5
Al Ahli M.,8,2,2,4,9,12,-3,8,Bahrain - Premier League,0.25,0.5,-3,1.12,1.0,4.0,2.0,6
AAli FC,8,1,4,3,10,14,-4,7,Bahrain - Premier League,0.12,0.62,-4,1.25,0.88,8.33,1.61,7
Manama,8,1,3,4,7,15,-8,6,Bahrain - Premier League,0.12,0.5,-8,0.88,0.75,8.33,2.0,8
Al-Najma,8,0,3,5,4,12,-8,3,Bahrain - Premier League,0.0,0.38,-8,0.5,0.38,0.0,2.63,9
Mohammedan,8,6,1,1,15,4,11,19,Bangladesh - Premier League,0.75,0.88,11,1.88,2.38,1.33,1.14,1
Abahani,8,5,3,0,17,2,15,18,Bangladesh - Premier League,0.62,1.0,15,2.12,2.25,1.61,1.0,2
Bashundhara K.,8,4,3,1,19,5,14,15,Bangladesh - Premier League,0.5,0.88,14,2.38,1.88,2.0,1.14,3
Fortis,8,3,4,1,9,5,4,13,Bangladesh - Premier League,0.38,0.88,4,1.12,1.62,2.63,1.14,4
B. Police,8,4,1,3,8,10,-2,13,Bangladesh - Premier League,0.5,0.62,-2,1.0,1.62,2.0,1.61,4
Brothers Union,8,3,2,3,10,6,4,11,Bangladesh - Premier League,0.38,0.62,4,1.25,1.38,2.63,1.61,5
Rahmatgonj,8,3,1,4,17,11,6,10,Bangladesh - Premier League,0.38,0.5,6,2.12,1.25,2.63,2.0,6
Fakirerpool,8,2,1,5,9,24,-15,7,Bangladesh - Premier League,0.25,0.38,-15,1.12,0.88,4.0,2.63,7
Chittagong,8,1,0,7,2,17,-15,3,Bangladesh - Premier League,0.12,0.12,-15,0.25,0.38,8.33,8.33,8
Dhaka Wanderers,8,1,0,7,5,27,-22,3,Bangladesh - Premier League,0.12,0.12,-22,0.62,0.38,8.33,8.33,8
Slavia Mozyr,6,4,2,0,13,5,8,14,Belarus - Vysshaya Liga,0.67,1.0,8,2.17,2.33,1.49,1.0,1
Maxline,6,4,2,0,12,4,8,14,Belarus - Vysshaya Liga,0.67,1.0,8,2.0,2.33,1.49,1.0,1
Isloch,6,3,3,0,14,6,8,12,Belarus - Vysshaya Liga,0.5,1.0,8,2.33,2.0,2.0,1.0,2
Vitebsk,6,3,1,2,12,6,6,10,Belarus - Vysshaya Liga,0.5,0.67,6,2.0,1.67,2.0,1.49,3
Dinamo Minsk,5,3,1,1,7,5,2,10,Belarus - Vysshaya Liga,0.6,0.8,2,1.4,2.0,1.67,1.25,3
BATE Borisov,6,3,1,2,5,3,2,10,Belarus - Vysshaya Liga,0.5,0.67,2,0.83,1.67,2.0,1.49,3
FC Minsk,6,3,1,2,9,10,-1,10,Belarus - Vysshaya Liga,0.5,0.67,-1,1.5,1.67,2.0,1.49,3
Neman Grodno,5,3,0,2,8,3,5,9,Belarus - Vysshaya Liga,0.6,0.6,5,1.6,1.8,1.67,1.67,4
Dinamo Brest,6,2,3,1,6,5,1,9,Belarus - Vysshaya Liga,0.33,0.83,1,1.0,1.5,3.03,1.2,4
T. Zhodino,6,1,5,0,4,3,1,8,Belarus - Vysshaya Liga,0.17,1.0,1,0.67,1.33,5.88,1.0,5
Naftan,6,2,1,3,7,12,-5,7,Belarus - Vysshaya Liga,0.33,0.5,-5,1.17,1.17,3.03,2.0,6
Gomel,6,1,2,3,2,5,-3,5,Belarus - Vysshaya Liga,0.17,0.5,-3,0.33,0.83,5.88,2.0,7
Slutsk,6,1,1,4,4,7,-3,4,Belarus - Vysshaya Liga,0.17,0.33,-3,0.67,0.67,5.88,3.03,8
Arsenal D.,6,0,4,2,6,10,-4,4,Belarus - Vysshaya Liga,0.0,0.67,-4,1.0,0.67,0.0,1.49,8
Smorgon,6,0,1,5,3,12,-9,1,Belarus - Vysshaya Liga,0.0,0.17,-9,0.5,0.17,0.0,5.88,9
Molodechno,6,0,0,6,3,19,-16,0,Belarus - Vysshaya Liga,0.0,0.0,-16,0.5,0.0,0.0,0.0,10
BATE B,5,3,1,1,16,6,10,10,Belarus - First League,0.6,0.8,10,3.2,2.0,1.67,1.25,1
Niva,5,2,3,0,11,6,5,9,Belarus - First League,0.4,1.0,5,2.2,1.8,2.5,1.0,2
Lida,5,3,0,2,13,9,4,9,Belarus - First League,0.6,0.6,4,2.6,1.8,1.67,1.67,2
Volna Pinsk,5,2,3,0,12,9,3,9,Belarus - First League,0.4,1.0,3,2.4,1.8,2.5,1.0,2
Dinamo Minsk B,5,2,3,0,7,4,3,9,Belarus - First League,0.4,1.0,3,1.4,1.8,2.5,1.0,2
Ostrovets,5,3,0,2,10,9,1,9,Belarus - First League,0.6,0.6,1,2.0,1.8,1.67,1.67,2
Slonim,5,3,0,2,7,7,0,9,Belarus - First League,0.6,0.6,0,1.4,1.8,1.67,1.67,2
Lokomotiv Gomel,5,2,2,1,8,8,0,8,Belarus - First League,0.4,0.8,0,1.6,1.6,2.5,1.25,3
Dnepr Mogilev,5,2,2,1,8,9,-1,8,Belarus - First League,0.4,0.8,-1,1.6,1.6,2.5,1.25,3
ABFF U19,5,2,1,2,4,4,0,7,Belarus - First League,0.4,0.6,0,0.8,1.4,2.5,1.67,4
Bumprom,5,1,3,1,6,5,1,6,Belarus - First League,0.2,0.8,1,1.2,1.2,5.0,1.25,5
Belshina,4,1,2,1,7,6,1,5,Belarus - First League,0.25,0.75,1,1.75,1.25,4.0,1.33,6
Baranovichi,4,1,2,1,6,6,0,5,Belarus - First League,0.25,0.75,0,1.5,1.25,4.0,1.33,6
Osipovichy,5,1,2,2,10,11,-1,5,Belarus - First League,0.2,0.6,-1,2.0,1.0,5.0,1.67,6
Uni X L. Minsk,5,1,1,3,6,13,-7,4,Belarus - First League,0.2,0.4,-7,1.2,0.8,5.0,2.5,7
Gomel B,5,0,3,2,5,7,-2,3,Belarus - First League,0.0,0.6,-2,1.0,0.6,0.0,1.67,8
Orsha,5,1,0,4,7,16,-9,3,Belarus - First League,0.2,0.2,-9,1.4,0.6,5.0,5.0,8
Minsk B,5,0,0,5,3,11,-8,0,Belarus - First League,0.0,0.0,-8,0.6,0.0,0.0,0.0,9
KRC Genk,8,6,2,0,11,5,6,20,Belgium - Pro League,0.75,1.0,6,1.38,2.5,1.33,1.0,1
Royale Union SG,8,6,0,2,18,6,12,18,Belgium - Pro League,0.75,0.75,12,2.25,2.25,1.33,1.33,2
Anderlecht,8,5,0,3,12,6,6,15,Belgium - Pro League,0.62,0.62,6,1.5,1.88,1.61,1.61,3
Westerlo,8,4,2,2,13,10,3,14,Belgium - Pro League,0.5,0.75,3,1.62,1.75,2.0,1.33,4
Gent,8,3,4,1,10,8,2,13,Belgium - Pro League,0.38,0.88,2,1.25,1.62,2.63,1.14,5
Club Brugge,8,3,3,2,14,11,3,12,Belgium - Pro League,0.38,0.75,3,1.75,1.5,2.63,1.33,6
OH Leuven,8,3,3,2,9,9,0,12,Belgium - Pro League,0.38,0.75,0,1.12,1.5,2.63,1.33,6
KV Mechelen,8,3,2,3,9,11,-2,11,Belgium - Pro League,0.38,0.62,-2,1.12,1.38,2.63,1.61,7
Antwerp,8,2,4,2,7,8,-1,10,Belgium - Pro League,0.25,0.75,-1,0.88,1.25,4.0,1.33,8
Charleroi,8,2,3,3,13,10,3,9,Belgium - Pro League,0.25,0.62,3,1.62,1.12,4.0,1.61,9
Sint-Truiden,8,2,3,3,14,13,1,9,Belgium - Pro League,0.25,0.62,1,1.75,1.12,4.0,1.61,9
Kortrijk,8,2,2,4,11,13,-2,8,Belgium - Pro League,0.25,0.5,-2,1.38,1.0,4.0,2.0,10
Standard Liege,8,2,2,4,7,13,-6,8,Belgium - Pro League,0.25,0.5,-6,0.88,1.0,4.0,2.0,10
Cercle Brugge,8,0,5,3,6,12,-6,5,Belgium - Pro League,0.0,0.62,-6,0.75,0.62,0.0,1.61,11
Beerschot,8,1,2,5,5,13,-8,5,Belgium - Pro League,0.12,0.38,-8,0.62,0.62,8.33,2.63,11
Dender,8,1,1,6,6,17,-11,4,Belgium - Pro League,0.12,0.25,-11,0.75,0.5,8.33,4.0,12
Lokeren-Temse,8,7,0,1,15,4,11,21,Belgium - Challenger Pro League,0.88,0.88,11,1.88,2.62,1.14,1.14,1
La Louviere,8,6,2,0,15,6,9,20,Belgium - Challenger Pro League,0.75,1.0,9,1.88,2.5,1.33,1.0,2
Beveren,8,6,1,1,17,8,9,19,Belgium - Challenger Pro League,0.75,0.88,9,2.12,2.38,1.33,1.14,3
RWDM,8,5,1,2,10,4,6,16,Belgium - Challenger Pro League,0.62,0.75,6,1.25,2.0,1.61,1.33,4
Club Brugge B,8,4,1,3,13,9,4,13,Belgium - Challenger Pro League,0.5,0.62,4,1.62,1.62,2.0,1.61,5
Zulte-Waregem,8,4,1,3,13,10,3,13,Belgium - Challenger Pro League,0.5,0.62,3,1.62,1.62,2.0,1.61,5
Patro Eisden,8,3,3,2,8,7,1,12,Belgium - Challenger Pro League,0.38,0.75,1,1.0,1.5,2.63,1.33,6
RFC Liege,8,3,2,3,15,14,1,11,Belgium - Challenger Pro League,0.38,0.62,1,1.88,1.38,2.63,1.61,7
Eupen,8,3,2,3,8,10,-2,11,Belgium - Challenger Pro League,0.38,0.62,-2,1.0,1.38,2.63,1.61,7
Lierse K.,8,3,1,4,9,8,1,10,Belgium - Challenger Pro League,0.38,0.5,1,1.12,1.25,2.63,2.0,8
Lommel SK,8,3,1,4,8,8,0,10,Belgium - Challenger Pro League,0.38,0.5,0,1.0,1.25,2.63,2.0,8
Francs Borains,8,2,0,6,8,15,-7,6,Belgium - Challenger Pro League,0.25,0.25,-7,1.0,0.75,4.0,4.0,9
Seraing,8,0,3,5,7,19,-12,3,Belgium - Challenger Pro League,0.0,0.38,-12,0.88,0.38,0.0,2.63,10
Anderlecht B,8,0,2,6,9,22,-13,2,Belgium - Challenger Pro League,0.0,0.25,-13,1.12,0.25,0.0,4.0,11
KRC Genk B,8,0,1,7,4,17,-13,1,Belgium - Challenger Pro League,0.0,0.12,-13,0.5,0.12,0.0,8.33,12
Deinze,0,0,0,0,0,0,0,0,Belgium - Challenger Pro League,0.0,0.0,0,0.0,0.0,0.0,0.0,13
Always Ready,5,5,0,0,14,2,12,15,Bolivia - Primera Div. - Apertura,1.0,1.0,12,2.8,3.0,1.0,1.0,1
Bolivar,5,4,0,1,18,7,11,12,Bolivia - Primera Div. - Apertura,0.8,0.8,11,3.6,2.4,1.25,1.25,2
ABB,5,3,2,0,5,1,4,11,Bolivia - Primera Div. - Apertura,0.6,1.0,4,1.0,2.2,1.67,1.0,3
The Strongest,5,3,1,1,11,6,5,10,Bolivia - Primera Div. - Apertura,0.6,0.8,5,2.2,2.0,1.67,1.25,4
Blooming,5,3,0,2,10,10,0,9,Bolivia - Primera Div. - Apertura,0.6,0.6,0,2.0,1.8,1.67,1.67,5
Aurora,5,2,1,2,13,11,2,7,Bolivia - Primera Div. - Apertura,0.4,0.6,2,2.6,1.4,2.5,1.67,6
Gualberto V. SJ,5,2,1,2,6,8,-2,7,Bolivia - Primera Div. - Apertura,0.4,0.6,-2,1.2,1.4,2.5,1.67,6
Guabira,5,2,0,3,10,13,-3,6,Bolivia - Primera Div. - Apertura,0.4,0.4,-3,2.0,1.2,2.5,2.5,7
SA Bulo Bulo,5,1,2,2,5,7,-2,5,Bolivia - Primera Div. - Apertura,0.2,0.6,-2,1.0,1.0,5.0,1.67,8
Real Tomayapo,5,1,2,2,4,6,-2,5,Bolivia - Primera Div. - Apertura,0.2,0.6,-2,0.8,1.0,5.0,1.67,8
I. Petrolero,5,1,2,2,3,6,-3,5,Bolivia - Primera Div. - Apertura,0.2,0.6,-3,0.6,1.0,5.0,1.67,8
U. de Vinto,5,1,2,2,6,12,-6,5,Bolivia - Primera Div. - Apertura,0.2,0.6,-6,1.2,1.0,5.0,1.67,8
Nacional Potosi,5,1,1,3,6,7,-1,4,Bolivia - Primera Div. - Apertura,0.2,0.4,-1,1.2,0.8,5.0,2.5,9
Real Oruro,5,0,3,2,4,7,-3,3,Bolivia - Primera Div. - Apertura,0.0,0.6,-3,0.8,0.6,0.0,1.67,10
Oriente P.,5,0,3,2,4,9,-5,3,Bolivia - Primera Div. - Apertura,0.0,0.6,-5,0.8,0.6,0.0,1.67,10
Wilstermann,5,1,0,4,3,10,-7,3,Bolivia - Primera Div. - Apertura,0.2,0.2,-7,0.6,0.6,5.0,5.0,10
Bolivar,8,6,1,1,28,11,17,19,Bolivia - Primera Div. - Clausura,0.75,0.88,17,3.5,2.38,1.33,1.14,1
The Strongest,8,6,0,2,26,11,15,18,Bolivia - Primera Div. - Clausura,0.75,0.75,15,3.25,2.25,1.33,1.33,2
Always Ready,8,4,1,3,20,13,7,13,Bolivia - Primera Div. - Clausura,0.5,0.62,7,2.5,1.62,2.0,1.61,3
Gualberto V. SJ,8,4,1,3,18,12,6,13,Bolivia - Primera Div. - Clausura,0.5,0.62,6,2.25,1.62,2.0,1.61,3
Nacional Potosi,8,4,1,3,16,12,4,13,Bolivia - Primera Div. - Clausura,0.5,0.62,4,2.0,1.62,2.0,1.61,3
Royal Pari,8,4,1,3,11,10,1,13,Bolivia - Primera Div. - Clausura,0.5,0.62,1,1.38,1.62,2.0,1.61,3
Aurora,8,3,3,2,19,14,5,12,Bolivia - Primera Div. - Clausura,0.38,0.75,5,2.38,1.5,2.63,1.33,4
Real Tomayapo,8,4,0,4,14,12,2,12,Bolivia - Primera Div. - Clausura,0.5,0.5,2,1.75,1.5,2.0,2.0,4
Blooming,8,3,3,2,10,13,-3,12,Bolivia - Primera Div. - Clausura,0.38,0.75,-3,1.25,1.5,2.63,1.33,4
Guabira,8,3,2,3,10,10,0,11,Bolivia - Primera Div. - Clausura,0.38,0.62,0,1.25,1.38,2.63,1.61,5
Wilstermann,8,2,4,2,11,13,-2,10,Bolivia - Primera Div. - Clausura,0.25,0.75,-2,1.38,1.25,4.0,1.33,6
I. Petrolero,8,3,0,5,13,20,-7,9,Bolivia - Primera Div. - Clausura,0.38,0.38,-7,1.62,1.12,2.63,2.63,7
SA Bulo Bulo,8,2,2,4,14,22,-8,8,Bolivia - Primera Div. - Clausura,0.25,0.5,-8,1.75,1.0,4.0,2.0,8
Oriente P.,8,2,1,5,14,23,-9,7,Bolivia - Primera Div. - Clausura,0.25,0.38,-9,1.75,0.88,4.0,2.63,9
U. de Vinto,8,2,1,5,8,17,-9,7,Bolivia - Primera Div. - Clausura,0.25,0.38,-9,1.0,0.88,4.0,2.63,9
Santa Cruz,8,1,0,7,7,27,-20,3,Bolivia - Primera Div. - Clausura,0.12,0.12,-20,0.88,0.38,8.33,8.33,10
Flamengo,6,4,2,0,15,2,13,14,Brazil - Serie A,0.67,1.0,13,2.5,2.33,1.49,1.0,1
Palmeiras,6,4,1,1,7,3,4,13,Brazil - Serie A,0.67,0.83,4,1.17,2.17,1.49,1.2,2
Bragantino,6,4,1,1,8,5,3,13,Brazil - Serie A,0.67,0.83,3,1.33,2.17,1.49,1.2,2
Cruzeiro,6,3,1,2,7,6,1,10,Brazil - Serie A,0.5,0.67,1,1.17,1.67,2.0,1.49,3
Fluminense,6,3,1,2,6,6,0,10,Brazil - Serie A,0.5,0.67,0,1.0,1.67,2.0,1.49,3
Internacional,6,2,3,1,8,4,4,9,Brazil - Serie A,0.33,0.83,4,1.33,1.5,3.03,1.2,4
Bahia,6,2,3,1,6,7,-1,9,Brazil - Serie A,0.33,0.83,-1,1.0,1.5,3.03,1.2,4
Botafogo,6,2,2,2,6,4,2,8,Brazil - Serie A,0.33,0.67,2,1.0,1.33,3.03,1.49,5
Ceara,6,2,2,2,8,7,1,8,Brazil - Serie A,0.33,0.67,1,1.33,1.33,3.03,1.49,5
Sao Paulo,6,1,5,0,6,5,1,8,Brazil - Serie A,0.17,1.0,1,1.0,1.33,5.88,1.0,5
Mirassol,6,1,4,1,11,9,2,7,Brazil - Serie A,0.17,0.83,2,1.83,1.17,5.88,1.2,6
Vasco da Gama,6,2,1,3,6,8,-2,7,Brazil - Serie A,0.33,0.5,-2,1.0,1.17,3.03,2.0,6
Corinthians,6,2,1,3,6,10,-4,7,Brazil - Serie A,0.33,0.5,-4,1.0,1.17,3.03,2.0,6
Juventude,6,2,1,3,7,14,-7,7,Brazil - Serie A,0.33,0.5,-7,1.17,1.17,3.03,2.0,6
Fortaleza,6,1,3,2,5,5,0,6,Brazil - Serie A,0.17,0.67,0,0.83,1.0,5.88,1.49,7
Vitoria,6,1,3,2,7,9,-2,6,Brazil - Serie A,0.17,0.67,-2,1.17,1.0,5.88,1.49,7
Atletico MG,6,1,3,2,6,8,-2,6,Brazil - Serie A,0.17,0.67,-2,1.0,1.0,5.88,1.49,7
Gremio,6,1,2,3,5,11,-6,5,Brazil - Serie A,0.17,0.5,-6,0.83,0.83,5.88,2.0,8
Santos,6,1,1,4,7,9,-2,4,Brazil - Serie A,0.17,0.33,-2,1.17,0.67,5.88,3.03,9
Sport Recife,6,0,2,4,3,8,-5,2,Brazil - Serie A,0.0,0.33,-5,0.5,0.33,0.0,3.03,10
Avai,5,3,2,0,9,3,6,11,Brazil - Serie B,0.6,1.0,6,1.8,2.2,1.67,1.0,1
Cuiaba,5,3,2,0,7,4,3,11,Brazil - Serie B,0.6,1.0,3,1.4,2.2,1.67,1.0,1
Vila Nova,5,3,1,1,6,3,3,10,Brazil - Serie B,0.6,0.8,3,1.2,2.0,1.67,1.25,2
Coritiba,5,3,1,1,5,2,3,10,Brazil - Serie B,0.6,0.8,3,1.0,2.0,1.67,1.25,2
CRB,5,3,1,1,5,4,1,10,Brazil - Serie B,0.6,0.8,1,1.0,2.0,1.67,1.25,2
Remo,5,2,3,0,7,4,3,9,Brazil - Serie B,0.4,1.0,3,1.4,1.8,2.5,1.0,3
Athletico PR,5,3,0,2,8,6,2,9,Brazil - Serie B,0.6,0.6,2,1.6,1.8,1.67,1.67,3
Novorizontino,5,2,3,0,5,3,2,9,Brazil - Serie B,0.4,1.0,2,1.0,1.8,2.5,1.0,3
America MG,5,3,0,2,5,6,-1,9,Brazil - Serie B,0.6,0.6,-1,1.0,1.8,1.67,1.67,3
Goias,4,2,1,1,5,4,1,7,Brazil - Serie B,0.5,0.75,1,1.25,1.75,2.0,1.33,4
Ferroviaria,5,1,3,1,3,2,1,6,Brazil - Serie B,0.2,0.8,1,0.6,1.2,5.0,1.25,5
Atletico GO,5,1,3,1,7,7,0,6,Brazil - Serie B,0.2,0.8,0,1.4,1.2,5.0,1.25,5
Chapecoense,5,2,0,3,4,4,0,6,Brazil - Serie B,0.4,0.4,0,0.8,1.2,2.5,2.5,5
Criciuma,5,1,2,2,8,6,2,5,Brazil - Serie B,0.2,0.6,2,1.6,1.0,5.0,1.67,6
Operario PR,5,1,1,3,3,6,-3,4,Brazil - Serie B,0.2,0.4,-3,0.6,0.8,5.0,2.5,7
Athletic Club,5,1,0,4,5,12,-7,3,Brazil - Serie B,0.2,0.2,-7,1.0,0.6,5.0,5.0,8
Botafogo SP,4,0,2,2,3,6,-3,2,Brazil - Serie B,0.0,0.5,-3,0.75,0.5,0.0,2.0,9
Paysandu,5,0,2,3,2,6,-4,2,Brazil - Serie B,0.0,0.4,-4,0.4,0.4,0.0,2.5,9
Amazonas,5,0,2,3,2,7,-5,2,Brazil - Serie B,0.0,0.4,-5,0.4,0.4,0.0,2.5,9
Volta Redonda,5,0,1,4,1,5,-4,1,Brazil - Serie B,0.0,0.2,-4,0.2,0.2,0.0,5.0,10
Londrina,3,2,1,0,6,2,4,7,Brazil - Serie C,0.67,1.0,4,2.0,2.33,1.49,1.0,1
Ituano,3,2,1,0,4,1,3,7,Brazil - Serie C,0.67,1.0,3,1.33,2.33,1.49,1.0,1
Maringa,3,2,1,0,5,3,2,7,Brazil - Serie C,0.67,1.0,2,1.67,2.33,1.49,1.0,1
Ponte Preta,3,2,1,0,4,2,2,7,Brazil - Serie C,0.67,1.0,2,1.33,2.33,1.49,1.0,1
Brusque,3,2,1,0,2,0,2,7,Brazil - Serie C,0.67,1.0,2,0.67,2.33,1.49,1.0,1
Botafogo PB,3,1,2,0,3,0,3,5,Brazil - Serie C,0.33,1.0,3,1.0,1.67,3.03,1.0,2
CSA,3,1,2,0,4,3,1,5,Brazil - Serie C,0.33,1.0,1,1.33,1.67,3.03,1.0,2
Retro,3,1,1,1,2,2,0,4,Brazil - Serie C,0.33,0.67,0,0.67,1.33,3.03,1.49,3
Sao Bernardo,3,1,1,1,2,2,0,4,Brazil - Serie C,0.33,0.67,0,0.67,1.33,3.03,1.49,3
Tombense,3,1,1,1,4,5,-1,4,Brazil - Serie C,0.33,0.67,-1,1.33,1.33,3.03,1.49,3
ABC,3,0,3,0,2,2,0,3,Brazil - Serie C,0.0,1.0,0,0.67,1.0,0.0,1.0,4
Caxias,2,1,0,1,2,2,0,3,Brazil - Serie C,0.5,0.5,0,1.0,1.5,2.0,2.0,4
Itabaiana,3,1,0,2,4,5,-1,3,Brazil - Serie C,0.33,0.33,-1,1.33,1.0,3.03,3.03,4
Ypiranga,3,1,0,2,4,6,-2,3,Brazil - Serie C,0.33,0.33,-2,1.33,1.0,3.03,3.03,4
Confianca,3,1,0,2,3,6,-3,3,Brazil - Serie C,0.33,0.33,-3,1.0,1.0,3.03,3.03,4
Anapolis,2,0,1,1,1,2,-1,1,Brazil - Serie C,0.0,0.5,-1,0.5,0.5,0.0,2.0,5
Figueirense,3,0,1,2,4,6,-2,1,Brazil - Serie C,0.0,0.33,-2,1.33,0.33,0.0,3.03,5
Nautico,3,0,1,2,2,4,-2,1,Brazil - Serie C,0.0,0.33,-2,0.67,0.33,0.0,3.03,5
Guarani,2,0,0,2,2,4,-2,0,Brazil - Serie C,0.0,0.0,-2,1.0,0.0,0.0,0.0,6
Floresta,2,0,0,2,0,3,-3,0,Brazil - Serie C,0.0,0.0,-3,0.0,0.0,0.0,0.0,6
ASA,2,2,0,0,7,2,5,6,Brazil - Serie D,1.0,1.0,5,3.5,3.0,1.0,1.0,1
Tuna Luso,2,2,0,0,7,2,5,6,Brazil - Serie D,1.0,1.0,5,3.5,3.0,1.0,1.0,1
Santa Cruz,2,2,0,0,5,0,5,6,Brazil - Serie D,1.0,1.0,5,2.5,3.0,1.0,1.0,1
Inter Limeira,2,2,0,0,4,1,3,6,Brazil - Serie D,1.0,1.0,3,2.0,3.0,1.0,1.0,1
Aguia de Maraba,2,2,0,0,3,0,3,6,Brazil - Serie D,1.0,1.0,3,1.5,3.0,1.0,1.0,1
Azuriz,2,2,0,0,3,1,2,6,Brazil - Serie D,1.0,1.0,2,1.5,3.0,1.0,1.0,1
Ceilandia,2,2,0,0,3,1,2,6,Brazil - Serie D,1.0,1.0,2,1.5,3.0,1.0,1.0,1
Luverdense,2,2,0,0,2,0,2,6,Brazil - Serie D,1.0,1.0,2,1.0,3.0,1.0,1.0,1
Manaus,2,1,1,0,5,1,4,4,Brazil - Serie D,0.5,1.0,4,2.5,2.0,2.0,1.0,2
America RN,2,1,1,0,4,0,4,4,Brazil - Serie D,0.5,1.0,4,2.0,2.0,2.0,1.0,2
Lagarto,2,1,1,0,4,3,1,4,Brazil - Serie D,0.5,1.0,1,2.0,2.0,2.0,1.0,2
Mixto,2,1,1,0,4,3,1,4,Brazil - Serie D,0.5,1.0,1,2.0,2.0,2.0,1.0,2
Portuguesa,2,1,1,0,4,3,1,4,Brazil - Serie D,0.5,1.0,1,2.0,2.0,2.0,1.0,2
Pouso Alegre,2,1,1,0,4,3,1,4,Brazil - Serie D,0.5,1.0,1,2.0,2.0,2.0,1.0,2
Cianorte,2,1,1,0,3,2,1,4,Brazil - Serie D,0.5,1.0,1,1.5,2.0,2.0,1.0,2
Itabirito,2,1,1,0,3,2,1,4,Brazil - Serie D,0.5,1.0,1,1.5,2.0,2.0,1.0,2
Manauara,2,1,1,0,3,2,1,4,Brazil - Serie D,0.5,1.0,1,1.5,2.0,2.0,1.0,2
Central,2,1,1,0,2,1,1,4,Brazil - Serie D,0.5,1.0,1,1.0,2.0,2.0,1.0,2
Imperatriz,2,1,1,0,2,1,1,4,Brazil - Serie D,0.5,1.0,1,1.0,2.0,2.0,1.0,2
Joinville,2,1,1,0,2,1,1,4,Brazil - Serie D,0.5,1.0,1,1.0,2.0,2.0,1.0,2
Aparecidense,2,1,1,0,1,0,1,4,Brazil - Serie D,0.5,1.0,1,0.5,2.0,2.0,1.0,2
Barra FC,2,1,0,1,3,1,2,3,Brazil - Serie D,0.5,0.5,2,1.5,1.5,2.0,2.0,3
Goiatuba EC,2,1,0,1,5,4,1,3,Brazil - Serie D,0.5,0.5,1,2.5,1.5,2.0,2.0,3
Ferroviario,2,1,0,1,4,3,1,3,Brazil - Serie D,0.5,0.5,1,2.0,1.5,2.0,2.0,3
CFRJ . Marica,2,1,0,1,3,2,1,3,Brazil - Serie D,0.5,0.5,1,1.5,1.5,2.0,2.0,3
Agua Santa,2,1,0,1,4,4,0,3,Brazil - Serie D,0.5,0.5,0,2.0,1.5,2.0,2.0,3
Iguatu,2,1,0,1,2,2,0,3,Brazil - Serie D,0.5,0.5,0,1.0,1.5,2.0,2.0,3
Rio Branco ES,2,1,0,1,2,2,0,3,Brazil - Serie D,0.5,0.5,0,1.0,1.5,2.0,2.0,3
Brasil de P.,2,1,0,1,1,1,0,3,Brazil - Serie D,0.5,0.5,0,0.5,1.5,2.0,2.0,3
Flamengo,8,7,1,0,22,0,22,22,Brazil - Carioca,0.88,1.0,22,2.75,2.75,1.14,1.0,1
Fluminense,8,4,3,1,12,7,5,15,Brazil - Carioca,0.5,0.88,5,1.5,1.88,2.0,1.14,2
Vasco da Gama,8,4,2,2,11,7,4,14,Brazil - Carioca,0.5,0.75,4,1.38,1.75,2.0,1.33,3
Volta Redonda,8,4,2,2,11,10,1,14,Brazil - Carioca,0.5,0.75,1,1.38,1.75,2.0,1.33,3
Sampaio Correa,8,3,3,2,11,9,2,12,Brazil - Carioca,0.38,0.75,2,1.38,1.5,2.63,1.33,4
Madureira,8,3,2,3,7,5,2,11,Brazil - Carioca,0.38,0.62,2,0.88,1.38,2.63,1.61,5
Boavista,8,1,7,0,7,5,2,10,Brazil - Carioca,0.12,1.0,2,0.88,1.25,8.33,1.0,6
Botafogo,8,3,1,4,7,8,-1,10,Brazil - Carioca,0.38,0.5,-1,0.88,1.25,2.63,2.0,6
Nova Iguacu,8,2,3,3,4,7,-3,9,Brazil - Carioca,0.25,0.62,-3,0.5,1.12,4.0,1.61,7
CFRJ . Marica,8,1,2,5,7,15,-8,5,Brazil - Carioca,0.12,0.38,-8,0.88,0.62,8.33,2.63,8
Portuguesa RJ,8,1,1,6,9,21,-12,4,Brazil - Carioca,0.12,0.25,-12,1.12,0.5,8.33,4.0,9
Bangu,8,0,3,5,4,18,-14,3,Brazil - Carioca,0.0,0.38,-14,0.5,0.38,0.0,2.63,10
Atletico MG,8,4,4,0,9,2,7,16,Brazil - Mineiro,0.5,1.0,7,1.12,2.0,2.0,1.0,1
Tombense,8,5,1,2,8,5,3,16,Brazil - Mineiro,0.62,0.75,3,1.0,2.0,1.61,1.33,1
Betim,8,4,3,1,12,5,7,15,Brazil - Mineiro,0.5,0.88,7,1.5,1.88,2.0,1.14,2
America MG,8,3,4,1,14,5,9,13,Brazil - Mineiro,0.38,0.88,9,1.75,1.62,2.63,1.14,3
Athletic Club,8,4,0,4,12,12,0,12,Brazil - Mineiro,0.5,0.5,0,1.5,1.5,2.0,2.0,4
Cruzeiro,8,3,2,3,11,9,2,11,Brazil - Mineiro,0.38,0.62,2,1.38,1.38,2.63,1.61,5
Democrata GV,8,3,2,3,8,9,-1,11,Brazil - Mineiro,0.38,0.62,-1,1.0,1.38,2.63,1.61,5
Uberlandia,8,2,3,3,10,10,0,9,Brazil - Mineiro,0.25,0.62,0,1.25,1.12,4.0,1.61,6
Itabirito,8,2,2,4,7,11,-4,8,Brazil - Mineiro,0.25,0.5,-4,0.88,1.0,4.0,2.0,7
Pouso Alegre,8,2,2,4,7,15,-8,8,Brazil - Mineiro,0.25,0.5,-8,0.88,1.0,4.0,2.0,7
Aymores,8,1,4,3,3,5,-2,7,Brazil - Mineiro,0.12,0.62,-2,0.38,0.88,8.33,1.61,8
Villa Nova,8,1,1,6,4,17,-13,4,Brazil - Mineiro,0.12,0.25,-13,0.5,0.5,8.33,4.0,9
Anapolis,8,6,0,2,13,6,7,18,Brazil - Goiano,0.75,0.75,7,1.62,2.25,1.33,1.33,1
Vila Nova,8,4,3,1,8,5,3,15,Brazil - Goiano,0.5,0.88,3,1.0,1.88,2.0,1.14,2
Atletico GO,8,4,2,2,10,6,4,14,Brazil - Goiano,0.5,0.75,4,1.25,1.75,2.0,1.33,3
CRAC,8,4,2,2,7,4,3,14,Brazil - Goiano,0.5,0.75,3,0.88,1.75,2.0,1.33,3
Goias,8,4,2,2,7,5,2,14,Brazil - Goiano,0.5,0.75,2,0.88,1.75,2.0,1.33,3
Goianesia,8,2,4,2,11,9,2,10,Brazil - Goiano,0.25,0.75,2,1.38,1.25,4.0,1.33,4
ABECAT Ouvidore,8,3,1,4,8,10,-2,10,Brazil - Goiano,0.38,0.5,-2,1.0,1.25,2.63,2.0,4
Goiatuba EC,8,2,4,2,4,6,-2,10,Brazil - Goiano,0.25,0.75,-2,0.5,1.25,4.0,1.33,4
Jataiense,8,3,0,5,10,10,0,9,Brazil - Goiano,0.38,0.38,0,1.25,1.12,2.63,2.63,5
Goiania,8,2,1,5,8,14,-6,7,Brazil - Goiano,0.25,0.38,-6,1.0,0.88,4.0,2.63,6
Aparecidense,8,1,3,4,4,7,-3,6,Brazil - Goiano,0.12,0.5,-3,0.5,0.75,8.33,2.0,7
Inhumas,8,1,2,5,5,13,-8,5,Brazil - Goiano,0.12,0.38,-8,0.62,0.62,8.33,2.63,8
Santa Cruz,8,6,1,1,13,3,10,19,Brazil - Pernambucano,0.75,0.88,10,1.62,2.38,1.33,1.14,1
Nautico,8,5,0,3,14,8,6,15,Brazil - Pernambucano,0.62,0.62,6,1.75,1.88,1.61,1.61,2
Sport Recife,8,4,2,2,16,7,9,14,Brazil - Pernambucano,0.5,0.75,9,2.0,1.75,2.0,1.33,3
Maguary PE,8,4,2,2,10,9,1,14,Brazil - Pernambucano,0.5,0.75,1,1.25,1.75,2.0,1.33,3
Retro,8,3,3,2,7,7,0,12,Brazil - Pernambucano,0.38,0.75,0,0.88,1.5,2.63,1.33,4
Decisao,8,3,3,2,10,11,-1,12,Brazil - Pernambucano,0.38,0.75,-1,1.25,1.5,2.63,1.33,4
Jaguar,8,3,1,4,10,16,-6,10,Brazil - Pernambucano,0.38,0.5,-6,1.25,1.25,2.63,2.0,5
Central,8,2,2,4,8,9,-1,8,Brazil - Pernambucano,0.25,0.5,-1,1.0,1.0,4.0,2.0,6
Afogados,8,0,4,4,4,12,-8,4,Brazil - Pernambucano,0.0,0.5,-8,0.5,0.5,0.0,2.0,7
Petrolina,8,0,2,6,3,13,-10,2,Brazil - Pernambucano,0.0,0.25,-10,0.38,0.25,0.0,4.0,8
Corinthians,8,5,3,0,13,7,6,18,Brazil - Paulista,0.62,1.0,6,1.62,2.25,1.61,1.0,1
Palmeiras,8,4,4,0,15,6,9,16,Brazil - Paulista,0.5,1.0,9,1.88,2.0,2.0,1.0,2
Ponte Preta,8,5,1,2,9,6,3,16,Brazil - Paulista,0.62,0.75,3,1.12,2.0,1.61,1.33,2
Santos,8,4,2,2,15,8,7,14,Brazil - Paulista,0.5,0.75,7,1.88,1.75,2.0,1.33,3
Bragantino,8,4,2,2,10,5,5,14,Brazil - Paulista,0.5,0.75,5,1.25,1.75,2.0,1.33,3
Sao Bernardo,8,4,2,2,12,11,1,14,Brazil - Paulista,0.5,0.75,1,1.5,1.75,2.0,1.33,3
Novorizontino,8,3,4,1,8,6,2,13,Brazil - Paulista,0.38,0.88,2,1.0,1.62,2.63,1.14,4
Portuguesa,8,2,5,1,12,10,2,11,Brazil - Paulista,0.25,0.88,2,1.5,1.38,4.0,1.14,5
Velo Clube,8,2,4,2,10,10,0,10,Brazil - Paulista,0.25,0.75,0,1.25,1.25,4.0,1.33,6
Sao Paulo,8,2,3,3,12,11,1,9,Brazil - Paulista,0.25,0.62,1,1.5,1.12,4.0,1.61,7
Botafogo SP,8,2,3,3,8,10,-2,9,Brazil - Paulista,0.25,0.62,-2,1.0,1.12,4.0,1.61,7
Mirassol,8,2,1,5,10,17,-7,7,Brazil - Paulista,0.25,0.38,-7,1.25,0.88,4.0,2.63,8
Guarani,8,1,3,4,10,13,-3,6,Brazil - Paulista,0.12,0.5,-3,1.25,0.75,8.33,2.0,9
Agua Santa,8,0,4,4,5,13,-8,4,Brazil - Paulista,0.0,0.5,-8,0.62,0.5,0.0,2.0,10
Noroeste,8,0,3,5,9,16,-7,3,Brazil - Paulista,0.0,0.38,-7,1.12,0.38,0.0,2.63,11
Inter Limeira,8,0,3,5,5,15,-10,3,Brazil - Paulista,0.0,0.38,-10,0.62,0.38,0.0,2.63,11
Treze,8,5,2,1,17,7,10,17,Brazil - Paraibano,0.62,0.88,10,2.12,2.12,1.61,1.14,1
Sousa,8,5,2,1,12,3,9,17,Brazil - Paraibano,0.62,0.88,9,1.5,2.12,1.61,1.14,1
Botafogo PB,8,5,1,2,15,6,9,16,Brazil - Paraibano,0.62,0.75,9,1.88,2.0,1.61,1.33,2
Serra Branca,8,4,2,2,20,8,12,14,Brazil - Paraibano,0.5,0.75,12,2.5,1.75,2.0,1.33,3
Campinense,8,4,2,2,14,9,5,14,Brazil - Paraibano,0.5,0.75,5,1.75,1.75,2.0,1.33,3
Pombal,8,2,3,3,7,8,-1,9,Brazil - Paraibano,0.25,0.62,-1,0.88,1.12,4.0,1.61,4
Nacional Patos,8,2,3,3,13,17,-4,9,Brazil - Paraibano,0.25,0.62,-4,1.62,1.12,4.0,1.61,4
EC de Patos,8,2,1,5,11,16,-5,7,Brazil - Paraibano,0.25,0.38,-5,1.38,0.88,4.0,2.63,5
Auto Esporte,8,1,3,4,8,15,-7,6,Brazil - Paraibano,0.12,0.5,-7,1.0,0.75,8.33,2.0,6
Picuiense,8,0,1,7,5,33,-28,1,Brazil - Paraibano,0.0,0.12,-28,0.62,0.12,0.0,8.33,7
Santa Catarina,8,4,3,1,14,9,5,15,Brazil - Catarinense,0.5,0.88,5,1.75,1.88,2.0,1.14,1
Brusque,8,4,2,2,12,6,6,14,Brazil - Catarinense,0.5,0.75,6,1.5,1.75,2.0,1.33,2
Avai,8,4,1,3,12,6,6,13,Brazil - Catarinense,0.5,0.62,6,1.5,1.62,2.0,1.61,3
Criciuma,8,3,4,1,10,4,6,13,Brazil - Catarinense,0.38,0.88,6,1.25,1.62,2.63,1.14,3
Figueirense,8,4,1,3,16,11,5,13,Brazil - Catarinense,0.5,0.62,5,2.0,1.62,2.0,1.61,3
Barra FC,8,3,3,2,6,7,-1,12,Brazil - Catarinense,0.38,0.75,-1,0.75,1.5,2.63,1.33,4
Marcilio Dias,8,2,4,2,7,8,-1,10,Brazil - Catarinense,0.25,0.75,-1,0.88,1.25,4.0,1.33,5
Concordia,8,3,1,4,8,15,-7,10,Brazil - Catarinense,0.38,0.5,-7,1.0,1.25,2.63,2.0,5
Chapecoense,8,1,6,1,10,9,1,9,Brazil - Catarinense,0.12,0.88,1,1.25,1.12,8.33,1.14,6
Joinville,8,2,3,3,9,14,-5,9,Brazil - Catarinense,0.25,0.62,-5,1.12,1.12,4.0,1.61,6
Caravaggio,8,2,1,5,5,12,-7,7,Brazil - Catarinense,0.25,0.38,-7,0.62,0.88,4.0,2.63,7
Hercilio Luz,8,1,2,5,6,13,-7,5,Brazil - Catarinense,0.12,0.38,-7,0.75,0.62,8.33,2.63,8
Internacional,8,6,2,0,16,4,12,20,Brazil - Gaucho,0.75,1.0,12,2.0,2.5,1.33,1.0,1
Juventude,8,6,1,1,14,6,8,19,Brazil - Gaucho,0.75,0.88,8,1.75,2.38,1.33,1.14,2
Gremio,8,5,2,1,19,3,16,17,Brazil - Gaucho,0.62,0.88,16,2.38,2.12,1.61,1.14,3
Caxias,8,4,2,2,8,9,-1,14,Brazil - Gaucho,0.5,0.75,-1,1.0,1.75,2.0,1.33,4
Ypiranga,8,3,3,2,6,6,0,12,Brazil - Gaucho,0.38,0.75,0,0.75,1.5,2.63,1.33,5
Guarany de Bage,8,2,3,3,6,6,0,9,Brazil - Gaucho,0.25,0.62,0,0.75,1.12,4.0,1.61,6
Sao Luiz,8,2,3,3,7,13,-6,9,Brazil - Gaucho,0.25,0.62,-6,0.88,1.12,4.0,1.61,6
Brasil de P.,8,1,4,3,5,10,-5,7,Brazil - Gaucho,0.12,0.62,-5,0.62,0.88,8.33,1.61,7
Monsoon,8,2,1,5,7,14,-7,7,Brazil - Gaucho,0.25,0.38,-7,0.88,0.88,4.0,2.63,7
Pelotas,8,1,3,4,6,13,-7,6,Brazil - Gaucho,0.12,0.5,-7,0.75,0.75,8.33,2.0,8
EC Sao Jose,8,0,5,3,5,10,-5,5,Brazil - Gaucho,0.0,0.62,-5,0.62,0.62,0.0,1.61,9
Avenida,8,0,3,5,4,9,-5,3,Brazil - Gaucho,0.0,0.38,-5,0.5,0.38,0.0,2.63,10
Ludogorets,8,7,0,1,17,4,13,21,Bulgaria - Parva Liga,0.88,0.88,13,2.12,2.62,1.14,1.14,1
CSKA Sofia,8,5,2,1,9,3,6,17,Bulgaria - Parva Liga,0.62,0.88,6,1.12,2.12,1.61,1.14,2
Arda,8,4,3,1,21,7,14,15,Bulgaria - Parva Liga,0.5,0.88,14,2.62,1.88,2.0,1.14,3
Slavia Sofia,8,4,2,2,18,15,3,14,Bulgaria - Parva Liga,0.5,0.75,3,2.25,1.75,2.0,1.33,4
Levski Sofia,8,3,4,1,11,8,3,13,Bulgaria - Parva Liga,0.38,0.88,3,1.38,1.62,2.63,1.14,5
Spartak Varna,8,4,1,3,11,9,2,13,Bulgaria - Parva Liga,0.5,0.62,2,1.38,1.62,2.0,1.61,5
Lokomotiv Sofia,8,3,1,4,11,14,-3,10,Bulgaria - Parva Liga,0.38,0.5,-3,1.38,1.25,2.63,2.0,6
CSKA 1948 Sofia,8,3,0,5,13,13,0,9,Bulgaria - Parva Liga,0.38,0.38,0,1.62,1.12,2.63,2.63,7
Botev Plovdiv,8,1,6,1,8,10,-2,9,Bulgaria - Parva Liga,0.12,0.88,-2,1.0,1.12,8.33,1.14,7
Lok. Plovdiv,8,2,2,4,4,7,-3,8,Bulgaria - Parva Liga,0.25,0.5,-3,0.5,1.0,4.0,2.0,8
Botev Vratsa,8,2,2,4,7,11,-4,8,Bulgaria - Parva Liga,0.25,0.5,-4,0.88,1.0,4.0,2.0,8
Cherno More,8,1,5,2,7,12,-5,8,Bulgaria - Parva Liga,0.12,0.75,-5,0.88,1.0,8.33,1.33,8
L. Krumovgrad,8,2,2,4,3,11,-8,8,Bulgaria - Parva Liga,0.25,0.5,-8,0.38,1.0,4.0,2.0,8
Septemvri Sofia,8,2,1,5,11,16,-5,7,Bulgaria - Parva Liga,0.25,0.38,-5,1.38,0.88,4.0,2.63,9
Hebar,8,2,1,5,8,15,-7,7,Bulgaria - Parva Liga,0.25,0.38,-7,1.0,0.88,4.0,2.63,9
Beroe,8,1,3,4,6,11,-5,6,Bulgaria - Parva Liga,0.12,0.5,-5,0.75,0.75,8.33,2.0,10
A. Ottawa,4,3,1,0,12,6,6,10,Canada - Premier League,0.75,1.0,6,3.0,2.5,1.33,1.0,1
HFX Wanderers,4,3,1,0,8,4,4,10,Canada - Premier League,0.75,1.0,4,2.0,2.5,1.33,1.0,1
Forge,4,2,2,0,6,3,3,8,Canada - Premier League,0.5,1.0,3,1.5,2.0,2.0,1.0,2
York Utd,4,1,1,2,7,7,0,4,Canada - Premier League,0.25,0.5,0,1.75,1.0,4.0,2.0,3
Pacific,4,1,1,2,4,6,-2,4,Canada - Premier League,0.25,0.5,-2,1.0,1.0,4.0,2.0,3
Vancouver FC,4,0,2,2,3,8,-5,2,Canada - Premier League,0.0,0.5,-5,0.75,0.5,0.0,2.0,4
Cavalry,3,0,1,2,2,5,-3,1,Canada - Premier League,0.0,0.33,-3,0.67,0.33,0.0,3.03,5
Valour,3,0,1,2,1,4,-3,1,Canada - Premier League,0.0,0.33,-3,0.33,0.33,0.0,3.03,5
U. Catolica,8,5,2,1,16,6,10,17,Chile - Primera Division,0.62,0.88,10,2.0,2.12,1.61,1.14,1
Audax Italiano,8,5,1,2,14,7,7,16,Chile - Primera Division,0.62,0.75,7,1.75,2.0,1.61,1.33,2
Huachipato,8,5,1,2,14,7,7,16,Chile - Primera Division,0.62,0.75,7,1.75,2.0,1.61,1.33,2
Cobresal,8,4,3,1,12,7,5,15,Chile - Primera Division,0.5,0.88,5,1.5,1.88,2.0,1.14,3
U. de Chile,7,4,1,2,14,8,6,13,Chile - Primera Division,0.57,0.71,6,2.0,1.86,1.75,1.41,4
Palestino,8,4,1,3,12,8,4,13,Chile - Primera Division,0.5,0.62,4,1.5,1.62,2.0,1.61,4
OHiggins,8,3,4,1,10,7,3,13,Chile - Primera Division,0.38,0.88,3,1.25,1.62,2.63,1.14,4
Coquimbo Unido,8,3,4,1,6,5,1,13,Chile - Primera Division,0.38,0.88,1,0.75,1.62,2.63,1.14,4
La Serena,8,4,1,3,9,10,-1,13,Chile - Primera Division,0.5,0.62,-1,1.12,1.62,2.0,1.61,4
Union La Calera,8,3,2,3,7,7,0,11,Chile - Primera Division,0.38,0.62,0,0.88,1.38,2.63,1.61,5
Colo-Colo,6,3,1,2,9,5,4,10,Chile - Primera Division,0.5,0.67,4,1.5,1.67,2.0,1.49,6
Nublense,8,2,3,3,6,10,-4,9,Chile - Primera Division,0.25,0.62,-4,0.75,1.12,4.0,1.61,7
Union Espanola,8,2,0,6,9,14,-5,6,Chile - Primera Division,0.25,0.25,-5,1.12,0.75,4.0,4.0,8
Everton,8,1,2,5,5,17,-12,5,Chile - Primera Division,0.12,0.38,-12,0.62,0.62,8.33,2.63,9
D. Limache,8,1,1,6,10,17,-7,4,Chile - Primera Division,0.12,0.25,-7,1.25,0.5,8.33,4.0,10
D. Iquique,8,0,2,6,6,20,-14,2,Chile - Primera Division,0.0,0.25,-14,0.75,0.25,0.0,4.0,11
San Marcos,8,5,1,2,12,8,4,16,Chile - Primera B,0.62,0.75,4,1.5,2.0,1.61,1.33,1
Copiapo,8,4,3,1,12,6,6,15,Chile - Primera B,0.5,0.88,6,1.5,1.88,2.0,1.14,2
S. Wanderers,8,4,3,1,13,9,4,15,Chile - Primera B,0.5,0.88,4,1.62,1.88,2.0,1.14,2
Recoleta,8,4,2,2,8,8,0,14,Chile - Primera B,0.5,0.75,0,1.0,1.75,2.0,1.33,3
Concepcion,8,4,1,3,13,11,2,13,Chile - Primera B,0.5,0.62,2,1.62,1.62,2.0,1.61,4
San Luis,8,3,4,1,9,7,2,13,Chile - Primera B,0.38,0.88,2,1.12,1.62,2.63,1.14,4
Cobreloa,8,2,5,1,11,9,2,11,Chile - Primera B,0.25,0.88,2,1.38,1.38,4.0,1.14,5
Rangers,8,2,4,2,11,11,0,10,Chile - Primera B,0.25,0.75,0,1.38,1.25,4.0,1.33,6
Curico Unido,8,2,4,2,9,9,0,10,Chile - Primera B,0.25,0.75,0,1.12,1.25,4.0,1.33,6
U. Concepcion,8,3,1,4,7,7,0,10,Chile - Primera B,0.38,0.5,0,0.88,1.25,2.63,2.0,6
Antofagasta,8,2,3,3,11,15,-4,9,Chile - Primera B,0.25,0.62,-4,1.38,1.12,4.0,1.61,7
Magallanes,8,2,2,4,7,8,-1,8,Chile - Primera B,0.25,0.5,-1,0.88,1.0,4.0,2.0,8
S. Morning,8,2,2,4,6,9,-3,8,Chile - Primera B,0.25,0.5,-3,0.75,1.0,4.0,2.0,8
CD Santa Cruz,8,2,1,5,8,13,-5,7,Chile - Primera B,0.25,0.38,-5,1.0,0.88,4.0,2.63,9
U. San Felipe,8,1,3,4,6,9,-3,6,Chile - Primera B,0.12,0.5,-3,0.75,0.75,8.33,2.0,10
Deportes Temuco,8,1,3,4,7,11,-4,6,Chile - Primera B,0.12,0.5,-4,0.88,0.75,8.33,2.0,10
S. Shenhua,8,6,2,0,18,9,9,20,China - Super League,0.75,1.0,9,2.25,2.5,1.33,1.0,1
Chengdu,8,5,2,1,14,6,8,17,China - Super League,0.62,0.88,8,1.75,2.12,1.61,1.14,2
Shanghai Port,8,5,2,1,19,12,7,17,China - Super League,0.62,0.88,7,2.38,2.12,1.61,1.14,2
Beijing Guoan,8,4,4,0,20,10,10,16,China - Super League,0.5,1.0,10,2.5,2.0,2.0,1.0,3
Shandong T.,8,5,0,3,20,16,4,15,China - Super League,0.62,0.62,4,2.5,1.88,1.61,1.61,4
Qingdao West C.,8,3,3,2,16,16,0,12,China - Super League,0.38,0.75,0,2.0,1.5,2.63,1.33,5
Tianjin T.,8,3,3,2,12,12,0,12,China - Super League,0.38,0.75,0,1.5,1.5,2.63,1.33,5
Zhejiang,8,3,2,3,14,11,3,11,China - Super League,0.38,0.62,3,1.75,1.38,2.63,1.61,6
Meizhou Hakka,8,3,2,3,16,14,2,11,China - Super League,0.38,0.62,2,2.0,1.38,2.63,1.61,6
Yunnan Yukun,8,2,3,3,11,14,-3,9,China - Super League,0.25,0.62,-3,1.38,1.12,4.0,1.61,7
Dalian Yingbo,8,2,3,3,7,11,-4,9,China - Super League,0.25,0.62,-4,0.88,1.12,4.0,1.61,7
Wuhan Three T.,8,2,2,4,11,18,-7,8,China - Super League,0.25,0.5,-7,1.38,1.0,4.0,2.0,8
Henan SL,8,2,1,5,10,12,-2,7,China - Super League,0.25,0.38,-2,1.25,0.88,4.0,2.63,9
Sichuan Jiuniu,8,2,1,5,9,19,-10,7,China - Super League,0.25,0.38,-10,1.12,0.88,4.0,2.63,9
Changchun Yatai,8,1,2,5,7,13,-6,5,China - Super League,0.12,0.38,-6,0.88,0.62,8.33,2.63,10
Qingdao Hainiu,8,0,2,6,5,12,-7,2,China - Super League,0.0,0.25,-7,0.62,0.25,0.0,4.0,11
Chongqing T.,6,5,1,0,13,5,8,16,China - League One,0.83,1.0,8,2.17,2.67,1.2,1.0,1
Liaoning Tieren,6,5,0,1,18,5,13,15,China - League One,0.83,0.83,13,3.0,2.5,1.2,1.2,2
S. Gongfu,6,4,2,0,10,3,7,14,China - League One,0.67,1.0,7,1.67,2.33,1.49,1.0,3
Guangdong GZP,6,4,1,1,12,4,8,13,China - League One,0.67,0.83,8,2.0,2.17,1.49,1.2,4
Suzhou Dongwu,6,2,4,0,5,1,4,10,China - League One,0.33,1.0,4,0.83,1.67,3.03,1.0,5
Nantong Zhiyun,6,2,2,2,6,7,-1,8,China - League One,0.33,0.67,-1,1.0,1.33,3.03,1.49,6
Heilongjiang IC,6,1,4,1,7,8,-1,7,China - League One,0.17,0.83,-1,1.17,1.17,5.88,1.2,7
Shanghai Jiadin,6,2,1,3,5,7,-2,7,China - League One,0.33,0.5,-2,0.83,1.17,3.03,2.0,7
Yanbian Longdin,6,2,1,3,6,11,-5,7,China - League One,0.33,0.5,-5,1.0,1.17,3.03,2.0,7
Nanjing City,6,1,3,2,4,5,-1,6,China - League One,0.17,0.67,-1,0.67,1.0,5.88,1.49,8
Dalian Kuncheng,6,1,3,2,5,7,-2,6,China - League One,0.17,0.67,-2,0.83,1.0,5.88,1.49,8
Shenzhen J.,6,2,0,4,6,14,-8,6,China - League One,0.33,0.33,-8,1.0,1.0,3.03,3.03,8
Shaanxi Union,6,1,2,3,6,7,-1,5,China - League One,0.17,0.5,-1,1.0,0.83,5.88,2.0,9
Foshan Nanshi,6,1,1,4,3,9,-6,4,China - League One,0.17,0.33,-6,0.5,0.67,5.88,3.03,10
Qingdao RL,6,0,3,3,3,8,-5,3,China - League One,0.0,0.5,-5,0.5,0.5,0.0,2.0,11
Guangxi Baoyun,6,0,2,4,3,11,-8,2,China - League One,0.0,0.33,-8,0.5,0.33,0.0,3.03,12
Guangzhou Dande,6,4,1,1,10,3,7,13,China - League Two,0.67,0.83,7,1.67,2.17,1.49,1.2,1
Changchun Xidu,6,4,1,1,8,3,5,13,China - League Two,0.67,0.83,5,1.33,2.17,1.49,1.2,1
Wuxi Wugou,6,3,3,0,8,2,6,12,China - League Two,0.5,1.0,6,1.33,2.0,2.0,1.0,2
Wenzhou Pro.,6,3,3,0,7,2,5,12,China - League Two,0.5,1.0,5,1.17,2.0,2.0,1.0,2
Chengdu Rongche,6,3,2,1,8,4,4,11,China - League Two,0.5,0.83,4,1.33,1.83,2.0,1.2,3
Guangxi H.,6,3,2,1,6,4,2,11,China - League Two,0.5,0.83,2,1.0,1.83,2.0,1.2,3
Ganzhou Ruishi,6,2,4,0,6,3,3,10,China - League Two,0.33,1.0,3,1.0,1.67,3.03,1.0,4
Guizhou Zhuchen,6,3,1,2,6,6,0,10,China - League Two,0.5,0.67,0,1.0,1.67,2.0,1.49,4
Shanghai Port B,6,3,0,3,9,6,3,9,China - League Two,0.5,0.5,3,1.5,1.5,2.0,2.0,5
Haikou M.,6,2,3,1,6,5,1,9,China - League Two,0.33,0.83,1,1.0,1.5,3.03,1.2,5
Shandong T. B,6,2,3,1,6,5,1,9,China - League Two,0.33,0.83,1,1.0,1.5,3.03,1.2,5
Jiangxi Lushan,6,2,3,1,5,4,1,9,China - League Two,0.33,0.83,1,0.83,1.5,3.03,1.2,5
Langfang Glory,6,2,3,1,6,7,-1,9,China - League Two,0.33,0.83,-1,1.0,1.5,3.03,1.2,5
Shenzhen 2028,6,2,2,2,4,5,-1,8,China - League Two,0.33,0.67,-1,0.67,1.33,3.03,1.49,6
Xian Ronghai,6,1,4,1,3,6,-3,7,China - League Two,0.17,0.83,-3,0.5,1.17,5.88,1.2,7
Hubei Istar,6,1,3,2,4,5,-1,6,China - League Two,0.17,0.67,-1,0.67,1.0,5.88,1.49,8
Rizhao Yuqi,6,1,3,2,3,6,-3,6,China - League Two,0.17,0.67,-3,0.5,1.0,5.88,1.49,8
Nantong Haimen,6,1,3,2,4,8,-4,6,China - League Two,0.17,0.67,-4,0.67,1.0,5.88,1.49,8
Taian Tiankuang,6,1,1,4,5,6,-1,4,China - League Two,0.17,0.33,-1,0.83,0.67,5.88,3.03,9
Wuhan Three Tow,6,0,4,2,2,4,-2,4,China - League Two,0.0,0.67,-2,0.33,0.67,0.0,1.49,9
Beijing IT,6,1,1,4,4,7,-3,4,China - League Two,0.17,0.33,-3,0.67,0.67,5.88,3.03,9
Quanzhou Yassin,6,0,3,3,2,6,-4,3,China - League Two,0.0,0.5,-4,0.33,0.5,0.0,2.0,10
Guangdong Mingt,6,0,2,4,2,9,-7,2,China - League Two,0.0,0.33,-7,0.33,0.33,0.0,3.03,11
Guangxi Lanhang,6,0,1,5,2,10,-8,1,China - League Two,0.0,0.17,-8,0.33,0.17,0.0,5.88,12
Millonarios,8,5,2,1,11,3,8,17,Colombia - Primera A - Apertura,0.62,0.88,8,1.38,2.12,1.61,1.14,1
Junior,8,5,2,1,10,5,5,17,Colombia - Primera A - Apertura,0.62,0.88,5,1.25,2.12,1.61,1.14,1
D. Pereira,8,4,3,1,11,6,5,15,Colombia - Primera A - Apertura,0.5,0.88,5,1.38,1.88,2.0,1.14,2
A. Bucaramanga,8,4,2,2,12,7,5,14,Colombia - Primera A - Apertura,0.5,0.75,5,1.5,1.75,2.0,1.33,3
Deportes Tolima,8,4,2,2,14,11,3,14,Colombia - Primera A - Apertura,0.5,0.75,3,1.75,1.75,2.0,1.33,3
Deportivo Pasto,8,3,4,1,9,7,2,13,Colombia - Primera A - Apertura,0.38,0.88,2,1.12,1.62,2.63,1.14,4
A. Nacional,8,3,3,2,10,8,2,12,Colombia - Primera A - Apertura,0.38,0.75,2,1.25,1.5,2.63,1.33,5
America de Cali,8,3,3,2,8,7,1,12,Colombia - Primera A - Apertura,0.38,0.75,1,1.0,1.5,2.63,1.33,5
Once Caldas,8,3,2,3,8,6,2,11,Colombia - Primera A - Apertura,0.38,0.62,2,1.0,1.38,2.63,1.61,6
I. Medelin,8,2,5,1,5,3,2,11,Colombia - Primera A - Apertura,0.25,0.88,2,0.62,1.38,4.0,1.14,6
Envigado,8,3,2,3,8,8,0,11,Colombia - Primera A - Apertura,0.38,0.62,0,1.0,1.38,2.63,1.61,6
Deportivo Cali,8,2,4,2,6,7,-1,10,Colombia - Primera A - Apertura,0.25,0.75,-1,0.75,1.25,4.0,1.33,7
Santa Fe,8,2,3,3,8,10,-2,9,Colombia - Primera A - Apertura,0.25,0.62,-2,1.0,1.12,4.0,1.61,8
Fortaleza CEIF,8,2,3,3,4,8,-4,9,Colombia - Primera A - Apertura,0.25,0.62,-4,0.5,1.12,4.0,1.61,8
A. Petrolera,8,2,2,4,4,8,-4,8,Colombia - Primera A - Apertura,0.25,0.5,-4,0.5,1.0,4.0,2.0,9
R. Aguilas,8,1,4,3,3,5,-2,7,Colombia - Primera A - Apertura,0.12,0.62,-2,0.38,0.88,8.33,1.61,10
La Equidad,8,2,1,5,8,13,-5,7,Colombia - Primera A - Apertura,0.25,0.38,-5,1.0,0.88,4.0,2.63,10
Llaneros,8,2,0,6,4,8,-4,6,Colombia - Primera A - Apertura,0.25,0.25,-4,0.5,0.75,4.0,4.0,11
Union Magdalena,8,0,4,4,7,11,-4,4,Colombia - Primera A - Apertura,0.0,0.5,-4,0.88,0.5,0.0,2.0,12
Boyaca Chico,8,0,4,4,3,14,-11,4,Colombia - Primera A - Apertura,0.0,0.5,-11,0.38,0.5,0.0,2.0,12
I. Medelin,8,5,2,1,15,6,9,17,Colombia - Primera A - Clausura,0.62,0.88,9,1.88,2.12,1.61,1.14,1
Millonarios,8,5,2,1,11,4,7,17,Colombia - Primera A - Clausura,0.62,0.88,7,1.38,2.12,1.61,1.14,1
Junior,8,4,3,1,11,4,7,15,Colombia - Primera A - Clausura,0.5,0.88,7,1.38,1.88,2.0,1.14,2
Santa Fe,8,4,3,1,12,6,6,15,Colombia - Primera A - Clausura,0.5,0.88,6,1.5,1.88,2.0,1.14,2
D. Pereira,8,4,3,1,12,9,3,15,Colombia - Primera A - Clausura,0.5,0.88,3,1.5,1.88,2.0,1.14,2
Deportes Tolima,8,4,2,2,9,4,5,14,Colombia - Primera A - Clausura,0.5,0.75,5,1.12,1.75,2.0,1.33,3
Deportivo Pasto,8,4,1,3,14,11,3,13,Colombia - Primera A - Clausura,0.5,0.62,3,1.75,1.62,2.0,1.61,4
A. Nacional,8,3,4,1,9,7,2,13,Colombia - Primera A - Clausura,0.38,0.88,2,1.12,1.62,2.63,1.14,4
A. Bucaramanga,8,3,3,2,12,7,5,12,Colombia - Primera A - Clausura,0.38,0.75,5,1.5,1.5,2.63,1.33,5
America de Cali,8,3,2,3,10,10,0,11,Colombia - Primera A - Clausura,0.38,0.62,0,1.25,1.38,2.63,1.61,6
Fortaleza CEIF,8,3,1,4,9,8,1,10,Colombia - Primera A - Clausura,0.38,0.5,1,1.12,1.25,2.63,2.0,7
La Equidad,8,2,3,3,12,13,-1,9,Colombia - Primera A - Clausura,0.25,0.62,-1,1.5,1.12,4.0,1.61,8
Patriotas,8,2,2,4,12,14,-2,8,Colombia - Primera A - Clausura,0.25,0.5,-2,1.5,1.0,4.0,2.0,9
Deportivo Cali,8,2,2,4,5,9,-4,8,Colombia - Primera A - Clausura,0.25,0.5,-4,0.62,1.0,4.0,2.0,9
A. Petrolera,8,2,2,4,7,12,-5,8,Colombia - Primera A - Clausura,0.25,0.5,-5,0.88,1.0,4.0,2.0,9
Jaguares de C.,8,2,2,4,7,14,-7,8,Colombia - Primera A - Clausura,0.25,0.5,-7,0.88,1.0,4.0,2.0,9
Envigado,8,2,1,5,5,9,-4,7,Colombia - Primera A - Clausura,0.25,0.38,-4,0.62,0.88,4.0,2.63,10
Boyaca Chico,8,2,1,5,5,15,-10,7,Colombia - Primera A - Clausura,0.25,0.38,-10,0.62,0.88,4.0,2.63,10
Once Caldas,8,1,2,5,4,12,-8,5,Colombia - Primera A - Clausura,0.12,0.38,-8,0.5,0.62,8.33,2.63,11
R. Aguilas,8,1,1,6,4,15,-11,4,Colombia - Primera A - Clausura,0.12,0.25,-11,0.5,0.5,8.33,4.0,12
Saprissa,8,5,2,1,13,7,6,17,Costa Rica - Primera Div. - Apertura,0.62,0.88,6,1.62,2.12,1.61,1.14,1
Alajuelense,8,5,1,2,13,6,7,16,Costa Rica - Primera Div. - Apertura,0.62,0.75,7,1.62,2.0,1.61,1.33,2
Santos Guapiles,8,5,1,2,14,8,6,16,Costa Rica - Primera Div. - Apertura,0.62,0.75,6,1.75,2.0,1.61,1.33,2
Guanacasteca,8,4,1,3,11,11,0,13,Costa Rica - Primera Div. - Apertura,0.5,0.62,0,1.38,1.62,2.0,1.61,3
Herediano,8,3,3,2,11,9,2,12,Costa Rica - Primera Div. - Apertura,0.38,0.75,2,1.38,1.5,2.63,1.33,4
San Carlos,8,2,5,1,11,11,0,11,Costa Rica - Primera Div. - Apertura,0.25,0.88,0,1.38,1.38,4.0,1.14,5
Cartagines,8,3,1,4,15,18,-3,10,Costa Rica - Primera Div. - Apertura,0.38,0.5,-3,1.88,1.25,2.63,2.0,6
Zeledon,8,3,1,4,9,12,-3,10,Costa Rica - Primera Div. - Apertura,0.38,0.5,-3,1.12,1.25,2.63,2.0,6
M. Liberia,8,2,2,4,9,11,-2,8,Costa Rica - Primera Div. - Apertura,0.25,0.5,-2,1.12,1.0,4.0,2.0,7
Sporting SJ,8,2,1,5,10,11,-1,7,Costa Rica - Primera Div. - Apertura,0.25,0.38,-1,1.25,0.88,4.0,2.63,8
Santa Ana,8,2,1,5,7,11,-4,7,Costa Rica - Primera Div. - Apertura,0.25,0.38,-4,0.88,0.88,4.0,2.63,8
Puntarenas,8,2,1,5,8,16,-8,7,Costa Rica - Primera Div. - Apertura,0.25,0.38,-8,1.0,0.88,4.0,2.63,8
Slavia Prague,8,6,1,1,18,3,15,19,CzechRepublic - 1. Liga,0.75,0.88,15,2.25,2.38,1.33,1.14,1
Banik Ostrava,8,6,1,1,17,7,10,19,CzechRepublic - 1. Liga,0.75,0.88,10,2.12,2.38,1.33,1.14,1
Viktoria Plzen,8,6,1,1,16,6,10,19,CzechRepublic - 1. Liga,0.75,0.88,10,2.0,2.38,1.33,1.14,1
Karvina,8,5,2,1,14,11,3,17,CzechRepublic - 1. Liga,0.62,0.88,3,1.75,2.12,1.61,1.14,2
Slovan Liberec,8,4,3,1,12,4,8,15,CzechRepublic - 1. Liga,0.5,0.88,8,1.5,1.88,2.0,1.14,3
Jablonec,8,4,3,1,6,5,1,15,CzechRepublic - 1. Liga,0.5,0.88,1,0.75,1.88,2.0,1.14,3
Teplice,8,3,4,1,9,6,3,13,CzechRepublic - 1. Liga,0.38,0.88,3,1.12,1.62,2.63,1.14,4
Sparta Prague,8,4,1,3,11,10,1,13,CzechRepublic - 1. Liga,0.5,0.62,1,1.38,1.62,2.0,1.61,4
Hradec Kralove,8,3,2,3,11,9,2,11,CzechRepublic - 1. Liga,0.38,0.62,2,1.38,1.38,2.63,1.61,5
Dukla Praha,8,2,4,2,8,9,-1,10,CzechRepublic - 1. Liga,0.25,0.75,-1,1.0,1.25,4.0,1.33,6
Sigma Olomouc,8,2,2,4,9,13,-4,8,CzechRepublic - 1. Liga,0.25,0.5,-4,1.12,1.0,4.0,2.0,7
Slovacko,8,2,1,5,6,17,-11,7,CzechRepublic - 1. Liga,0.25,0.38,-11,0.75,0.88,4.0,2.63,8
Bohemians,8,1,2,5,4,10,-6,5,CzechRepublic - 1. Liga,0.12,0.38,-6,0.5,0.62,8.33,2.63,9
Pardubice,8,1,1,6,5,12,-7,4,CzechRepublic - 1. Liga,0.12,0.25,-7,0.62,0.5,8.33,4.0,10
Mlada Boleslav,8,1,0,7,5,14,-9,3,CzechRepublic - 1. Liga,0.12,0.12,-9,0.62,0.38,8.33,8.33,11
C. Budejovice,8,0,1,7,5,18,-13,1,CzechRepublic - 1. Liga,0.0,0.12,-13,0.62,0.12,0.0,8.33,12
Viborg,8,4,4,0,18,11,7,16,Denmark - Superligaen,0.5,1.0,7,2.25,2.0,2.0,1.0,1
Brondby IF,8,4,3,1,14,11,3,15,Denmark - Superligaen,0.5,0.88,3,1.75,1.88,2.0,1.14,2
SonderjyskE,8,4,2,2,12,11,1,14,Denmark - Superligaen,0.5,0.75,1,1.5,1.75,2.0,1.33,3
FC Midtjylland,8,4,1,3,21,13,8,13,Denmark - Superligaen,0.5,0.62,8,2.62,1.62,2.0,1.61,4
FC Kobenhavn,8,4,1,3,14,12,2,13,Denmark - Superligaen,0.5,0.62,2,1.75,1.62,2.0,1.61,4
Lyngby,8,3,2,3,9,9,0,11,Denmark - Superligaen,0.38,0.62,0,1.12,1.38,2.63,1.61,5
Silkeborg,8,3,1,4,14,10,4,10,Denmark - Superligaen,0.38,0.5,4,1.75,1.25,2.63,2.0,6
Randers FC,8,3,1,4,16,18,-2,10,Denmark - Superligaen,0.38,0.5,-2,2.0,1.25,2.63,2.0,6
Nordsjaelland,8,3,1,4,11,14,-3,10,Denmark - Superligaen,0.38,0.5,-3,1.38,1.25,2.63,2.0,6
Vejle BK,8,2,2,4,11,18,-7,8,Denmark - Superligaen,0.25,0.5,-7,1.38,1.0,4.0,2.0,7
Aalborg BK,8,1,3,4,9,18,-9,6,Denmark - Superligaen,0.12,0.5,-9,1.12,0.75,8.33,2.0,8
AGF Aarhus,8,1,2,5,10,16,-6,5,Denmark - Superligaen,0.12,0.38,-6,1.25,0.62,8.33,2.63,9
Hillerod,8,5,2,1,15,4,11,17,Denmark - 1st Division,0.62,0.88,11,1.88,2.12,1.61,1.14,1
Fredericia,8,5,2,1,11,4,7,17,Denmark - 1st Division,0.62,0.88,7,1.38,2.12,1.61,1.14,1
B 93,8,3,4,1,14,9,5,13,Denmark - 1st Division,0.38,0.88,5,1.75,1.62,2.63,1.14,2
Kolding IF,8,4,1,3,13,12,1,13,Denmark - 1st Division,0.5,0.62,1,1.62,1.62,2.0,1.61,2
Odense BK,8,3,3,2,14,8,6,12,Denmark - 1st Division,0.38,0.75,6,1.75,1.5,2.63,1.33,3
Hvidovre,8,3,3,2,7,7,0,12,Denmark - 1st Division,0.38,0.75,0,0.88,1.5,2.63,1.33,3
AC Horsens,8,4,0,4,12,15,-3,12,Denmark - 1st Division,0.5,0.5,-3,1.5,1.5,2.0,2.0,3
Roskilde,8,2,3,3,12,14,-2,9,Denmark - 1st Division,0.25,0.62,-2,1.5,1.12,4.0,1.61,4
Hobro,8,2,2,4,7,13,-6,8,Denmark - 1st Division,0.25,0.5,-6,0.88,1.0,4.0,2.0,5
HB Koge,8,1,4,3,6,12,-6,7,Denmark - 1st Division,0.12,0.62,-6,0.75,0.88,8.33,1.61,6
Vendsyssel,8,1,3,4,6,10,-4,6,Denmark - 1st Division,0.12,0.5,-4,0.75,0.75,8.33,2.0,7
Esbjerg,8,1,1,6,8,17,-9,4,Denmark - 1st Division,0.12,0.25,-9,1.0,0.5,8.33,4.0,8
AB Copenhagen,8,5,1,2,20,11,9,16,Denmark - 2nd Division,0.62,0.75,9,2.5,2.0,1.61,1.33,1
Aarhus Fremad,8,5,1,2,12,3,9,16,Denmark - 2nd Division,0.62,0.75,9,1.5,2.0,1.61,1.33,1
Middelfart,8,5,1,2,12,9,3,16,Denmark - 2nd Division,0.62,0.75,3,1.5,2.0,1.61,1.33,1
Skive,8,4,2,2,9,6,3,14,Denmark - 2nd Division,0.5,0.75,3,1.12,1.75,2.0,1.33,2
Naestved,8,4,1,3,10,9,1,13,Denmark - 2nd Division,0.5,0.62,1,1.25,1.62,2.0,1.61,3
BK Frem,8,3,2,3,9,7,2,11,Denmark - 2nd Division,0.38,0.62,2,1.12,1.38,2.63,1.61,4
Ishoj,8,3,2,3,8,9,-1,11,Denmark - 2nd Division,0.38,0.62,-1,1.0,1.38,2.63,1.61,4
Fremad Amager,8,3,1,4,10,11,-1,10,Denmark - 2nd Division,0.38,0.5,-1,1.25,1.25,2.63,2.0,5
Hellerup IK,8,3,0,5,6,16,-10,9,Denmark - 2nd Division,0.38,0.38,-10,0.75,1.12,2.63,2.63,6
Helsingor,8,1,5,2,9,11,-2,8,Denmark - 2nd Division,0.12,0.75,-2,1.12,1.0,8.33,1.33,7
Nykobing,8,1,2,5,8,13,-5,5,Denmark - 2nd Division,0.12,0.38,-5,1.0,0.62,8.33,2.63,8
Thisted,8,1,2,5,8,16,-8,5,Denmark - 2nd Division,0.12,0.38,-8,1.0,0.62,8.33,2.63,8
I. del Valle,8,6,2,0,19,5,14,20,Ecuador - Liga Pro 1st Stage,0.75,1.0,14,2.38,2.5,1.33,1.0,1
Barcelona SC,8,6,0,2,11,8,3,18,Ecuador - Liga Pro 1st Stage,0.75,0.75,3,1.38,2.25,1.33,1.33,2
Cuniburo,8,5,2,1,17,8,9,17,Ecuador - Liga Pro 1st Stage,0.62,0.88,9,2.12,2.12,1.61,1.14,3
LDU Quito,8,4,2,2,14,6,8,14,Ecuador - Liga Pro 1st Stage,0.5,0.75,8,1.75,1.75,2.0,1.33,4
U. Catolica,8,3,3,2,12,8,4,12,Ecuador - Liga Pro 1st Stage,0.38,0.75,4,1.5,1.5,2.63,1.33,5
Aucas,8,3,3,2,11,10,1,12,Ecuador - Liga Pro 1st Stage,0.38,0.75,1,1.38,1.5,2.63,1.33,5
Libertad,8,3,3,2,13,13,0,12,Ecuador - Liga Pro 1st Stage,0.38,0.75,0,1.62,1.5,2.63,1.33,5
Emelec,8,2,4,2,6,6,0,10,Ecuador - Liga Pro 1st Stage,0.25,0.75,0,0.75,1.25,4.0,1.33,6
Manta,8,2,4,2,11,14,-3,10,Ecuador - Liga Pro 1st Stage,0.25,0.75,-3,1.38,1.25,4.0,1.33,6
Orense,8,3,1,4,8,14,-6,10,Ecuador - Liga Pro 1st Stage,0.38,0.5,-6,1.0,1.25,2.63,2.0,6
Mushuc Runa,8,2,3,3,9,10,-1,9,Ecuador - Liga Pro 1st Stage,0.25,0.62,-1,1.12,1.12,4.0,1.61,7
Tecnico U.,8,2,2,4,6,9,-3,8,Ecuador - Liga Pro 1st Stage,0.25,0.5,-3,0.75,1.0,4.0,2.0,8
El Nacional,8,2,1,5,10,13,-3,7,Ecuador - Liga Pro 1st Stage,0.25,0.38,-3,1.25,0.88,4.0,2.63,9
D. Cuenca,8,2,1,5,4,11,-7,7,Ecuador - Liga Pro 1st Stage,0.25,0.38,-7,0.5,0.88,4.0,2.63,9
Macara,8,0,4,4,2,6,-4,4,Ecuador - Liga Pro 1st Stage,0.0,0.5,-4,0.25,0.5,0.0,2.0,10
Delfin,8,0,4,4,5,16,-11,4,Ecuador - Liga Pro 1st Stage,0.0,0.5,-11,0.62,0.5,0.0,2.0,10
Cumbaya,6,4,2,0,12,4,8,14,Ecuador - Serie B,0.67,1.0,8,2.0,2.33,1.49,1.0,1
Gualaceo,6,3,3,0,9,6,3,12,Ecuador - Serie B,0.5,1.0,3,1.5,2.0,2.0,1.0,2
Leones Norte,6,2,4,0,9,5,4,10,Ecuador - Serie B,0.33,1.0,4,1.5,1.67,3.03,1.0,3
22 de Julio,6,2,3,1,5,6,-1,9,Ecuador - Serie B,0.33,0.83,-1,0.83,1.5,3.03,1.2,4
Guayaquil City,6,2,2,2,9,7,2,8,Ecuador - Serie B,0.33,0.67,2,1.5,1.33,3.03,1.49,5
Nueve Octubre,6,2,2,2,5,5,0,8,Ecuador - Serie B,0.33,0.67,0,0.83,1.33,3.03,1.49,5
Vargas Torres,6,1,4,1,4,4,0,7,Ecuador - Serie B,0.17,0.83,0,0.67,1.17,5.88,1.2,6
San Antonio,6,2,1,3,4,6,-2,7,Ecuador - Serie B,0.33,0.5,-2,0.67,1.17,3.03,2.0,6
Vinotinto,6,2,0,4,7,10,-3,6,Ecuador - Serie B,0.33,0.33,-3,1.17,1.0,3.03,3.03,7
Chacaritas,6,0,4,2,5,8,-3,4,Ecuador - Serie B,0.0,0.67,-3,0.83,0.67,0.0,1.49,8
Imbabura,6,0,4,2,5,8,-3,4,Ecuador - Serie B,0.0,0.67,-3,0.83,0.67,0.0,1.49,8
I. Juniors,6,1,1,4,6,11,-5,4,Ecuador - Serie B,0.17,0.33,-5,1.0,0.67,5.88,3.03,8
Pyramids FC,8,6,2,0,13,4,9,20,Egypt - Premier League,0.75,1.0,9,1.62,2.5,1.33,1.0,1
Zamalek,8,5,3,0,14,3,11,18,Egypt - Premier League,0.62,1.0,11,1.75,2.25,1.61,1.0,2
El Gouna,8,5,2,1,11,4,7,17,Egypt - Premier League,0.62,0.88,7,1.38,2.12,1.61,1.14,3
Al Ahly,8,5,2,1,12,6,6,17,Egypt - Premier League,0.62,0.88,6,1.5,2.12,1.61,1.14,3
Al Masry,8,4,3,1,13,4,9,15,Egypt - Premier League,0.5,0.88,9,1.62,1.88,2.0,1.14,4
National Bank,8,4,3,1,14,9,5,15,Egypt - Premier League,0.5,0.88,5,1.75,1.88,2.0,1.14,4
Ghazl El M.,8,4,0,4,8,9,-1,12,Egypt - Premier League,0.5,0.5,-1,1.0,1.5,2.0,2.0,5
Pharco,8,3,2,3,6,7,-1,11,Egypt - Premier League,0.38,0.62,-1,0.75,1.38,2.63,1.61,6
ZED FC,8,2,4,2,11,8,3,10,Egypt - Premier League,0.25,0.75,3,1.38,1.25,4.0,1.33,7
El Geish,8,2,3,3,6,8,-2,9,Egypt - Premier League,0.25,0.62,-2,0.75,1.12,4.0,1.61,8
Ceramica C.,8,2,2,4,11,11,0,8,Egypt - Premier League,0.25,0.5,0,1.38,1.0,4.0,2.0,9
ENPPI,8,2,2,4,6,12,-6,8,Egypt - Premier League,0.25,0.5,-6,0.75,1.0,4.0,2.0,9
Petrojet,8,2,2,4,9,16,-7,8,Egypt - Premier League,0.25,0.5,-7,1.12,1.0,4.0,2.0,9
Haras El Hodood,8,2,1,5,7,12,-5,7,Egypt - Premier League,0.25,0.38,-5,0.88,0.88,4.0,2.63,10
Ismaily,8,1,3,4,3,12,-9,6,Egypt - Premier League,0.12,0.5,-9,0.38,0.75,8.33,2.0,11
Smouha,8,2,0,6,3,12,-9,6,Egypt - Premier League,0.25,0.25,-9,0.38,0.75,4.0,4.0,11
Modern Sport,8,1,2,5,8,12,-4,5,Egypt - Premier League,0.12,0.38,-4,1.0,0.62,8.33,2.63,12
Al Ittihad,8,1,2,5,6,12,-6,5,Egypt - Premier League,0.12,0.38,-6,0.75,0.62,8.33,2.63,12
Liverpool,8,7,0,1,18,6,12,21,Premier League,0.88,0.88,12,2.25,2.62,1.14,1.14,2
Wolverhampton,8,6,1,1,15,7,8,19,Premier League,0.75,0.88,8,1.88,2.38,1.33,1.14,3
Newcastle Utd,8,6,0,2,19,8,11,18,Premier League,0.75,0.75,11,2.38,2.25,1.33,1.33,4
Aston Villa,8,6,0,2,17,9,8,18,Premier League,0.75,0.75,8,2.12,2.25,1.33,1.33,4
Manchester City,8,5,2,1,14,6,8,17,Premier League,0.62,0.88,8,1.75,2.12,1.61,1.14,5
Chelsea,8,5,2,1,11,4,7,17,Premier League,0.62,0.88,7,1.38,2.12,1.61,1.14,5
Arsenal,8,3,5,0,12,6,6,14,Premier League,0.38,1.0,6,1.5,1.75,2.63,1.0,8
Nottm Forest,8,4,1,3,12,10,2,13,Premier League,0.5,0.62,2,1.5,1.62,2.0,1.61,9
Brentford,8,3,3,2,13,8,5,12,Premier League,0.38,0.75,5,1.62,1.5,2.63,1.33,10
Fulham,8,4,0,4,12,11,1,12,Premier League,0.5,0.5,1,1.5,1.5,2.0,2.0,10
Crystal Palace,8,3,3,2,12,15,-3,12,Premier League,0.38,0.75,-3,1.5,1.5,2.63,1.33,10
Brighton,8,3,2,3,14,17,-3,11,Premier League,0.38,0.62,-3,1.75,1.38,2.63,1.61,11
Manchester Utd,8,2,3,3,9,10,-1,9,Premier League,0.25,0.62,-1,1.12,1.12,4.0,1.61,13
Bournemouth,8,1,4,3,9,11,-2,7,Premier League,0.12,0.62,-2,1.12,0.88,8.33,1.61,15
Everton,8,1,4,3,5,8,-3,7,Premier League,0.12,0.62,-3,0.62,0.88,8.33,1.61,15
West Ham Utd,8,1,3,4,9,11,-2,6,Premier League,0.12,0.5,-2,1.12,0.75,8.33,2.0,16
Tottenham,8,1,1,6,9,18,-9,4,Premier League,0.12,0.25,-9,1.12,0.5,8.33,4.0,18
Ipswich Town,8,1,1,6,9,20,-11,4,Premier League,0.12,0.25,-11,1.12,0.5,8.33,4.0,18
Southampton,8,0,2,6,6,19,-13,2,Premier League,0.0,0.25,-13,0.75,0.25,0.0,4.0,19
Leicester City,8,0,1,7,2,17,-15,1,Premier League,0.0,0.12,-15,0.25,0.12,0.0,8.33,20
Burnley,8,7,1,0,16,4,12,22,Premier League,0.88,1.0,12,2.0,2.75,1.14,1.0,1
Leeds Utd,8,5,3,0,17,6,11,18,Premier League,0.62,1.0,11,2.12,2.25,1.61,1.0,4
Millwall,8,6,0,2,10,7,3,18,Premier League,0.75,0.75,3,1.25,2.25,1.33,1.33,4
Swansea City,8,5,1,2,10,6,4,16,Premier League,0.62,0.75,4,1.25,2.0,1.61,1.33,6
Luton Town,8,4,3,1,8,4,4,15,Premier League,0.5,0.88,4,1.0,1.88,2.0,1.14,7
Derby County,8,4,2,2,11,7,4,14,Premier League,0.5,0.75,4,1.38,1.75,2.0,1.33,8
Bristol City,8,4,2,2,11,10,1,14,Premier League,0.5,0.75,1,1.38,1.75,2.0,1.33,8
Blackburn,8,4,1,3,11,9,2,13,Premier League,0.5,0.62,2,1.38,1.62,2.0,1.61,9
Oxford Utd,8,4,1,3,8,7,1,13,Premier League,0.5,0.62,1,1.0,1.62,2.0,1.61,9
Plymouth,8,4,1,3,12,12,0,13,Premier League,0.5,0.62,0,1.5,1.62,2.0,1.61,9
Sheffield Utd,8,4,0,4,10,7,3,12,Premier League,0.5,0.5,3,1.25,1.5,2.0,2.0,10
Portsmouth,8,3,2,3,12,11,1,11,Premier League,0.38,0.62,1,1.5,1.38,2.63,1.61,11
Middlesbrough,8,3,2,3,7,6,1,11,Premier League,0.38,0.62,1,0.88,1.38,2.63,1.61,11
Stoke City,8,3,2,3,8,12,-4,11,Premier League,0.38,0.62,-4,1.0,1.38,2.63,1.61,11
Coventry City,8,3,1,4,10,10,0,10,Premier League,0.38,0.5,0,1.25,1.25,2.63,2.0,12
QP Rangers,8,2,3,3,10,15,-5,9,Premier League,0.25,0.62,-5,1.25,1.12,4.0,1.61,13
Cardiff City,8,1,5,2,6,8,-2,8,Premier League,0.12,0.75,-2,0.75,1.0,8.33,1.33,14
Hull City,8,2,2,4,5,7,-2,8,Premier League,0.25,0.5,-2,0.62,1.0,4.0,2.0,14
Sunderland,8,2,1,5,3,9,-6,7,Premier League,0.25,0.38,-6,0.38,0.88,4.0,2.63,15
Sheffield Wed,8,1,3,4,6,10,-4,6,Premier League,0.12,0.5,-4,0.75,0.75,8.33,2.0,16
Preston,8,1,2,5,9,14,-5,5,Premier League,0.12,0.38,-5,1.12,0.62,8.33,2.63,17
Norwich City,8,1,2,5,8,14,-6,5,Premier League,0.12,0.38,-6,1.0,0.62,8.33,2.63,17
West Brom,8,1,2,5,5,11,-6,5,Premier League,0.12,0.38,-6,0.62,0.62,8.33,2.63,17
Watford,8,1,1,6,5,10,-5,4,Premier League,0.12,0.25,-5,0.62,0.5,8.33,4.0,18
Birmingham City,8,7,1,0,21,6,15,22,League One,0.88,1.0,15,2.62,2.75,1.14,1.0,1
Stockport,8,6,1,1,16,7,9,19,League One,0.75,0.88,9,2.0,2.38,1.33,1.14,2
Leyton Orient,8,6,1,1,15,9,6,19,League One,0.75,0.88,6,1.88,2.38,1.33,1.14,2
Wrexham,8,5,3,0,14,4,10,18,League One,0.62,1.0,10,1.75,2.25,1.61,1.0,3
Reading,8,5,1,2,14,7,7,16,League One,0.62,0.75,7,1.75,2.0,1.61,1.33,4
Charlton,8,5,1,2,15,10,5,16,League One,0.62,0.75,5,1.88,2.0,1.61,1.33,4
Crawley Town,8,4,1,3,16,11,5,13,League One,0.5,0.62,5,2.0,1.62,2.0,1.61,5
Blackpool,8,4,1,3,14,9,5,13,League One,0.5,0.62,5,1.75,1.62,2.0,1.61,5
Burton Albion,8,4,1,3,11,9,2,13,League One,0.5,0.62,2,1.38,1.62,2.0,1.61,5
Wycombe,8,4,1,3,5,6,-1,13,League One,0.5,0.62,-1,0.62,1.62,2.0,1.61,5
Lincoln City,8,3,3,2,11,9,2,12,League One,0.38,0.75,2,1.38,1.5,2.63,1.33,6
Wigan Athletic,8,2,5,1,5,4,1,11,League One,0.25,0.88,1,0.62,1.38,4.0,1.14,7
Exeter City,8,3,2,3,9,11,-2,11,League One,0.38,0.62,-2,1.12,1.38,2.63,1.61,7
Rotherham,8,3,2,3,10,13,-3,11,League One,0.38,0.62,-3,1.25,1.38,2.63,1.61,7
Cambridge Utd,8,2,3,3,9,10,-1,9,League One,0.25,0.62,-1,1.12,1.12,4.0,1.61,8
Peterborough,8,2,3,3,12,15,-3,9,League One,0.25,0.62,-3,1.5,1.12,4.0,1.61,8
Northampton,8,2,2,4,10,11,-1,8,League One,0.25,0.5,-1,1.25,1.0,4.0,2.0,9
Stevenage,8,2,1,5,6,11,-5,7,League One,0.25,0.38,-5,0.75,0.88,4.0,2.63,10
Bolton,8,2,1,5,7,14,-7,7,League One,0.25,0.38,-7,0.88,0.88,4.0,2.63,10
Mansfield,8,2,1,5,12,21,-9,7,League One,0.25,0.38,-9,1.5,0.88,4.0,2.63,10
Barnsley,8,1,3,4,14,18,-4,6,League One,0.12,0.5,-4,1.75,0.75,8.33,2.0,11
Shrewsbury,8,1,2,5,6,15,-9,5,League One,0.12,0.38,-9,0.75,0.62,8.33,2.63,12
Huddersfield,8,1,0,7,5,17,-12,3,League One,0.12,0.12,-12,0.62,0.38,8.33,8.33,13
Bristol Rovers,8,0,1,7,4,12,-8,1,League One,0.0,0.12,-8,0.5,0.12,0.0,8.33,14
Doncaster,8,5,3,0,17,5,12,18,League Two,0.62,1.0,12,2.12,2.25,1.61,1.0,1
Port Vale,8,5,1,2,17,8,9,16,League Two,0.62,0.75,9,2.12,2.0,1.61,1.33,2
Salford City,8,4,3,1,18,11,7,15,League Two,0.5,0.88,7,2.25,1.88,2.0,1.14,3
Chesterfield,8,4,3,1,14,10,4,15,League Two,0.5,0.88,4,1.75,1.88,2.0,1.14,3
Swindon Town,8,4,2,2,16,8,8,14,League Two,0.5,0.75,8,2.0,1.75,2.0,1.33,4
Barrow,8,3,4,1,10,5,5,13,League Two,0.38,0.88,5,1.25,1.62,2.63,1.14,5
Tranmere,8,3,3,2,13,9,4,12,League Two,0.38,0.75,4,1.62,1.5,2.63,1.33,6
Gillingham,8,2,6,0,9,7,2,12,League Two,0.25,1.0,2,1.12,1.5,4.0,1.0,6
Grimsby,8,3,3,2,10,12,-2,12,League Two,0.38,0.75,-2,1.25,1.5,2.63,1.33,6
Notts County,8,3,2,3,11,8,3,11,League Two,0.38,0.62,3,1.38,1.38,2.63,1.61,7
Carlisle Utd,8,3,2,3,14,15,-1,11,League Two,0.38,0.62,-1,1.75,1.38,2.63,1.61,7
Bromley,8,3,2,3,13,14,-1,11,League Two,0.38,0.62,-1,1.62,1.38,2.63,1.61,7
Fleetwood,8,3,2,3,11,13,-2,11,League Two,0.38,0.62,-2,1.38,1.38,2.63,1.61,7
Harrogate,8,2,4,2,12,12,0,10,League Two,0.25,0.75,0,1.5,1.25,4.0,1.33,8
Cheltenham,8,3,1,4,9,13,-4,10,League Two,0.38,0.5,-4,1.12,1.25,2.63,2.0,8
Accrington,8,2,4,2,8,13,-5,10,League Two,0.25,0.75,-5,1.0,1.25,4.0,1.33,8
Bradford,8,2,3,3,15,14,1,9,League Two,0.25,0.62,1,1.88,1.12,4.0,1.61,9
Colchester Utd,8,2,2,4,7,14,-7,8,League Two,0.25,0.5,-7,0.88,1.0,4.0,2.0,10
AFC Wimbledon,8,1,4,3,6,9,-3,7,League Two,0.12,0.62,-3,0.75,0.88,8.33,1.61,11
Morecambe,8,2,0,6,6,14,-8,6,League Two,0.25,0.25,-8,0.75,0.75,4.0,4.0,12
Milton Keynes,8,1,3,4,5,13,-8,6,League Two,0.12,0.5,-8,0.62,0.75,8.33,2.0,12
Walsall,8,0,5,3,7,11,-4,5,League Two,0.0,0.62,-4,0.88,0.62,0.0,1.61,13
Crewe Alexandra,8,1,2,5,4,9,-5,5,League Two,0.12,0.38,-5,0.5,0.62,8.33,2.63,13
Newport,8,0,3,5,3,11,-8,3,League Two,0.0,0.38,-8,0.38,0.38,0.0,2.63,14
York City,8,6,1,1,24,7,17,19,England - National League,0.75,0.88,17,3.0,2.38,1.33,1.14,1
Boston Utd,8,6,0,2,14,7,7,18,England - National League,0.75,0.75,7,1.75,2.25,1.33,1.33,2
Barnet,8,5,2,1,15,6,9,17,England - National League,0.62,0.88,9,1.88,2.12,1.61,1.14,3
Woking,8,4,4,0,13,7,6,16,England - National League,0.5,1.0,6,1.62,2.0,2.0,1.0,4
Dagenham & R.,8,4,3,1,12,5,7,15,England - National League,0.5,0.88,7,1.5,1.88,2.0,1.14,5
Tamworth,8,5,0,3,17,14,3,15,England - National League,0.62,0.62,3,2.12,1.88,1.61,1.61,5
Rochdale,8,4,2,2,16,8,8,14,England - National League,0.5,0.75,8,2.0,1.75,2.0,1.33,6
Southend Utd,8,4,2,2,11,6,5,14,England - National League,0.5,0.75,5,1.38,1.75,2.0,1.33,6
Hartlepool,8,4,2,2,15,14,1,14,England - National League,0.5,0.75,1,1.88,1.75,2.0,1.33,6
Maidenhead Utd,8,3,3,2,11,7,4,12,England - National League,0.38,0.75,4,1.38,1.5,2.63,1.33,7
Forest Green,8,3,2,3,11,11,0,11,England - National League,0.38,0.62,0,1.38,1.38,2.63,1.61,8
Braintree Town,8,3,2,3,10,10,0,11,England - National League,0.38,0.62,0,1.25,1.38,2.63,1.61,8
Solihull Moors,8,3,2,3,8,11,-3,11,England - National League,0.38,0.62,-3,1.0,1.38,2.63,1.61,8
Yeovil Town,8,3,1,4,9,8,1,10,England - National League,0.38,0.5,1,1.12,1.25,2.63,2.0,9
Sutton Utd,8,2,3,3,9,13,-4,9,England - National League,0.25,0.62,-4,1.12,1.12,4.0,1.61,10
Oldham,8,2,2,4,8,9,-1,8,England - National League,0.25,0.5,-1,1.0,1.0,4.0,2.0,11
Ebbsfleet Utd,8,2,2,4,12,16,-4,8,England - National League,0.25,0.5,-4,1.5,1.0,4.0,2.0,11
Altrincham,8,2,2,4,10,14,-4,8,England - National League,0.25,0.5,-4,1.25,1.0,4.0,2.0,11
Halifax Town,8,2,2,4,3,9,-6,8,England - National League,0.25,0.5,-6,0.38,1.0,4.0,2.0,11
Wealdstone,8,2,2,4,6,14,-8,8,England - National League,0.25,0.5,-8,0.75,1.0,4.0,2.0,11
Eastleigh,8,1,4,3,9,15,-6,7,England - National League,0.12,0.62,-6,1.12,0.88,8.33,1.61,12
Aldershot Town,8,2,1,5,9,22,-13,7,England - National League,0.25,0.38,-13,1.12,0.88,4.0,2.63,12
Gateshead FC,8,2,0,6,11,19,-8,6,England - National League,0.25,0.25,-8,1.38,0.75,4.0,4.0,13
AFC Fylde,8,1,1,6,7,12,-5,4,England - National League,0.12,0.25,-5,0.88,0.5,8.33,4.0,14
Brackley Town,8,7,0,1,15,3,12,21,England - National L. North,0.88,0.88,12,1.88,2.62,1.14,1.14,1
Kidderminster,8,6,1,1,20,6,14,19,England - National L. North,0.75,0.88,14,2.5,2.38,1.33,1.14,2
Chester,8,5,2,1,13,8,5,17,England - National L. North,0.62,0.88,5,1.62,2.12,1.61,1.14,3
Buxton,8,5,1,2,12,6,6,16,England - National L. North,0.62,0.75,6,1.5,2.0,1.61,1.33,4
Spennymoor,8,5,1,2,12,9,3,16,England - National L. North,0.62,0.75,3,1.5,2.0,1.61,1.33,4
Kings Lynn,8,5,1,2,7,7,0,16,England - National L. North,0.62,0.75,0,0.88,2.0,1.61,1.33,4
Chorley,8,4,3,1,17,3,14,15,England - National L. North,0.5,0.88,14,2.12,1.88,2.0,1.14,5
Scunthorpe,8,5,0,3,13,4,9,15,England - National L. North,0.62,0.62,9,1.62,1.88,1.61,1.61,5
Marine,8,4,2,2,10,8,2,14,England - National L. North,0.5,0.75,2,1.25,1.75,2.0,1.33,6
Hereford Utd,8,4,1,3,15,11,4,13,England - National L. North,0.5,0.62,4,1.88,1.62,2.0,1.61,7
Alfreton Town,8,3,4,1,8,6,2,13,England - National L. North,0.38,0.88,2,1.0,1.62,2.63,1.14,7
Darlington,8,3,3,2,15,12,3,12,England - National L. North,0.38,0.75,3,1.88,1.5,2.63,1.33,8
Scarborough,8,3,3,2,8,8,0,12,England - National L. North,0.38,0.75,0,1.0,1.5,2.63,1.33,8
Curzon,8,3,3,2,9,10,-1,12,England - National L. North,0.38,0.75,-1,1.12,1.5,2.63,1.33,8
Oxford City,8,3,2,3,10,8,2,11,England - National L. North,0.38,0.62,2,1.25,1.38,2.63,1.61,9
Peterborough S.,8,3,1,4,10,14,-4,10,England - National L. North,0.38,0.5,-4,1.25,1.25,2.63,2.0,10
Southport,8,2,3,3,6,7,-1,9,England - National L. North,0.25,0.62,-1,0.75,1.12,4.0,1.61,11
Radcliffe,8,2,2,4,7,13,-6,8,England - National L. North,0.25,0.5,-6,0.88,1.0,4.0,2.0,12
Leamington,8,1,2,5,3,10,-7,5,England - National L. North,0.12,0.38,-7,0.38,0.62,8.33,2.63,13
Rushall,8,1,2,5,8,17,-9,5,England - National L. North,0.12,0.38,-9,1.0,0.62,8.33,2.63,13
Needham Market,8,1,0,7,6,16,-10,3,England - National L. North,0.12,0.12,-10,0.75,0.38,8.33,8.33,14
South Shields,8,0,2,6,4,14,-10,2,England - National L. North,0.0,0.25,-10,0.5,0.25,0.0,4.0,15
Warrington,8,0,1,7,3,15,-12,1,England - National L. North,0.0,0.12,-12,0.38,0.12,0.0,8.33,16
Farsley Celtic,8,0,0,8,5,28,-23,0,England - National L. North,0.0,0.0,-23,0.62,0.0,0.0,0.0,17
Torquay Utd,8,7,0,1,14,3,11,21,England - National L. South,0.88,0.88,11,1.75,2.62,1.14,1.14,1
Eastbourne,8,6,1,1,17,5,12,19,England - National L. South,0.75,0.88,12,2.12,2.38,1.33,1.14,2
Truro City,8,5,1,2,15,8,7,16,England - National L. South,0.62,0.75,7,1.88,2.0,1.61,1.33,3
Maidstone Utd,8,4,3,1,17,6,11,15,England - National L. South,0.5,0.88,11,2.12,1.88,2.0,1.14,4
Boreham Wood,8,5,0,3,18,11,7,15,England - National L. South,0.62,0.62,7,2.25,1.88,1.61,1.61,4
Dorking,8,4,3,1,14,8,6,15,England - National L. South,0.5,0.88,6,1.75,1.88,2.0,1.14,4
Hornchurch,8,4,2,2,12,8,4,14,England - National L. South,0.5,0.75,4,1.5,1.75,2.0,1.33,5
Weston-s.-Mare,8,4,1,3,12,10,2,13,England - National L. South,0.5,0.62,2,1.5,1.62,2.0,1.61,6
Chesham Utd,8,4,1,3,12,11,1,13,England - National L. South,0.5,0.62,1,1.5,1.62,2.0,1.61,6
Slough Town,8,4,1,3,13,15,-2,13,England - National L. South,0.5,0.62,-2,1.62,1.62,2.0,1.61,6
Bath City,8,3,3,2,13,6,7,12,England - National L. South,0.38,0.75,7,1.62,1.5,2.63,1.33,7
St Albans,8,3,3,2,9,10,-1,12,England - National L. South,0.38,0.75,-1,1.12,1.5,2.63,1.33,7
Worthing,8,3,2,3,14,9,5,11,England - National L. South,0.38,0.62,5,1.75,1.38,2.63,1.61,8
Chelmsford City,8,3,1,4,14,8,6,10,England - National L. South,0.38,0.5,6,1.75,1.25,2.63,2.0,9
Farnborough,8,3,1,4,17,15,2,10,England - National L. South,0.38,0.5,2,2.12,1.25,2.63,2.0,9
Enfield Town,8,2,4,2,10,15,-5,10,England - National L. South,0.25,0.75,-5,1.25,1.25,4.0,1.33,9
Chippenham,8,3,1,4,5,12,-7,10,England - National L. South,0.38,0.5,-7,0.62,1.25,2.63,2.0,9
Hemel Hempstead,8,2,3,3,7,11,-4,9,England - National L. South,0.25,0.62,-4,0.88,1.12,4.0,1.61,10
Salisbury,8,2,2,4,7,11,-4,8,England - National L. South,0.25,0.5,-4,0.88,1.0,4.0,2.0,11
Aveley,8,2,2,4,6,11,-5,8,England - National L. South,0.25,0.5,-5,0.75,1.0,4.0,2.0,11
Weymouth,8,2,2,4,10,17,-7,8,England - National L. South,0.25,0.5,-7,1.25,1.0,4.0,2.0,11
Welling Utd,8,1,2,5,6,21,-15,5,England - National L. South,0.12,0.38,-15,0.75,0.62,8.33,2.63,12
Tonbridge,8,1,1,6,5,17,-12,4,England - National L. South,0.12,0.25,-12,0.62,0.5,8.33,4.0,13
Hampton & R.,8,1,0,7,10,25,-15,3,England - National L. South,0.12,0.12,-15,1.25,0.38,8.33,8.33,14
Horsham,8,8,0,0,19,3,16,24,England - Isthmian league,1.0,1.0,16,2.38,3.0,1.0,1.0,1
Billericay Town,8,6,0,2,21,9,12,18,England - Isthmian league,0.75,0.75,12,2.62,2.25,1.33,1.33,2
Cray Valley PM,8,6,0,2,16,9,7,18,England - Isthmian league,0.75,0.75,7,2.0,2.25,1.33,1.33,2
Dartford,8,5,2,1,16,9,7,17,England - Isthmian league,0.62,0.88,7,2.0,2.12,1.61,1.14,3
Dover Athletic,8,5,1,2,14,10,4,16,England - Isthmian league,0.62,0.75,4,1.75,2.0,1.61,1.33,4
Carshalton,8,5,0,3,20,13,7,15,England - Isthmian league,0.62,0.62,7,2.5,1.88,1.61,1.61,5
Chichester City,8,5,0,3,14,7,7,15,England - Isthmian league,0.62,0.62,7,1.75,1.88,1.61,1.61,5
Chatham Town,8,4,2,2,13,8,5,14,England - Isthmian league,0.5,0.75,5,1.62,1.75,2.0,1.33,6
Potters Bar,8,4,0,4,12,14,-2,12,England - Isthmian league,0.5,0.5,-2,1.5,1.5,2.0,2.0,7
Cray Wanderers,8,3,1,4,17,14,3,10,England - Isthmian league,0.38,0.5,3,2.12,1.25,2.63,2.0,8
Folkestone,8,3,1,4,8,12,-4,10,England - Isthmian league,0.38,0.5,-4,1.0,1.25,2.63,2.0,8
Lewes,8,3,1,4,12,17,-5,10,England - Isthmian league,0.38,0.5,-5,1.5,1.25,2.63,2.0,8
Whitehawk,8,3,0,5,7,8,-1,9,England - Isthmian league,0.38,0.38,-1,0.88,1.12,2.63,2.63,9
Hashtag United,8,2,3,3,11,13,-2,9,England - Isthmian league,0.25,0.62,-2,1.38,1.12,4.0,1.61,9
Wingate & F.,8,2,3,3,10,12,-2,9,England - Isthmian league,0.25,0.62,-2,1.25,1.12,4.0,1.61,9
Cheshunt,8,3,0,5,10,15,-5,9,England - Isthmian league,0.38,0.38,-5,1.25,1.12,2.63,2.63,9
Hendon,8,2,2,4,15,20,-5,8,England - Isthmian league,0.25,0.5,-5,1.88,1.0,4.0,2.0,10
Bowers & Pitsea,8,2,1,5,6,15,-9,7,England - Isthmian league,0.25,0.38,-9,0.75,0.88,4.0,2.63,11
Bognor Regis,8,2,1,5,6,18,-12,7,England - Isthmian league,0.25,0.38,-12,0.75,0.88,4.0,2.63,11
Canvey Island,8,1,3,4,4,9,-5,6,England - Isthmian league,0.12,0.5,-5,0.5,0.75,8.33,2.0,12
Hastings Utd,8,1,3,4,7,13,-6,6,England - Isthmian league,0.12,0.5,-6,0.88,0.75,8.33,2.0,12
Dulwich Hamlet,8,1,1,6,6,17,-11,4,England - Isthmian league,0.12,0.25,-11,0.75,0.5,8.33,4.0,13
Macclesfield,8,8,0,0,27,4,23,24,England - Northern league,1.0,1.0,23,3.38,3.0,1.0,1.0,1
Stockton Town,8,6,1,1,9,3,6,19,England - Northern league,0.75,0.88,6,1.12,2.38,1.33,1.14,2
Worksop Town,8,6,0,2,19,9,10,18,England - Northern league,0.75,0.75,10,2.38,2.25,1.33,1.33,3
Bamber Bridge,8,5,0,3,13,7,6,15,England - Northern league,0.62,0.62,6,1.62,1.88,1.61,1.61,4
Gainsborough,8,5,0,3,13,8,5,15,England - Northern league,0.62,0.62,5,1.62,1.88,1.61,1.61,4
Prescot Cables,8,5,0,3,10,8,2,15,England - Northern league,0.62,0.62,2,1.25,1.88,1.61,1.61,4
Ilkeston Town,8,4,2,2,12,10,2,14,England - Northern league,0.5,0.75,2,1.5,1.75,2.0,1.33,5
Leek Town,8,4,1,3,13,9,4,13,England - Northern league,0.5,0.62,4,1.62,1.62,2.0,1.61,6
Guiseley,8,3,3,2,9,8,1,12,England - Northern league,0.38,0.75,1,1.12,1.5,2.63,1.33,7
Whitby Town,8,4,0,4,11,14,-3,12,England - Northern league,0.5,0.5,-3,1.38,1.5,2.0,2.0,7
Morpeth Town,8,2,5,1,8,10,-2,11,England - Northern league,0.25,0.88,-2,1.0,1.38,4.0,1.14,8
Mickleover,8,3,2,3,9,13,-4,11,England - Northern league,0.38,0.62,-4,1.12,1.38,2.63,1.61,8
Workington,8,3,1,4,14,9,5,10,England - Northern league,0.38,0.5,5,1.75,1.25,2.63,2.0,9
Matlock,8,2,3,3,11,10,1,9,England - Northern league,0.25,0.62,1,1.38,1.12,4.0,1.61,10
Ashton Utd,8,3,0,5,12,15,-3,9,England - Northern league,0.38,0.38,-3,1.5,1.12,2.63,2.63,10
Hyde Utd,8,3,0,5,9,16,-7,9,England - Northern league,0.38,0.38,-7,1.12,1.12,2.63,2.63,10
Rylands,8,2,2,4,8,11,-3,8,England - Northern league,0.25,0.5,-3,1.0,1.0,4.0,2.0,11
Lancaster City,8,2,2,4,8,16,-8,8,England - Northern league,0.25,0.5,-8,1.0,1.0,4.0,2.0,11
FC United,8,1,3,4,8,15,-7,6,England - Northern league,0.12,0.5,-7,1.0,0.75,8.33,2.0,12
Basford Utd,8,1,2,5,8,15,-7,5,England - Northern league,0.12,0.38,-7,1.0,0.62,8.33,2.63,13
Hebburn Town,8,1,2,5,8,15,-7,5,England - Northern league,0.12,0.38,-7,1.0,0.62,8.33,2.63,13
Blyth Spartans,8,0,0,8,7,22,-15,0,England - Northern league,0.0,0.0,-15,0.88,0.0,0.0,0.0,14
Bedford Town,8,6,2,0,17,6,11,20,England - Southern Central,0.75,1.0,11,2.12,2.5,1.33,1.0,1
Spalding United,8,5,3,0,25,7,18,18,England - Southern Central,0.62,1.0,18,3.12,2.25,1.61,1.0,2
AFC Sudbury,8,5,2,1,11,7,4,17,England - Southern Central,0.62,0.88,4,1.38,2.12,1.61,1.14,3
Kettering Town,8,4,4,0,11,6,5,16,England - Southern Central,0.5,1.0,5,1.38,2.0,2.0,1.0,4
Harborough Town,8,4,3,1,15,6,9,15,England - Southern Central,0.5,0.88,9,1.88,1.88,2.0,1.14,5
Telford Utd,8,3,5,0,16,5,11,14,England - Southern Central,0.38,1.0,11,2.0,1.75,2.63,1.0,6
Halesowen Town,8,3,5,0,12,6,6,14,England - Southern Central,0.38,1.0,6,1.5,1.75,2.63,1.0,6
Stourbridge,8,4,2,2,12,10,2,14,England - Southern Central,0.5,0.75,2,1.5,1.75,2.0,1.33,6
Banbury Utd,8,3,3,2,13,10,3,12,England - Southern Central,0.38,0.75,3,1.62,1.5,2.63,1.33,7
Stamford,8,3,3,2,8,13,-5,12,England - Southern Central,0.38,0.75,-5,1.0,1.5,2.63,1.33,7
Stratford Town,8,2,4,2,10,9,1,10,England - Southern Central,0.25,0.75,1,1.25,1.25,4.0,1.33,8
Royston,8,2,4,2,9,8,1,10,England - Southern Central,0.25,0.75,1,1.12,1.25,4.0,1.33,8
Barwell,8,3,1,4,11,19,-8,10,England - Southern Central,0.38,0.5,-8,1.38,1.25,2.63,2.0,8
Redditch Utd,8,2,3,3,8,9,-1,9,England - Southern Central,0.25,0.62,-1,1.0,1.12,4.0,1.61,9
Alvechurch,8,2,3,3,9,11,-2,9,England - Southern Central,0.25,0.62,-2,1.12,1.12,4.0,1.61,9
B. Stortford,8,2,2,4,8,14,-6,8,England - Southern Central,0.25,0.5,-6,1.0,1.0,4.0,2.0,10
Bromsgrove,8,2,1,5,13,14,-1,7,England - Southern Central,0.25,0.38,-1,1.62,0.88,4.0,2.63,11
St. Ives Town,8,1,4,3,10,13,-3,7,England - Southern Central,0.12,0.62,-3,1.25,0.88,8.33,1.61,11
Biggleswade,8,2,1,5,8,14,-6,7,England - Southern Central,0.25,0.38,-6,1.0,0.88,4.0,2.63,11
Leiston,8,1,3,4,6,11,-5,6,England - Southern Central,0.12,0.5,-5,0.75,0.75,8.33,2.0,12
Hitchin Town,8,0,2,6,9,20,-11,2,England - Southern Central,0.0,0.25,-11,1.12,0.25,0.0,4.0,13
Lowestoft,8,0,1,7,8,27,-19,1,England - Southern Central,0.0,0.12,-19,1.0,0.12,0.0,8.33,14
Levadia,8,6,1,1,21,5,16,19,Estonia - Meistriliiga,0.75,0.88,16,2.62,2.38,1.33,1.14,1
Flora,8,6,1,1,20,6,14,19,Estonia - Meistriliiga,0.75,0.88,14,2.5,2.38,1.33,1.14,1
Nomme Kalju,8,5,1,2,20,10,10,16,Estonia - Meistriliiga,0.62,0.75,10,2.5,2.0,1.61,1.33,2
Paide,8,5,0,3,11,5,6,15,Estonia - Meistriliiga,0.62,0.62,6,1.38,1.88,1.61,1.61,3
Narva Trans,8,5,0,3,11,7,4,15,Estonia - Meistriliiga,0.62,0.62,4,1.38,1.88,1.61,1.61,3
Vaprus,8,2,2,4,11,9,2,8,Estonia - Meistriliiga,0.25,0.5,2,1.38,1.0,4.0,2.0,4
Harju JK,8,2,1,5,9,16,-7,7,Estonia - Meistriliiga,0.25,0.38,-7,1.12,0.88,4.0,2.63,5
Tallinna Kalev,8,2,1,5,8,28,-20,7,Estonia - Meistriliiga,0.25,0.38,-20,1.0,0.88,4.0,2.63,5
Kuressaare,8,2,0,6,6,17,-11,6,Estonia - Meistriliiga,0.25,0.25,-11,0.75,0.75,4.0,4.0,6
Tammeka,8,1,1,6,6,20,-14,4,Estonia - Meistriliiga,0.12,0.25,-14,0.75,0.5,8.33,4.0,7
Nomme Utd,8,7,0,1,16,6,10,21,Estonia - Esiliiga,0.88,0.88,10,2.0,2.62,1.14,1.14,1
Tartu Welco,8,5,2,1,16,11,5,17,Estonia - Esiliiga,0.62,0.88,5,2.0,2.12,1.61,1.14,2
Viimsi,8,4,2,2,18,10,8,14,Estonia - Esiliiga,0.5,0.75,8,2.25,1.75,2.0,1.33,3
Elva,8,4,2,2,16,13,3,14,Estonia - Esiliiga,0.5,0.75,3,2.0,1.75,2.0,1.33,3
Flora B,8,3,3,2,20,10,10,12,Estonia - Esiliiga,0.38,0.75,10,2.5,1.5,2.63,1.33,4
Levadia B,7,3,1,3,10,9,1,10,Estonia - Esiliiga,0.43,0.57,1,1.43,1.43,2.33,1.75,5
Nomme Kalju B,7,3,0,4,10,16,-6,9,Estonia - Esiliiga,0.43,0.43,-6,1.43,1.29,2.33,2.33,6
FC Tallinn,8,2,2,4,12,15,-3,8,Estonia - Esiliiga,0.25,0.5,-3,1.5,1.0,4.0,2.0,7
Tammeka B,8,1,0,7,11,24,-13,3,Estonia - Esiliiga,0.12,0.12,-13,1.38,0.38,8.33,8.33,8
Tallinna K. B,8,0,2,6,7,22,-15,2,Estonia - Esiliiga,0.0,0.25,-15,0.88,0.25,0.0,4.0,9
NSI Runavik,7,7,0,0,33,5,28,21,FaroeIslands - Premier League,1.0,1.0,28,4.71,3.0,1.0,1.0,1
Klaksvik,7,7,0,0,20,3,17,21,FaroeIslands - Premier League,1.0,1.0,17,2.86,3.0,1.0,1.0,1
HB Torshavn,7,5,0,2,17,12,5,15,FaroeIslands - Premier League,0.71,0.71,5,2.43,2.14,1.41,1.41,2
B36 Torshavn,7,4,1,2,13,11,2,13,FaroeIslands - Premier League,0.57,0.71,2,1.86,1.86,1.75,1.41,3
Vikingur,7,2,2,3,6,8,-2,8,FaroeIslands - Premier League,0.29,0.57,-2,0.86,1.14,3.45,1.75,4
Streymur,7,2,1,4,7,16,-9,7,FaroeIslands - Premier League,0.29,0.43,-9,1.0,1.0,3.45,2.33,5
Suduroy,7,2,0,5,3,14,-11,6,FaroeIslands - Premier League,0.29,0.29,-11,0.43,0.86,3.45,3.45,6
TB Tvoroyri,7,1,2,4,8,14,-6,5,FaroeIslands - Premier League,0.14,0.43,-6,1.14,0.71,7.14,2.33,7
B68 Toftir,7,1,1,5,5,19,-14,4,FaroeIslands - Premier League,0.14,0.29,-14,0.71,0.57,7.14,3.45,8
07 Vestur,7,0,1,6,6,16,-10,1,FaroeIslands - Premier League,0.0,0.14,-10,0.86,0.14,0.0,7.14,9
Skala,7,6,1,0,21,2,19,19,FaroeIslands - 1. Deild,0.86,1.0,19,3.0,2.71,1.16,1.0,1
B71 Sandur,7,5,0,2,11,10,1,15,FaroeIslands - 1. Deild,0.71,0.71,1,1.57,2.14,1.41,1.41,2
AB Argir,6,4,2,0,15,4,11,14,FaroeIslands - 1. Deild,0.67,1.0,11,2.5,2.33,1.49,1.0,3
Vikingur B,7,4,0,3,16,11,5,12,FaroeIslands - 1. Deild,0.57,0.57,5,2.29,1.71,1.75,1.75,4
Streymur B,6,4,0,2,9,6,3,12,FaroeIslands - 1. Deild,0.67,0.67,3,1.5,2.0,1.49,1.49,4
Klaksvik B,7,3,1,3,10,13,-3,10,FaroeIslands - 1. Deild,0.43,0.57,-3,1.43,1.43,2.33,1.75,5
IF Fuglafjordur,7,2,2,3,11,13,-2,8,FaroeIslands - 1. Deild,0.29,0.57,-2,1.57,1.14,3.45,1.75,6
NSI Runavik B,7,2,1,4,14,15,-1,7,FaroeIslands - 1. Deild,0.29,0.43,-1,2.0,1.0,3.45,2.33,7
B36 Torshavn B,7,0,1,6,4,24,-20,1,FaroeIslands - 1. Deild,0.0,0.14,-20,0.57,0.14,0.0,7.14,8
07 Vestur B,7,0,0,7,7,20,-13,0,FaroeIslands - 1. Deild,0.0,0.0,-13,1.0,0.0,0.0,0.0,9
KuPS,5,4,1,0,9,3,6,13,Finland - Veikkausliiga,0.8,1.0,6,1.8,2.6,1.25,1.0,1
SJK,4,4,0,0,7,2,5,12,Finland - Veikkausliiga,1.0,1.0,5,1.75,3.0,1.0,1.0,2
Inter Turku,4,3,1,0,10,2,8,10,Finland - Veikkausliiga,0.75,1.0,8,2.5,2.5,1.33,1.0,3
Ilves,4,3,0,1,12,6,6,9,Finland - Veikkausliiga,0.75,0.75,6,3.0,2.25,1.33,1.33,4
Haka,3,2,0,1,5,4,1,6,Finland - Veikkausliiga,0.67,0.67,1,1.67,2.0,1.49,1.49,5
Mariehamn,5,2,0,3,6,10,-4,6,Finland - Veikkausliiga,0.4,0.4,-4,1.2,1.2,2.5,2.5,5
VPS,4,1,1,2,7,10,-3,4,Finland - Veikkausliiga,0.25,0.5,-3,1.75,1.0,4.0,2.0,6
KTP,4,1,1,2,5,10,-5,4,Finland - Veikkausliiga,0.25,0.5,-5,1.25,1.0,4.0,2.0,6
HJK Helsinki,4,1,0,3,5,6,-1,3,Finland - Veikkausliiga,0.25,0.25,-1,1.25,0.75,4.0,4.0,7
Jaro,4,1,0,3,5,6,-1,3,Finland - Veikkausliiga,0.25,0.25,-1,1.25,0.75,4.0,4.0,7
Gnistan,4,1,0,3,4,8,-4,3,Finland - Veikkausliiga,0.25,0.25,-4,1.0,0.75,4.0,4.0,7
Oulu,5,0,0,5,6,14,-8,0,Finland - Veikkausliiga,0.0,0.0,-8,1.2,0.0,0.0,0.0,8
Ekenas IF,2,2,0,0,8,4,4,6,Finland - Ykkosliga,1.0,1.0,4,4.0,3.0,1.0,1.0,1
TPS,2,2,0,0,6,4,2,6,Finland - Ykkosliga,1.0,1.0,2,3.0,3.0,1.0,1.0,1
PK-35,2,1,1,0,2,1,1,4,Finland - Ykkosliga,0.5,1.0,1,1.0,2.0,2.0,1.0,2
SJK Akatemia,2,1,0,1,6,4,2,3,Finland - Ykkosliga,0.5,0.5,2,3.0,1.5,2.0,2.0,3
JIPPO,2,1,0,1,3,2,1,3,Finland - Ykkosliga,0.5,0.5,1,1.5,1.5,2.0,2.0,3
JaPS,2,1,0,1,8,8,0,3,Finland - Ykkosliga,0.5,0.5,0,4.0,1.5,2.0,2.0,3
Lahti,1,0,1,0,0,0,0,1,Finland - Ykkosliga,0.0,1.0,0,0.0,1.0,0.0,1.0,4
Klubi-04,1,0,0,1,4,6,-2,0,Finland - Ykkosliga,0.0,0.0,-2,4.0,0.0,0.0,0.0,5
SalPa,2,0,0,2,1,4,-3,0,Finland - Ykkosliga,0.0,0.0,-3,0.5,0.0,0.0,0.0,5
KaPa,2,0,0,2,2,7,-5,0,Finland - Ykkosliga,0.0,0.0,-5,1.0,0.0,0.0,0.0,5
Atlantis,3,2,0,1,5,2,3,6,Finland - Ykkonen,0.67,0.67,3,1.67,2.0,1.49,1.49,1
EPS,3,2,0,1,5,2,3,6,Finland - Ykkonen,0.67,0.67,3,1.67,2.0,1.49,1.49,1
KuPS Ak.,2,2,0,0,4,2,2,6,Finland - Ykkonen,1.0,1.0,2,2.0,3.0,1.0,1.0,1
Tampere Utd,3,2,0,1,5,4,1,6,Finland - Ykkonen,0.67,0.67,1,1.67,2.0,1.49,1.49,1
Rovaniemi,3,2,0,1,5,6,-1,6,Finland - Ykkonen,0.67,0.67,-1,1.67,2.0,1.49,1.49,1
JJK,3,1,1,1,7,5,2,4,Finland - Ykkonen,0.33,0.67,2,2.33,1.33,3.03,1.49,2
KPV Kokkola,3,1,1,1,3,4,-1,4,Finland - Ykkonen,0.33,0.67,-1,1.0,1.33,3.03,1.49,2
PKKU,2,1,0,1,5,1,4,3,Finland - Ykkonen,0.5,0.5,4,2.5,1.5,2.0,2.0,3
Inter Turku B,3,1,0,2,7,7,0,3,Finland - Ykkonen,0.33,0.33,0,2.33,1.0,3.03,3.03,3
Jazz Pori,3,1,0,2,2,5,-3,3,Finland - Ykkonen,0.33,0.33,-3,0.67,1.0,3.03,3.03,3
OLS Oulu,3,0,2,1,5,8,-3,2,Finland - Ykkonen,0.0,0.67,-3,1.67,0.67,0.0,1.49,4
Mikkelin,3,0,0,3,1,8,-7,0,Finland - Ykkonen,0.0,0.0,-7,0.33,0.0,0.0,0.0,5
VJS,2,2,0,0,11,1,10,6,Finland - Kakkonen Group A,1.0,1.0,10,5.5,3.0,1.0,1.0,1
Honka,2,2,0,0,8,1,7,6,Finland - Kakkonen Group A,1.0,1.0,7,4.0,3.0,1.0,1.0,1
MYPA,2,1,1,0,5,4,1,4,Finland - Kakkonen Group A,0.5,1.0,1,2.5,2.0,2.0,1.0,2
PuiU Helsinki,1,1,0,0,3,0,3,3,Finland - Kakkonen Group A,1.0,1.0,3,3.0,3.0,1.0,1.0,3
GrIFK,2,1,0,1,5,3,2,3,Finland - Kakkonen Group A,0.5,0.5,2,2.5,1.5,2.0,2.0,3
PEPO,2,0,1,1,2,5,-3,1,Finland - Kakkonen Group A,0.0,0.5,-3,1.0,0.5,0.0,2.0,4
HaPK,2,0,1,1,1,4,-3,1,Finland - Kakkonen Group A,0.0,0.5,-3,0.5,0.5,0.0,2.0,4
Vaajakoski,2,0,1,1,3,8,-5,1,Finland - Kakkonen Group A,0.0,0.5,-5,1.5,0.5,0.0,2.0,4
Reipas,2,0,0,2,2,8,-6,0,Finland - Kakkonen Group A,0.0,0.0,-6,1.0,0.0,0.0,0.0,5
JPS,1,0,0,1,0,6,-6,0,Finland - Kakkonen Group A,0.0,0.0,-6,0.0,0.0,0.0,0.0,5
TPV,2,2,0,0,7,2,5,6,Finland - Kakkonen Group B,1.0,1.0,5,3.5,3.0,1.0,1.0,1
P-Iirot,2,1,0,1,5,3,2,3,Finland - Kakkonen Group B,0.5,0.5,2,2.5,1.5,2.0,2.0,2
Kiffen,2,1,0,1,6,5,1,3,Finland - Kakkonen Group B,0.5,0.5,1,3.0,1.5,2.0,2.0,2
MuSa,2,1,0,1,4,3,1,3,Finland - Kakkonen Group B,0.5,0.5,1,2.0,1.5,2.0,2.0,2
NJS,1,1,0,0,3,2,1,3,Finland - Kakkonen Group B,1.0,1.0,1,3.0,3.0,1.0,1.0,2
Ilves B,1,1,0,0,2,1,1,3,Finland - Kakkonen Group B,1.0,1.0,1,2.0,3.0,1.0,1.0,2
HJS,2,1,0,1,3,4,-1,3,Finland - Kakkonen Group B,0.5,0.5,-1,1.5,1.5,2.0,2.0,2
PPJ,2,1,0,1,3,6,-3,3,Finland - Kakkonen Group B,0.5,0.5,-3,1.5,1.5,2.0,2.0,2
HPS,2,0,0,2,1,4,-3,0,Finland - Kakkonen Group B,0.0,0.0,-3,0.5,0.0,0.0,0.0,3
Atlantis B,2,0,0,2,2,6,-4,0,Finland - Kakkonen Group B,0.0,0.0,-4,1.0,0.0,0.0,0.0,3
VPS B,2,2,0,0,12,0,12,6,Finland - Kakkonen Group C,1.0,1.0,12,6.0,3.0,1.0,1.0,1
SJK Akatemia B,2,2,0,0,9,2,7,6,Finland - Kakkonen Group C,1.0,1.0,7,4.5,3.0,1.0,1.0,1
JS Hercules,2,2,0,0,6,3,3,6,Finland - Kakkonen Group C,1.0,1.0,3,3.0,3.0,1.0,1.0,1
JBK,2,1,1,0,4,3,1,4,Finland - Kakkonen Group C,0.5,1.0,1,2.0,2.0,2.0,1.0,2
OsPa,2,0,1,1,3,4,-1,1,Finland - Kakkonen Group C,0.0,0.5,-1,1.5,0.5,0.0,2.0,3
VIFK,2,0,1,1,3,4,-1,1,Finland - Kakkonen Group C,0.0,0.5,-1,1.5,0.5,0.0,2.0,3
Narpes Kraft,2,0,1,1,2,3,-1,1,Finland - Kakkonen Group C,0.0,0.5,-1,1.0,0.5,0.0,2.0,3
GBK Kokkola,2,0,1,1,1,4,-3,1,Finland - Kakkonen Group C,0.0,0.5,-3,0.5,0.5,0.0,2.0,3
TP-47,2,0,1,1,2,8,-6,1,Finland - Kakkonen Group C,0.0,0.5,-6,1.0,0.5,0.0,2.0,3
Kuopion Elo,2,0,0,2,1,12,-11,0,Finland - Kakkonen Group C,0.0,0.0,-11,0.5,0.0,0.0,0.0,4
Strasbourg,8,6,2,0,14,6,8,20,France - Ligue 1,0.75,1.0,8,1.75,2.5,1.33,1.0,1
Paris SG,8,6,1,1,22,9,13,19,France - Ligue 1,0.75,0.88,13,2.75,2.38,1.33,1.14,2
Lyon,8,6,0,2,20,12,8,18,France - Ligue 1,0.75,0.75,8,2.5,2.25,1.33,1.33,3
Monaco,8,4,3,1,13,5,8,15,France - Ligue 1,0.5,0.88,8,1.62,1.88,2.0,1.14,4
Lille,8,5,0,3,11,9,2,15,France - Ligue 1,0.62,0.62,2,1.38,1.88,1.61,1.61,4
Auxerre,8,4,1,3,11,8,3,13,France - Ligue 1,0.5,0.62,3,1.38,1.62,2.0,1.61,5
Rennes,8,4,0,4,16,12,4,12,France - Ligue 1,0.5,0.5,4,2.0,1.5,2.0,2.0,6
Marseille,8,4,0,4,16,14,2,12,France - Ligue 1,0.5,0.5,2,2.0,1.5,2.0,2.0,6
Lens,8,4,0,4,9,12,-3,12,France - Ligue 1,0.5,0.5,-3,1.12,1.5,2.0,2.0,6
Nice,8,3,2,3,13,12,1,11,France - Ligue 1,0.38,0.62,1,1.62,1.38,2.63,1.61,7
Brest,8,3,2,3,14,15,-1,11,France - Ligue 1,0.38,0.62,-1,1.75,1.38,2.63,1.61,7
Reims,8,3,2,3,6,7,-1,11,France - Ligue 1,0.38,0.62,-1,0.75,1.38,2.63,1.61,7
Le Havre,8,3,2,3,15,18,-3,11,France - Ligue 1,0.38,0.62,-3,1.88,1.38,2.63,1.61,7
Nantes,8,2,2,4,7,10,-3,8,France - Ligue 1,0.25,0.5,-3,0.88,1.0,4.0,2.0,8
Saint-Etienne,8,2,2,4,11,18,-7,8,France - Ligue 1,0.25,0.5,-7,1.38,1.0,4.0,2.0,8
Toulouse,8,1,2,5,11,13,-2,5,France - Ligue 1,0.12,0.38,-2,1.38,0.62,8.33,2.63,9
Angers,8,1,0,7,3,16,-13,3,France - Ligue 1,0.12,0.12,-13,0.38,0.38,8.33,8.33,10
Montpellier,8,0,1,7,1,17,-16,1,France - Ligue 1,0.0,0.12,-16,0.12,0.12,0.0,8.33,11
Lorient,8,6,1,1,22,6,16,19,France - Ligue 2,0.75,0.88,16,2.75,2.38,1.33,1.14,1
Paris FC,8,6,1,1,16,11,5,19,France - Ligue 2,0.75,0.88,5,2.0,2.38,1.33,1.14,1
Metz,8,5,2,1,21,12,9,17,France - Ligue 2,0.62,0.88,9,2.62,2.12,1.61,1.14,2
Troyes,8,4,2,2,10,5,5,14,France - Ligue 2,0.5,0.75,5,1.25,1.75,2.0,1.33,3
Guingamp,8,4,0,4,13,13,0,12,France - Ligue 2,0.5,0.5,0,1.62,1.5,2.0,2.0,4
Laval,8,4,0,4,10,11,-1,12,France - Ligue 2,0.5,0.5,-1,1.25,1.5,2.0,2.0,4
Pau FC,8,3,3,2,9,13,-4,12,France - Ligue 2,0.38,0.75,-4,1.12,1.5,2.63,1.33,4
Rodez Aveyron,8,2,4,2,13,11,2,10,France - Ligue 2,0.25,0.75,2,1.62,1.25,4.0,1.33,5
Red Star,8,2,4,2,12,10,2,10,France - Ligue 2,0.25,0.75,2,1.5,1.25,4.0,1.33,5
Martigues,8,3,1,4,10,10,0,10,France - Ligue 2,0.38,0.5,0,1.25,1.25,2.63,2.0,5
SC Bastia,8,3,1,4,11,13,-2,10,France - Ligue 2,0.38,0.5,-2,1.38,1.25,2.63,2.0,5
Amiens,8,3,1,4,9,11,-2,10,France - Ligue 2,0.38,0.5,-2,1.12,1.25,2.63,2.0,5
AC Ajaccio,8,2,3,3,8,11,-3,9,France - Ligue 2,0.25,0.62,-3,1.0,1.12,4.0,1.61,6
Annecy,8,2,3,3,8,11,-3,9,France - Ligue 2,0.25,0.62,-3,1.0,1.12,4.0,1.61,6
USL Dunkerque,8,3,0,5,10,14,-4,9,France - Ligue 2,0.38,0.38,-4,1.25,1.12,2.63,2.63,6
Grenoble,8,2,2,4,9,12,-3,8,France - Ligue 2,0.25,0.5,-3,1.12,1.0,4.0,2.0,7
Caen,8,1,2,5,8,18,-10,5,France - Ligue 2,0.12,0.38,-10,1.0,0.62,8.33,2.63,8
Clermont,8,0,4,4,5,12,-7,4,France - Ligue 2,0.0,0.5,-7,0.62,0.5,0.0,2.0,9
Le Mans,8,6,1,1,13,5,8,19,France - National,0.75,0.88,8,1.62,2.38,1.33,1.14,1
Nancy,8,5,1,2,16,7,9,16,France - National,0.62,0.75,9,2.0,2.0,1.61,1.33,2
Dijon,8,4,3,1,11,7,4,15,France - National,0.5,0.88,4,1.38,1.88,2.0,1.14,3
Concarneau,8,3,4,1,13,7,6,13,France - National,0.38,0.88,6,1.62,1.62,2.63,1.14,4
Boulogne,8,3,4,1,11,9,2,13,France - National,0.38,0.88,2,1.38,1.62,2.63,1.14,4
Rouen,8,3,2,3,13,14,-1,11,France - National,0.38,0.62,-1,1.62,1.38,2.63,1.61,5
Bourg-en-Bresse,8,3,2,3,6,7,-1,11,France - National,0.38,0.62,-1,0.75,1.38,2.63,1.61,5
Quevilly Rouen,8,3,2,3,6,11,-5,11,France - National,0.38,0.62,-5,0.75,1.38,2.63,1.61,5
Orleans,8,2,4,2,10,12,-2,10,France - National,0.25,0.75,-2,1.25,1.25,4.0,1.33,6
Aubagne,8,2,3,3,11,10,1,9,France - National,0.25,0.62,1,1.38,1.12,4.0,1.61,7
Sochaux,8,2,3,3,6,7,-1,9,France - National,0.25,0.62,-1,0.75,1.12,4.0,1.61,7
Nimes,8,2,3,3,5,10,-5,9,France - National,0.25,0.62,-5,0.62,1.12,4.0,1.61,7
Valenciennes,8,2,2,4,6,7,-1,8,France - National,0.25,0.5,-1,0.75,1.0,4.0,2.0,8
Chateauroux,8,2,2,4,10,16,-6,8,France - National,0.25,0.5,-6,1.25,1.0,4.0,2.0,8
Versailles,8,1,4,3,11,12,-1,7,France - National,0.12,0.62,-1,1.38,0.88,8.33,1.61,9
Villefranche,8,1,4,3,9,12,-3,7,France - National,0.12,0.62,-3,1.12,0.88,8.33,1.61,9
Paris 13 A.,8,1,3,4,6,9,-3,6,France - National,0.12,0.5,-3,0.75,0.75,8.33,2.0,10
Dila Gori,8,6,1,1,16,6,10,19,Georgia - Erovnuli Liga,0.75,0.88,10,2.0,2.38,1.33,1.14,1
Dinamo Batumi,8,5,3,0,11,3,8,18,Georgia - Erovnuli Liga,0.62,1.0,8,1.38,2.25,1.61,1.0,2
Iberia,8,5,3,0,11,3,8,18,Georgia - Erovnuli Liga,0.62,1.0,8,1.38,2.25,1.61,1.0,2
Dinamo Tbilisi,8,3,2,3,10,8,2,11,Georgia - Erovnuli Liga,0.38,0.62,2,1.25,1.38,2.63,1.61,3
Torpedo Kutaisi,8,2,3,3,10,10,0,9,Georgia - Erovnuli Liga,0.25,0.62,0,1.25,1.12,4.0,1.61,4
Gagra,8,3,0,5,6,11,-5,9,Georgia - Erovnuli Liga,0.38,0.38,-5,0.75,1.12,2.63,2.63,4
Samgurali,8,2,2,4,11,7,4,8,Georgia - Erovnuli Liga,0.25,0.5,4,1.38,1.0,4.0,2.0,5
Telavi,8,2,2,4,5,18,-13,8,Georgia - Erovnuli Liga,0.25,0.5,-13,0.62,1.0,4.0,2.0,5
Kolkheti Poti,8,2,1,5,5,14,-9,7,Georgia - Erovnuli Liga,0.25,0.38,-9,0.62,0.88,4.0,2.63,6
Gareji Sagarejo,8,1,1,6,4,9,-5,4,Georgia - Erovnuli Liga,0.12,0.25,-5,0.5,0.5,8.33,4.0,7
Spaeri,8,5,3,0,19,10,9,18,Georgia - Erovnuli Liga 2,0.62,1.0,9,2.38,2.25,1.61,1.0,1
Rustavi,8,3,4,1,12,10,2,13,Georgia - Erovnuli Liga 2,0.38,0.88,2,1.5,1.62,2.63,1.14,2
Merani Martvili,8,4,1,3,13,14,-1,13,Georgia - Erovnuli Liga 2,0.5,0.62,-1,1.62,1.62,2.0,1.61,2
Bolnisi,8,3,2,3,8,8,0,11,Georgia - Erovnuli Liga 2,0.38,0.62,0,1.0,1.38,2.63,1.61,3
Gonio,8,2,4,2,11,10,1,10,Georgia - Erovnuli Liga 2,0.25,0.75,1,1.38,1.25,4.0,1.33,4
L. Tbilisi,8,1,5,2,11,11,0,8,Georgia - Erovnuli Liga 2,0.12,0.75,0,1.38,1.0,8.33,1.33,5
Samtredia,8,1,5,2,7,8,-1,8,Georgia - Erovnuli Liga 2,0.12,0.75,-1,0.88,1.0,8.33,1.33,5
Meshakhte,8,1,5,2,5,8,-3,8,Georgia - Erovnuli Liga 2,0.12,0.75,-3,0.62,1.0,8.33,1.33,5
D. Tbilisi B,8,1,4,3,9,12,-3,7,Georgia - Erovnuli Liga 2,0.12,0.62,-3,1.12,0.88,8.33,1.61,6
Iberia B,8,1,3,4,7,11,-4,6,Georgia - Erovnuli Liga 2,0.12,0.5,-4,0.88,0.75,8.33,2.0,7
Bayern Munich,8,5,2,1,21,10,11,17,Germany - Bundesliga,0.62,0.88,11,2.62,2.12,1.61,1.14,1
Leverkusen,8,5,2,1,15,8,7,17,Germany - Bundesliga,0.62,0.88,7,1.88,2.12,1.61,1.14,1
Dortmund,8,5,1,2,17,11,6,16,Germany - Bundesliga,0.62,0.75,6,2.12,2.0,1.61,1.33,2
Werder Bremen,8,5,1,2,13,7,6,16,Germany - Bundesliga,0.62,0.75,6,1.62,2.0,1.61,1.33,2
E. Frankfurt,8,4,1,3,13,9,4,13,Germany - Bundesliga,0.5,0.62,4,1.62,1.62,2.0,1.61,3
Union Berlin,8,3,4,1,11,9,2,13,Germany - Bundesliga,0.38,0.88,2,1.38,1.62,2.63,1.14,3
Freiburg,8,3,3,2,10,11,-1,12,Germany - Bundesliga,0.38,0.75,-1,1.25,1.5,2.63,1.33,4
FC Augsburg,8,3,3,2,6,7,-1,12,Germany - Bundesliga,0.38,0.75,-1,0.75,1.5,2.63,1.33,4
RB Leipzig,8,3,2,3,10,11,-1,11,Germany - Bundesliga,0.38,0.62,-1,1.25,1.38,2.63,1.61,5
Monchengladbach,8,3,1,4,16,15,1,10,Germany - Bundesliga,0.38,0.5,1,2.0,1.25,2.63,2.0,6
Sankt Pauli,8,2,4,2,8,9,-1,10,Germany - Bundesliga,0.25,0.75,-1,1.0,1.25,4.0,1.33,6
Heidenheim,8,3,1,4,6,13,-7,10,Germany - Bundesliga,0.38,0.5,-7,0.75,1.25,2.63,2.0,6
FSV Mainz,8,2,3,3,11,15,-4,9,Germany - Bundesliga,0.25,0.62,-4,1.38,1.12,4.0,1.61,7
Holstein Kiel,8,2,3,3,11,15,-4,9,Germany - Bundesliga,0.25,0.62,-4,1.38,1.12,4.0,1.61,7
Hoffenheim,8,2,2,4,10,12,-2,8,Germany - Bundesliga,0.25,0.5,-2,1.25,1.0,4.0,2.0,8
Stuttgart,8,1,2,5,15,17,-2,5,Germany - Bundesliga,0.12,0.38,-2,1.88,0.62,8.33,2.63,9
Wolfsburg,8,1,2,5,7,11,-4,5,Germany - Bundesliga,0.12,0.38,-4,0.88,0.62,8.33,2.63,9
Bochum,8,1,1,6,7,17,-10,4,Germany - Bundesliga,0.12,0.25,-10,0.88,0.5,8.33,4.0,10
Hertha Berlin,8,4,2,2,15,12,3,14,Germany - 2. Bundesliga,0.5,0.75,3,1.88,1.75,2.0,1.33,1
Karlsruher SC,8,4,2,2,7,8,-1,14,Germany - 2. Bundesliga,0.5,0.75,-1,0.88,1.75,2.0,1.33,1
Elversberg,8,3,4,1,16,5,11,13,Germany - 2. Bundesliga,0.38,0.88,11,2.0,1.62,2.63,1.14,2
FC Koln,8,4,1,3,9,7,2,13,Germany - 2. Bundesliga,0.5,0.62,2,1.12,1.62,2.0,1.61,2
Braunschweig,8,3,4,1,14,13,1,13,Germany - 2. Bundesliga,0.38,0.88,1,1.75,1.62,2.63,1.14,2
Magdeburg,8,3,3,2,11,7,4,12,Germany - 2. Bundesliga,0.38,0.75,4,1.38,1.5,2.63,1.33,3
Hamburger SV,8,3,2,3,15,11,4,11,Germany - 2. Bundesliga,0.38,0.62,4,1.88,1.38,2.63,1.61,4
Paderborn,8,3,2,3,15,13,2,11,Germany - 2. Bundesliga,0.38,0.62,2,1.88,1.38,2.63,1.61,4
Darmstadt,8,3,2,3,12,11,1,11,Germany - 2. Bundesliga,0.38,0.62,1,1.5,1.38,2.63,1.61,4
Ulm,8,3,2,3,8,8,0,11,Germany - 2. Bundesliga,0.38,0.62,0,1.0,1.38,2.63,1.61,4
Schalke 04,8,3,2,3,12,13,-1,11,Germany - 2. Bundesliga,0.38,0.62,-1,1.5,1.38,2.63,1.61,4
Hannover 96,8,3,2,3,8,10,-2,11,Germany - 2. Bundesliga,0.38,0.62,-2,1.0,1.38,2.63,1.61,4
Dusseldorf,8,3,2,3,11,14,-3,11,Germany - 2. Bundesliga,0.38,0.62,-3,1.38,1.38,2.63,1.61,4
FC Nurnberg,8,3,1,4,13,14,-1,10,Germany - 2. Bundesliga,0.38,0.5,-1,1.62,1.25,2.63,2.0,5
Kaiserslautern,8,3,1,4,13,14,-1,10,Germany - 2. Bundesliga,0.38,0.5,-1,1.62,1.25,2.63,2.0,5
Regensburg,8,2,2,4,5,15,-10,8,Germany - 2. Bundesliga,0.25,0.5,-10,0.62,1.0,4.0,2.0,6
Preuss. Munster,8,1,3,4,5,9,-4,6,Germany - 2. Bundesliga,0.12,0.5,-4,0.62,0.75,8.33,2.0,7
Greuther Furth,8,1,3,4,7,12,-5,6,Germany - 2. Bundesliga,0.12,0.5,-5,0.88,0.75,8.33,2.0,7
Bielefeld,8,7,1,0,20,5,15,22,Germany - 3. Liga,0.88,1.0,15,2.5,2.75,1.14,1.0,1
1860 Munchen,8,5,1,2,14,5,9,16,Germany - 3. Liga,0.62,0.75,9,1.75,2.0,1.61,1.33,2
Alemannia A.,8,5,1,2,12,6,6,16,Germany - 3. Liga,0.62,0.75,6,1.5,2.0,1.61,1.33,2
Dynamo Dresden,8,4,3,1,14,8,6,15,Germany - 3. Liga,0.5,0.88,6,1.75,1.88,2.0,1.14,3
Hansa Rostock,8,4,1,3,12,9,3,13,Germany - 3. Liga,0.5,0.62,3,1.5,1.62,2.0,1.61,4
Verl,8,4,1,3,15,13,2,13,Germany - 3. Liga,0.5,0.62,2,1.88,1.62,2.0,1.61,4
Viktoria Koln,8,4,1,3,10,9,1,13,Germany - 3. Liga,0.5,0.62,1,1.25,1.62,2.0,1.61,4
Osnabruck,8,4,1,3,6,5,1,13,Germany - 3. Liga,0.5,0.62,1,0.75,1.62,2.0,1.61,4
RW Essen,8,4,1,3,10,11,-1,13,Germany - 3. Liga,0.5,0.62,-1,1.25,1.62,2.0,1.61,4
Hannover 96 B,8,2,5,1,18,14,4,11,Germany - 3. Liga,0.25,0.88,4,2.25,1.38,4.0,1.14,5
Energie Cottbus,8,3,2,3,8,13,-5,11,Germany - 3. Liga,0.38,0.62,-5,1.0,1.38,2.63,1.61,5
Dortmund B,8,2,4,2,10,11,-1,10,Germany - 3. Liga,0.25,0.75,-1,1.25,1.25,4.0,1.33,6
Mannheim,8,2,4,2,7,10,-3,10,Germany - 3. Liga,0.25,0.75,-3,0.88,1.25,4.0,1.33,6
VfB Stuttgart B,8,2,3,3,10,10,0,9,Germany - 3. Liga,0.25,0.62,0,1.25,1.12,4.0,1.61,7
FC Ingolstadt,8,2,3,3,15,17,-2,9,Germany - 3. Liga,0.25,0.62,-2,1.88,1.12,4.0,1.61,7
Saarbrucken,8,2,3,3,9,11,-2,9,Germany - 3. Liga,0.25,0.62,-2,1.12,1.12,4.0,1.61,7
Wehen Wiesbaden,8,1,3,4,10,14,-4,6,Germany - 3. Liga,0.12,0.5,-4,1.25,0.75,8.33,2.0,8
Erzgebirge Aue,8,2,0,6,8,19,-11,6,Germany - 3. Liga,0.25,0.25,-11,1.0,0.75,4.0,4.0,8
Unterhaching,8,1,2,5,8,15,-7,5,Germany - 3. Liga,0.12,0.38,-7,1.0,0.62,8.33,2.63,9
Sandhausen,8,0,0,8,6,17,-11,0,Germany - 3. Liga,0.0,0.0,-11,0.75,0.0,0.0,0.0,10
Samartex,8,5,2,1,14,5,9,17,Ghana - Premier League,0.62,0.88,9,1.75,2.12,1.61,1.14,1
Accra Lions,8,5,1,2,13,7,6,16,Ghana - Premier League,0.62,0.75,6,1.62,2.0,1.61,1.33,2
Nations,8,5,1,2,8,2,6,16,Ghana - Premier League,0.62,0.75,6,1.0,2.0,1.61,1.33,2
Bibiani GS,8,5,1,2,8,6,2,16,Ghana - Premier League,0.62,0.75,2,1.0,2.0,1.61,1.33,2
Dreams,8,5,1,2,9,8,1,16,Ghana - Premier League,0.62,0.75,1,1.12,2.0,1.61,1.33,2
Heart of Lions,8,4,1,3,11,7,4,13,Ghana - Premier League,0.5,0.62,4,1.38,1.62,2.0,1.61,3
Berekum Chelsea,8,4,1,3,9,6,3,13,Ghana - Premier League,0.5,0.62,3,1.12,1.62,2.0,1.61,3
Aduana Stars,8,4,1,3,9,7,2,13,Ghana - Premier League,0.5,0.62,2,1.12,1.62,2.0,1.61,3
Medeama,8,4,0,4,12,6,6,12,Ghana - Premier League,0.5,0.5,6,1.5,1.5,2.0,2.0,4
Asante Kotoko,8,3,3,2,5,7,-2,12,Ghana - Premier League,0.38,0.75,-2,0.62,1.5,2.63,1.33,4
Karela,8,3,2,3,7,6,1,11,Ghana - Premier League,0.38,0.62,1,0.88,1.38,2.63,1.61,5
Vision,8,2,4,2,8,7,1,10,Ghana - Premier League,0.25,0.75,1,1.0,1.25,4.0,1.33,6
Holy Stars,8,3,0,5,6,10,-4,9,Ghana - Premier League,0.38,0.38,-4,0.75,1.12,2.63,2.63,7
Bechem Utd,8,2,1,5,7,10,-3,7,Ghana - Premier League,0.25,0.38,-3,0.88,0.88,4.0,2.63,8
Young Apostles,8,1,4,3,5,9,-4,7,Ghana - Premier League,0.12,0.62,-4,0.62,0.88,8.33,1.61,8
Hearts of Oak,8,1,3,4,3,7,-4,6,Ghana - Premier League,0.12,0.5,-4,0.38,0.75,8.33,2.0,9
Legon Cities,8,1,2,5,5,9,-4,5,Ghana - Premier League,0.12,0.38,-4,0.62,0.62,8.33,2.63,10
Nsoatreman,8,0,0,8,0,24,-24,0,Ghana - Premier League,0.0,0.0,-24,0.0,0.0,0.0,0.0,11
St Josephs,8,6,1,1,18,4,14,19,Gibraltar - Premier Division,0.75,0.88,14,2.25,2.38,1.33,1.14,1
Lincoln RI,8,6,1,1,16,3,13,19,Gibraltar - Premier Division,0.75,0.88,13,2.0,2.38,1.33,1.14,1
Manchester 62,8,5,1,2,19,7,12,16,Gibraltar - Premier Division,0.62,0.75,12,2.38,2.0,1.61,1.33,2
Magpies,8,4,0,4,15,12,3,12,Gibraltar - Premier Division,0.5,0.5,3,1.88,1.5,2.0,2.0,3
Europa FC,8,4,0,4,15,13,2,12,Gibraltar - Premier Division,0.5,0.5,2,1.88,1.5,2.0,2.0,3
College 1975,8,3,1,4,13,13,0,10,Gibraltar - Premier Division,0.38,0.5,0,1.62,1.25,2.63,2.0,4
Lynx,8,3,1,4,10,22,-12,10,Gibraltar - Premier Division,0.38,0.5,-12,1.25,1.25,2.63,2.0,4
Glacis Utd,8,2,0,6,13,24,-11,6,Gibraltar - Premier Division,0.25,0.25,-11,1.62,0.75,4.0,4.0,5
Lions FC,8,1,1,6,5,17,-12,4,Gibraltar - Premier Division,0.12,0.25,-12,0.62,0.5,8.33,4.0,6
Europa Point,8,0,2,6,7,28,-21,2,Gibraltar - Premier Division,0.0,0.25,-21,0.88,0.25,0.0,4.0,7
Mons Calpe,8,0,1,7,7,25,-18,1,Gibraltar - Premier Division,0.0,0.12,-18,0.88,0.12,0.0,8.33,8
Olympiakos,8,7,0,1,16,5,11,21,Greece - Super League,0.88,0.88,11,2.0,2.62,1.14,1.14,1
Levadiakos,8,5,1,2,15,6,9,16,Greece - Super League,0.62,0.75,9,1.88,2.0,1.61,1.33,2
PAOK,8,5,0,3,19,11,8,15,Greece - Super League,0.62,0.62,8,2.38,1.88,1.61,1.61,3
Aris,8,4,3,1,9,6,3,15,Greece - Super League,0.5,0.88,3,1.12,1.88,2.0,1.14,3
Panathinaikos,8,4,1,3,15,13,2,13,Greece - Super League,0.5,0.62,2,1.88,1.62,2.0,1.61,4
Atromitos,8,4,1,3,9,8,1,13,Greece - Super League,0.5,0.62,1,1.12,1.62,2.0,1.61,4
OFI Crete,8,4,0,4,13,14,-1,12,Greece - Super League,0.5,0.5,-1,1.62,1.5,2.0,2.0,5
Panserraikos,8,3,2,3,9,13,-4,11,Greece - Super League,0.38,0.62,-4,1.12,1.38,2.63,1.61,6
Asteras T.,8,3,1,4,7,11,-4,10,Greece - Super League,0.38,0.5,-4,0.88,1.25,2.63,2.0,7
Volos,8,2,3,3,8,8,0,9,Greece - Super League,0.25,0.62,0,1.0,1.12,4.0,1.61,8
Panaitolikos,8,2,3,3,6,7,-1,9,Greece - Super League,0.25,0.62,-1,0.75,1.12,4.0,1.61,8
AEK Athens,8,2,1,5,8,11,-3,7,Greece - Super League,0.25,0.38,-3,1.0,0.88,4.0,2.63,9
A. Kallithea,8,2,1,5,8,15,-7,7,Greece - Super League,0.25,0.38,-7,1.0,0.88,4.0,2.63,9
Lamia,8,2,1,5,6,18,-12,7,Greece - Super League,0.25,0.38,-12,0.75,0.88,4.0,2.63,9
Malacateco,8,6,0,2,15,5,10,18,Guatemala - Liga Nacional - Apertura,0.75,0.75,10,1.88,2.25,1.33,1.33,1
Xelaju,8,5,2,1,16,5,11,17,Guatemala - Liga Nacional - Apertura,0.62,0.88,11,2.0,2.12,1.61,1.14,2
Municipal,8,4,2,2,13,13,0,14,Guatemala - Liga Nacional - Apertura,0.5,0.75,0,1.62,1.75,2.0,1.33,3
Coban Imperial,8,4,1,3,13,9,4,13,Guatemala - Liga Nacional - Apertura,0.5,0.62,4,1.62,1.62,2.0,1.61,4
Antigua GFC,8,3,3,2,14,11,3,12,Guatemala - Liga Nacional - Apertura,0.38,0.75,3,1.75,1.5,2.63,1.33,5
Xinabajul,8,3,2,3,15,14,1,11,Guatemala - Liga Nacional - Apertura,0.38,0.62,1,1.88,1.38,2.63,1.61,6
Comunicaciones,8,3,2,3,12,13,-1,11,Guatemala - Liga Nacional - Apertura,0.38,0.62,-1,1.5,1.38,2.63,1.61,6
Guastatoya,8,2,4,2,12,10,2,10,Guatemala - Liga Nacional - Apertura,0.25,0.75,2,1.5,1.25,4.0,1.33,7
Mixco,8,3,1,4,7,11,-4,10,Guatemala - Liga Nacional - Apertura,0.38,0.5,-4,0.88,1.25,2.63,2.0,7
Achuapa,8,2,3,3,6,10,-4,9,Guatemala - Liga Nacional - Apertura,0.25,0.62,-4,0.75,1.12,4.0,1.61,8
Marquense,8,0,3,5,4,16,-12,3,Guatemala - Liga Nacional - Apertura,0.0,0.38,-12,0.5,0.38,0.0,2.63,9
Zacapa Tellioz,8,0,2,6,3,14,-11,2,Guatemala - Liga Nacional - Apertura,0.0,0.25,-11,0.38,0.25,0.0,4.0,10
Municipal,8,3,2,3,8,6,2,11,guatemala2,0.38,0.62,2,1.0,1.38,2.63,1.61,1
Guastatoya,8,3,2,3,9,10,-1,11,guatemala2,0.38,0.62,-1,1.12,1.38,2.63,1.61,1
Comunicaciones,8,2,3,3,10,11,-1,9,guatemala2,0.25,0.62,-1,1.25,1.12,4.0,1.61,2
Antigua GFC,8,2,3,3,5,7,-2,9,guatemala2,0.25,0.62,-2,0.62,1.12,4.0,1.61,2
Mixco,8,1,5,2,7,8,-1,8,guatemala2,0.12,0.75,-1,0.88,1.0,8.33,1.33,3
Coban Imperial,8,2,0,6,10,16,-6,6,guatemala2,0.25,0.25,-6,1.25,0.75,4.0,4.0,4
Malacateco,8,1,2,5,10,16,-6,5,guatemala2,0.12,0.38,-6,1.25,0.62,8.33,2.63,5
Marquense,8,1,2,5,3,9,-6,5,guatemala2,0.12,0.38,-6,0.38,0.62,8.33,2.63,5
Xinabajul,8,1,1,6,6,18,-12,4,guatemala2,0.12,0.25,-12,0.75,0.5,8.33,4.0,6
Xelaju,8,0,3,5,5,10,-5,3,guatemala2,0.0,0.38,-5,0.62,0.38,0.0,2.63,7
Achuapa,8,1,0,7,6,12,-6,3,guatemala2,0.12,0.12,-6,0.75,0.38,8.33,8.33,7
Olimpia,8,6,2,0,16,4,12,20,Honduras - Liga Nacional - Apertura,0.75,1.0,12,2.0,2.5,1.33,1.0,1
Genesis,8,4,3,1,16,8,8,15,Honduras - Liga Nacional - Apertura,0.5,0.88,8,2.0,1.88,2.0,1.14,2
Motagua,8,4,2,2,18,14,4,14,Honduras - Liga Nacional - Apertura,0.5,0.75,4,2.25,1.75,2.0,1.33,3
Olancho,8,3,4,1,15,10,5,13,Honduras - Liga Nacional - Apertura,0.38,0.88,5,1.88,1.62,2.63,1.14,4
Marathon,8,2,4,2,9,8,1,10,Honduras - Liga Nacional - Apertura,0.25,0.75,1,1.12,1.25,4.0,1.33,5
Juticalpa,8,2,2,4,7,14,-7,8,Honduras - Liga Nacional - Apertura,0.25,0.5,-7,0.88,1.0,4.0,2.0,6
UPNFM,8,2,2,4,6,16,-10,8,Honduras - Liga Nacional - Apertura,0.25,0.5,-10,0.75,1.0,4.0,2.0,6
Real Espana,8,1,4,3,6,7,-1,7,Honduras - Liga Nacional - Apertura,0.12,0.62,-1,0.75,0.88,8.33,1.61,7
Real Sociedad,8,1,3,4,10,17,-7,6,Honduras - Liga Nacional - Apertura,0.12,0.5,-7,1.25,0.75,8.33,2.0,8
Victoria,8,1,2,5,13,18,-5,5,Honduras - Liga Nacional - Apertura,0.12,0.38,-5,1.62,0.62,8.33,2.63,9
Marathon,8,4,3,1,12,6,6,15,honduras2,0.5,0.88,6,1.5,1.88,2.0,1.14,1
Olimpia,8,4,2,2,12,7,5,14,honduras2,0.5,0.75,5,1.5,1.75,2.0,1.33,2
Real Espana,8,3,3,2,11,9,2,12,honduras2,0.38,0.75,2,1.38,1.5,2.63,1.33,3
Victoria,8,2,4,2,12,11,1,10,honduras2,0.25,0.75,1,1.5,1.25,4.0,1.33,4
Motagua,8,2,3,3,9,9,0,9,honduras2,0.25,0.62,0,1.12,1.12,4.0,1.61,5
Olancho,8,1,4,3,9,12,-3,7,honduras2,0.12,0.62,-3,1.12,0.88,8.33,1.61,6
Genesis,8,1,4,3,5,9,-4,7,honduras2,0.12,0.62,-4,0.62,0.88,8.33,1.61,6
Juticalpa,8,1,2,5,3,15,-12,5,honduras2,0.12,0.38,-12,0.38,0.62,8.33,2.63,7
Real Sociedad,8,0,4,4,5,13,-8,4,honduras2,0.0,0.5,-8,0.62,0.5,0.0,2.0,8
UPNFM,8,0,3,5,7,17,-10,3,honduras2,0.0,0.38,-10,0.88,0.38,0.0,2.63,9
LM Warriors,8,6,1,1,19,12,7,19,Hong Kong - Premier League,0.75,0.88,7,2.38,2.38,1.33,1.14,1
Tai Po,8,5,1,2,27,16,11,16,Hong Kong - Premier League,0.62,0.75,11,3.38,2.0,1.61,1.33,2
Eastern,8,4,2,2,21,14,7,14,Hong Kong - Premier League,0.5,0.75,7,2.62,1.75,2.0,1.33,3
Kitchee,8,4,0,4,17,13,4,12,Hong Kong - Premier League,0.5,0.5,4,2.12,1.5,2.0,2.0,4
North District,8,4,0,4,15,21,-6,12,Hong Kong - Premier League,0.5,0.5,-6,1.88,1.5,2.0,2.0,4
HK Rangers,8,3,2,3,17,12,5,11,Hong Kong - Premier League,0.38,0.62,5,2.12,1.38,2.63,1.61,5
Southern D.,8,2,2,4,11,14,-3,8,Hong Kong - Premier League,0.25,0.5,-3,1.38,1.0,4.0,2.0,6
Kowloon City,8,1,1,6,14,29,-15,4,Hong Kong - Premier League,0.12,0.25,-15,1.75,0.5,8.33,4.0,7
Hong Kong FC,8,0,1,7,6,22,-16,1,Hong Kong - Premier League,0.0,0.12,-16,0.75,0.12,0.0,8.33,8
Ferencvaros,8,6,2,0,22,5,17,20,Hungary - NB I,0.75,1.0,17,2.75,2.5,1.33,1.0,1
Gyor,8,5,3,0,14,6,8,18,Hungary - NB I,0.62,1.0,8,1.75,2.25,1.61,1.0,2
Paks,8,4,3,1,17,9,8,15,Hungary - NB I,0.5,0.88,8,2.12,1.88,2.0,1.14,3
Puskas A.,8,3,3,2,12,10,2,12,Hungary - NB I,0.38,0.75,2,1.5,1.5,2.63,1.33,4
Debrecen,8,3,1,4,13,11,2,10,Hungary - NB I,0.38,0.5,2,1.62,1.25,2.63,2.0,5
MTK Budapest,8,2,3,3,15,11,4,9,Hungary - NB I,0.25,0.62,4,1.88,1.12,4.0,1.61,6
DVTK,8,2,3,3,9,14,-5,9,Hungary - NB I,0.25,0.62,-5,1.12,1.12,4.0,1.61,6
Zalaegerszegi,8,1,4,3,8,10,-2,7,Hungary - NB I,0.12,0.62,-2,1.0,0.88,8.33,1.61,7
Fehervar,8,1,4,3,8,12,-4,7,Hungary - NB I,0.12,0.62,-4,1.0,0.88,8.33,1.61,7
Ujpest,8,1,4,3,8,18,-10,7,Hungary - NB I,0.12,0.62,-10,1.0,0.88,8.33,1.61,7
Nyiregyhaza,8,2,1,5,2,15,-13,7,Hungary - NB I,0.25,0.38,-13,0.25,0.88,4.0,2.63,7
Kecskemeti TE,8,0,5,3,7,14,-7,5,Hungary - NB I,0.0,0.62,-7,0.88,0.62,0.0,1.61,8
Kisvarda,8,7,1,0,20,10,10,22,Hungary - NB II,0.88,1.0,10,2.5,2.75,1.14,1.0,1
Honved,8,5,1,2,12,9,3,16,Hungary - NB II,0.62,0.75,3,1.5,2.0,1.61,1.33,2
Mezokovesd,8,5,0,3,13,8,5,15,Hungary - NB II,0.62,0.62,5,1.62,1.88,1.61,1.61,3
Vasas,8,5,0,3,13,9,4,15,Hungary - NB II,0.62,0.62,4,1.62,1.88,1.61,1.61,3
Szentlorinc,8,3,4,1,15,9,6,13,Hungary - NB II,0.38,0.88,6,1.88,1.62,2.63,1.14,4
Kazincbarcika,8,3,4,1,9,6,3,13,Hungary - NB II,0.38,0.88,3,1.12,1.62,2.63,1.14,4
Kozarmisleny,8,4,0,4,11,11,0,12,Hungary - NB II,0.5,0.5,0,1.38,1.5,2.0,2.0,5
BVSC,8,2,3,3,11,12,-1,9,Hungary - NB II,0.25,0.62,-1,1.38,1.12,4.0,1.61,6
Soroksar,8,2,3,3,10,11,-1,9,Hungary - NB II,0.25,0.62,-1,1.25,1.12,4.0,1.61,6
Ajka,8,2,3,3,7,10,-3,9,Hungary - NB II,0.25,0.62,-3,0.88,1.12,4.0,1.61,6
Tatabanya,8,2,3,3,9,13,-4,9,Hungary - NB II,0.25,0.62,-4,1.12,1.12,4.0,1.61,6
Szeged,8,2,3,3,8,12,-4,9,Hungary - NB II,0.25,0.62,-4,1.0,1.12,4.0,1.61,6
Budafoki,8,2,1,5,12,15,-3,7,Hungary - NB II,0.25,0.38,-3,1.5,0.88,4.0,2.63,7
Gyirmot,8,0,5,3,5,8,-3,5,Hungary - NB II,0.0,0.62,-3,0.62,0.62,0.0,1.61,8
Csakvari,8,1,2,5,8,15,-7,5,Hungary - NB II,0.12,0.38,-7,1.0,0.62,8.33,2.63,8
Bekescsaba,8,1,2,5,5,12,-7,5,Hungary - NB II,0.12,0.38,-7,0.62,0.62,8.33,2.63,8
Breidablik,4,3,0,1,7,5,2,9,Iceland - Besta deild,0.75,0.75,2,1.75,2.25,1.33,1.33,1
Vestri,4,2,1,1,4,2,2,7,Iceland - Besta deild,0.5,0.75,2,1.0,1.75,2.0,1.33,2
KR Reykjavik,4,1,3,0,12,7,5,6,Iceland - Besta deild,0.25,1.0,5,3.0,1.5,4.0,1.0,3
Vikingur R.,3,2,0,1,6,1,5,6,Iceland - Besta deild,0.67,0.67,5,2.0,2.0,1.49,1.49,3
Stjarnan,3,2,0,1,5,4,1,6,Iceland - Besta deild,0.67,0.67,1,1.67,2.0,1.49,1.49,3
Valur,3,1,2,0,7,5,2,5,Iceland - Besta deild,0.33,1.0,2,2.33,1.67,3.03,1.0,4
IBV,3,1,1,1,3,3,0,4,Iceland - Besta deild,0.33,0.67,0,1.0,1.33,3.03,1.49,5
Afturelding,3,1,1,1,1,2,-1,4,Iceland - Besta deild,0.33,0.67,-1,0.33,1.33,3.03,1.49,5
KA Akureyri,4,1,1,2,6,11,-5,4,Iceland - Besta deild,0.25,0.5,-5,1.5,1.0,4.0,2.0,5
Fram,3,1,0,2,5,6,-1,3,Iceland - Besta deild,0.33,0.33,-1,1.67,1.0,3.03,3.03,6
IA Akranes,4,1,0,3,2,9,-7,3,Iceland - Besta deild,0.25,0.25,-7,0.5,0.75,4.0,4.0,6
Hafnarfjordur,4,0,1,3,5,8,-3,1,Iceland - Besta deild,0.0,0.25,-3,1.25,0.25,0.0,4.0,7
Afturelding,8,6,1,1,18,7,11,19,Iceland - 1. Deild,0.75,0.88,11,2.25,2.38,1.33,1.14,1
Keflavik,8,5,2,1,17,9,8,17,Iceland - 1. Deild,0.62,0.88,8,2.12,2.12,1.61,1.14,2
Leiknir R.,8,4,4,0,18,10,8,16,Iceland - 1. Deild,0.5,1.0,8,2.25,2.0,2.0,1.0,3
IBV,8,4,2,2,22,12,10,14,Iceland - 1. Deild,0.5,0.75,10,2.75,1.75,2.0,1.33,4
IR Reykjavik,8,3,4,1,10,10,0,13,Iceland - 1. Deild,0.38,0.88,0,1.25,1.62,2.63,1.14,5
Throttur R.,8,3,2,3,15,12,3,11,Iceland - 1. Deild,0.38,0.62,3,1.88,1.38,2.63,1.61,6
Grindavik,8,2,3,3,18,19,-1,9,Iceland - 1. Deild,0.25,0.62,-1,2.25,1.12,4.0,1.61,7
Thor Akureyri,8,2,3,3,11,16,-5,9,Iceland - 1. Deild,0.25,0.62,-5,1.38,1.12,4.0,1.61,7
Njardvik,8,1,5,2,8,11,-3,8,Iceland - 1. Deild,0.12,0.75,-3,1.0,1.0,8.33,1.33,8
Fjolnir,8,1,3,4,6,14,-8,6,Iceland - 1. Deild,0.12,0.5,-8,0.75,0.75,8.33,2.0,9
Dalvik / Reynir,8,1,1,6,10,25,-15,4,Iceland - 1. Deild,0.12,0.25,-15,1.25,0.5,8.33,4.0,10
Grotta,8,1,0,7,9,17,-8,3,Iceland - 1. Deild,0.12,0.12,-8,1.12,0.38,8.33,8.33,11
Throttur Vogar,8,6,2,0,29,7,22,20,Iceland - 2. Deild,0.75,1.0,22,3.62,2.5,1.33,1.0,1
Selfoss,8,6,1,1,22,12,10,19,Iceland - 2. Deild,0.75,0.88,10,2.75,2.38,1.33,1.14,2
Volsungur,8,5,3,0,21,7,14,18,Iceland - 2. Deild,0.62,1.0,14,2.62,2.25,1.61,1.0,3
V. Olafsvik,8,5,1,2,19,13,6,16,Iceland - 2. Deild,0.62,0.75,6,2.38,2.0,1.61,1.33,4
Haukar,8,3,1,4,16,14,2,10,Iceland - 2. Deild,0.38,0.5,2,2.0,1.25,2.63,2.0,5
Fjardabyggd/L.,8,3,1,4,23,24,-1,10,Iceland - 2. Deild,0.38,0.5,-1,2.88,1.25,2.63,2.0,5
AEggir,8,2,4,2,9,12,-3,10,Iceland - 2. Deild,0.25,0.75,-3,1.12,1.25,4.0,1.33,5
Hottur/Huginn,8,3,0,5,11,23,-12,9,Iceland - 2. Deild,0.38,0.38,-12,1.38,1.12,2.63,2.63,6
KFG,8,2,2,4,12,16,-4,8,Iceland - 2. Deild,0.25,0.5,-4,1.5,1.0,4.0,2.0,7
Reynir,8,2,1,5,11,16,-5,7,Iceland - 2. Deild,0.25,0.38,-5,1.38,0.88,4.0,2.63,8
Fjallabyggd,8,2,1,5,12,22,-10,7,Iceland - 2. Deild,0.25,0.38,-10,1.5,0.88,4.0,2.63,8
Kormakur/Hvot,8,0,1,7,5,24,-19,1,Iceland - 2. Deild,0.0,0.12,-19,0.62,0.12,0.0,8.33,9
Mohun Bagan,8,6,2,0,16,2,14,20,India - Super League,0.75,1.0,14,2.0,2.5,1.33,1.0,1
Goa,8,6,0,2,13,7,6,18,India - Super League,0.75,0.75,6,1.62,2.25,1.33,1.33,2
NorthEast Utd,8,4,2,2,15,7,8,14,India - Super League,0.5,0.75,8,1.88,1.75,2.0,1.33,3
East Bengal,8,4,2,2,11,11,0,14,India - Super League,0.5,0.75,0,1.38,1.75,2.0,1.33,3
Mumbai City,8,3,3,2,10,6,4,12,India - Super League,0.38,0.75,4,1.25,1.5,2.63,1.33,4
Odisha FC,8,3,3,2,13,11,2,12,India - Super League,0.38,0.75,2,1.62,1.5,2.63,1.33,4
Bengaluru,8,3,1,4,11,10,1,10,India - Super League,0.38,0.5,1,1.38,1.25,2.63,2.0,5
Chennaiyin,8,3,1,4,11,12,-1,10,India - Super League,0.38,0.5,-1,1.38,1.25,2.63,2.0,5
Jamshedpur,8,3,1,4,12,16,-4,10,India - Super League,0.38,0.5,-4,1.5,1.25,2.63,2.0,5
Kerala Blasters,8,2,3,3,7,10,-3,9,India - Super League,0.25,0.62,-3,0.88,1.12,4.0,1.61,6
Punjab,8,2,2,4,11,15,-4,8,India - Super League,0.25,0.5,-4,1.38,1.0,4.0,2.0,7
Hyderabad,8,2,2,4,10,16,-6,8,India - Super League,0.25,0.5,-6,1.25,1.0,4.0,2.0,7
Mohammedan,8,0,2,6,4,19,-15,2,India - Super League,0.0,0.25,-15,0.5,0.25,0.0,4.0,8
Gokulam,8,6,0,2,23,14,9,18,India - I-League,0.75,0.75,9,2.88,2.25,1.33,1.33,1
Inter Kashi,8,4,3,1,14,11,3,15,India - I-League,0.5,0.88,3,1.75,1.88,2.0,1.14,2
Churchill B.,8,3,5,0,18,9,9,14,India - I-League,0.38,1.0,9,2.25,1.75,2.63,1.0,3
Real Kashmir,8,4,2,2,12,12,0,14,India - I-League,0.5,0.75,0,1.5,1.75,2.0,1.33,3
Rajasthan,8,4,0,4,16,13,3,12,India - I-League,0.5,0.5,3,2.0,1.5,2.0,2.0,4
Sreenidi Deccan,8,3,3,2,11,10,1,12,India - I-League,0.38,0.75,1,1.38,1.5,2.63,1.33,4
Dempo,8,3,2,3,24,17,7,11,India - I-League,0.38,0.62,7,3.0,1.38,2.63,1.61,5
Aizawl,8,3,2,3,16,15,1,11,India - I-League,0.38,0.62,1,2.0,1.38,2.63,1.61,5
SC Bengaluru,8,2,2,4,11,18,-7,8,India - I-League,0.25,0.5,-7,1.38,1.0,4.0,2.0,6
Namdhari,8,2,1,5,8,14,-6,7,India - I-League,0.25,0.38,-6,1.0,0.88,4.0,2.63,7
Shillong Lajong,8,1,3,4,12,23,-11,6,India - I-League,0.12,0.5,-11,1.5,0.75,8.33,2.0,8
Delhi FC,8,1,1,6,7,16,-9,4,India - I-League,0.12,0.25,-9,0.88,0.5,8.33,4.0,9
Malut United,8,5,3,0,13,7,6,18,Indonesia - Liga 1,0.62,1.0,6,1.62,2.25,1.61,1.0,1
Persib,8,4,3,1,18,11,7,15,Indonesia - Liga 1,0.5,0.88,7,2.25,1.88,2.0,1.14,2
Persis Solo,8,4,3,1,11,7,4,15,Indonesia - Liga 1,0.5,0.88,4,1.38,1.88,2.0,1.14,2
Persebaya S.,8,4,3,1,10,6,4,15,Indonesia - Liga 1,0.5,0.88,4,1.25,1.88,2.0,1.14,2
PSBS Biak N.,8,4,3,1,10,6,4,15,Indonesia - Liga 1,0.5,0.88,4,1.25,1.88,2.0,1.14,2
Borneo,8,4,2,2,13,9,4,14,Indonesia - Liga 1,0.5,0.75,4,1.62,1.75,2.0,1.33,3
Madura Utd,8,4,2,2,8,6,2,14,Indonesia - Liga 1,0.5,0.75,2,1.0,1.75,2.0,1.33,3
Dewa Utd,8,4,1,3,13,7,6,13,Indonesia - Liga 1,0.5,0.62,6,1.62,1.62,2.0,1.61,4
PSM,8,3,3,2,10,7,3,12,Indonesia - Liga 1,0.38,0.75,3,1.25,1.5,2.63,1.33,5
Arema,8,3,2,3,19,14,5,11,Indonesia - Liga 1,0.38,0.62,5,2.38,1.38,2.63,1.61,6
Semen Padang,8,3,2,3,10,16,-6,11,Indonesia - Liga 1,0.38,0.62,-6,1.25,1.38,2.63,1.61,6
Persija,8,2,2,4,7,10,-3,8,Indonesia - Liga 1,0.25,0.5,-3,0.88,1.0,4.0,2.0,7
Barito Putera,8,2,1,5,11,14,-3,7,Indonesia - Liga 1,0.25,0.38,-3,1.38,0.88,4.0,2.63,8
Persita,8,2,1,5,9,13,-4,7,Indonesia - Liga 1,0.25,0.38,-4,1.12,0.88,4.0,2.63,8
Bali Utd,8,1,4,3,7,11,-4,7,Indonesia - Liga 1,0.12,0.62,-4,0.88,0.88,8.33,1.61,8
Persik Kediri,8,0,4,4,5,11,-6,4,Indonesia - Liga 1,0.0,0.5,-6,0.62,0.5,0.0,2.0,9
PSIS Semarang,8,0,4,4,9,16,-7,4,Indonesia - Liga 1,0.0,0.5,-7,1.12,0.5,0.0,2.0,9
PSS Sleman,8,1,0,7,7,20,-13,3,Indonesia - Liga 1,0.12,0.12,-13,0.88,0.38,8.33,8.33,10
Tractor Sazi,8,6,2,0,13,5,8,20,Iran - Pro League,0.75,1.0,8,1.62,2.5,1.33,1.0,1
Sepahan,8,4,4,0,12,4,8,16,Iran - Pro League,0.5,1.0,8,1.5,2.0,2.0,1.0,2
Malavan,8,5,0,3,10,8,2,15,Iran - Pro League,0.62,0.62,2,1.25,1.88,1.61,1.61,3
Persepolis,8,4,2,2,9,7,2,14,Iran - Pro League,0.5,0.75,2,1.12,1.75,2.0,1.33,4
Foolad,8,4,1,3,9,8,1,13,Iran - Pro League,0.5,0.62,1,1.12,1.62,2.0,1.61,5
Shams A. Qazvin,8,3,2,3,10,9,1,11,Iran - Pro League,0.38,0.62,1,1.25,1.38,2.63,1.61,6
Zob Ahan,8,3,2,3,9,9,0,11,Iran - Pro League,0.38,0.62,0,1.12,1.38,2.63,1.61,6
K. Khorramabad,8,3,2,3,5,7,-2,11,Iran - Pro League,0.38,0.62,-2,0.62,1.38,2.63,1.61,6
Gol Gohar,8,2,4,2,6,6,0,10,Iran - Pro League,0.25,0.75,0,0.75,1.25,4.0,1.33,7
Mes Rafsanjan,8,2,3,3,6,7,-1,9,Iran - Pro League,0.25,0.62,-1,0.75,1.12,4.0,1.61,8
Chadormalu,8,2,2,4,7,8,-1,8,Iran - Pro League,0.25,0.5,-1,0.88,1.0,4.0,2.0,9
Havadar,8,2,2,4,9,15,-6,8,Iran - Pro League,0.25,0.5,-6,1.12,1.0,4.0,2.0,9
Esteghlal,8,1,4,3,8,10,-2,7,Iran - Pro League,0.12,0.62,-2,1.0,0.88,8.33,1.61,10
Aluminium Arak,8,1,4,3,4,6,-2,7,Iran - Pro League,0.12,0.62,-2,0.5,0.88,8.33,1.61,10
E. Khuzestan,8,1,4,3,5,8,-3,7,Iran - Pro League,0.12,0.62,-3,0.62,0.88,8.33,1.61,10
N. Mazandaran,8,1,2,5,2,7,-5,5,Iran - Pro League,0.12,0.38,-5,0.25,0.62,8.33,2.63,11
Shamrock Rovers,8,4,3,1,15,9,6,15,Ireland - Premier Division,0.5,0.88,6,1.88,1.88,2.0,1.14,1
Bohemians,8,5,0,3,13,11,2,15,Ireland - Premier Division,0.62,0.62,2,1.62,1.88,1.61,1.61,1
Derry City,8,4,2,2,12,9,3,14,Ireland - Premier Division,0.5,0.75,3,1.5,1.75,2.0,1.33,2
Galway Utd,8,4,2,2,12,9,3,14,Ireland - Premier Division,0.5,0.75,3,1.5,1.75,2.0,1.33,2
St. Patricks,8,3,3,2,10,6,4,12,Ireland - Premier Division,0.38,0.75,4,1.25,1.5,2.63,1.33,3
Drogheda Utd,8,3,3,2,11,8,3,12,Ireland - Premier Division,0.38,0.75,3,1.38,1.5,2.63,1.33,3
Shelbourne,8,2,5,1,10,9,1,11,Ireland - Premier Division,0.25,0.88,1,1.25,1.38,4.0,1.14,4
Cork City,8,1,3,4,7,13,-6,6,Ireland - Premier Division,0.12,0.5,-6,0.88,0.75,8.33,2.0,5
Sligo Rovers,8,1,2,5,10,14,-4,5,Ireland - Premier Division,0.12,0.38,-4,1.25,0.62,8.33,2.63,6
Waterford,8,1,0,7,4,17,-13,3,Ireland - Premier Division,0.12,0.12,-13,0.5,0.38,8.33,8.33,7
Bray Wanderers,8,7,0,1,16,9,7,21,Ireland - First Division,0.88,0.88,7,2.0,2.62,1.14,1.14,1
Dundalk,8,6,2,0,15,4,11,20,Ireland - First Division,0.75,1.0,11,1.88,2.5,1.33,1.0,2
Cobh Ramblers,8,5,0,3,12,8,4,15,Ireland - First Division,0.62,0.62,4,1.5,1.88,1.61,1.61,3
Finn Harps,8,3,3,2,16,11,5,12,Ireland - First Division,0.38,0.75,5,2.0,1.5,2.63,1.33,4
Wexford,8,3,2,3,12,11,1,11,Ireland - First Division,0.38,0.62,1,1.5,1.38,2.63,1.61,5
UC Dublin,8,3,1,4,3,5,-2,10,Ireland - First Division,0.38,0.5,-2,0.38,1.25,2.63,2.0,6
Treaty Utd,8,2,2,4,6,8,-2,8,Ireland - First Division,0.25,0.5,-2,0.75,1.0,4.0,2.0,7
Kerry,8,2,0,6,11,18,-7,6,Ireland - First Division,0.25,0.25,-7,1.38,0.75,4.0,4.0,8
Athlone Town,8,1,2,5,4,11,-7,5,Ireland - First Division,0.12,0.38,-7,0.5,0.62,8.33,2.63,9
Longford Town,8,1,2,5,6,15,-9,5,Ireland - First Division,0.12,0.38,-9,0.75,0.62,8.33,2.63,9
M. Tel Aviv,8,6,1,1,20,9,11,19,Israel - Ligat HaAl,0.75,0.88,11,2.5,2.38,1.33,1.14,1
H. Beer Sheva,8,4,2,2,16,11,5,14,Israel - Ligat HaAl,0.5,0.75,5,2.0,1.75,2.0,1.33,2
Ironi Tiberias,8,4,2,2,11,8,3,14,Israel - Ligat HaAl,0.5,0.75,3,1.38,1.75,2.0,1.33,2
H. Jerusalem,8,3,4,1,11,5,6,13,Israel - Ligat HaAl,0.38,0.88,6,1.38,1.62,2.63,1.14,3
Ashdod,8,3,4,1,11,7,4,13,Israel - Ligat HaAl,0.38,0.88,4,1.38,1.62,2.63,1.14,3
B. Jerusalem,8,3,3,2,12,11,1,12,Israel - Ligat HaAl,0.38,0.75,1,1.5,1.5,2.63,1.33,4
Maccabi Haifa,8,3,3,2,12,12,0,12,Israel - Ligat HaAl,0.38,0.75,0,1.5,1.5,2.63,1.33,4
M. Bnei Raina,8,3,1,4,9,9,0,10,Israel - Ligat HaAl,0.38,0.5,0,1.12,1.25,2.63,2.0,5
Sakhnin,8,3,1,4,7,11,-4,10,Israel - Ligat HaAl,0.38,0.5,-4,0.88,1.25,2.63,2.0,5
Hapoel Hadera,8,3,1,4,9,14,-5,10,Israel - Ligat HaAl,0.38,0.5,-5,1.12,1.25,2.63,2.0,5
M. Petah Tikva,8,2,1,5,9,10,-1,7,Israel - Ligat HaAl,0.25,0.38,-1,1.12,0.88,4.0,2.63,6
Kiryat Shmona,8,2,1,5,7,13,-6,7,Israel - Ligat HaAl,0.25,0.38,-6,0.88,0.88,4.0,2.63,6
Hapoel Haifa,8,2,1,5,7,15,-8,7,Israel - Ligat HaAl,0.25,0.38,-8,0.88,0.88,4.0,2.63,6
Maccabi Netanya,8,1,3,4,6,12,-6,6,Israel - Ligat HaAl,0.12,0.5,-6,0.75,0.75,8.33,2.0,7
H. Petah Tikva,8,7,1,0,8,1,7,22,Israel - Leumit League,0.88,1.0,7,1.0,2.75,1.14,1.0,1
Hapoel Tel Aviv,8,6,1,1,17,3,14,19,Israel - Leumit League,0.75,0.88,14,2.12,2.38,1.33,1.14,2
H. Ramat Gan,8,4,2,2,19,8,11,14,Israel - Leumit League,0.5,0.75,11,2.38,1.75,2.0,1.33,3
H. Ironi Rishon,8,4,1,3,14,13,1,13,Israel - Leumit League,0.5,0.62,1,1.75,1.62,2.0,1.61,4
Hapoel Akko,8,3,3,2,9,7,2,12,Israel - Leumit League,0.38,0.75,2,1.12,1.5,2.63,1.33,5
Maccabi Jaffa,8,2,5,1,8,8,0,11,Israel - Leumit League,0.25,0.88,0,1.0,1.38,4.0,1.14,6
Hapoel Raanana,8,2,4,2,6,6,0,10,Israel - Leumit League,0.25,0.75,0,0.75,1.25,4.0,1.33,7
M. Herziliya,8,3,1,4,10,12,-2,10,Israel - Leumit League,0.38,0.5,-2,1.25,1.25,2.63,2.0,7
H. Kfar Shalem,8,3,0,5,8,9,-1,9,Israel - Leumit League,0.38,0.38,-1,1.0,1.12,2.63,2.63,8
Hapoel Afula,8,2,3,3,8,9,-1,9,Israel - Leumit League,0.25,0.62,-1,1.0,1.12,4.0,1.61,8
Kafr Qasim,8,2,3,3,8,11,-3,9,Israel - Leumit League,0.25,0.62,-3,1.0,1.12,4.0,1.61,8
Bnei Yehuda,8,3,0,5,9,15,-6,9,Israel - Leumit League,0.38,0.38,-6,1.12,1.12,2.63,2.63,8
H. Kfar Saba,8,2,2,4,6,11,-5,8,Israel - Leumit League,0.25,0.5,-5,0.75,1.0,4.0,2.0,9
H. Nof Hagalil,8,1,4,3,4,6,-2,7,Israel - Leumit League,0.12,0.62,-2,0.5,0.88,8.33,1.61,10
H. Umm al-Fahm,8,1,4,3,9,13,-4,7,Israel - Leumit League,0.12,0.62,-4,1.12,0.88,8.33,1.61,10
Ramat Hasharon,8,1,4,3,8,15,-7,7,Israel - Leumit League,0.12,0.62,-7,1.0,0.88,8.33,1.61,10
AS Roma,8,6,2,0,9,3,6,20,Italy - Serie A,0.75,1.0,6,1.12,2.5,1.33,1.0,1
Bologna,8,6,1,1,14,6,8,19,Italy - Serie A,0.75,0.88,8,1.75,2.38,1.33,1.14,2
Napoli,8,5,3,0,12,4,8,18,Italy - Serie A,0.62,1.0,8,1.5,2.25,1.61,1.0,3
Fiorentina,8,5,2,1,12,6,6,17,Italy - Serie A,0.62,0.88,6,1.5,2.12,1.61,1.14,4
Como,8,4,2,2,12,7,5,14,Italy - Serie A,0.5,0.75,5,1.5,1.75,2.0,1.33,5
Inter Milan,8,4,2,2,13,9,4,14,Italy - Serie A,0.5,0.75,4,1.62,1.75,2.0,1.33,5
AC Milan,8,4,1,3,15,10,5,13,Italy - Serie A,0.5,0.62,5,1.88,1.62,2.0,1.61,6
Lazio,8,3,4,1,8,9,-1,13,Italy - Serie A,0.38,0.88,-1,1.0,1.62,2.63,1.14,6
Juventus,8,4,1,3,8,10,-2,13,Italy - Serie A,0.5,0.62,-2,1.0,1.62,2.0,1.61,6
Torino,8,3,3,2,9,7,2,12,Italy - Serie A,0.38,0.75,2,1.12,1.5,2.63,1.33,7
Atalanta,8,3,2,3,8,5,3,11,Italy - Serie A,0.38,0.62,3,1.0,1.38,2.63,1.61,8
Parma,8,2,5,1,8,6,2,11,Italy - Serie A,0.25,0.88,2,1.0,1.38,4.0,1.14,8
Genoa,8,2,3,3,5,7,-2,9,Italy - Serie A,0.25,0.62,-2,0.62,1.12,4.0,1.61,9
Hellas Verona,8,2,3,3,4,6,-2,9,Italy - Serie A,0.25,0.62,-2,0.5,1.12,4.0,1.61,9
Venezia,8,1,5,2,5,7,-2,8,Italy - Serie A,0.12,0.75,-2,0.62,1.0,8.33,1.33,10
Udinese,8,2,1,5,4,11,-7,7,Italy - Serie A,0.25,0.38,-7,0.5,0.88,4.0,2.63,11
Cagliari,8,1,2,5,7,10,-3,5,Italy - Serie A,0.12,0.38,-3,0.88,0.62,8.33,2.63,12
Empoli,8,0,4,4,5,11,-6,4,Italy - Serie A,0.0,0.5,-6,0.62,0.5,0.0,2.0,13
Lecce,8,0,2,6,6,14,-8,2,Italy - Serie A,0.0,0.25,-8,0.75,0.25,0.0,4.0,14
Monza,8,0,1,7,4,16,-12,1,Italy - Serie A,0.0,0.12,-12,0.5,0.12,0.0,8.33,15
Sassuolo,8,5,2,1,17,9,8,17,Italy - Serie B,0.62,0.88,8,2.12,2.12,1.61,1.14,1
Palermo,8,5,1,2,18,11,7,16,Italy - Serie B,0.62,0.75,7,2.25,2.0,1.61,1.33,2
Frosinone,8,4,4,0,14,8,6,16,Italy - Serie B,0.5,1.0,6,1.75,2.0,2.0,1.0,2
Cremonese,8,4,3,1,19,12,7,15,Italy - Serie B,0.5,0.88,7,2.38,1.88,2.0,1.14,3
Pisa,8,5,0,3,16,9,7,15,Italy - Serie B,0.62,0.62,7,2.0,1.88,1.61,1.61,3
Modena,8,4,1,3,11,10,1,13,Italy - Serie B,0.5,0.62,1,1.38,1.62,2.0,1.61,4
Carrarese,8,2,5,1,11,10,1,11,Italy - Serie B,0.25,0.88,1,1.38,1.38,4.0,1.14,5
Salernitana,8,3,2,3,8,8,0,11,Italy - Serie B,0.38,0.62,0,1.0,1.38,2.63,1.61,5
Juve Stabia,8,3,2,3,8,10,-2,11,Italy - Serie B,0.38,0.62,-2,1.0,1.38,2.63,1.61,5
Sudtirol,8,2,4,2,12,9,3,10,Italy - Serie B,0.25,0.75,3,1.5,1.25,4.0,1.33,6
Spezia,8,2,4,2,10,9,1,10,Italy - Serie B,0.25,0.75,1,1.25,1.25,4.0,1.33,6
Bari,8,2,4,2,10,10,0,10,Italy - Serie B,0.25,0.75,0,1.25,1.25,4.0,1.33,6
Cesena,8,2,4,2,8,8,0,10,Italy - Serie B,0.25,0.75,0,1.0,1.25,4.0,1.33,6
Catanzaro,8,2,3,3,13,15,-2,9,Italy - Serie B,0.25,0.62,-2,1.62,1.12,4.0,1.61,7
Mantova,8,2,2,4,11,14,-3,8,Italy - Serie B,0.25,0.5,-3,1.38,1.0,4.0,2.0,8
Sampdoria,8,1,4,3,5,10,-5,7,Italy - Serie B,0.12,0.62,-5,0.62,0.88,8.33,1.61,9
Brescia,8,1,3,4,6,9,-3,6,Italy - Serie B,0.12,0.5,-3,0.75,0.75,8.33,2.0,10
Reggiana,8,1,3,4,9,16,-7,6,Italy - Serie B,0.12,0.5,-7,1.12,0.75,8.33,2.0,10
Cosenza,8,1,3,4,6,17,-11,6,Italy - Serie B,0.12,0.5,-11,0.75,0.75,8.33,2.0,10
Cittadella,8,1,2,5,6,14,-8,5,Italy - Serie B,0.12,0.38,-8,0.75,0.62,8.33,2.63,11
Renate,8,6,1,1,13,7,6,19,Italy - Serie C - Group A,0.75,0.88,6,1.62,2.38,1.33,1.14,1
FeralpiSalo,8,5,1,2,14,8,6,16,Italy - Serie C - Group A,0.62,0.75,6,1.75,2.0,1.61,1.33,2
AlbinoLeffe,8,5,1,2,14,10,4,16,Italy - Serie C - Group A,0.62,0.75,4,1.75,2.0,1.61,1.33,2
Vicenza,8,5,1,2,10,8,2,16,Italy - Serie C - Group A,0.62,0.75,2,1.25,2.0,1.61,1.33,2
Atalanta B,8,4,3,1,13,8,5,15,Italy - Serie C - Group A,0.5,0.88,5,1.62,1.88,2.0,1.14,3
Arzignano,8,5,0,3,10,6,4,15,Italy - Serie C - Group A,0.62,0.62,4,1.25,1.88,1.61,1.61,3
Giana Erminio,8,4,2,2,12,6,6,14,Italy - Serie C - Group A,0.5,0.75,6,1.5,1.75,2.0,1.33,4
Padova,8,4,2,2,11,9,2,14,Italy - Serie C - Group A,0.5,0.75,2,1.38,1.75,2.0,1.33,4
Trento,8,4,1,3,11,10,1,13,Italy - Serie C - Group A,0.5,0.62,1,1.38,1.62,2.0,1.61,5
Pro Patria,8,3,2,3,10,8,2,11,Italy - Serie C - Group A,0.38,0.62,2,1.25,1.38,2.63,1.61,6
Caldiero Terme,8,3,2,3,10,10,0,11,Italy - Serie C - Group A,0.38,0.62,0,1.25,1.38,2.63,1.61,6
Virtus Verona,8,2,4,2,8,8,0,10,Italy - Serie C - Group A,0.25,0.75,0,1.0,1.25,4.0,1.33,7
Novara,8,3,1,4,9,14,-5,10,Italy - Serie C - Group A,0.38,0.5,-5,1.12,1.25,2.63,2.0,7
Triestina,8,3,0,5,9,9,0,9,Italy - Serie C - Group A,0.38,0.38,0,1.12,1.12,2.63,2.63,8
Lecco,8,2,3,3,6,7,-1,9,Italy - Serie C - Group A,0.25,0.62,-1,0.75,1.12,4.0,1.61,8
Pergolettese,8,2,0,6,7,12,-5,6,Italy - Serie C - Group A,0.25,0.25,-5,0.88,0.75,4.0,4.0,9
Pro Vercelli,8,1,3,4,6,11,-5,6,Italy - Serie C - Group A,0.12,0.5,-5,0.75,0.75,8.33,2.0,9
Alcione,8,1,3,4,5,10,-5,6,Italy - Serie C - Group A,0.12,0.5,-5,0.62,0.75,8.33,2.0,9
Lumezzane,8,0,4,4,6,14,-8,4,Italy - Serie C - Group A,0.0,0.5,-8,0.75,0.5,0.0,2.0,10
Clodiense,8,1,0,7,8,17,-9,3,Italy - Serie C - Group A,0.12,0.12,-9,1.0,0.38,8.33,8.33,11
Entella,8,4,4,0,15,6,9,16,Italy - Serie C - Group B,0.5,1.0,9,1.88,2.0,2.0,1.0,1
Arezzo,8,5,0,3,12,7,5,15,Italy - Serie C - Group B,0.62,0.62,5,1.5,1.88,1.61,1.61,2
Perugia,8,4,2,2,12,7,5,14,Italy - Serie C - Group B,0.5,0.75,5,1.5,1.75,2.0,1.33,3
Lucchese,8,4,2,2,15,14,1,14,Italy - Serie C - Group B,0.5,0.75,1,1.88,1.75,2.0,1.33,3
Pescara,8,4,1,3,14,8,6,13,Italy - Serie C - Group B,0.5,0.62,6,1.75,1.62,2.0,1.61,4
Pontedera,8,3,3,2,13,10,3,12,Italy - Serie C - Group B,0.38,0.75,3,1.62,1.5,2.63,1.33,5
Pineto,8,3,3,2,10,14,-4,12,Italy - Serie C - Group B,0.38,0.75,-4,1.25,1.5,2.63,1.33,5
Torres,8,3,2,3,12,10,2,11,Italy - Serie C - Group B,0.38,0.62,2,1.5,1.38,2.63,1.61,6
Ternana,8,3,2,3,7,6,1,11,Italy - Serie C - Group B,0.38,0.62,1,0.88,1.38,2.63,1.61,6
AC Milan B,8,3,2,3,11,11,0,11,Italy - Serie C - Group B,0.38,0.62,0,1.38,1.38,2.63,1.61,6
Rimini,8,3,2,3,11,12,-1,11,Italy - Serie C - Group B,0.38,0.62,-1,1.38,1.38,2.63,1.61,6
Gubbio,8,3,2,3,7,10,-3,11,Italy - Serie C - Group B,0.38,0.62,-3,0.88,1.38,2.63,1.61,6
SPAL,8,2,4,2,9,9,0,10,Italy - Serie C - Group B,0.25,0.75,0,1.12,1.25,4.0,1.33,7
Campobasso,8,3,1,4,9,13,-4,10,Italy - Serie C - Group B,0.38,0.5,-4,1.12,1.25,2.63,2.0,7
Pianese,8,3,0,5,10,12,-2,9,Italy - Serie C - Group B,0.38,0.38,-2,1.25,1.12,2.63,2.63,8
Vis Pesaro,8,1,5,2,8,8,0,8,Italy - Serie C - Group B,0.12,0.75,0,1.0,1.0,8.33,1.33,9
Sestri Levante,8,2,2,4,10,14,-4,8,Italy - Serie C - Group B,0.25,0.5,-4,1.25,1.0,4.0,2.0,9
Athletic Carpi,8,2,2,4,6,11,-5,8,Italy - Serie C - Group B,0.25,0.5,-5,0.75,1.0,4.0,2.0,9
Ascoli,8,1,4,3,4,7,-3,7,Italy - Serie C - Group B,0.12,0.62,-3,0.5,0.88,8.33,1.61,10
Legnago Salus,8,1,3,4,7,13,-6,6,Italy - Serie C - Group B,0.12,0.5,-6,0.88,0.75,8.33,2.0,11
Avellino,8,8,0,0,13,4,9,24,Italy - Serie C - Group C,1.0,1.0,9,1.62,3.0,1.0,1.0,1
Catania,8,5,2,1,13,5,8,17,Italy - Serie C - Group C,0.62,0.88,8,1.62,2.12,1.61,1.14,2
Monopoli,8,4,2,2,9,6,3,14,Italy - Serie C - Group C,0.5,0.75,3,1.12,1.75,2.0,1.33,3
Crotone,8,4,2,2,14,12,2,14,Italy - Serie C - Group C,0.5,0.75,2,1.75,1.75,2.0,1.33,3
Casertana,8,4,1,3,13,6,7,13,Italy - Serie C - Group C,0.5,0.62,7,1.62,1.62,2.0,1.61,4
Picerno,8,3,4,1,9,5,4,13,Italy - Serie C - Group C,0.38,0.88,4,1.12,1.62,2.63,1.14,4
ACR Messina,8,4,1,3,14,12,2,13,Italy - Serie C - Group C,0.5,0.62,2,1.75,1.62,2.0,1.61,4
A. Cerignola,8,4,1,3,10,9,1,13,Italy - Serie C - Group C,0.5,0.62,1,1.25,1.62,2.0,1.61,4
Juventus U23,8,4,0,4,15,11,4,12,Italy - Serie C - Group C,0.5,0.5,4,1.88,1.5,2.0,2.0,5
Cavese,8,3,2,3,10,12,-2,11,Italy - Serie C - Group C,0.38,0.62,-2,1.25,1.38,2.63,1.61,6
Benevento,8,2,4,2,10,9,1,10,Italy - Serie C - Group C,0.25,0.75,1,1.25,1.25,4.0,1.33,7
Latina,8,3,1,4,7,13,-6,10,Italy - Serie C - Group C,0.38,0.5,-6,0.88,1.25,2.63,2.0,7
Potenza,8,2,3,3,12,12,0,9,Italy - Serie C - Group C,0.25,0.62,0,1.5,1.12,4.0,1.61,8
Trapani,8,3,0,5,7,10,-3,9,Italy - Serie C - Group C,0.38,0.38,-3,0.88,1.12,2.63,2.63,8
Altamura,8,3,0,5,9,13,-4,9,Italy - Serie C - Group C,0.38,0.38,-4,1.12,1.12,2.63,2.63,8
Giugliano,8,2,2,4,17,16,1,8,Italy - Serie C - Group C,0.25,0.5,1,2.12,1.0,4.0,2.0,9
Foggia,8,1,1,6,7,16,-9,4,Italy - Serie C - Group C,0.12,0.25,-9,0.88,0.5,8.33,4.0,10
Sorrento,8,1,1,6,4,17,-13,4,Italy - Serie C - Group C,0.12,0.25,-13,0.5,0.5,8.33,4.0,10
Taranto,0,0,0,0,0,0,0,0,Italy - Serie C - Group C,0.0,0.0,0,0.0,0.0,0.0,0.0,11
Turris,0,0,0,0,0,0,0,0,Italy - Serie C - Group C,0.0,0.0,0,0.0,0.0,0.0,0.0,11
Lavagnese,8,7,0,1,12,5,7,21,Italy - Serie D - Group A,0.88,0.88,7,1.5,2.62,1.14,1.14,1
Gozzano,8,6,2,0,14,6,8,20,Italy - Serie D - Group A,0.75,1.0,8,1.75,2.5,1.33,1.0,2
Oltrepo,8,5,2,1,10,5,5,17,Italy - Serie D - Group A,0.62,0.88,5,1.25,2.12,1.61,1.14,3
NovaRomentin,8,4,2,2,17,6,11,14,Italy - Serie D - Group A,0.5,0.75,11,2.12,1.75,2.0,1.33,4
Bra,8,4,2,2,11,7,4,14,Italy - Serie D - Group A,0.5,0.75,4,1.38,1.75,2.0,1.33,4
Asti,8,3,3,2,7,4,3,12,Italy - Serie D - Group A,0.38,0.75,3,0.88,1.5,2.63,1.33,5
Saluzzo,8,3,3,2,8,6,2,12,Italy - Serie D - Group A,0.38,0.75,2,1.0,1.5,2.63,1.33,5
Ligorna,8,3,3,2,11,12,-1,12,Italy - Serie D - Group A,0.38,0.75,-1,1.38,1.5,2.63,1.33,5
Chieri,8,2,5,1,9,6,3,11,Italy - Serie D - Group A,0.25,0.88,3,1.12,1.38,4.0,1.14,6
Vado,8,3,2,3,8,7,1,11,Italy - Serie D - Group A,0.38,0.62,1,1.0,1.38,2.63,1.61,6
Derthona,8,3,2,3,7,7,0,11,Italy - Serie D - Group A,0.38,0.62,0,0.88,1.38,2.63,1.61,6
Borgaro Nobis,8,3,1,4,8,15,-7,10,Italy - Serie D - Group A,0.38,0.5,-7,1.0,1.25,2.63,2.0,7
Sanremese,8,2,3,3,5,6,-1,9,Italy - Serie D - Group A,0.25,0.62,-1,0.62,1.12,4.0,1.61,8
Citta di Varese,8,2,2,4,7,9,-2,8,Italy - Serie D - Group A,0.25,0.5,-2,0.88,1.0,4.0,2.0,9
Vogherese,8,1,5,2,4,6,-2,8,Italy - Serie D - Group A,0.12,0.75,-2,0.5,1.0,8.33,1.33,9
Chisola,8,1,2,5,6,11,-5,5,Italy - Serie D - Group A,0.12,0.38,-5,0.75,0.62,8.33,2.63,10
Cairese,8,1,2,5,4,9,-5,5,Italy - Serie D - Group A,0.12,0.38,-5,0.5,0.62,8.33,2.63,10
Pro Imperia,8,1,1,6,5,15,-10,4,Italy - Serie D - Group A,0.12,0.25,-10,0.62,0.5,8.33,4.0,11
Fossano,8,1,0,7,5,16,-11,3,Italy - Serie D - Group A,0.12,0.12,-11,0.62,0.38,8.33,8.33,12
Albenga,0,0,0,0,0,0,0,0,Italy - Serie D - Group A,0.0,0.0,0,0.0,0.0,0.0,0.0,13
Sondrio,8,6,0,2,12,4,8,18,Italy - Serie D - Group B,0.75,0.75,8,1.5,2.25,1.33,1.33,1
Desenxano,8,6,0,2,10,4,6,18,Italy - Serie D - Group B,0.75,0.75,6,1.25,2.25,1.33,1.33,1
USD Casatese,8,5,1,2,15,5,10,16,Italy - Serie D - Group B,0.62,0.75,10,1.88,2.0,1.61,1.33,2
Pro Palazzolo,8,5,1,2,15,7,8,16,Italy - Serie D - Group B,0.62,0.75,8,1.88,2.0,1.61,1.33,2
Ospitaletto,8,4,3,1,12,8,4,15,Italy - Serie D - Group B,0.5,0.88,4,1.5,1.88,2.0,1.14,3
Varesina,8,4,2,2,16,12,4,14,Italy - Serie D - Group B,0.5,0.75,4,2.0,1.75,2.0,1.33,4
Castellanzese,8,3,5,0,14,10,4,14,Italy - Serie D - Group B,0.38,1.0,4,1.75,1.75,2.63,1.0,4
F. Caratese,8,4,1,3,18,11,7,13,Italy - Serie D - Group B,0.5,0.62,7,2.25,1.62,2.0,1.61,5
Sangiuliano C.,8,3,3,2,10,8,2,12,Italy - Serie D - Group B,0.38,0.75,2,1.25,1.5,2.63,1.33,6
Pro Sesto,8,3,2,3,10,11,-1,11,Italy - Serie D - Group B,0.38,0.62,-1,1.25,1.38,2.63,1.61,7
Club Milano,8,3,1,4,11,15,-4,10,Italy - Serie D - Group B,0.38,0.5,-4,1.38,1.25,2.63,2.0,8
Magenta,8,2,3,3,6,9,-3,9,Italy - Serie D - Group B,0.25,0.62,-3,0.75,1.12,4.0,1.61,9
Arconatese,8,2,3,3,9,13,-4,9,Italy - Serie D - Group B,0.25,0.62,-4,1.12,1.12,4.0,1.61,9
Vigasio,8,3,0,5,8,12,-4,9,Italy - Serie D - Group B,0.38,0.38,-4,1.0,1.12,2.63,2.63,9
Crema,8,2,2,4,13,14,-1,8,Italy - Serie D - Group B,0.25,0.5,-1,1.62,1.0,4.0,2.0,10
Chievo,8,2,1,5,10,9,1,7,Italy - Serie D - Group B,0.25,0.38,1,1.25,0.88,4.0,2.63,11
Breno,8,2,1,5,8,22,-14,7,Italy - Serie D - Group B,0.25,0.38,-14,1.0,0.88,4.0,2.63,11
SantAngelo,8,1,3,4,7,11,-4,6,Italy - Serie D - Group B,0.12,0.5,-4,0.88,0.75,8.33,2.0,12
Ciliverghe,8,1,2,5,7,19,-12,5,Italy - Serie D - Group B,0.12,0.38,-12,0.88,0.62,8.33,2.63,13
Fanfulla,8,0,4,4,5,12,-7,4,Italy - Serie D - Group B,0.0,0.5,-7,0.62,0.5,0.0,2.0,14
Real Calepina,8,5,2,1,12,6,6,17,Italy - Serie D - Group C,0.62,0.88,6,1.5,2.12,1.61,1.14,1
Treviso,8,5,2,1,10,4,6,17,Italy - Serie D - Group C,0.62,0.88,6,1.25,2.12,1.61,1.14,1
Villa Alme,8,5,1,2,14,10,4,16,Italy - Serie D - Group C,0.62,0.75,4,1.75,2.0,1.61,1.33,2
Mestre,8,5,1,2,8,5,3,16,Italy - Serie D - Group C,0.62,0.75,3,1.0,2.0,1.61,1.33,2
Adriese,8,5,0,3,13,8,5,15,Italy - Serie D - Group C,0.62,0.62,5,1.62,1.88,1.61,1.61,3
D. Bellunesi,8,3,4,1,14,12,2,13,Italy - Serie D - Group C,0.38,0.88,2,1.75,1.62,2.63,1.14,4
Brian Lignano,8,3,4,1,10,8,2,13,Italy - Serie D - Group C,0.38,0.88,2,1.25,1.62,2.63,1.14,4
Brusaporto,8,3,3,2,8,6,2,12,Italy - Serie D - Group C,0.38,0.75,2,1.0,1.5,2.63,1.33,5
Luparense,8,3,3,2,9,8,1,12,Italy - Serie D - Group C,0.38,0.75,1,1.12,1.5,2.63,1.33,5
Este,8,3,3,2,10,11,-1,12,Italy - Serie D - Group C,0.38,0.75,-1,1.25,1.5,2.63,1.33,5
Bassano Virtus,8,3,1,4,14,6,8,10,Italy - Serie D - Group C,0.38,0.5,8,1.75,1.25,2.63,2.0,6
Campodarsego,8,2,4,2,10,9,1,10,Italy - Serie D - Group C,0.25,0.75,1,1.25,1.25,4.0,1.33,6
Portogruaro,8,2,4,2,6,6,0,10,Italy - Serie D - Group C,0.25,0.75,0,0.75,1.25,4.0,1.33,6
Calvi Noale,8,2,2,4,11,12,-1,8,Italy - Serie D - Group C,0.25,0.5,-1,1.38,1.0,4.0,2.0,7
Ciserano,8,1,5,2,5,7,-2,8,Italy - Serie D - Group C,0.12,0.75,-2,0.62,1.0,8.33,1.33,7
Chions,8,2,2,4,10,13,-3,8,Italy - Serie D - Group C,0.25,0.5,-3,1.25,1.0,4.0,2.0,7
Cjarlins Muzane,8,1,4,3,10,16,-6,7,Italy - Serie D - Group C,0.12,0.62,-6,1.25,0.88,8.33,1.61,8
Caravaggio,8,1,3,4,6,10,-4,6,Italy - Serie D - Group C,0.12,0.5,-4,0.75,0.75,8.33,2.0,9
Lavis,8,1,0,7,5,18,-13,3,Italy - Serie D - Group C,0.12,0.12,-13,0.62,0.38,8.33,8.33,10
Montecchio M.,8,0,2,6,3,13,-10,2,Italy - Serie D - Group C,0.0,0.25,-10,0.38,0.25,0.0,4.0,11
Forli,8,8,0,0,21,5,16,24,Italy - Serie D - Group D,1.0,1.0,16,2.62,3.0,1.0,1.0,1
Lentigione,8,7,1,0,18,4,14,22,Italy - Serie D - Group D,0.88,1.0,14,2.25,2.75,1.14,1.0,2
Ravenna,8,5,1,2,19,12,7,16,Italy - Serie D - Group D,0.62,0.75,7,2.38,2.0,1.61,1.33,3
Pistoiese,8,5,0,3,12,5,7,15,Italy - Serie D - Group D,0.62,0.62,7,1.5,1.88,1.61,1.61,4
Imolese,8,3,3,2,14,9,5,12,Italy - Serie D - Group D,0.38,0.75,5,1.75,1.5,2.63,1.33,5
Cittadella Vis,8,3,3,2,14,10,4,12,Italy - Serie D - Group D,0.38,0.75,4,1.75,1.5,2.63,1.33,5
Piacenza,8,3,3,2,11,7,4,12,Italy - Serie D - Group D,0.38,0.75,4,1.38,1.5,2.63,1.33,5
Zenith Prato,8,3,2,3,10,11,-1,11,Italy - Serie D - Group D,0.38,0.62,-1,1.25,1.38,2.63,1.61,6
Sammaurese,8,3,1,4,5,5,0,10,Italy - Serie D - Group D,0.38,0.5,0,0.62,1.25,2.63,2.0,7
Prato,8,3,1,4,9,11,-2,10,Italy - Serie D - Group D,0.38,0.5,-2,1.12,1.25,2.63,2.0,7
Sasso Marconi,8,2,3,3,11,13,-2,9,Italy - Serie D - Group D,0.25,0.62,-2,1.38,1.12,4.0,1.61,8
San Marino C.,8,2,3,3,12,15,-3,9,Italy - Serie D - Group D,0.25,0.62,-3,1.5,1.12,4.0,1.61,8
Progresso,8,2,2,4,9,10,-1,8,Italy - Serie D - Group D,0.25,0.5,-1,1.12,1.0,4.0,2.0,9
Tau Altopascio,8,1,5,2,8,9,-1,8,Italy - Serie D - Group D,0.12,0.75,-1,1.0,1.0,8.33,1.33,9
Tuttocuoio,8,1,4,3,9,11,-2,7,Italy - Serie D - Group D,0.12,0.62,-2,1.12,0.88,8.33,1.61,10
Fiorenzuola,8,2,1,5,4,12,-8,7,Italy - Serie D - Group D,0.25,0.38,-8,0.5,0.88,4.0,2.63,10
Corticella,8,2,1,5,6,23,-17,7,Italy - Serie D - Group D,0.25,0.38,-17,0.75,0.88,4.0,2.63,10
United Riccione,8,0,0,8,1,21,-20,0,Italy - Serie D - Group D,0.0,0.0,-20,0.12,0.0,0.0,0.0,11
Flaminia,8,5,2,1,16,9,7,17,Italy - Serie D - Group E,0.62,0.88,7,2.0,2.12,1.61,1.14,1
Ghiviborgo,8,5,1,2,20,8,12,16,Italy - Serie D - Group E,0.62,0.75,12,2.5,2.0,1.61,1.33,2
Orvietana,8,5,1,2,15,9,6,16,Italy - Serie D - Group E,0.62,0.75,6,1.88,2.0,1.61,1.33,2
S. Trestina,8,4,2,2,9,7,2,14,Italy - Serie D - Group E,0.5,0.75,2,1.12,1.75,2.0,1.33,3
Fulgens Foligno,8,3,3,2,14,12,2,12,Italy - Serie D - Group E,0.38,0.75,2,1.75,1.5,2.63,1.33,4
Ostia Mare,8,3,3,2,11,12,-1,12,Italy - Serie D - Group E,0.38,0.75,-1,1.38,1.5,2.63,1.33,4
Livorno,8,3,3,2,16,18,-2,12,Italy - Serie D - Group E,0.38,0.75,-2,2.0,1.5,2.63,1.33,4
FC Siena,8,3,2,3,13,12,1,11,Italy - Serie D - Group E,0.38,0.62,1,1.62,1.38,2.63,1.61,5
T. Traiana,8,2,5,1,7,7,0,11,Italy - Serie D - Group E,0.25,0.88,0,0.88,1.38,4.0,1.14,5
Seravezza,8,3,2,3,12,13,-1,11,Italy - Serie D - Group E,0.38,0.62,-1,1.5,1.38,2.63,1.61,5
Poggibonsi,8,3,1,4,3,6,-3,10,Italy - Serie D - Group E,0.38,0.5,-3,0.38,1.25,2.63,2.0,6
San Donato,8,2,3,3,8,7,1,9,Italy - Serie D - Group E,0.25,0.62,1,1.0,1.12,4.0,1.61,7
Montevarchi,8,1,6,1,7,6,1,9,Italy - Serie D - Group E,0.12,0.88,1,0.88,1.12,8.33,1.14,7
Grosseto,8,1,4,3,8,9,-1,7,Italy - Serie D - Group E,0.12,0.62,-1,1.0,0.88,8.33,1.61,8
Gavorrano,8,1,4,3,7,13,-6,7,Italy - Serie D - Group E,0.12,0.62,-6,0.88,0.88,8.33,1.61,8
Fezzanese,8,2,1,5,9,17,-8,7,Italy - Serie D - Group E,0.25,0.38,-8,1.12,0.88,4.0,2.63,8
Figline,8,1,3,4,3,8,-5,6,Italy - Serie D - Group E,0.12,0.5,-5,0.38,0.75,8.33,2.0,9
Sangiovannese,8,1,2,5,8,13,-5,5,Italy - Serie D - Group E,0.12,0.38,-5,1.0,0.62,8.33,2.63,10
Teramo,8,5,1,2,11,6,5,16,Italy - Serie D - Group F,0.62,0.75,5,1.38,2.0,1.61,1.33,1
Sambenedettese,8,4,2,2,10,6,4,14,Italy - Serie D - Group F,0.5,0.75,4,1.25,1.75,2.0,1.33,2
Avezzano,8,4,2,2,11,9,2,14,Italy - Serie D - Group F,0.5,0.75,2,1.38,1.75,2.0,1.33,2
Termoli Calcio,8,3,4,1,10,10,0,13,Italy - Serie D - Group F,0.38,0.88,0,1.25,1.62,2.63,1.14,3
San Nicolo,8,4,1,3,9,10,-1,13,Italy - Serie D - Group F,0.5,0.62,-1,1.12,1.62,2.0,1.61,3
Sora,8,3,3,2,10,6,4,12,Italy - Serie D - Group F,0.38,0.75,4,1.25,1.5,2.63,1.33,4
Fossombrone,8,3,3,2,10,7,3,12,Italy - Serie D - Group F,0.38,0.75,3,1.25,1.5,2.63,1.33,4
LAquila,8,3,2,3,11,8,3,11,Italy - Serie D - Group F,0.38,0.62,3,1.38,1.38,2.63,1.61,5
Civitanovese,8,3,2,3,9,7,2,11,Italy - Serie D - Group F,0.38,0.62,2,1.12,1.38,2.63,1.61,5
Chieti,8,3,2,3,9,11,-2,11,Italy - Serie D - Group F,0.38,0.62,-2,1.12,1.38,2.63,1.61,5
Atletico Ascoli,8,2,4,2,7,7,0,10,Italy - Serie D - Group F,0.25,0.75,0,0.88,1.25,4.0,1.33,6
Isernia,8,3,1,4,8,9,-1,10,Italy - Serie D - Group F,0.38,0.5,-1,1.0,1.25,2.63,2.0,6
Recanatese,8,3,1,4,9,14,-5,10,Italy - Serie D - Group F,0.38,0.5,-5,1.12,1.25,2.63,2.0,6
Ancona 1905,8,2,3,3,10,11,-1,9,Italy - Serie D - Group F,0.25,0.62,-1,1.25,1.12,4.0,1.61,7
Roma City,8,2,3,3,9,10,-1,9,Italy - Serie D - Group F,0.25,0.62,-1,1.12,1.12,4.0,1.61,7
V. Senigallia,8,1,4,3,6,10,-4,7,Italy - Serie D - Group F,0.12,0.62,-4,0.75,0.88,8.33,1.61,8
Fermana,8,1,3,4,7,10,-3,6,Italy - Serie D - Group F,0.12,0.5,-3,0.88,0.75,8.33,2.0,9
Castelfidardo,8,1,3,4,4,9,-5,6,Italy - Serie D - Group F,0.12,0.5,-5,0.5,0.75,8.33,2.0,9
Guidonia,8,7,1,0,23,6,17,22,Italy - Serie D - Group G,0.88,1.0,17,2.88,2.75,1.14,1.0,1
Savoia,8,6,2,0,13,2,11,20,Italy - Serie D - Group G,0.75,1.0,11,1.62,2.5,1.33,1.0,2
Sarnese,8,5,3,0,12,6,6,18,Italy - Serie D - Group G,0.62,1.0,6,1.5,2.25,1.61,1.0,3
Olbia,8,4,2,2,13,7,6,14,Italy - Serie D - Group G,0.5,0.75,6,1.62,1.75,2.0,1.33,4
Gelbison,8,4,2,2,14,9,5,14,Italy - Serie D - Group G,0.5,0.75,5,1.75,1.75,2.0,1.33,4
Ilvamaddalena,8,4,1,3,13,8,5,13,Italy - Serie D - Group G,0.5,0.62,5,1.62,1.62,2.0,1.61,5
Paganese,8,4,1,3,11,7,4,13,Italy - Serie D - Group G,0.5,0.62,4,1.38,1.62,2.0,1.61,5
CynthiAlbalonga,8,4,1,3,9,11,-2,13,Italy - Serie D - Group G,0.5,0.62,-2,1.12,1.62,2.0,1.61,5
A. Lodigiani,8,3,3,2,13,11,2,12,Italy - Serie D - Group G,0.38,0.75,2,1.62,1.5,2.63,1.33,6
S. Ogliastra,8,3,3,2,13,14,-1,12,Italy - Serie D - Group G,0.38,0.75,-1,1.62,1.5,2.63,1.33,6
R. Monterotondo,8,3,1,4,7,12,-5,10,Italy - Serie D - Group G,0.38,0.5,-5,0.88,1.25,2.63,2.0,7
Trastevere,8,2,2,4,12,15,-3,8,Italy - Serie D - Group G,0.25,0.5,-3,1.5,1.0,4.0,2.0,8
Latte Dolce,8,2,2,4,10,14,-4,8,Italy - Serie D - Group G,0.25,0.5,-4,1.25,1.0,4.0,2.0,8
Cassino,8,2,1,5,7,11,-4,7,Italy - Serie D - Group G,0.25,0.38,-4,0.88,0.88,4.0,2.63,9
Anzio,8,1,3,4,6,14,-8,6,Italy - Serie D - Group G,0.12,0.5,-8,0.75,0.75,8.33,2.0,10
Atletico Uri,8,1,1,6,6,10,-4,4,Italy - Serie D - Group G,0.12,0.25,-4,0.75,0.5,8.33,4.0,11
Puteolana,8,0,3,5,6,18,-12,3,Italy - Serie D - Group G,0.0,0.38,-12,0.75,0.38,0.0,2.63,12
Terracina,8,0,2,6,7,20,-13,2,Italy - Serie D - Group G,0.0,0.25,-13,0.88,0.25,0.0,4.0,13
Casarano,8,6,1,1,20,9,11,19,Italy - Serie D - Group H,0.75,0.88,11,2.5,2.38,1.33,1.14,1
Nocerina,8,5,2,1,19,6,13,17,Italy - Serie D - Group H,0.62,0.88,13,2.38,2.12,1.61,1.14,2
Citta di Fasano,8,4,2,2,15,9,6,14,Italy - Serie D - Group H,0.5,0.75,6,1.88,1.75,2.0,1.33,3
Manfredonia,8,3,4,1,13,9,4,13,Italy - Serie D - Group H,0.38,0.88,4,1.62,1.62,2.63,1.14,4
Ischia,8,3,4,1,6,5,1,13,Italy - Serie D - Group H,0.38,0.88,1,0.75,1.62,2.63,1.14,4
Gravina,8,3,3,2,12,8,4,12,Italy - Serie D - Group H,0.38,0.75,4,1.5,1.5,2.63,1.33,5
Brindisi,8,3,3,2,14,12,2,12,Italy - Serie D - Group H,0.38,0.75,2,1.75,1.5,2.63,1.33,5
Francavilla,8,4,0,4,8,10,-2,12,Italy - Serie D - Group H,0.5,0.5,-2,1.0,1.5,2.0,2.0,5
Nardo,8,3,2,3,10,11,-1,11,Italy - Serie D - Group H,0.38,0.62,-1,1.25,1.38,2.63,1.61,6
V. Francavilla,8,2,4,2,12,9,3,10,Italy - Serie D - Group H,0.25,0.75,3,1.5,1.25,4.0,1.33,7
Martina Franca,8,2,4,2,6,5,1,10,Italy - Serie D - Group H,0.25,0.75,1,0.75,1.25,4.0,1.33,7
Ugento,8,3,1,4,9,13,-4,10,Italy - Serie D - Group H,0.38,0.5,-4,1.12,1.25,2.63,2.0,7
USD Palmese,8,2,3,3,9,10,-1,9,Italy - Serie D - Group H,0.25,0.62,-1,1.12,1.12,4.0,1.61,8
Matera,8,2,3,3,14,17,-3,9,Italy - Serie D - Group H,0.25,0.62,-3,1.75,1.12,4.0,1.61,8
Real Acerrana,8,2,2,4,9,12,-3,8,Italy - Serie D - Group H,0.25,0.5,-3,1.12,1.0,4.0,2.0,9
Fidelis Andria,8,1,4,3,5,9,-4,7,Italy - Serie D - Group H,0.12,0.62,-4,0.62,0.88,8.33,1.61,10
Costa DAmalfi,8,1,2,5,6,14,-8,5,Italy - Serie D - Group H,0.12,0.38,-8,0.75,0.62,8.33,2.63,11
Angri Calcio,8,0,2,6,5,24,-19,2,Italy - Serie D - Group H,0.0,0.25,-19,0.62,0.25,0.0,4.0,12
Reggina,8,8,0,0,18,6,12,24,Italy - Serie D - Group I,1.0,1.0,12,2.25,3.0,1.0,1.0,1
Siracusa,8,7,0,1,19,5,14,21,Italy - Serie D - Group I,0.88,0.88,14,2.38,2.62,1.14,1.14,2
Scafatese,8,5,0,3,17,10,7,15,Italy - Serie D - Group I,0.62,0.62,7,2.12,1.88,1.61,1.61,3
Sancataldese,8,4,2,2,9,8,1,14,Italy - Serie D - Group I,0.5,0.75,1,1.12,1.75,2.0,1.33,4
Acireale,8,3,4,1,11,8,3,13,Italy - Serie D - Group I,0.38,0.88,3,1.38,1.62,2.63,1.14,5
Pompei,8,4,1,3,8,10,-2,13,Italy - Serie D - Group I,0.5,0.62,-2,1.0,1.62,2.0,1.61,5
Paterno,8,3,3,2,8,9,-1,12,Italy - Serie D - Group I,0.38,0.75,-1,1.0,1.5,2.63,1.33,6
Nissa,8,3,2,3,13,14,-1,11,Italy - Serie D - Group I,0.38,0.62,-1,1.62,1.38,2.63,1.61,7
Ragusa,8,3,1,4,11,11,0,10,Italy - Serie D - Group I,0.38,0.5,0,1.38,1.25,2.63,2.0,8
Licata,8,3,1,4,9,9,0,10,Italy - Serie D - Group I,0.38,0.5,0,1.12,1.25,2.63,2.0,8
CD S. Agata,8,2,2,4,13,15,-2,8,Italy - Serie D - Group I,0.25,0.5,-2,1.62,1.0,4.0,2.0,9
Sambiase,8,2,2,4,6,8,-2,8,Italy - Serie D - Group I,0.25,0.5,-2,0.75,1.0,4.0,2.0,9
Enna,8,2,2,4,5,10,-5,8,Italy - Serie D - Group I,0.25,0.5,-5,0.62,1.0,4.0,2.0,9
Vibonese,8,2,1,5,7,13,-6,7,Italy - Serie D - Group I,0.25,0.38,-6,0.88,0.88,4.0,2.63,10
Igea Virtus,8,2,1,5,7,14,-7,7,Italy - Serie D - Group I,0.25,0.38,-7,0.88,0.88,4.0,2.63,10
CastrumFavara,8,1,3,4,7,13,-6,6,Italy - Serie D - Group I,0.12,0.5,-6,0.88,0.75,8.33,2.0,11
Locri 1909,8,1,1,6,9,15,-6,4,Italy - Serie D - Group I,0.12,0.25,-6,1.12,0.5,8.33,4.0,12
Akragas,0,0,0,0,0,0,0,0,Italy - Serie D - Group I,0.0,0.0,0,0.0,0.0,0.0,0.0,13
Roma U20,8,6,0,2,24,11,13,18,Italy - Primavera 1,0.75,0.75,13,3.0,2.25,1.33,1.33,1
Cagliari U20,8,5,3,0,12,5,7,18,Italy - Primavera 1,0.62,1.0,7,1.5,2.25,1.61,1.0,1
Cesena U20,8,5,2,1,14,9,5,17,Italy - Primavera 1,0.62,0.88,5,1.75,2.12,1.61,1.14,2
Atalanta U20,8,5,1,2,15,6,9,16,Italy - Primavera 1,0.62,0.75,9,1.88,2.0,1.61,1.33,3
H. Verona U20,8,5,1,2,12,5,7,16,Italy - Primavera 1,0.62,0.75,7,1.5,2.0,1.61,1.33,3
Juventus U20,8,5,0,3,16,14,2,15,Italy - Primavera 1,0.62,0.62,2,2.0,1.88,1.61,1.61,4
Lecce U20,8,4,2,2,14,10,4,14,Italy - Primavera 1,0.5,0.75,4,1.75,1.75,2.0,1.33,5
Inter Milan U20,8,4,2,2,8,4,4,14,Italy - Primavera 1,0.5,0.75,4,1.0,1.75,2.0,1.33,5
Lazio U20,8,4,2,2,11,8,3,14,Italy - Primavera 1,0.5,0.75,3,1.38,1.75,2.0,1.33,5
Bologna U20,8,4,1,3,11,7,4,13,Italy - Primavera 1,0.5,0.62,4,1.38,1.62,2.0,1.61,6
Sassuolo U20,8,4,1,3,8,8,0,13,Italy - Primavera 1,0.5,0.62,0,1.0,1.62,2.0,1.61,6
Torino U20,8,3,1,4,17,15,2,10,Italy - Primavera 1,0.38,0.5,2,2.12,1.25,2.63,2.0,7
Genoa U20,8,3,1,4,10,11,-1,10,Italy - Primavera 1,0.38,0.5,-1,1.25,1.25,2.63,2.0,7
Cremonese U20,8,2,3,3,11,10,1,9,Italy - Primavera 1,0.25,0.62,1,1.38,1.12,4.0,1.61,8
Monza U20,8,2,2,4,11,16,-5,8,Italy - Primavera 1,0.25,0.5,-5,1.38,1.0,4.0,2.0,9
Milan U20,8,2,2,4,8,13,-5,8,Italy - Primavera 1,0.25,0.5,-5,1.0,1.0,4.0,2.0,9
Empoli U20,8,2,2,4,6,12,-6,8,Italy - Primavera 1,0.25,0.5,-6,0.75,1.0,4.0,2.0,9
Sampdoria U20,8,1,2,5,8,18,-10,5,Italy - Primavera 1,0.12,0.38,-10,1.0,0.62,8.33,2.63,10
Fiorentina U20,8,1,1,6,12,15,-3,4,Italy - Primavera 1,0.12,0.25,-3,1.5,0.5,8.33,4.0,11
Udinese U20,8,0,1,7,3,27,-24,1,Italy - Primavera 1,0.0,0.12,-24,0.38,0.12,0.0,8.33,12
Mount Pleasant,8,7,1,0,17,1,16,22,Jamaica - Premier League,0.88,1.0,16,2.12,2.75,1.14,1.0,1
Waterhouse,8,5,2,1,11,5,6,17,Jamaica - Premier League,0.62,0.88,6,1.38,2.12,1.61,1.14,2
Tivoli Gardens,8,4,4,0,12,7,5,16,Jamaica - Premier League,0.5,1.0,5,1.5,2.0,2.0,1.0,3
Montego Bay,8,4,3,1,14,3,11,15,Jamaica - Premier League,0.5,0.88,11,1.75,1.88,2.0,1.14,4
Cavalier,8,4,3,1,14,7,7,15,Jamaica - Premier League,0.5,0.88,7,1.75,1.88,2.0,1.14,4
Arnett Gardens,8,3,2,3,13,10,3,11,Jamaica - Premier League,0.38,0.62,3,1.62,1.38,2.63,1.61,5
Chapelton,8,3,2,3,7,11,-4,11,Jamaica - Premier League,0.38,0.62,-4,0.88,1.38,2.63,1.61,5
Portmore Utd,8,3,1,4,4,6,-2,10,Jamaica - Premier League,0.38,0.5,-2,0.5,1.25,2.63,2.0,6
Racing United,8,3,1,4,9,12,-3,10,Jamaica - Premier League,0.38,0.5,-3,1.12,1.25,2.63,2.0,6
Humble Lions,8,2,3,3,9,8,1,9,Jamaica - Premier League,0.25,0.62,1,1.12,1.12,4.0,1.61,7
Harbour View,8,2,2,4,10,12,-2,8,Jamaica - Premier League,0.25,0.5,-2,1.25,1.0,4.0,2.0,8
Molynes Utd,8,2,1,5,6,16,-10,7,Jamaica - Premier League,0.25,0.38,-10,0.75,0.88,4.0,2.63,9
Dunbeholden,8,1,2,5,4,13,-9,5,Jamaica - Premier League,0.12,0.38,-9,0.5,0.62,8.33,2.63,10
Vere Utd,8,0,1,7,4,21,-17,1,Jamaica - Premier League,0.0,0.12,-17,0.5,0.12,0.0,8.33,11
Kyoto Sanga,8,6,1,1,15,9,6,19,Japan - J1 League,0.75,0.88,6,1.88,2.38,1.33,1.14,1
Urawa RD,8,5,2,1,12,6,6,17,Japan - J1 League,0.62,0.88,6,1.5,2.12,1.61,1.14,2
Avispa Fukuoka,8,5,2,1,10,7,3,17,Japan - J1 League,0.62,0.88,3,1.25,2.12,1.61,1.14,2
Vissel Kobe,8,5,0,3,7,5,2,15,Japan - J1 League,0.62,0.62,2,0.88,1.88,1.61,1.61,3
Kashima Antlers,8,4,1,3,11,9,2,13,Japan - J1 League,0.5,0.62,2,1.38,1.62,2.0,1.61,4
K. Frontale,8,2,5,1,12,8,4,11,Japan - J1 League,0.25,0.88,4,1.5,1.38,4.0,1.14,5
Tokyo Verdy,8,2,5,1,7,6,1,11,Japan - J1 League,0.25,0.88,1,0.88,1.38,4.0,1.14,5
Machida Zelvia,8,3,2,3,8,8,0,11,Japan - J1 League,0.38,0.62,0,1.0,1.38,2.63,1.61,5
Kashiwa Reysol,8,2,5,1,7,7,0,11,Japan - J1 League,0.25,0.88,0,0.88,1.38,4.0,1.14,5
Fagiano Okayama,8,3,2,3,6,6,0,11,Japan - J1 League,0.38,0.62,0,0.75,1.38,2.63,1.61,5
Shimizu S-Pulse,8,3,1,4,12,11,1,10,Japan - J1 League,0.38,0.5,1,1.5,1.25,2.63,2.0,6
Nagoya G.,8,3,1,4,9,10,-1,10,Japan - J1 League,0.38,0.5,-1,1.12,1.25,2.63,2.0,6
S. Hiroshima,8,3,1,4,6,7,-1,10,Japan - J1 League,0.38,0.5,-1,0.75,1.25,2.63,2.0,6
Cerezo Osaka,8,2,3,3,7,9,-2,9,Japan - J1 League,0.25,0.62,-2,0.88,1.12,4.0,1.61,7
Yokohama FC,8,2,2,4,7,8,-1,8,Japan - J1 League,0.25,0.5,-1,0.88,1.0,4.0,2.0,8
Gamba Osaka,8,2,2,4,7,11,-4,8,Japan - J1 League,0.25,0.5,-4,0.88,1.0,4.0,2.0,8
Albirex Niigata,8,1,4,3,8,10,-2,7,Japan - J1 League,0.12,0.62,-2,1.0,0.88,8.33,1.61,9
FC Tokyo,8,1,4,3,7,9,-2,7,Japan - J1 League,0.12,0.62,-2,0.88,0.88,8.33,1.61,9
Shonan Bellmare,8,2,1,5,4,11,-7,7,Japan - J1 League,0.25,0.38,-7,0.5,0.88,4.0,2.63,9
Yokohama M.,8,1,2,5,9,14,-5,5,Japan - J1 League,0.12,0.38,-5,1.12,0.62,8.33,2.63,10
JEF Utd Chiba,8,7,0,1,19,8,11,21,Japan - J2 League,0.88,0.88,11,2.38,2.62,1.14,1.14,1
Sagan Tosu,8,5,2,1,11,7,4,17,Japan - J2 League,0.62,0.88,4,1.38,2.12,1.61,1.14,2
FC Imabari,8,4,4,0,12,6,6,16,Japan - J2 League,0.5,1.0,6,1.5,2.0,2.0,1.0,3
Omiya Ardija,8,4,2,2,9,6,3,14,Japan - J2 League,0.5,0.75,3,1.12,1.75,2.0,1.33,4
Vegalta Sendai,8,3,4,1,9,7,2,13,Japan - J2 League,0.38,0.88,2,1.12,1.62,2.63,1.14,5
M. Yamagata,8,3,3,2,13,10,3,12,Japan - J2 League,0.38,0.75,3,1.62,1.5,2.63,1.33,6
Mito Hollyhock,8,3,3,2,11,8,3,12,Japan - J2 League,0.38,0.75,3,1.38,1.5,2.63,1.33,6
R. Kumamoto,8,3,3,2,8,6,2,12,Japan - J2 League,0.38,0.75,2,1.0,1.5,2.63,1.33,6
C. Sapporo,8,4,0,4,10,11,-1,12,Japan - J2 League,0.5,0.5,-1,1.25,1.5,2.0,2.0,6
Oita Trinita,8,2,5,1,9,6,3,11,Japan - J2 League,0.25,0.88,3,1.12,1.38,4.0,1.14,7
Jubilo Iwata,8,3,2,3,9,12,-3,11,Japan - J2 League,0.38,0.62,-3,1.12,1.38,2.63,1.61,7
Ventforet Kofu,8,2,4,2,8,8,0,10,Japan - J2 League,0.25,0.75,0,1.0,1.25,4.0,1.33,8
Tokushima V.,8,2,3,3,3,4,-1,9,Japan - J2 League,0.25,0.62,-1,0.38,1.12,4.0,1.61,9
V-V. Nagasaki,8,2,2,4,14,16,-2,8,Japan - J2 League,0.25,0.5,-2,1.75,1.0,4.0,2.0,10
Fujieda MYFC,8,2,2,4,12,14,-2,8,Japan - J2 League,0.25,0.5,-2,1.5,1.0,4.0,2.0,10
Iwaki,8,2,1,5,8,14,-6,7,Japan - J2 League,0.25,0.38,-6,1.0,0.88,4.0,2.63,11
Kataller Toyama,8,1,3,4,6,8,-2,6,Japan - J2 League,0.12,0.5,-2,0.75,0.75,8.33,2.0,12
Ehime FC,8,1,3,4,9,15,-6,6,Japan - J2 League,0.12,0.5,-6,1.12,0.75,8.33,2.0,12
Blaublitz Akita,8,2,0,6,9,19,-10,6,Japan - J2 League,0.25,0.25,-10,1.12,0.75,4.0,4.0,12
R. Yamaguchi,8,0,4,4,8,12,-4,4,Japan - J2 League,0.0,0.5,-4,1.0,0.5,0.0,2.0,13
Tochigi City,8,5,3,0,15,6,9,18,Japan - J3 League,0.62,1.0,9,1.88,2.25,1.61,1.0,1
Osaka,8,6,0,2,12,7,5,18,Japan - J3 League,0.75,0.75,5,1.5,2.25,1.33,1.33,1
Kagoshima Utd,8,4,4,0,15,7,8,16,Japan - J3 League,0.5,1.0,8,1.88,2.0,2.0,1.0,2
Nara Club,8,4,3,1,12,8,4,15,Japan - J3 League,0.5,0.88,4,1.5,1.88,2.0,1.14,3
Fukushima Utd,8,4,2,2,15,12,3,14,Japan - J3 League,0.5,0.75,3,1.88,1.75,2.0,1.33,4
G. Kitakyushu,8,4,1,3,8,5,3,13,Japan - J3 League,0.5,0.62,3,1.0,1.62,2.0,1.61,5
T. Miyazaki,8,3,4,1,9,7,2,13,Japan - J3 League,0.38,0.88,2,1.12,1.62,2.63,1.14,5
V. Hachinohe,8,4,1,3,9,7,2,13,Japan - J3 League,0.5,0.62,2,1.12,1.62,2.0,1.61,5
Z. Kanazawa,8,4,1,3,10,9,1,13,Japan - J3 League,0.5,0.62,1,1.25,1.62,2.0,1.61,5
Kochi United,8,3,2,3,17,17,0,11,Japan - J3 League,0.38,0.62,0,2.12,1.38,2.63,1.61,6
Matsumoto Y.,8,3,2,3,8,10,-2,11,Japan - J3 League,0.38,0.62,-2,1.0,1.38,2.63,1.61,6
FC Ryukyu,8,2,3,3,8,8,0,9,Japan - J3 League,0.25,0.62,0,1.0,1.12,4.0,1.61,7
Tochigi SC,8,2,2,4,5,7,-2,8,Japan - J3 League,0.25,0.5,-2,0.62,1.0,4.0,2.0,8
Gifu,8,2,2,4,9,13,-4,8,Japan - J3 League,0.25,0.5,-4,1.12,1.0,4.0,2.0,8
Nagano Parceiro,8,2,1,5,9,14,-5,7,Japan - J3 League,0.25,0.38,-5,1.12,0.88,4.0,2.63,9
SC Sagamihara,8,1,4,3,6,11,-5,7,Japan - J3 League,0.12,0.62,-5,0.75,0.88,8.33,1.61,9
Gainare Tottori,8,1,3,4,6,10,-4,6,Japan - J3 League,0.12,0.5,-4,0.75,0.75,8.33,2.0,10
Kamatamare S.,8,1,3,4,4,9,-5,6,Japan - J3 League,0.12,0.5,-5,0.5,0.75,8.33,2.0,10
AC Numazu,8,0,5,3,4,8,-4,5,Japan - J3 League,0.0,0.62,-4,0.5,0.62,0.0,1.61,11
Kusatsu,8,1,2,5,11,18,-7,5,Japan - J3 League,0.12,0.38,-7,1.38,0.62,8.33,2.63,11
Al Wihdat,8,6,1,1,17,6,11,19,Jordan - Premier League,0.75,0.88,11,2.12,2.38,1.33,1.14,1
Al Faysali,8,4,4,0,7,3,4,16,Jordan - Premier League,0.5,1.0,4,0.88,2.0,2.0,1.0,2
Al Salt,8,4,2,2,8,5,3,14,Jordan - Premier League,0.5,0.75,3,1.0,1.75,2.0,1.33,3
Al Hussein,8,3,4,1,20,7,13,13,Jordan - Premier League,0.38,0.88,13,2.5,1.62,2.63,1.14,4
Shabab Al Ordon,8,3,2,3,11,8,3,11,Jordan - Premier League,0.38,0.62,3,1.38,1.38,2.63,1.61,5
Al Ramtha,8,3,2,3,9,7,2,11,Jordan - Premier League,0.38,0.62,2,1.12,1.38,2.63,1.61,5
Al Sareeh,8,3,2,3,6,6,0,11,Jordan - Premier League,0.38,0.62,0,0.75,1.38,2.63,1.61,5
Aqaba,8,3,2,3,7,15,-8,11,Jordan - Premier League,0.38,0.62,-8,0.88,1.38,2.63,1.61,5
Al Jazeera,8,3,1,4,8,8,0,10,Jordan - Premier League,0.38,0.5,0,1.0,1.25,2.63,2.0,6
Al Ahli,8,2,1,5,4,14,-10,7,Jordan - Premier League,0.25,0.38,-10,0.5,0.88,4.0,2.63,7
Maan,8,1,1,6,7,16,-9,4,Jordan - Premier League,0.12,0.25,-9,0.88,0.5,8.33,4.0,8
Moghayer Al S.,8,1,0,7,4,18,-14,3,Jordan - Premier League,0.12,0.12,-14,0.5,0.38,8.33,8.33,9
Kairat Almaty,7,5,2,0,17,4,13,17,Kazakhstan - Premier League,0.71,1.0,13,2.43,2.43,1.41,1.0,1
FC Astana,6,4,2,0,11,4,7,14,Kazakhstan - Premier League,0.67,1.0,7,1.83,2.33,1.49,1.0,2
Yelimay Semey,6,4,1,1,11,3,8,13,Kazakhstan - Premier League,0.67,0.83,8,1.83,2.17,1.49,1.2,3
Aktobe,6,4,1,1,11,4,7,13,Kazakhstan - Premier League,0.67,0.83,7,1.83,2.17,1.49,1.2,3
Tobol,6,3,2,1,7,3,4,11,Kazakhstan - Premier League,0.5,0.83,4,1.17,1.83,2.0,1.2,4
Kyzylzhar,6,2,2,2,7,8,-1,8,Kazakhstan - Premier League,0.33,0.67,-1,1.17,1.33,3.03,1.49,5
Okzhetpes,6,2,2,2,6,7,-1,8,Kazakhstan - Premier League,0.33,0.67,-1,1.0,1.33,3.03,1.49,5
Ordabasy,6,2,2,2,3,6,-3,8,Kazakhstan - Premier League,0.33,0.67,-3,0.5,1.33,3.03,1.49,5
Turan,6,2,1,3,8,8,0,7,Kazakhstan - Premier League,0.33,0.5,0,1.33,1.17,3.03,2.0,6
Zhenys,6,0,5,1,2,3,-1,5,Kazakhstan - Premier League,0.0,0.83,-1,0.33,0.83,0.0,1.2,7
Kaisar K.,6,0,3,3,4,10,-6,3,Kazakhstan - Premier League,0.0,0.5,-6,0.67,0.5,0.0,2.0,8
Zhetysu,6,0,3,3,1,8,-7,3,Kazakhstan - Premier League,0.0,0.5,-7,0.17,0.5,0.0,2.0,8
Atyrau,7,1,0,6,6,19,-13,3,Kazakhstan - Premier League,0.14,0.14,-13,0.86,0.43,7.14,7.14,8
Ulytau,6,0,2,4,1,8,-7,2,Kazakhstan - Premier League,0.0,0.33,-7,0.17,0.33,0.0,3.03,9
Drita,8,5,2,1,14,6,8,17,Kosovo - Superliga,0.62,0.88,8,1.75,2.12,1.61,1.14,1
Ferizaj,8,5,0,3,14,11,3,15,Kosovo - Superliga,0.62,0.62,3,1.75,1.88,1.61,1.61,2
Gjilani,8,4,2,2,9,10,-1,14,Kosovo - Superliga,0.5,0.75,-1,1.12,1.75,2.0,1.33,3
Ballkani,8,4,1,3,11,9,2,13,Kosovo - Superliga,0.5,0.62,2,1.38,1.62,2.0,1.61,4
Llapi,8,3,3,2,7,3,4,12,Kosovo - Superliga,0.38,0.75,4,0.88,1.5,2.63,1.33,5
Malisheva,8,3,3,2,10,7,3,12,Kosovo - Superliga,0.38,0.75,3,1.25,1.5,2.63,1.33,5
Dukagjini,8,3,3,2,5,4,1,12,Kosovo - Superliga,0.38,0.75,1,0.62,1.5,2.63,1.33,5
Prishtina,8,0,6,2,7,9,-2,6,Kosovo - Superliga,0.0,0.75,-2,0.88,0.75,0.0,1.33,6
Suhareka,8,1,1,6,7,16,-9,4,Kosovo - Superliga,0.12,0.25,-9,0.88,0.5,8.33,4.0,7
Feronikeli,8,1,1,6,4,13,-9,4,Kosovo - Superliga,0.12,0.25,-9,0.5,0.5,8.33,4.0,7
Al Kuwait,8,5,3,0,24,5,19,18,Kuwait - Premier League,0.62,1.0,19,3.0,2.25,1.61,1.0,1
Al Qadsia,8,6,0,2,19,12,7,18,Kuwait - Premier League,0.75,0.75,7,2.38,2.25,1.33,1.33,1
Al Arabi SC,8,4,4,0,11,6,5,16,Kuwait - Premier League,0.5,1.0,5,1.38,2.0,2.0,1.0,2
Al Fahaheel,8,2,4,2,12,12,0,10,Kuwait - Premier League,0.25,0.75,0,1.5,1.25,4.0,1.33,3
Al Nasar,8,3,1,4,12,15,-3,10,Kuwait - Premier League,0.38,0.5,-3,1.5,1.25,2.63,2.0,3
Kazma,8,2,3,3,13,10,3,9,Kuwait - Premier League,0.25,0.62,3,1.62,1.12,4.0,1.61,4
Al Salmiyah,8,2,3,3,13,14,-1,9,Kuwait - Premier League,0.25,0.62,-1,1.62,1.12,4.0,1.61,4
Al Tadhamon,8,2,0,6,6,21,-15,6,Kuwait - Premier League,0.25,0.25,-15,0.75,0.75,4.0,4.0,5
Khaitan,8,1,2,5,5,9,-4,5,Kuwait - Premier League,0.12,0.38,-4,0.62,0.62,8.33,2.63,6
Yarmouk,8,1,2,5,5,20,-15,5,Kuwait - Premier League,0.12,0.38,-15,0.62,0.62,8.33,2.63,6
Auda,8,6,1,1,14,4,10,19,Latvia - Virsliga,0.75,0.88,10,1.75,2.38,1.33,1.14,1
RFS,8,6,0,2,15,6,9,18,Latvia - Virsliga,0.75,0.75,9,1.88,2.25,1.33,1.33,2
Riga FC,8,4,3,1,17,8,9,15,Latvia - Virsliga,0.5,0.88,9,2.12,1.88,2.0,1.14,3
Daugavpils,8,4,1,3,15,14,1,13,Latvia - Virsliga,0.5,0.62,1,1.88,1.62,2.0,1.61,4
FS Jelgava,8,3,2,3,9,8,1,11,Latvia - Virsliga,0.38,0.62,1,1.12,1.38,2.63,1.61,5
Metta,8,3,2,3,9,12,-3,11,Latvia - Virsliga,0.38,0.62,-3,1.12,1.38,2.63,1.61,5
Liepaja,8,2,2,4,12,19,-7,8,Latvia - Virsliga,0.25,0.5,-7,1.5,1.0,4.0,2.0,6
Super Nova,8,1,4,3,12,11,1,7,Latvia - Virsliga,0.12,0.62,1,1.5,0.88,8.33,1.61,7
Tukums,8,1,2,5,7,14,-7,5,Latvia - Virsliga,0.12,0.38,-7,0.88,0.62,8.33,2.63,8
Grobina,8,1,1,6,8,22,-14,4,Latvia - Virsliga,0.12,0.25,-14,1.0,0.5,8.33,4.0,9
Hegelmann L.,8,6,0,2,13,12,1,18,Lithuania - A Lyga,0.75,0.75,1,1.62,2.25,1.33,1.33,1
Dziugas Telsiai,8,5,0,3,7,5,2,15,Lithuania - A Lyga,0.62,0.62,2,0.88,1.88,1.61,1.61,2
Suduva,8,4,2,2,8,6,2,14,Lithuania - A Lyga,0.5,0.75,2,1.0,1.75,2.0,1.33,3
Kauno Zalgiris,8,3,3,2,9,6,3,12,Lithuania - A Lyga,0.38,0.75,3,1.12,1.5,2.63,1.33,4
Siauliai,8,3,3,2,12,10,2,12,Lithuania - A Lyga,0.38,0.75,2,1.5,1.5,2.63,1.33,4
Riteriai,8,2,4,2,13,11,2,10,Lithuania - A Lyga,0.25,0.75,2,1.62,1.25,4.0,1.33,5
Panevezys,8,3,1,4,11,12,-1,10,Lithuania - A Lyga,0.38,0.5,-1,1.38,1.25,2.63,2.0,5
Zalgiris,8,2,3,3,11,11,0,9,Lithuania - A Lyga,0.25,0.62,0,1.38,1.12,4.0,1.61,6
Banga,8,2,2,4,7,10,-3,8,Lithuania - A Lyga,0.25,0.5,-3,0.88,1.0,4.0,2.0,7
Dainava,8,0,2,6,7,15,-8,2,Lithuania - A Lyga,0.0,0.25,-8,0.88,0.25,0.0,4.0,8
Tauras,6,5,1,0,15,1,14,16,Lithuania - 1st League,0.83,1.0,14,2.5,2.67,1.2,1.0,1
BFA Vilnius,6,5,1,0,13,3,10,16,Lithuania - 1st League,0.83,1.0,10,2.17,2.67,1.2,1.0,1
TransINVEST,6,5,0,1,18,6,12,15,Lithuania - 1st League,0.83,0.83,12,3.0,2.5,1.2,1.2,2
Neptuna K.,6,4,1,1,15,5,10,13,Lithuania - 1st League,0.67,0.83,10,2.5,2.17,1.49,1.2,3
Babrungas,6,3,2,1,10,11,-1,11,Lithuania - 1st League,0.5,0.83,-1,1.67,1.83,2.0,1.2,4
Kauno Z. B,5,3,0,2,4,3,1,9,Lithuania - 1st League,0.6,0.6,1,0.8,1.8,1.67,1.67,5
Zalgiris B,6,2,2,2,9,9,0,8,Lithuania - 1st League,0.33,0.67,0,1.5,1.33,3.03,1.49,6
Atmosfera,6,2,1,3,6,9,-3,7,Lithuania - 1st League,0.33,0.5,-3,1.0,1.17,3.03,2.0,7
Panevezys B,5,2,1,2,8,12,-4,7,Lithuania - 1st League,0.4,0.6,-4,1.6,1.4,2.5,1.67,7
Ekranas,6,2,0,4,8,9,-1,6,Lithuania - 1st League,0.33,0.33,-1,1.33,1.0,3.03,3.03,8
Hegelmann B,6,1,3,2,6,8,-2,6,Lithuania - 1st League,0.17,0.67,-2,1.0,1.0,5.88,1.49,8
Minija,6,2,0,4,4,12,-8,6,Lithuania - 1st League,0.33,0.33,-8,0.67,1.0,3.03,3.03,8
Nevezis,6,1,1,4,9,14,-5,4,Lithuania - 1st League,0.17,0.33,-5,1.5,0.67,5.88,3.03,9
Siauliai B,6,1,1,4,7,17,-10,4,Lithuania - 1st League,0.17,0.33,-10,1.17,0.67,5.88,3.03,9
Jonava,6,0,2,4,2,6,-4,2,Lithuania - 1st League,0.0,0.33,-4,0.33,0.33,0.0,3.03,10
Be1 NFA,6,0,2,4,2,11,-9,2,Lithuania - 1st League,0.0,0.33,-9,0.33,0.33,0.0,3.03,10
Differdange,8,8,0,0,19,0,19,24,Luxembourg - National Division,1.0,1.0,19,2.38,3.0,1.0,1.0,1
UNA Strassen,8,5,1,2,20,8,12,16,Luxembourg - National Division,0.62,0.75,12,2.5,2.0,1.61,1.33,2
Racing,8,5,1,2,15,6,9,16,Luxembourg - National Division,0.62,0.75,9,1.88,2.0,1.61,1.33,2
Niedercorn,8,5,1,2,13,8,5,16,Luxembourg - National Division,0.62,0.75,5,1.62,2.0,1.61,1.33,2
Hostert,8,4,2,2,13,13,0,14,Luxembourg - National Division,0.5,0.75,0,1.62,1.75,2.0,1.33,3
Hesperange,8,4,1,3,12,9,3,13,Luxembourg - National Division,0.5,0.62,3,1.5,1.62,2.0,1.61,4
Mondorf,8,4,1,3,11,9,2,13,Luxembourg - National Division,0.5,0.62,2,1.38,1.62,2.0,1.61,4
Dudelange,8,3,3,2,13,9,4,12,Luxembourg - National Division,0.38,0.75,4,1.62,1.5,2.63,1.33,5
Rodange,8,3,3,2,8,8,0,12,Luxembourg - National Division,0.38,0.75,0,1.0,1.5,2.63,1.33,5
Petange,8,3,2,3,10,11,-1,11,Luxembourg - National Division,0.38,0.62,-1,1.25,1.38,2.63,1.61,6
V. Rosport,8,1,5,2,6,8,-2,8,Luxembourg - National Division,0.12,0.75,-2,0.75,1.0,8.33,1.33,7
Wiltz,8,2,1,5,9,17,-8,7,Luxembourg - National Division,0.25,0.38,-8,1.12,0.88,4.0,2.63,8
Bettembourg,8,2,0,6,10,16,-6,6,Luxembourg - National Division,0.25,0.25,-6,1.25,0.75,4.0,4.0,9
Jeunesse Esch,8,1,2,5,7,13,-6,5,Luxembourg - National Division,0.12,0.38,-6,0.88,0.62,8.33,2.63,10
Mondercange,8,1,1,6,3,20,-17,4,Luxembourg - National Division,0.12,0.25,-17,0.38,0.5,8.33,4.0,11
Fola Esch,8,1,0,7,5,19,-14,3,Luxembourg - National Division,0.12,0.12,-14,0.62,0.38,8.33,8.33,12
Johor Darul,8,8,0,0,31,1,30,24,Malaysia - Super League,1.0,1.0,30,3.88,3.0,1.0,1.0,1
Selangor,8,5,2,1,15,3,12,17,Malaysia - Super League,0.62,0.88,12,1.88,2.12,1.61,1.14,2
Kuching,8,5,2,1,16,7,9,17,Malaysia - Super League,0.62,0.88,9,2.0,2.12,1.61,1.14,2
Kuala Lumpur,8,4,2,2,15,11,4,14,Malaysia - Super League,0.5,0.75,4,1.88,1.75,2.0,1.33,3
Pahang,8,4,1,3,16,14,2,13,Malaysia - Super League,0.5,0.62,2,2.0,1.62,2.0,1.61,4
Perak,8,3,3,2,14,8,6,12,Malaysia - Super League,0.38,0.75,6,1.75,1.5,2.63,1.33,5
Pulau Pinang,8,3,3,2,16,12,4,12,Malaysia - Super League,0.38,0.75,4,2.0,1.5,2.63,1.33,5
Terengganu,8,3,2,3,15,9,6,11,Malaysia - Super League,0.38,0.62,6,1.88,1.38,2.63,1.61,6
Sabah,8,2,5,1,9,8,1,11,Malaysia - Super League,0.25,0.88,1,1.12,1.38,4.0,1.14,6
Negeri Sembilan,8,2,1,5,7,12,-5,7,Malaysia - Super League,0.25,0.38,-5,0.88,0.88,4.0,2.63,7
PDRM,8,2,0,6,5,15,-10,6,Malaysia - Super League,0.25,0.25,-10,0.62,0.75,4.0,4.0,8
Kedah,8,1,1,6,5,24,-19,4,Malaysia - Super League,0.12,0.25,-19,0.62,0.5,8.33,4.0,9
Kelantan United,8,0,0,8,4,40,-36,0,Malaysia - Super League,0.0,0.0,-36,0.5,0.0,0.0,0.0,10
Mosta,8,5,1,2,11,9,2,16,Malta - Premier League,0.62,0.75,2,1.38,2.0,1.61,1.33,1
Floriana,8,4,3,1,11,7,4,15,Malta - Premier League,0.5,0.88,4,1.38,1.88,2.0,1.14,2
Birkirkara,8,4,2,2,12,5,7,14,Malta - Premier League,0.5,0.75,7,1.5,1.75,2.0,1.33,3
Hibernians,8,4,2,2,13,12,1,14,Malta - Premier League,0.5,0.75,1,1.62,1.75,2.0,1.33,3
Marsaxlokk,8,4,1,3,13,6,7,13,Malta - Premier League,0.5,0.62,7,1.62,1.62,2.0,1.61,4
Sliema,8,4,0,4,13,12,1,12,Malta - Premier League,0.5,0.5,1,1.62,1.5,2.0,2.0,5
Hamrun Spartans,8,3,1,4,7,6,1,10,Malta - Premier League,0.38,0.5,1,0.88,1.25,2.63,2.0,6
Naxxar Lions,8,3,1,4,11,15,-4,10,Malta - Premier League,0.38,0.5,-4,1.38,1.25,2.63,2.0,6
Zabbar,8,2,2,4,10,9,1,8,Malta - Premier League,0.25,0.5,1,1.25,1.0,4.0,2.0,7
Gzira Utd,8,2,2,4,5,13,-8,8,Malta - Premier League,0.25,0.5,-8,0.62,1.0,4.0,2.0,7
Balzan,8,1,4,3,6,8,-2,7,Malta - Premier League,0.12,0.62,-2,0.75,0.88,8.33,1.61,8
Melita,8,1,3,4,10,20,-10,6,Malta - Premier League,0.12,0.5,-10,1.25,0.75,8.33,2.0,9
Cruz Azul,8,6,2,0,20,6,14,20,Mexico - Liga MX - Apertura,0.75,1.0,14,2.5,2.5,1.33,1.0,1
Toluca,8,5,2,1,21,7,14,17,Mexico - Liga MX - Apertura,0.62,0.88,14,2.62,2.12,1.61,1.14,2
A. San Luis,8,5,1,2,12,8,4,16,Mexico - Liga MX - Apertura,0.62,0.75,4,1.5,2.0,1.61,1.33,3
Pumas UNAM,8,4,3,1,8,3,5,15,Mexico - Liga MX - Apertura,0.5,0.88,5,1.0,1.88,2.0,1.14,4
Tijuana,8,4,3,1,10,9,1,15,Mexico - Liga MX - Apertura,0.5,0.88,1,1.25,1.88,2.0,1.14,4
CF America,8,4,2,2,15,10,5,14,Mexico - Liga MX - Apertura,0.5,0.75,5,1.88,1.75,2.0,1.33,5
Tigres,8,4,2,2,13,11,2,14,Mexico - Liga MX - Apertura,0.5,0.75,2,1.62,1.75,2.0,1.33,5
Juarez,8,4,1,3,13,15,-2,13,Mexico - Liga MX - Apertura,0.5,0.62,-2,1.62,1.62,2.0,1.61,6
Monterrey,8,3,3,2,12,7,5,12,Mexico - Liga MX - Apertura,0.38,0.75,5,1.5,1.5,2.63,1.33,7
Club Leon,8,2,5,1,13,9,4,11,Mexico - Liga MX - Apertura,0.25,0.88,4,1.62,1.38,4.0,1.14,8
Guadalajara,8,3,2,3,10,8,2,11,Mexico - Liga MX - Apertura,0.38,0.62,2,1.25,1.38,2.63,1.61,8
Queretaro,8,2,2,4,7,13,-6,8,Mexico - Liga MX - Apertura,0.25,0.5,-6,0.88,1.0,4.0,2.0,9
Atlas,8,1,5,2,6,12,-6,8,Mexico - Liga MX - Apertura,0.12,0.75,-6,0.75,1.0,8.33,1.33,9
Mazatlan,8,1,4,3,4,9,-5,7,Mexico - Liga MX - Apertura,0.12,0.62,-5,0.5,0.88,8.33,1.61,10
Pachuca,8,1,1,6,12,16,-4,4,Mexico - Liga MX - Apertura,0.12,0.25,-4,1.5,0.5,8.33,4.0,11
Necaxa,8,0,3,5,7,18,-11,3,Mexico - Liga MX - Apertura,0.0,0.38,-11,0.88,0.38,0.0,2.63,12
Puebla,8,1,0,7,7,18,-11,3,Mexico - Liga MX - Apertura,0.12,0.12,-11,0.88,0.38,8.33,8.33,12
Santos Laguna,8,0,2,6,4,16,-12,2,Mexico - Liga MX - Apertura,0.0,0.25,-12,0.5,0.25,0.0,4.0,13
Toluca,8,6,1,1,19,12,7,19,Mexico - Liga MX - Clausura,0.75,0.88,7,2.38,2.38,1.33,1.14,1
Tigres,8,5,2,1,10,6,4,17,Mexico - Liga MX - Clausura,0.62,0.88,4,1.25,2.12,1.61,1.14,2
Monterrey,8,5,1,2,16,9,7,16,Mexico - Liga MX - Clausura,0.62,0.75,7,2.0,2.0,1.61,1.33,3
Cruz Azul,8,4,4,0,13,7,6,16,Mexico - Liga MX - Clausura,0.5,1.0,6,1.62,2.0,2.0,1.0,3
CF America,8,4,2,2,14,3,11,14,Mexico - Liga MX - Clausura,0.5,0.75,11,1.75,1.75,2.0,1.33,4
Queretaro,8,4,1,3,9,7,2,13,Mexico - Liga MX - Clausura,0.5,0.62,2,1.12,1.62,2.0,1.61,5
Necaxa,8,4,1,3,15,16,-1,13,Mexico - Liga MX - Clausura,0.5,0.62,-1,1.88,1.62,2.0,1.61,5
Pachuca,8,3,3,2,16,12,4,12,Mexico - Liga MX - Clausura,0.38,0.75,4,2.0,1.5,2.63,1.33,6
Tijuana,8,4,0,4,16,14,2,12,Mexico - Liga MX - Clausura,0.5,0.5,2,2.0,1.5,2.0,2.0,6
A. San Luis,8,4,0,4,10,13,-3,12,Mexico - Liga MX - Clausura,0.5,0.5,-3,1.25,1.5,2.0,2.0,6
Atlas,8,3,2,3,16,16,0,11,Mexico - Liga MX - Clausura,0.38,0.62,0,2.0,1.38,2.63,1.61,7
Pumas UNAM,8,3,1,4,11,11,0,10,Mexico - Liga MX - Clausura,0.38,0.5,0,1.38,1.25,2.63,2.0,8
Guadalajara,8,2,4,2,6,7,-1,10,Mexico - Liga MX - Clausura,0.25,0.75,-1,0.75,1.25,4.0,1.33,8
Juarez,8,1,5,2,8,9,-1,8,Mexico - Liga MX - Clausura,0.12,0.75,-1,1.0,1.0,8.33,1.33,9
Club Leon,8,2,1,5,8,12,-4,7,Mexico - Liga MX - Clausura,0.25,0.38,-4,1.0,0.88,4.0,2.63,10
Mazatlan,8,1,3,4,7,15,-8,6,Mexico - Liga MX - Clausura,0.12,0.5,-8,0.88,0.75,8.33,2.0,11
Santos Laguna,8,1,0,7,8,21,-13,3,Mexico - Liga MX - Clausura,0.12,0.12,-13,1.0,0.38,8.33,8.33,12
Puebla,8,0,1,7,1,13,-12,1,Mexico - Liga MX - Clausura,0.0,0.12,-12,0.12,0.12,0.0,8.33,13
Buducnost,8,5,3,0,29,11,18,18,Montenegro - First League,0.62,1.0,18,3.62,2.25,1.61,1.0,1
Jezero,8,4,3,1,15,11,4,15,Montenegro - First League,0.5,0.88,4,1.88,1.88,2.0,1.14,2
Arsenal Tivat,8,4,1,3,6,10,-4,13,Montenegro - First League,0.5,0.62,-4,0.75,1.62,2.0,1.61,3
Decic,8,3,3,2,6,4,2,12,Montenegro - First League,0.38,0.75,2,0.75,1.5,2.63,1.33,4
Petrovac,8,2,5,1,11,7,4,11,Montenegro - First League,0.25,0.88,4,1.38,1.38,4.0,1.14,5
Sutjeska,8,3,2,3,9,9,0,11,Montenegro - First League,0.38,0.62,0,1.12,1.38,2.63,1.61,5
Jedinstvo,8,2,4,2,11,11,0,10,Montenegro - First League,0.25,0.75,0,1.38,1.25,4.0,1.33,6
Otrant,8,2,2,4,14,17,-3,8,Montenegro - First League,0.25,0.5,-3,1.75,1.0,4.0,2.0,7
Mornar Bar,8,2,2,4,7,14,-7,8,Montenegro - First League,0.25,0.5,-7,0.88,1.0,4.0,2.0,7
Bokelj,8,1,1,6,2,14,-12,4,Montenegro - First League,0.12,0.25,-12,0.25,0.5,8.33,4.0,8
Berkane,8,5,2,1,11,3,8,17,morocco,0.62,0.88,8,1.38,2.12,1.61,1.14,1
Difaa El Jadida,8,4,3,1,9,5,4,15,morocco,0.5,0.88,4,1.12,1.88,2.0,1.14,2
Wydad,8,3,5,0,13,5,8,14,morocco,0.38,1.0,8,1.62,1.75,2.63,1.0,3
FUS Rabat,8,4,2,2,13,8,5,14,morocco,0.5,0.75,5,1.62,1.75,2.0,1.33,3
Raja Casablanca,8,3,5,0,9,5,4,14,morocco,0.38,1.0,4,1.12,1.75,2.63,1.0,3
FAR Rabat,8,4,2,2,11,9,2,14,morocco,0.5,0.75,2,1.38,1.75,2.0,1.33,3
Meknes,8,3,3,2,9,7,2,12,morocco,0.38,0.75,2,1.12,1.5,2.63,1.33,4
Union Touarga,8,3,3,2,9,7,2,12,morocco,0.38,0.75,2,1.12,1.5,2.63,1.33,4
Olympic Safi,8,2,4,2,7,7,0,10,morocco,0.25,0.75,0,0.88,1.25,4.0,1.33,5
Maghreb de Fes,8,2,4,2,8,10,-2,10,morocco,0.25,0.75,-2,1.0,1.25,4.0,1.33,5
Hassania Agadir,8,2,3,3,11,9,2,9,morocco,0.25,0.62,2,1.38,1.12,4.0,1.61,6
Moghreb Tetouan,8,2,3,3,8,10,-2,9,morocco,0.25,0.62,-2,1.0,1.12,4.0,1.61,6
R. Zemamra,8,3,0,5,6,10,-4,9,morocco,0.38,0.38,-4,0.75,1.12,2.63,2.63,6
Ittihad Tanger,8,2,2,4,11,14,-3,8,morocco,0.25,0.5,-3,1.38,1.0,4.0,2.0,7
JS Sousalem,8,0,1,7,4,17,-13,1,morocco,0.0,0.12,-13,0.5,0.12,0.0,8.33,8
C. Mohammedia,8,0,1,7,3,17,-14,1,morocco,0.0,0.12,-14,0.38,0.12,0.0,8.33,8
Shan Utd,8,7,1,0,24,2,22,22,myanmar,0.88,1.0,22,3.0,2.75,1.14,1.0,1
Yangon Utd,8,5,2,1,21,6,15,17,myanmar,0.62,0.88,15,2.62,2.12,1.61,1.14,2
Sagaing Utd,8,4,2,2,16,13,3,14,myanmar,0.5,0.75,3,2.0,1.75,2.0,1.33,3
Thitsar Arman,8,4,1,3,15,12,3,13,myanmar,0.5,0.62,3,1.88,1.62,2.0,1.61,4
Yadanarbon,8,3,3,2,18,15,3,12,myanmar,0.38,0.75,3,2.25,1.5,2.63,1.33,5
Dagon,8,3,2,3,10,11,-1,11,myanmar,0.38,0.62,-1,1.25,1.38,2.63,1.61,6
Hantharwady,8,3,2,3,7,11,-4,11,myanmar,0.38,0.62,-4,0.88,1.38,2.63,1.61,6
Rakhine Utd,8,3,2,3,10,16,-6,11,myanmar,0.38,0.62,-6,1.25,1.38,2.63,1.61,6
Ayeyawady,8,2,0,6,9,16,-7,6,myanmar,0.25,0.25,-7,1.12,0.75,4.0,4.0,7
Ispe FC,8,1,3,4,4,14,-10,6,myanmar,0.12,0.5,-10,0.5,0.75,8.33,2.0,7
Dagon Port,8,1,2,5,12,21,-9,5,myanmar,0.12,0.38,-9,1.5,0.62,8.33,2.63,8
Myawady,8,1,2,5,11,20,-9,5,myanmar,0.12,0.38,-9,1.38,0.62,8.33,2.63,8
Feyenoord,8,7,1,0,22,6,16,22,netherlands,0.88,1.0,16,2.75,2.75,1.14,1.0,1
FC Utrecht,8,6,1,1,19,6,13,19,netherlands,0.75,0.88,13,2.38,2.38,1.33,1.14,2
Ajax Amsterdam,8,5,2,1,12,9,3,17,netherlands,0.62,0.88,3,1.5,2.12,1.61,1.14,3
PSV Eindhoven,8,5,1,2,20,10,10,16,netherlands,0.62,0.75,10,2.5,2.0,1.61,1.33,4
Sparta,8,4,3,1,15,5,10,15,netherlands,0.5,0.88,10,1.88,1.88,2.0,1.14,5
Heerenveen,8,4,1,3,12,11,1,13,netherlands,0.5,0.62,1,1.5,1.62,2.0,1.61,6
Go Ahead Eagles,8,3,3,2,12,12,0,12,netherlands,0.38,0.75,0,1.5,1.5,2.63,1.33,7
FC Groningen,8,3,2,3,13,14,-1,11,netherlands,0.38,0.62,-1,1.62,1.38,2.63,1.61,8
Heracles Almelo,8,3,2,3,9,13,-4,11,netherlands,0.38,0.62,-4,1.12,1.38,2.63,1.61,8
Fortuna Sittard,8,3,1,4,5,9,-4,10,netherlands,0.38,0.5,-4,0.62,1.25,2.63,2.0,9
FC Twente,8,2,3,3,10,14,-4,9,netherlands,0.25,0.62,-4,1.25,1.12,4.0,1.61,10
NEC Nijmegen,8,2,2,4,8,12,-4,8,netherlands,0.25,0.5,-4,1.0,1.0,4.0,2.0,11
AZ Alkmaar,8,1,4,3,10,13,-3,7,netherlands,0.12,0.62,-3,1.25,0.88,8.33,1.61,12
PEC Zwolle,8,1,4,3,9,14,-5,7,netherlands,0.12,0.62,-5,1.12,0.88,8.33,1.61,12
NAC Breda,8,0,6,2,6,9,-3,6,netherlands,0.0,0.75,-3,0.75,0.75,0.0,1.33,13
Almere City,8,1,3,4,6,12,-6,6,netherlands,0.12,0.5,-6,0.75,0.75,8.33,2.0,13
RKC Waalwijk,8,0,2,6,4,17,-13,2,netherlands,0.0,0.25,-13,0.5,0.25,0.0,4.0,14
Willem II,8,0,0,8,5,19,-14,0,netherlands,0.0,0.0,-14,0.62,0.0,0.0,0.0,15
FC Volendam,8,7,0,1,20,6,14,21,netherlands2,0.88,0.88,14,2.5,2.62,1.14,1.14,1
Excelsior,8,7,0,1,19,6,13,21,netherlands2,0.88,0.88,13,2.38,2.62,1.14,1.14,1
Telstar,8,5,2,1,19,9,10,17,netherlands2,0.62,0.88,10,2.38,2.12,1.61,1.14,2
De Graafschap,8,5,1,2,12,6,6,16,netherlands2,0.62,0.75,6,1.5,2.0,1.61,1.33,3
Cambuur,8,5,1,2,13,12,1,16,netherlands2,0.62,0.75,1,1.62,2.0,1.61,1.33,3
Jong AZ,8,4,3,1,18,8,10,15,netherlands2,0.5,0.88,10,2.25,1.88,2.0,1.14,4
ADO Den Haag,8,4,3,1,10,9,1,15,netherlands2,0.5,0.88,1,1.25,1.88,2.0,1.14,4
FC Dordrecht,8,4,0,4,15,10,5,12,netherlands2,0.5,0.5,5,1.88,1.5,2.0,2.0,5
VVV,8,3,3,2,12,10,2,12,netherlands2,0.38,0.75,2,1.5,1.5,2.63,1.33,5
FC Emmen,8,4,0,4,10,9,1,12,netherlands2,0.5,0.5,1,1.25,1.5,2.0,2.0,5
FC Eindhoven,8,2,4,2,13,15,-2,10,netherlands2,0.25,0.75,-2,1.62,1.25,4.0,1.33,6
Roda JC,8,3,1,4,9,16,-7,10,netherlands2,0.38,0.5,-7,1.12,1.25,2.63,2.0,6
Vitesse Arnhem,8,2,3,3,12,10,2,9,netherlands2,0.25,0.62,2,1.5,1.12,4.0,1.61,7
TOP Oss,8,2,2,4,9,13,-4,8,netherlands2,0.25,0.5,-4,1.12,1.0,4.0,2.0,8
FC Den Bosch,8,2,2,4,11,16,-5,8,netherlands2,0.25,0.5,-5,1.38,1.0,4.0,2.0,8
Helmond Sport,8,1,4,3,14,16,-2,7,netherlands2,0.12,0.62,-2,1.75,0.88,8.33,1.61,9
Jong PSV,8,1,3,4,13,20,-7,6,netherlands2,0.12,0.5,-7,1.62,0.75,8.33,2.0,10
MVV Maastricht,8,1,1,6,9,15,-6,4,netherlands2,0.12,0.25,-6,1.12,0.5,8.33,4.0,11
Jong Utrecht,8,0,2,6,3,21,-18,2,netherlands2,0.0,0.25,-18,0.38,0.25,0.0,4.0,12
Jong Ajax,8,0,1,7,2,16,-14,1,netherlands2,0.0,0.12,-14,0.25,0.12,0.0,8.33,13
Diriangen,8,7,1,0,29,1,28,22,nicaragua,0.88,1.0,28,3.62,2.75,1.14,1.0,1
Matagalpa,8,6,1,1,16,6,10,19,nicaragua,0.75,0.88,10,2.0,2.38,1.33,1.14,2
Real Esteli,8,4,3,1,13,9,4,15,nicaragua,0.5,0.88,4,1.62,1.88,2.0,1.14,3
Walter Ferreti,8,3,3,2,7,6,1,12,nicaragua,0.38,0.75,1,0.88,1.5,2.63,1.33,4
Managua FC,8,3,1,4,11,10,1,10,nicaragua,0.38,0.5,1,1.38,1.25,2.63,2.0,5
UNAN Managua,8,3,1,4,9,15,-6,10,nicaragua,0.38,0.5,-6,1.12,1.25,2.63,2.0,5
Jalapa,8,2,3,3,6,13,-7,9,nicaragua,0.25,0.62,-7,0.75,1.12,4.0,1.61,6
Export Sebaco,8,2,2,4,9,10,-1,8,nicaragua,0.25,0.5,-1,1.12,1.0,4.0,2.0,7
Rancho Santana,8,1,1,6,6,20,-14,4,nicaragua,0.12,0.25,-14,0.75,0.5,8.33,4.0,8
D. Ocotal,8,1,1,6,6,21,-15,4,nicaragua,0.12,0.25,-15,0.75,0.5,8.33,4.0,8
Real Esteli,8,8,0,0,19,9,10,24,nicaragua2,1.0,1.0,10,2.38,3.0,1.0,1.0,1
Managua FC,8,5,1,2,19,8,11,16,nicaragua2,0.62,0.75,11,2.38,2.0,1.61,1.33,2
Matagalpa,8,3,3,2,16,12,4,12,nicaragua2,0.38,0.75,4,2.0,1.5,2.63,1.33,3
UNAN Managua,8,3,2,3,11,11,0,11,nicaragua2,0.38,0.62,0,1.38,1.38,2.63,1.61,4
CS Sebaco,8,3,2,3,9,10,-1,11,nicaragua2,0.38,0.62,-1,1.12,1.38,2.63,1.61,4
D. Ocotal,8,2,2,4,10,15,-5,8,nicaragua2,0.25,0.5,-5,1.25,1.0,4.0,2.0,5
Diriangen,8,2,2,4,10,16,-6,8,nicaragua2,0.25,0.5,-6,1.25,1.0,4.0,2.0,5
Walter Ferreti,8,1,4,3,7,7,0,7,nicaragua2,0.12,0.62,0,0.88,0.88,8.33,1.61,6
Jalapa,8,1,3,4,7,11,-4,6,nicaragua2,0.12,0.5,-4,0.88,0.75,8.33,2.0,7
Rancho Santana,8,0,3,5,3,17,-14,3,nicaragua2,0.0,0.38,-14,0.38,0.38,0.0,2.63,8
Linfield,8,6,0,2,15,5,10,18,northernireland,0.75,0.75,10,1.88,2.25,1.33,1.33,1
Cliftonville,8,5,1,2,19,7,12,16,northernireland,0.62,0.75,12,2.38,2.0,1.61,1.33,2
Larne,8,3,5,0,11,8,3,14,northernireland,0.38,1.0,3,1.38,1.75,2.63,1.0,3
Portadown,8,4,2,2,11,9,2,14,northernireland,0.5,0.75,2,1.38,1.75,2.0,1.33,3
Coleraine,8,3,2,3,10,12,-2,11,northernireland,0.38,0.62,-2,1.25,1.38,2.63,1.61,4
Dungannon,8,3,2,3,10,12,-2,11,northernireland,0.38,0.62,-2,1.25,1.38,2.63,1.61,4
Glentoran,8,2,3,3,11,9,2,9,northernireland,0.25,0.62,2,1.38,1.12,4.0,1.61,5
Glenavon,8,2,2,4,10,10,0,8,northernireland,0.25,0.5,0,1.25,1.0,4.0,2.0,6
Crusaders,8,2,2,4,8,13,-5,8,northernireland,0.25,0.5,-5,1.0,1.0,4.0,2.0,6
Loughgall,8,2,2,4,10,17,-7,8,northernireland,0.25,0.5,-7,1.25,1.0,4.0,2.0,6
Ballymena Utd,8,2,1,5,10,16,-6,7,northernireland,0.25,0.38,-6,1.25,0.88,4.0,2.63,7
Carrick Rangers,8,1,3,4,8,15,-7,6,northernireland,0.12,0.5,-7,1.0,0.75,8.33,2.0,8
Annagh Utd,8,8,0,0,20,6,14,24,northernireland2,1.0,1.0,14,2.5,3.0,1.0,1.0,1
Newington,8,5,2,1,21,16,5,17,northernireland2,0.62,0.88,5,2.62,2.12,1.61,1.14,2
Bangor,8,4,2,2,17,13,4,14,northernireland2,0.5,0.75,4,2.12,1.75,2.0,1.33,3
Limavady,8,3,4,1,12,9,3,13,northernireland2,0.38,0.88,3,1.5,1.62,2.63,1.14,4
Institute,8,4,1,3,18,19,-1,13,northernireland2,0.5,0.62,-1,2.25,1.62,2.0,1.61,4
Ards,8,3,2,3,12,13,-1,11,northernireland2,0.38,0.62,-1,1.5,1.38,2.63,1.61,5
Ballinamallard,8,3,1,4,8,9,-1,10,northernireland2,0.38,0.5,-1,1.0,1.25,2.63,2.0,6
HW Welders,8,3,0,5,15,15,0,9,northernireland2,0.38,0.38,0,1.88,1.12,2.63,2.63,7
Newry City,8,1,3,4,11,17,-6,6,northernireland2,0.12,0.5,-6,1.38,0.75,8.33,2.0,8
Ballyclare,8,1,2,5,12,19,-7,5,northernireland2,0.12,0.38,-7,1.5,0.62,8.33,2.63,9
Armagh City,8,1,1,6,14,20,-6,4,northernireland2,0.12,0.25,-6,1.75,0.5,8.33,4.0,10
Dundela,8,1,1,6,5,14,-9,4,northernireland2,0.12,0.25,-9,0.62,0.5,8.33,4.0,10
Sileks,8,5,3,0,18,4,14,18,northmacedonia,0.62,1.0,14,2.25,2.25,1.61,1.0,1
Shkendija,8,5,2,1,15,10,5,17,northmacedonia,0.62,0.88,5,1.88,2.12,1.61,1.14,2
Vardar,8,4,4,0,15,7,8,16,northmacedonia,0.5,1.0,8,1.88,2.0,2.0,1.0,3
Struga,8,4,3,1,12,5,7,15,northmacedonia,0.5,0.88,7,1.5,1.88,2.0,1.14,4
Rabotnicki,8,3,3,2,5,5,0,12,northmacedonia,0.38,0.75,0,0.62,1.5,2.63,1.33,5
Tikves,8,3,2,3,8,8,0,11,northmacedonia,0.38,0.62,0,1.0,1.38,2.63,1.61,6
Gostivar,8,2,3,3,9,10,-1,9,northmacedonia,0.25,0.62,-1,1.12,1.12,4.0,1.61,7
Pelister,8,3,0,5,7,12,-5,9,northmacedonia,0.38,0.38,-5,0.88,1.12,2.63,2.63,7
Besa,8,3,0,5,11,22,-11,9,northmacedonia,0.38,0.38,-11,1.38,1.12,2.63,2.63,7
Voska Sport,8,2,2,4,8,11,-3,8,northmacedonia,0.25,0.5,-3,1.0,1.0,4.0,2.0,8
Brera Strumica,8,1,1,6,7,15,-8,4,northmacedonia,0.12,0.25,-8,0.88,0.5,8.33,4.0,9
Shkupi,8,0,3,5,7,13,-6,3,northmacedonia,0.0,0.38,-6,0.88,0.38,0.0,2.63,10
Brann,5,4,0,1,10,8,2,12,norway,0.8,0.8,2,2.0,2.4,1.25,1.25,1
Bodo.Glimt,4,3,1,0,9,2,7,10,norway,0.75,1.0,7,2.25,2.5,1.33,1.0,2
Fredrikstad,5,3,1,1,8,2,6,10,norway,0.6,0.8,6,1.6,2.0,1.67,1.25,2
Viking,5,3,1,1,16,11,5,10,norway,0.6,0.8,5,3.2,2.0,1.67,1.25,2
Rosenborg,4,3,1,0,5,1,4,10,norway,0.75,1.0,4,1.25,2.5,1.33,1.0,2
Sarpsborg 08,4,2,1,1,8,5,3,7,norway,0.5,0.75,3,2.0,1.75,2.0,1.33,3
Valerenga,5,2,1,2,6,6,0,7,norway,0.4,0.6,0,1.2,1.4,2.5,1.67,3
Stromsgodset,5,2,0,3,11,8,3,6,norway,0.4,0.4,3,2.2,1.2,2.5,2.5,4
Sandefjord,4,2,0,2,7,6,1,6,norway,0.5,0.5,1,1.75,1.5,2.0,2.0,4
Kristiansund,5,2,0,3,7,10,-3,6,norway,0.4,0.4,-3,1.4,1.2,2.5,2.5,4
Tromso,4,1,1,2,8,10,-2,4,norway,0.25,0.5,-2,2.0,1.0,4.0,2.0,5
Bryne,4,1,0,3,6,7,-1,3,norway,0.25,0.25,-1,1.5,0.75,4.0,4.0,6
KFUM Oslo,4,1,0,3,5,10,-5,3,norway,0.25,0.25,-5,1.25,0.75,4.0,4.0,6
HamKam,4,1,0,3,4,11,-7,3,norway,0.25,0.25,-7,1.0,0.75,4.0,4.0,6
Molde,4,0,2,2,2,7,-5,2,norway,0.0,0.5,-5,0.5,0.5,0.0,2.0,7
Haugesund,4,0,1,3,1,9,-8,1,norway,0.0,0.25,-8,0.25,0.25,0.0,4.0,8
Lillestrom,4,3,1,0,7,2,5,10,norway2,0.75,1.0,5,1.75,2.5,1.33,1.0,1
Egersund,3,3,0,0,9,5,4,9,norway2,1.0,1.0,4,3.0,3.0,1.0,1.0,2
Kongsvinger,3,2,1,0,9,1,8,7,norway2,0.67,1.0,8,3.0,2.33,1.49,1.0,3
Raufoss,3,2,1,0,7,5,2,7,norway2,0.67,1.0,2,2.33,2.33,1.49,1.0,3
Start,3,2,0,1,6,4,2,6,norway2,0.67,0.67,2,2.0,2.0,1.49,1.49,4
Odd,3,2,0,1,4,3,1,6,norway2,0.67,0.67,1,1.33,2.0,1.49,1.49,4
Moss,4,2,0,2,8,11,-3,6,norway2,0.5,0.5,-3,2.0,1.5,2.0,2.0,4
Aalesund,3,1,2,0,6,5,1,5,norway2,0.33,1.0,1,2.0,1.67,3.03,1.0,5
Hodd,3,1,1,1,3,4,-1,4,norway2,0.33,0.67,-1,1.0,1.33,3.03,1.49,6
Stabaek,4,1,1,2,4,8,-4,4,norway2,0.25,0.5,-4,1.0,1.0,4.0,2.0,6
Lyn,4,1,0,3,4,4,0,3,norway2,0.25,0.25,0,1.0,0.75,4.0,4.0,7
Sogndal,3,1,0,2,6,7,-1,3,norway2,0.33,0.33,-1,2.0,1.0,3.03,3.03,7
Mjondalen,3,0,2,1,3,4,-1,2,norway2,0.0,0.67,-1,1.0,0.67,0.0,1.49,8
Asane,3,0,1,2,3,6,-3,1,norway2,0.0,0.33,-3,1.0,0.33,0.0,3.03,9
Skeid,3,0,0,3,5,9,-4,0,norway2,0.0,0.0,-4,1.67,0.0,0.0,0.0,10
Ranheim,3,0,0,3,1,7,-6,0,norway2,0.0,0.0,-6,0.33,0.0,0.0,0.0,10
Sandviken,4,3,0,1,10,7,3,9,norway3,0.75,0.75,3,2.5,2.25,1.33,1.33,1
Notodden,4,2,2,0,7,4,3,8,norway3,0.5,1.0,3,1.75,2.0,2.0,1.0,2
Sotra,4,2,1,1,9,4,5,7,norway3,0.5,0.75,5,2.25,1.75,2.0,1.33,3
Sandnes Ulf,3,2,1,0,8,5,3,7,norway3,0.67,1.0,3,2.67,2.33,1.49,1.0,3
Jerv,4,2,1,1,7,6,1,7,norway3,0.5,0.75,1,1.75,1.75,2.0,1.33,3
Brann B,3,2,0,1,10,9,1,6,norway3,0.67,0.67,1,3.33,2.0,1.49,1.49,4
Arendal,4,1,3,0,6,5,1,6,norway3,0.25,1.0,1,1.5,1.5,4.0,1.0,4
Eik Tonsberg,4,1,2,1,5,5,0,5,norway3,0.25,0.75,0,1.25,1.25,4.0,1.33,5
Pors Grenland,4,1,2,1,5,5,0,5,norway3,0.25,0.75,0,1.25,1.25,4.0,1.33,5
Lysekloster,4,1,1,2,5,6,-1,4,norway3,0.25,0.5,-1,1.25,1.0,4.0,2.0,6
Traef,4,1,1,2,5,6,-1,4,norway3,0.25,0.5,-1,1.25,1.0,4.0,2.0,6
Brattvag,4,1,0,3,7,9,-2,3,norway3,0.25,0.25,-2,1.75,0.75,4.0,4.0,7
V. Haugesund,4,0,1,3,3,7,-4,1,norway3,0.0,0.25,-4,0.75,0.25,0.0,4.0,8
Flekkeroy,4,0,1,3,5,14,-9,1,norway3,0.0,0.25,-9,1.25,0.25,0.0,4.0,8
Strommen,4,4,0,0,10,3,7,12,norway4,1.0,1.0,7,2.5,3.0,1.0,1.0,1
Tromsdalen,4,3,1,0,10,5,5,10,norway4,0.75,1.0,5,2.5,2.5,1.33,1.0,2
Kjelsas,4,3,0,1,7,5,2,9,norway4,0.75,0.75,2,1.75,2.25,1.33,1.33,3
Grorud,4,2,1,1,9,7,2,7,norway4,0.5,0.75,2,2.25,1.75,2.0,1.33,4
Eidsvold,4,2,1,1,8,6,2,7,norway4,0.5,0.75,2,2.0,1.75,2.0,1.33,4
Follo,4,2,1,1,6,5,1,7,norway4,0.5,0.75,1,1.5,1.75,2.0,1.33,4
Stjordals-Blink,4,2,0,2,4,6,-2,6,norway4,0.5,0.5,-2,1.0,1.5,2.0,2.0,5
Levanger,4,1,1,2,8,9,-1,4,norway4,0.25,0.5,-1,2.0,1.0,4.0,2.0,6
Ull/Kisa,4,1,1,2,5,6,-1,4,norway4,0.25,0.5,-1,1.25,1.0,4.0,2.0,6
Rana,4,1,1,2,5,7,-2,4,norway4,0.25,0.5,-2,1.25,1.0,4.0,2.0,6
Asker,4,0,3,1,5,6,-1,3,norway4,0.0,0.75,-1,1.25,0.75,0.0,1.33,7
Honefoss,4,1,0,3,6,9,-3,3,norway4,0.25,0.25,-3,1.5,0.75,4.0,4.0,7
Alta,4,1,0,3,6,10,-4,3,norway4,0.25,0.25,-4,1.5,0.75,4.0,4.0,7
Strindheim,4,0,0,4,4,9,-5,0,norway4,0.0,0.0,-5,1.0,0.0,0.0,0.0,8
Junkeren,4,4,0,0,14,3,11,12,norway5,1.0,1.0,11,3.5,3.0,1.0,1.0,1
Frigg,4,3,1,0,14,7,7,10,norway5,0.75,1.0,7,3.5,2.5,1.33,1.0,2
Floya,4,3,1,0,11,6,5,10,norway5,0.75,1.0,5,2.75,2.5,1.33,1.0,2
Ullern,4,2,0,2,10,7,3,6,norway5,0.5,0.5,3,2.5,1.5,2.0,2.0,3
Harstad,4,2,0,2,10,9,1,6,norway5,0.5,0.5,1,2.5,1.5,2.0,2.0,3
Ulfstind,4,2,0,2,4,8,-4,6,norway5,0.5,0.5,-4,1.0,1.5,2.0,2.0,3
Gamle Oslo,4,1,2,1,8,5,3,5,norway5,0.25,0.75,3,2.0,1.25,4.0,1.33,4
Skjervoy,4,1,2,1,8,10,-2,5,norway5,0.25,0.75,-2,2.0,1.25,4.0,1.33,4
Sortland,4,1,1,2,6,12,-6,4,norway5,0.25,0.5,-6,1.5,1.0,4.0,2.0,5
Baerum,3,1,0,2,3,4,-1,3,norway5,0.33,0.33,-1,1.0,1.0,3.03,3.03,6
Tromso B,4,1,0,3,10,12,-2,3,norway5,0.25,0.25,-2,2.5,0.75,4.0,4.0,6
Funnefoss/V,4,0,2,2,9,13,-4,2,norway5,0.0,0.5,-4,2.25,0.5,0.0,2.0,7
Alta B,4,0,2,2,3,11,-8,2,norway5,0.0,0.5,-8,0.75,0.5,0.0,2.0,7
KFUM B,3,0,1,2,5,8,-3,1,norway5,0.0,0.33,-3,1.67,0.33,0.0,3.03,8
Melhus,4,4,0,0,18,1,17,12,norway6,1.0,1.0,17,4.5,3.0,1.0,1.0,1
Spjelkavik,4,3,0,1,14,5,9,9,norway6,0.75,0.75,9,3.5,2.25,1.33,1.33,2
Rosenborg B,3,3,0,0,6,0,6,9,norway6,1.0,1.0,6,2.0,3.0,1.0,1.0,2
Trygg/Lade,4,2,1,1,14,4,10,7,norway6,0.5,0.75,10,3.5,1.75,2.0,1.33,3
Nardo,3,2,1,0,9,3,6,7,norway6,0.67,1.0,6,3.0,2.33,1.49,1.0,3
Volda,3,2,1,0,7,2,5,7,norway6,0.67,1.0,5,2.33,2.33,1.49,1.0,3
Byasen,4,1,2,1,6,5,1,5,norway6,0.25,0.75,1,1.5,1.25,4.0,1.33,4
Tiller,4,1,2,1,5,5,0,5,norway6,0.25,0.75,0,1.25,1.25,4.0,1.33,4
Aalesund B,3,1,0,2,6,9,-3,3,norway6,0.33,0.33,-3,2.0,1.0,3.03,3.03,5
Kvik Trondheim,3,1,0,2,4,8,-4,3,norway6,0.33,0.33,-4,1.33,1.0,3.03,3.03,5
Ranheim B,3,1,0,2,3,7,-4,3,norway6,0.33,0.33,-4,1.0,1.0,3.03,3.03,5
Kristiansund B,4,0,1,3,1,14,-13,1,norway6,0.0,0.25,-13,0.25,0.25,0.0,4.0,6
Molde B,4,0,0,4,4,13,-9,0,norway6,0.0,0.0,-9,1.0,0.0,0.0,0.0,7
Surnadal,4,0,0,4,3,24,-21,0,norway6,0.0,0.0,-21,0.75,0.0,0.0,0.0,7
Elverum,4,3,0,1,13,4,9,9,norway7,0.75,0.75,9,3.25,2.25,1.33,1.33,1
Lorenskog,4,3,0,1,11,5,6,9,norway7,0.75,0.75,6,2.75,2.25,1.33,1.33,1
Skjetten,4,2,1,1,11,6,5,7,norway7,0.5,0.75,5,2.75,1.75,2.0,1.33,2
Lillehammer,4,2,1,1,10,6,4,7,norway7,0.5,0.75,4,2.5,1.75,2.0,1.33,2
Kongsvinger B,3,2,1,0,8,4,4,7,norway7,0.67,1.0,4,2.67,2.33,1.49,1.0,2
Nordstrand,4,2,1,1,10,11,-1,7,norway7,0.5,0.75,-1,2.5,1.75,2.0,1.33,2
Skedsmo,4,2,0,2,10,10,0,6,norway7,0.5,0.5,0,2.5,1.5,2.0,2.0,3
Gjovik-Lyn,3,1,2,0,4,2,2,5,norway7,0.33,1.0,2,1.33,1.67,3.03,1.0,4
Bjorkelangen,3,1,1,1,4,7,-3,4,norway7,0.33,0.67,-3,1.33,1.33,3.03,1.49,5
Stromsgodset B,3,1,0,2,4,7,-3,3,norway7,0.33,0.33,-3,1.33,1.0,3.03,3.03,6
Lillestrom B,3,1,0,2,6,10,-4,3,norway7,0.33,0.33,-4,2.0,1.0,3.03,3.03,6
Assiden IF,3,0,1,2,5,8,-3,1,norway7,0.0,0.33,-3,1.67,0.33,0.0,3.03,7
HamKam B,3,0,0,3,4,9,-5,0,norway7,0.0,0.0,-5,1.33,0.0,0.0,0.0,8
Ull/Kisa B,3,0,0,3,2,13,-11,0,norway7,0.0,0.0,-11,0.67,0.0,0.0,0.0,8
Bjarg,4,4,0,0,20,2,18,12,norway8,1.0,1.0,18,5.0,3.0,1.0,1.0,1
Forde,4,3,1,0,9,3,6,10,norway8,0.75,1.0,6,2.25,2.5,1.33,1.0,2
Gneist,4,2,2,0,10,8,2,8,norway8,0.5,1.0,2,2.5,2.0,2.0,1.0,3
Fana,4,2,1,1,15,8,7,7,norway8,0.5,0.75,7,3.75,1.75,2.0,1.33,4
Lyn B,3,2,0,1,10,9,1,6,norway8,0.67,0.67,1,3.33,2.0,1.49,1.49,5
Fyllingsdalen,4,2,0,2,8,9,-1,6,norway8,0.5,0.5,-1,2.0,1.5,2.0,2.0,5
Askoy,4,2,0,2,6,9,-3,6,norway8,0.5,0.5,-3,1.5,1.5,2.0,2.0,5
Fjora,4,2,0,2,8,12,-4,6,norway8,0.5,0.5,-4,2.0,1.5,2.0,2.0,5
Lyngbo,4,1,1,2,7,5,2,4,norway8,0.25,0.5,2,1.75,1.0,4.0,2.0,6
Sandefjord B,3,1,1,1,8,10,-2,4,norway8,0.33,0.67,-2,2.67,1.33,3.03,1.49,6
OS,4,1,0,3,11,8,3,3,norway8,0.25,0.25,3,2.75,0.75,4.0,4.0,7
Loddefjord,4,1,0,3,6,15,-9,3,norway8,0.25,0.25,-9,1.5,0.75,4.0,4.0,7
Asane B,4,1,0,3,6,18,-12,3,norway8,0.25,0.25,-12,1.5,0.75,4.0,4.0,7
Valerenga B,4,0,0,4,5,13,-8,0,norway8,0.0,0.0,-8,1.25,0.0,0.0,0.0,8
Vidar,4,4,0,0,10,2,8,12,norway9,1.0,1.0,8,2.5,3.0,1.0,1.0,1
Vindbjart,4,2,1,1,4,4,0,7,norway9,0.5,0.75,0,1.0,1.75,2.0,1.33,2
Torvastad,4,2,1,1,9,11,-2,7,norway9,0.5,0.75,-2,2.25,1.75,2.0,1.33,2
Hinna,4,2,0,2,17,10,7,6,norway9,0.5,0.5,7,4.25,1.5,2.0,2.0,3
Djerv,4,2,0,2,14,10,4,6,norway9,0.5,0.5,4,3.5,1.5,2.0,2.0,3
Brodd,4,2,0,2,7,10,-3,6,norway9,0.5,0.5,-3,1.75,1.5,2.0,2.0,3
Sola,4,2,0,2,10,17,-7,6,norway9,0.5,0.5,-7,2.5,1.5,2.0,2.0,3
Madla,3,1,2,0,5,4,1,5,norway9,0.33,1.0,1,1.67,1.67,3.03,1.0,4
Viking B,3,1,1,1,9,4,5,4,norway9,0.33,0.67,5,3.0,1.33,3.03,1.49,5
Staal Jorpeland,4,1,1,2,13,13,0,4,norway9,0.25,0.5,0,3.25,1.0,4.0,2.0,5
Vag,4,1,0,3,12,13,-1,3,norway9,0.25,0.25,-1,3.0,0.75,4.0,4.0,6
Haugesund B,3,1,0,2,6,9,-3,3,norway9,0.33,0.33,-3,2.0,1.0,3.03,3.03,6
Sandnes Ulf B,3,1,0,2,7,11,-4,3,norway9,0.33,0.33,-4,2.33,1.0,3.03,3.03,6
Stord,4,0,2,2,4,9,-5,2,norway9,0.0,0.5,-5,1.0,0.5,0.0,2.0,7
Sarpsborg 08 B,3,3,0,0,10,3,7,9,norway10,1.0,1.0,7,3.33,3.0,1.0,1.0,1
Kvik Halden,4,3,0,1,11,7,4,9,norway10,0.75,0.75,4,2.75,2.25,1.33,1.33,1
Pors Grenland B,4,2,1,1,6,5,1,7,norway10,0.5,0.75,1,1.5,1.75,2.0,1.33,2
Stabaek B,3,2,0,1,6,3,3,6,norway10,0.67,0.67,3,2.0,2.0,1.49,1.49,3
Orn Horten,4,2,0,2,10,8,2,6,norway10,0.5,0.5,2,2.5,1.5,2.0,2.0,3
Odd B,4,2,0,2,7,7,0,6,norway10,0.5,0.5,0,1.75,1.5,2.0,2.0,3
Grei,4,1,2,1,5,7,-2,5,norway10,0.25,0.75,-2,1.25,1.25,4.0,1.33,4
Drobak-Frogn,4,1,2,1,4,7,-3,5,norway10,0.25,0.75,-3,1.0,1.25,4.0,1.33,4
Fram,3,1,1,1,7,4,3,4,norway10,0.33,0.67,3,2.33,1.33,3.03,1.49,5
Lokomotiv Oslo,4,1,1,2,4,8,-4,4,norway10,0.25,0.5,-4,1.0,1.0,4.0,2.0,5
Flint,3,1,0,2,6,6,0,3,norway10,0.33,0.33,0,2.0,1.0,3.03,3.03,6
Oppsal,3,1,0,2,5,6,-1,3,norway10,0.33,0.33,-1,1.67,1.0,3.03,3.03,6
Fredrikstad B,3,1,0,2,5,9,-4,3,norway10,0.33,0.33,-4,1.67,1.0,3.03,3.03,6
IF Ready,4,0,1,3,2,8,-6,1,norway10,0.0,0.25,-6,0.5,0.25,0.0,4.0,7
Universitario,8,6,1,1,12,6,6,19,panama,0.75,0.88,6,1.5,2.38,1.33,1.14,1
Plaza Amador,8,4,3,1,11,7,4,15,panama,0.5,0.88,4,1.38,1.88,2.0,1.14,2
San Francisco,8,4,2,2,12,6,6,14,panama,0.5,0.75,6,1.5,1.75,2.0,1.33,3
Veraguas,8,4,1,3,12,14,-2,13,panama,0.5,0.62,-2,1.5,1.62,2.0,1.61,4
Tauro,8,3,2,3,12,9,3,11,panama,0.38,0.62,3,1.5,1.38,2.63,1.61,5
San Miguelito,8,3,2,3,6,8,-2,11,panama,0.38,0.62,-2,0.75,1.38,2.63,1.61,5
Independiente,8,2,4,2,10,7,3,10,panama,0.25,0.75,3,1.25,1.25,4.0,1.33,6
Arabe Unido,8,3,1,4,7,6,1,10,panama,0.38,0.5,1,0.88,1.25,2.63,2.0,6
Alianza,8,2,3,3,9,11,-2,9,panama,0.25,0.62,-2,1.12,1.12,4.0,1.61,7
Costa del Este,8,3,0,5,6,11,-5,9,panama,0.38,0.38,-5,0.75,1.12,2.63,2.63,7
Herrera,8,1,5,2,6,8,-2,8,panama,0.12,0.75,-2,0.75,1.0,8.33,1.33,8
UMECIT,8,1,2,5,6,13,-7,5,panama,0.12,0.38,-7,0.75,0.62,8.33,2.63,9
San Miguelito,8,5,2,1,8,4,4,17,panama2,0.62,0.88,4,1.0,2.12,1.61,1.14,1
Independiente,8,5,1,2,14,11,3,16,panama2,0.62,0.75,3,1.75,2.0,1.61,1.33,2
Plaza Amador,8,4,3,1,9,6,3,15,panama2,0.5,0.88,3,1.12,1.88,2.0,1.14,3
Tauro,8,4,3,1,9,6,3,15,panama2,0.5,0.88,3,1.12,1.88,2.0,1.14,3
Veraguas,8,3,3,2,11,7,4,12,panama2,0.38,0.75,4,1.38,1.5,2.63,1.33,4
Arabe Unido,8,2,5,1,7,6,1,11,panama2,0.25,0.88,1,0.88,1.38,4.0,1.14,5
Universitario,8,3,2,3,6,5,1,11,panama2,0.38,0.62,1,0.75,1.38,2.63,1.61,5
UMECIT,8,3,1,4,8,8,0,10,panama2,0.38,0.5,0,1.0,1.25,2.63,2.0,6
Costa del Este,8,2,3,3,10,15,-5,9,panama2,0.25,0.62,-5,1.25,1.12,4.0,1.61,7
Alianza,8,2,0,6,8,12,-4,6,panama2,0.25,0.25,-4,1.0,0.75,4.0,4.0,8
San Francisco,8,1,2,5,4,10,-6,5,panama2,0.12,0.38,-6,0.5,0.62,8.33,2.63,9
Herrera,8,1,1,6,4,8,-4,4,panama2,0.12,0.25,-4,0.5,0.5,8.33,4.0,10
Cerro Porteno,8,5,2,1,9,3,6,17,paraguay,0.62,0.88,6,1.12,2.12,1.61,1.14,1
Libertad,8,4,3,1,12,6,6,15,paraguay,0.5,0.88,6,1.5,1.88,2.0,1.14,2
Guarani,8,4,2,2,9,7,2,14,paraguay,0.5,0.75,2,1.12,1.75,2.0,1.33,3
D. Recoleta,8,3,4,1,14,8,6,13,paraguay,0.38,0.88,6,1.75,1.62,2.63,1.14,4
Olimpia,8,3,2,3,9,8,1,11,paraguay,0.38,0.62,1,1.12,1.38,2.63,1.61,5
Nacional,8,3,2,3,7,8,-1,11,paraguay,0.38,0.62,-1,0.88,1.38,2.63,1.61,5
S. Trinidense,8,2,4,2,8,7,1,10,paraguay,0.25,0.75,1,1.0,1.25,4.0,1.33,6
A. Tembetary,8,2,4,2,5,5,0,10,paraguay,0.25,0.75,0,0.62,1.25,4.0,1.33,6
S. Luqueno,8,2,4,2,6,7,-1,10,paraguay,0.25,0.75,-1,0.75,1.25,4.0,1.33,6
G. Caballero,8,2,2,4,3,10,-7,8,paraguay,0.25,0.5,-7,0.38,1.0,4.0,2.0,7
S. Ameliano,8,1,3,4,6,8,-2,6,paraguay,0.12,0.5,-2,0.75,0.75,8.33,2.0,8
2 de Mayo,8,1,3,4,5,13,-8,6,paraguay,0.12,0.5,-8,0.62,0.75,8.33,2.0,8
Olimpia,8,4,3,1,10,4,6,15,paraguay2,0.5,0.88,6,1.25,1.88,2.0,1.14,1
Guarani,8,3,5,0,10,7,3,14,paraguay2,0.38,1.0,3,1.25,1.75,2.63,1.0,2
S. Ameliano,8,4,1,3,7,6,1,13,paraguay2,0.5,0.62,1,0.88,1.62,2.0,1.61,3
Sol de America,8,3,3,2,12,9,3,12,paraguay2,0.38,0.75,3,1.5,1.5,2.63,1.33,4
S. Luqueno,8,3,3,2,10,8,2,12,paraguay2,0.38,0.75,2,1.25,1.5,2.63,1.33,4
S. Trinidense,8,3,3,2,10,9,1,12,paraguay2,0.38,0.75,1,1.25,1.5,2.63,1.33,4
2 de Mayo,8,2,4,2,7,5,2,10,paraguay2,0.25,0.75,2,0.88,1.25,4.0,1.33,5
G. Caballero,8,2,3,3,7,7,0,9,paraguay2,0.25,0.62,0,0.88,1.12,4.0,1.61,6
Nacional,8,1,5,2,8,9,-1,8,paraguay2,0.12,0.75,-1,1.0,1.0,8.33,1.33,7
Cerro Porteno,8,2,2,4,11,15,-4,8,paraguay2,0.25,0.5,-4,1.38,1.0,4.0,2.0,7
Libertad,8,2,1,5,8,12,-4,7,paraguay2,0.25,0.38,-4,1.0,0.88,4.0,2.63,8
Tacuary,8,1,3,4,5,14,-9,6,paraguay2,0.12,0.5,-9,0.62,0.75,8.33,2.0,9
Universitario,8,7,1,0,26,6,20,22,peru,0.88,1.0,20,3.25,2.75,1.14,1.0,1
D. Garcilaso,8,5,1,2,14,5,9,16,peru,0.62,0.75,9,1.75,2.0,1.61,1.33,2
FBC Melgar,8,5,1,2,14,10,4,16,peru,0.62,0.75,4,1.75,2.0,1.61,1.33,2
Alianza Lima,8,5,1,2,9,8,1,16,peru,0.62,0.75,1,1.12,2.0,1.61,1.33,2
ADT,8,4,2,2,15,14,1,14,peru,0.5,0.75,1,1.88,1.75,2.0,1.33,3
Alianza A.,8,4,1,3,13,9,4,13,peru,0.5,0.62,4,1.62,1.62,2.0,1.61,4
Cusco,8,4,1,3,14,11,3,13,peru,0.5,0.62,3,1.75,1.62,2.0,1.61,4
Sport Huancayo,8,4,1,3,12,12,0,13,peru,0.5,0.62,0,1.5,1.62,2.0,1.61,4
S. Cristal,8,4,0,4,11,9,2,12,peru,0.5,0.5,2,1.38,1.5,2.0,2.0,5
Sport Boys,8,2,4,2,14,15,-1,10,peru,0.25,0.75,-1,1.75,1.25,4.0,1.33,6
Atletico Grau,8,2,4,2,12,13,-1,10,peru,0.25,0.75,-1,1.5,1.25,4.0,1.33,6
Binacional,8,2,2,4,8,16,-8,8,peru,0.25,0.5,-8,1.0,1.0,4.0,2.0,7
Cajamarca,8,2,2,4,8,17,-9,8,peru,0.25,0.5,-9,1.0,1.0,4.0,2.0,7
Cienciano,8,1,4,3,12,14,-2,7,peru,0.12,0.62,-2,1.5,0.88,8.33,1.61,8
Los Chankas,8,1,4,3,8,10,-2,7,peru,0.12,0.62,-2,1.0,0.88,8.33,1.61,8
Juan Pablo II C,7,2,0,5,7,11,-4,6,peru,0.29,0.29,-4,1.0,0.86,3.45,3.45,9
Comerciantes U.,8,1,3,4,11,17,-6,6,peru,0.12,0.5,-6,1.38,0.75,8.33,2.0,9
A. Huanuco,8,1,2,5,6,15,-9,5,peru,0.12,0.38,-9,0.75,0.62,8.33,2.63,10
Ayacucho,8,0,2,6,5,15,-10,2,peru,0.0,0.25,-10,0.62,0.25,0.0,4.0,11
Manila Digger,8,6,1,1,20,4,16,19,philippines,0.75,0.88,16,2.5,2.38,1.33,1.14,1
Kaya FC,8,6,1,1,16,6,10,19,philippines,0.75,0.88,10,2.0,2.38,1.33,1.14,1
Davao Aguilas,8,4,3,1,12,3,9,15,philippines,0.5,0.88,9,1.5,1.88,2.0,1.14,2
One Taguig,8,4,2,2,16,6,10,14,philippines,0.5,0.75,10,2.0,1.75,2.0,1.33,3
Stallion,8,3,2,3,15,12,3,11,philippines,0.38,0.62,3,1.88,1.38,2.63,1.61,4
DH Cebu,8,3,2,3,11,9,2,11,philippines,0.38,0.62,2,1.38,1.38,2.63,1.61,4
Maharlika,8,3,0,5,9,14,-5,9,philippines,0.38,0.38,-5,1.12,1.12,2.63,2.63,5
PFF Development,8,1,3,4,9,20,-11,6,philippines,0.12,0.5,-11,1.12,0.75,8.33,2.0,6
Mendiola,8,1,1,6,5,37,-32,4,philippines,0.12,0.25,-32,0.62,0.5,8.33,4.0,7
Loyola,8,0,1,7,5,21,-16,1,philippines,0.0,0.12,-16,0.62,0.12,0.0,8.33,8
Rakow C.,8,6,1,1,17,6,11,19,poland,0.75,0.88,11,2.12,2.38,1.33,1.14,1
Lech Poznan,8,5,1,2,16,10,6,16,poland,0.62,0.75,6,2.0,2.0,1.61,1.33,2
Pogon Szczecin,8,4,2,2,17,12,5,14,poland,0.5,0.75,5,2.12,1.75,2.0,1.33,3
Legia Warsaw,8,4,2,2,15,11,4,14,poland,0.5,0.75,4,1.88,1.75,2.0,1.33,3
Korona Kielce,8,4,2,2,11,10,1,14,poland,0.5,0.75,1,1.38,1.75,2.0,1.33,3
Jagiellonia,8,4,1,3,8,9,-1,13,poland,0.5,0.62,-1,1.0,1.62,2.0,1.61,4
Radomiak Radom,8,3,3,2,13,11,2,12,poland,0.38,0.75,2,1.62,1.5,2.63,1.33,5
Katowice,8,4,0,4,9,11,-2,12,poland,0.5,0.5,-2,1.12,1.5,2.0,2.0,5
Widzew Lodz,8,3,2,3,8,6,2,11,poland,0.38,0.62,2,1.0,1.38,2.63,1.61,6
Slask Wroclaw,8,3,2,3,14,14,0,11,poland,0.38,0.62,0,1.75,1.38,2.63,1.61,6
Motor Lublin,8,3,2,3,12,13,-1,11,poland,0.38,0.62,-1,1.5,1.38,2.63,1.61,6
Zaglebie Lubin,8,3,1,4,8,10,-2,10,poland,0.38,0.5,-2,1.0,1.25,2.63,2.0,7
Cracovia Krakow,8,3,1,4,12,15,-3,10,poland,0.38,0.5,-3,1.5,1.25,2.63,2.0,7
Lechia Gdansk,8,3,0,5,11,14,-3,9,poland,0.38,0.38,-3,1.38,1.12,2.63,2.63,8
Gornik Zabrze,8,2,2,4,9,8,1,8,poland,0.25,0.5,1,1.12,1.0,4.0,2.0,9
Piast Gliwice,8,2,2,4,7,13,-6,8,poland,0.25,0.5,-6,0.88,1.0,4.0,2.0,9
Puszcza Niepolo,8,1,2,5,12,18,-6,5,poland,0.12,0.38,-6,1.5,0.62,8.33,2.63,10
Stal Mielec,8,0,3,5,8,18,-10,3,poland,0.0,0.38,-10,1.0,0.38,0.0,2.63,11
Arka Gdynia,8,6,2,0,12,3,9,20,poland2,0.75,1.0,9,1.5,2.5,1.33,1.0,1
Tychy,8,6,1,1,12,5,7,19,poland2,0.75,0.88,7,1.5,2.38,1.33,1.14,2
Wisla Krakow,8,6,1,1,12,7,5,19,poland2,0.75,0.88,5,1.5,2.38,1.33,1.14,2
Polonia Warszaw,8,5,3,0,15,7,8,18,poland2,0.62,1.0,8,1.88,2.25,1.61,1.0,3
Wisla Plock,8,5,2,1,13,4,9,17,poland2,0.62,0.88,9,1.62,2.12,1.61,1.14,4
Gornik Leczna,8,4,2,2,7,2,5,14,poland2,0.5,0.75,5,0.88,1.75,2.0,1.33,5
T. Nieciecza,8,4,2,2,13,14,-1,14,poland2,0.5,0.75,-1,1.62,1.75,2.0,1.33,5
Znicz Pruszkow,8,3,2,3,9,9,0,11,poland2,0.38,0.62,0,1.12,1.38,2.63,1.61,6
Miedz Legnica,8,3,2,3,9,11,-2,11,poland2,0.38,0.62,-2,1.12,1.38,2.63,1.61,6
LKS Lodz,8,3,1,4,10,13,-3,10,poland2,0.38,0.5,-3,1.25,1.25,2.63,2.0,7
Pogon Siedlce,8,2,3,3,9,10,-1,9,poland2,0.25,0.62,-1,1.12,1.12,4.0,1.61,8
Odra Opole,8,2,2,4,7,7,0,8,poland2,0.25,0.5,0,0.88,1.0,4.0,2.0,9
Stalowa Wola,8,1,4,3,9,10,-1,7,poland2,0.12,0.62,-1,1.12,0.88,8.33,1.61,10
K. Kolobrzeg,8,1,4,3,7,9,-2,7,poland2,0.12,0.62,-2,0.88,0.88,8.33,1.61,10
Ruch Chorzow,8,2,1,5,9,12,-3,7,poland2,0.25,0.38,-3,1.12,0.88,4.0,2.63,10
Chrobry Glogow,8,1,3,4,10,14,-4,6,poland2,0.12,0.5,-4,1.25,0.75,8.33,2.0,11
Stal Rzeszow,8,0,2,6,5,17,-12,2,poland2,0.0,0.25,-12,0.62,0.25,0.0,4.0,12
Warta Poznan,8,0,1,7,4,15,-11,1,poland2,0.0,0.12,-11,0.5,0.12,0.0,8.33,13
Polonia Bytom,8,5,2,1,17,9,8,17,poland3,0.62,0.88,8,2.12,2.12,1.61,1.14,1
Pogon Grodzisk,8,5,1,2,16,10,6,16,poland3,0.62,0.75,6,2.0,2.0,1.61,1.33,2
Podbeskidzie,8,4,3,1,10,7,3,15,poland3,0.5,0.88,3,1.25,1.88,2.0,1.14,3
Rekord Bielsko,8,3,5,0,13,7,6,14,poland3,0.38,1.0,6,1.62,1.75,2.63,1.0,4
Chojniczanka,8,4,2,2,11,7,4,14,poland3,0.5,0.75,4,1.38,1.75,2.0,1.33,4
Zaglebie L. B,8,4,1,3,13,8,5,13,poland3,0.5,0.62,5,1.62,1.62,2.0,1.61,5
O. Grudziadz,8,4,1,3,11,12,-1,13,poland3,0.5,0.62,-1,1.38,1.62,2.0,1.61,5
Resovia Rzeszow,8,3,2,3,11,10,1,11,poland3,0.38,0.62,1,1.38,1.38,2.63,1.61,6
LKS Lodz B,8,3,2,3,12,12,0,11,poland3,0.38,0.62,0,1.5,1.38,2.63,1.61,6
Hutnik Krakow,8,3,2,3,9,13,-4,11,poland3,0.38,0.62,-4,1.12,1.38,2.63,1.61,6
Z. Sosnowiec,8,3,1,4,12,11,1,10,poland3,0.38,0.5,1,1.5,1.25,2.63,2.0,7
Wieczysta K.,8,3,1,4,11,11,0,10,poland3,0.38,0.5,0,1.38,1.25,2.63,2.0,7
Wisla Pulawy,8,3,1,4,9,15,-6,10,poland3,0.38,0.5,-6,1.12,1.25,2.63,2.0,7
Jastrzebie,8,3,0,5,7,9,-2,9,poland3,0.38,0.38,-2,0.88,1.12,2.63,2.63,8
SKRA Czestochow,8,3,0,5,7,12,-5,9,poland3,0.38,0.38,-5,0.88,1.12,2.63,2.63,8
Swit Skolwin,8,2,2,4,16,18,-2,8,poland3,0.25,0.5,-2,2.0,1.0,4.0,2.0,9
Olimpia Elblag,8,2,1,5,7,13,-6,7,poland3,0.25,0.38,-6,0.88,0.88,4.0,2.63,10
Kalisz,8,2,0,6,6,13,-7,6,poland3,0.25,0.25,-7,0.75,0.75,4.0,4.0,11
Benfica,8,7,1,0,27,7,20,22,portugal,0.88,1.0,20,3.38,2.75,1.14,1.0,1
Sporting CP,8,7,1,0,22,5,17,22,portugal,0.88,1.0,17,2.75,2.75,1.14,1.0,1
Guimaraes,8,6,1,1,13,6,7,19,portugal,0.75,0.88,7,1.62,2.38,1.33,1.14,2
Sporting Braga,8,5,2,1,13,6,7,17,portugal,0.62,0.88,7,1.62,2.12,1.61,1.14,3
FC Porto,8,5,0,3,10,9,1,15,portugal,0.62,0.62,1,1.25,1.88,1.61,1.61,4
Famalicao,8,4,1,3,14,10,4,13,portugal,0.5,0.62,4,1.75,1.62,2.0,1.61,5
Santa Clara,8,3,2,3,6,6,0,11,portugal,0.38,0.62,0,0.75,1.38,2.63,1.61,6
Gil Vicente,8,3,1,4,8,8,0,10,portugal,0.38,0.5,0,1.0,1.25,2.63,2.0,7
Moreirense,8,2,4,2,8,10,-2,10,portugal,0.25,0.75,-2,1.0,1.25,4.0,1.33,7
Nacional,8,3,1,4,7,11,-4,10,portugal,0.38,0.5,-4,0.88,1.25,2.63,2.0,7
Boavista,8,3,0,5,6,12,-6,9,portugal,0.38,0.38,-6,0.75,1.12,2.63,2.63,8
Estoril,8,2,2,4,10,14,-4,8,portugal,0.25,0.5,-4,1.25,1.0,4.0,2.0,9
Arouca,8,2,2,4,7,11,-4,8,portugal,0.25,0.5,-4,0.88,1.0,4.0,2.0,9
Casa Pia,8,2,2,4,6,10,-4,8,portugal,0.25,0.5,-4,0.75,1.0,4.0,2.0,9
Estrela Amadora,8,2,2,4,5,9,-4,8,portugal,0.25,0.5,-4,0.62,1.0,4.0,2.0,9
Rio Ave,8,2,1,5,8,13,-5,7,portugal,0.25,0.38,-5,1.0,0.88,4.0,2.63,10
Farense,8,1,2,5,5,9,-4,5,portugal,0.12,0.38,-4,0.62,0.62,8.33,2.63,11
AVS,8,1,1,6,4,21,-17,4,portugal,0.12,0.25,-17,0.5,0.5,8.33,4.0,12
Vizela,8,6,2,0,16,6,10,20,portugal2,0.75,1.0,10,2.0,2.5,1.33,1.0,1
Tondela,8,5,2,1,13,8,5,17,portugal2,0.62,0.88,5,1.62,2.12,1.61,1.14,2
Maritimo,8,4,4,0,10,5,5,16,portugal2,0.5,1.0,5,1.25,2.0,2.0,1.0,3
Chaves,8,5,0,3,13,8,5,15,portugal2,0.62,0.62,5,1.62,1.88,1.61,1.61,4
Alverca,8,3,4,1,13,7,6,13,portugal2,0.38,0.88,6,1.62,1.62,2.63,1.14,5
Torreense,8,3,4,1,17,13,4,13,portugal2,0.38,0.88,4,2.12,1.62,2.63,1.14,5
Uniao de Leiria,8,4,1,3,13,13,0,13,portugal2,0.5,0.62,0,1.62,1.62,2.0,1.61,5
Benfica B,8,3,3,2,8,6,2,12,portugal2,0.38,0.75,2,1.0,1.5,2.63,1.33,6
Felgueiras,8,2,5,1,9,5,4,11,portugal2,0.25,0.88,4,1.12,1.38,4.0,1.14,7
FC Porto B,8,3,2,3,8,7,1,11,portugal2,0.38,0.62,1,1.0,1.38,2.63,1.61,7
Oliveirense,8,3,1,4,8,15,-7,10,portugal2,0.38,0.5,-7,1.0,1.25,2.63,2.0,8
Academico Viseu,8,2,3,3,7,8,-1,9,portugal2,0.25,0.62,-1,0.88,1.12,4.0,1.61,9
Feirense,8,3,0,5,7,13,-6,9,portugal2,0.38,0.38,-6,0.88,1.12,2.63,2.63,9
Portimonense,8,2,2,4,11,13,-2,8,portugal2,0.25,0.5,-2,1.38,1.0,4.0,2.0,10
Leixoes,8,2,2,4,7,11,-4,8,portugal2,0.25,0.5,-4,0.88,1.0,4.0,2.0,10
Mafra,8,2,1,5,8,16,-8,7,portugal2,0.25,0.38,-8,1.0,0.88,4.0,2.63,11
Penafiel,8,1,0,7,7,15,-8,3,portugal2,0.12,0.12,-8,0.88,0.38,8.33,8.33,12
Pacos Ferreira,8,1,0,7,5,13,-8,3,portugal2,0.12,0.12,-8,0.62,0.38,8.33,8.33,12
Al Sadd,8,7,1,0,25,6,19,22,qatar,0.88,1.0,19,3.12,2.75,1.14,1.0,1
Al Duhail,8,6,1,1,17,5,12,19,qatar,0.75,0.88,12,2.12,2.38,1.33,1.14,2
Al Rayyan,8,5,0,3,21,12,9,15,qatar,0.62,0.62,9,2.62,1.88,1.61,1.61,3
Al Gharafa,8,4,3,1,16,12,4,15,qatar,0.5,0.88,4,2.0,1.88,2.0,1.14,3
Qatar SC,8,3,2,3,11,13,-2,11,qatar,0.38,0.62,-2,1.38,1.38,2.63,1.61,4
Al Shamal,8,3,1,4,11,8,3,10,qatar,0.38,0.5,3,1.38,1.25,2.63,2.0,5
Al Ahli Doha,8,3,1,4,13,19,-6,10,qatar,0.38,0.5,-6,1.62,1.25,2.63,2.0,5
Al Shahaniya,8,3,0,5,11,16,-5,9,qatar,0.38,0.38,-5,1.38,1.12,2.63,2.63,6
Umm Salal,8,2,1,5,9,18,-9,7,qatar,0.25,0.38,-9,1.12,0.88,4.0,2.63,7
Al Khor,8,2,1,5,6,16,-10,7,qatar,0.25,0.38,-10,0.75,0.88,4.0,2.63,7
Al Wakrah,8,2,0,6,9,18,-9,6,qatar,0.25,0.25,-9,1.12,0.75,4.0,4.0,8
Al Arabi,8,1,1,6,11,20,-9,4,qatar,0.12,0.25,-9,1.38,0.5,8.33,4.0,9
CFR Cluj,8,5,3,0,19,5,14,18,romania,0.62,1.0,14,2.38,2.25,1.61,1.0,1
FCSB,8,5,3,0,10,2,8,18,romania,0.62,1.0,8,1.25,2.25,1.61,1.0,1
Univ. Craiova,8,5,1,2,11,6,5,16,romania,0.62,0.75,5,1.38,2.0,1.61,1.33,2
Din. Bucharest,8,4,2,2,10,6,4,14,romania,0.5,0.75,4,1.25,1.75,2.0,1.33,3
Rapid Bucharest,8,4,2,2,9,6,3,14,romania,0.5,0.75,3,1.12,1.75,2.0,1.33,3
Hermannstadt,8,4,2,2,9,7,2,14,romania,0.5,0.75,2,1.12,1.75,2.0,1.33,3
U. Cluj,8,3,3,2,9,8,1,12,romania,0.38,0.75,1,1.12,1.5,2.63,1.33,4
Botosani,8,3,3,2,8,7,1,12,romania,0.38,0.75,1,1.0,1.5,2.63,1.33,4
Sepsi OSK,8,3,2,3,8,9,-1,11,romania,0.38,0.62,-1,1.0,1.38,2.63,1.61,5
Farul Constanta,8,3,1,4,8,10,-2,10,romania,0.38,0.5,-2,1.0,1.25,2.63,2.0,6
P. Iasi,8,2,3,3,8,12,-4,9,romania,0.25,0.62,-4,1.0,1.12,4.0,1.61,7
Petrolul,8,2,2,4,6,8,-2,8,romania,0.25,0.5,-2,0.75,1.0,4.0,2.0,8
UTA Arad,8,2,2,4,5,10,-5,8,romania,0.25,0.5,-5,0.62,1.0,4.0,2.0,8
Otelul,8,2,1,5,7,11,-4,7,romania,0.25,0.38,-4,0.88,0.88,4.0,2.63,9
FC Buzau,8,1,1,6,6,16,-10,4,romania,0.12,0.25,-10,0.75,0.5,8.33,4.0,10
Unirea Slobozia,8,0,1,7,4,14,-10,1,romania,0.0,0.12,-10,0.5,0.12,0.0,8.33,11
CSKA Moscow,8,6,2,0,13,4,9,20,russia,0.75,1.0,9,1.62,2.5,1.33,1.0,1
FC Krasnodar,8,6,1,1,18,8,10,19,russia,0.75,0.88,10,2.25,2.38,1.33,1.14,2
Zenit,8,4,3,1,14,5,9,15,russia,0.5,0.88,9,1.75,1.88,2.0,1.14,3
Spartak Moscow,8,4,1,3,13,9,4,13,russia,0.5,0.62,4,1.62,1.62,2.0,1.61,4
Rubin Kazan,8,4,1,3,9,12,-3,13,russia,0.5,0.62,-3,1.12,1.62,2.0,1.61,4
Dinamo Moscow,8,3,3,2,17,10,7,12,russia,0.38,0.75,7,2.12,1.5,2.63,1.33,5
Krylya Sovetov,8,3,3,2,13,11,2,12,russia,0.38,0.75,2,1.62,1.5,2.63,1.33,5
Rostov,8,3,2,3,10,11,-1,11,russia,0.38,0.62,-1,1.25,1.38,2.63,1.61,6
Makhachkala,8,3,1,4,14,14,0,10,russia,0.38,0.5,0,1.75,1.25,2.63,2.0,7
Lokomotiv M.,8,2,4,2,10,11,-1,10,russia,0.25,0.75,-1,1.25,1.25,4.0,1.33,7
Akhmat Grozny,8,2,4,2,7,8,-1,10,russia,0.25,0.75,-1,0.88,1.25,4.0,1.33,7
Orenburg,8,3,0,5,7,15,-8,9,russia,0.38,0.38,-8,0.88,1.12,2.63,2.63,8
Khimki,8,2,2,4,8,12,-4,8,russia,0.25,0.5,-4,1.0,1.0,4.0,2.0,9
Akron,8,2,1,5,11,13,-2,7,russia,0.25,0.38,-2,1.38,0.88,4.0,2.63,10
Nizhny Novgorod,8,2,1,5,5,13,-8,7,russia,0.25,0.38,-8,0.62,0.88,4.0,2.63,10
Fakel Voronezh,8,0,1,7,1,14,-13,1,russia,0.0,0.12,-13,0.12,0.12,0.0,8.33,11
Baltika,8,6,2,0,21,4,17,20,russia2,0.75,1.0,17,2.62,2.5,1.33,1.0,1
Rodina Moskva,8,5,2,1,12,3,9,17,russia2,0.62,0.88,9,1.5,2.12,1.61,1.14,2
Chernomorets,8,4,3,1,12,6,6,15,russia2,0.5,0.88,6,1.5,1.88,2.0,1.14,3
PFC Sochi,8,5,0,3,12,8,4,15,russia2,0.62,0.62,4,1.5,1.88,1.61,1.61,3
Shinnik,8,4,1,3,9,8,1,13,russia2,0.5,0.62,1,1.12,1.62,2.0,1.61,4
Torpedo Moscow,8,3,3,2,8,6,2,12,russia2,0.38,0.75,2,1.0,1.5,2.63,1.33,5
SKA Khabarovsk,8,4,0,4,7,7,0,12,russia2,0.5,0.5,0,0.88,1.5,2.0,2.0,5
Yenisey,8,3,3,2,6,6,0,12,russia2,0.38,0.75,0,0.75,1.5,2.63,1.33,5
Ural,8,3,3,2,10,11,-1,12,russia2,0.38,0.75,-1,1.25,1.5,2.63,1.33,5
Kamaz,8,3,2,3,8,7,1,11,russia2,0.38,0.62,1,1.0,1.38,2.63,1.61,6
Tyumen,8,3,2,3,8,8,0,11,russia2,0.38,0.62,0,1.0,1.38,2.63,1.61,6
Rotor Volgograd,8,2,4,2,7,7,0,10,russia2,0.25,0.75,0,0.88,1.25,4.0,1.33,7
Neftekhimik,8,2,2,4,8,10,-2,8,russia2,0.25,0.5,-2,1.0,1.0,4.0,2.0,8
Ufa,8,2,2,4,4,12,-8,8,russia2,0.25,0.5,-8,0.5,1.0,4.0,2.0,8
Arsenal Tula,8,1,4,3,3,5,-2,7,russia2,0.12,0.62,-2,0.38,0.88,8.33,1.61,9
Chayka,8,1,2,5,4,14,-10,5,russia2,0.12,0.38,-10,0.5,0.62,8.33,2.63,10
A. Vladikavkaz,8,1,2,5,7,18,-11,5,russia2,0.12,0.38,-11,0.88,0.62,8.33,2.63,10
Sokol Saratov,8,0,3,5,7,13,-6,3,russia2,0.0,0.38,-6,0.88,0.38,0.0,2.63,11
Al Shabab,8,5,3,0,19,6,13,18,saudiarabia,0.62,1.0,13,2.38,2.25,1.61,1.0,1
Al Ahli Jeddah,8,5,2,1,22,11,11,17,saudiarabia,0.62,0.88,11,2.75,2.12,1.61,1.14,2
Al Nassr,8,5,1,2,17,11,6,16,saudiarabia,0.62,0.75,6,2.12,2.0,1.61,1.33,3
Al Fateh,8,4,2,2,18,10,8,14,saudiarabia,0.5,0.75,8,2.25,1.75,2.0,1.33,4
Al Hilal,8,4,2,2,18,10,8,14,saudiarabia,0.5,0.75,8,2.25,1.75,2.0,1.33,4
Al Ittihad,8,3,4,1,12,10,2,13,saudiarabia,0.38,0.88,2,1.5,1.62,2.63,1.14,5
Al Taawon,8,4,1,3,12,10,2,13,saudiarabia,0.5,0.62,2,1.5,1.62,2.0,1.61,5
Al Wahda,8,4,1,3,11,9,2,13,saudiarabia,0.5,0.62,2,1.38,1.62,2.0,1.61,5
Al Ittifaq,8,3,3,2,9,9,0,12,saudiarabia,0.38,0.75,0,1.12,1.5,2.63,1.33,6
Al Akhdoud,8,3,3,2,7,7,0,12,saudiarabia,0.38,0.75,0,0.88,1.5,2.63,1.33,6
Al Feiha,8,2,4,2,7,11,-4,10,saudiarabia,0.25,0.75,-4,0.88,1.25,4.0,1.33,7
Al Quadisiya,8,2,3,3,8,11,-3,9,saudiarabia,0.25,0.62,-3,1.0,1.12,4.0,1.61,8
Damak,8,2,1,5,7,12,-5,7,saudiarabia,0.25,0.38,-5,0.88,0.88,4.0,2.63,9
Al Orubah,8,2,1,5,7,19,-12,7,saudiarabia,0.25,0.38,-12,0.88,0.88,4.0,2.63,9
Al Riyadh,8,1,3,4,5,8,-3,6,saudiarabia,0.12,0.5,-3,0.62,0.75,8.33,2.0,10
Al Khaleej,8,1,3,4,8,17,-9,6,saudiarabia,0.12,0.5,-9,1.0,0.75,8.33,2.0,10
Al Kholood,8,2,0,6,7,18,-11,6,saudiarabia,0.25,0.25,-11,0.88,0.75,4.0,4.0,10
Al Raed,8,1,1,6,12,17,-5,4,saudiarabia,0.12,0.25,-5,1.5,0.5,8.33,4.0,11
Neom SC,8,7,1,0,24,5,19,22,saudiarabia2,0.88,1.0,19,3.0,2.75,1.14,1.0,1
Al Najma,8,7,1,0,16,5,11,22,saudiarabia2,0.88,1.0,11,2.0,2.75,1.14,1.0,1
Al Bukayriyah,8,5,2,1,12,4,8,17,saudiarabia2,0.62,0.88,8,1.5,2.12,1.61,1.14,2
Al Zulfi,8,5,2,1,11,4,7,17,saudiarabia2,0.62,0.88,7,1.38,2.12,1.61,1.14,2
Al Adalha,8,4,2,2,14,11,3,14,saudiarabia2,0.5,0.75,3,1.75,1.75,2.0,1.33,3
Abha,8,2,6,0,14,9,5,12,saudiarabia2,0.25,1.0,5,1.75,1.5,4.0,1.0,4
Al Faisaly,8,3,3,2,8,9,-1,12,saudiarabia2,0.38,0.75,-1,1.0,1.5,2.63,1.33,4
Al Jabalain,8,3,2,3,12,10,2,11,saudiarabia2,0.38,0.62,2,1.5,1.38,2.63,1.61,5
Al Hazm,8,3,2,3,10,11,-1,11,saudiarabia2,0.38,0.62,-1,1.25,1.38,2.63,1.61,5
Al Batin,8,3,2,3,12,16,-4,11,saudiarabia2,0.38,0.62,-4,1.5,1.38,2.63,1.61,5
Ohod,8,2,2,4,8,11,-3,8,saudiarabia2,0.25,0.5,-3,1.0,1.0,4.0,2.0,6
Al Jubail,8,1,5,2,7,11,-4,8,saudiarabia2,0.12,0.75,-4,0.88,1.0,8.33,1.33,6
Al Tai,8,2,1,5,9,12,-3,7,saudiarabia2,0.25,0.38,-3,1.12,0.88,4.0,2.63,7
Jeddah,8,1,4,3,5,8,-3,7,saudiarabia2,0.12,0.62,-3,0.62,0.88,8.33,1.61,7
Al Ain,8,1,3,4,8,14,-6,6,saudiarabia2,0.12,0.5,-6,1.0,0.75,8.33,2.0,8
Al Jandal,8,1,2,5,5,11,-6,5,saudiarabia2,0.12,0.38,-6,0.62,0.62,8.33,2.63,9
Al Safa,8,0,2,6,6,20,-14,2,saudiarabia2,0.0,0.25,-14,0.75,0.25,0.0,4.0,10
Al Arabi,8,0,1,7,7,18,-11,1,saudiarabia2,0.0,0.12,-11,0.88,0.12,0.0,8.33,11
Hibernian,8,6,1,1,17,5,12,19,scotland,0.75,0.88,12,2.12,2.38,1.33,1.14,1
Celtic,8,5,0,3,26,10,16,15,scotland,0.62,0.62,16,3.25,1.88,1.61,1.61,2
Aberdeen,8,4,3,1,12,10,2,15,scotland,0.5,0.88,2,1.5,1.88,2.0,1.14,2
Dundee Utd,8,4,1,3,9,14,-5,13,scotland,0.5,0.62,-5,1.12,1.62,2.0,1.61,3
St. Mirren,8,3,2,3,17,17,0,11,scotland,0.38,0.62,0,2.12,1.38,2.63,1.61,4
Rangers,8,3,2,3,16,17,-1,11,scotland,0.38,0.62,-1,2.0,1.38,2.63,1.61,4
Motherwell,8,3,2,3,10,13,-3,11,scotland,0.38,0.62,-3,1.25,1.38,2.63,1.61,4
Hearts,8,3,1,4,8,9,-1,10,scotland,0.38,0.5,-1,1.0,1.25,2.63,2.0,5
Dundee FC,8,3,1,4,13,16,-3,10,scotland,0.38,0.5,-3,1.62,1.25,2.63,2.0,5
St. Johnstone,8,2,2,4,6,10,-4,8,scotland,0.25,0.5,-4,0.75,1.0,4.0,2.0,6
Kilmarnock,8,2,1,5,9,17,-8,7,scotland,0.25,0.38,-8,1.12,0.88,4.0,2.63,7
Ross County,8,2,0,6,6,11,-5,6,scotland,0.25,0.25,-5,0.75,0.75,4.0,4.0,8
Livingston,8,5,2,1,17,5,12,17,scotland2,0.62,0.88,12,2.12,2.12,1.61,1.14,1
Raith Rovers,8,4,4,0,14,6,8,16,scotland2,0.5,1.0,8,1.75,2.0,2.0,1.0,2
Partick Thistle,8,4,2,2,9,5,4,14,scotland2,0.5,0.75,4,1.12,1.75,2.0,1.33,3
Falkirk,8,4,1,3,15,7,8,13,scotland2,0.5,0.62,8,1.88,1.62,2.0,1.61,4
Airdrieonians,8,3,3,2,13,9,4,12,scotland2,0.38,0.75,4,1.62,1.5,2.63,1.33,5
Greenock Morton,8,3,2,3,10,13,-3,11,scotland2,0.38,0.62,-3,1.25,1.38,2.63,1.61,6
Dunfermline,8,2,2,4,2,7,-5,8,scotland2,0.25,0.5,-5,0.25,1.0,4.0,2.0,7
Hamilton,8,2,2,4,5,12,-7,8,scotland2,0.25,0.5,-7,0.62,1.0,4.0,2.0,7
Ayr Utd,8,1,3,4,8,14,-6,6,scotland2,0.12,0.5,-6,1.0,0.75,8.33,2.0,8
Queens Park,8,0,2,6,3,19,-16,2,scotland2,0.0,0.25,-16,0.38,0.25,0.0,4.0,9
Queen of South,8,6,1,1,17,8,9,19,scotland3,0.75,0.88,9,2.12,2.38,1.33,1.14,1
Arbroath,8,4,2,2,12,12,0,14,scotland3,0.5,0.75,0,1.5,1.75,2.0,1.33,2
Dumbarton,8,3,3,2,16,10,6,12,scotland3,0.38,0.75,6,2.0,1.5,2.63,1.33,3
Inverness,8,3,2,3,13,10,3,11,scotland3,0.38,0.62,3,1.62,1.38,2.63,1.61,4
Alloa Athletic,8,3,2,3,15,13,2,11,scotland3,0.38,0.62,2,1.88,1.38,2.63,1.61,4
Cove Rangers,8,2,4,2,12,10,2,10,scotland3,0.25,0.75,2,1.5,1.25,4.0,1.33,5
Montrose,8,2,3,3,12,12,0,9,scotland3,0.25,0.62,0,1.5,1.12,4.0,1.61,6
Annan Athletic,8,3,0,5,10,13,-3,9,scotland3,0.38,0.38,-3,1.25,1.12,2.63,2.63,6
Kelty Hearts,8,1,3,4,7,18,-11,6,scotland3,0.12,0.5,-11,0.88,0.75,8.33,2.0,7
Stenhousemuir,8,0,3,5,5,18,-13,3,scotland3,0.0,0.38,-13,0.62,0.38,0.0,2.63,8
Peterhead,8,5,2,1,11,5,6,17,scotland4,0.62,0.88,6,1.38,2.12,1.61,1.14,1
Elgin City,8,5,0,3,12,7,5,15,scotland4,0.62,0.62,5,1.5,1.88,1.61,1.61,2
Edinburgh City,8,4,1,3,11,9,2,13,scotland4,0.5,0.62,2,1.38,1.62,2.0,1.61,3
Spartans,8,4,0,4,12,10,2,12,scotland4,0.5,0.5,2,1.5,1.5,2.0,2.0,4
East Fife,8,4,0,4,12,13,-1,12,scotland4,0.5,0.5,-1,1.5,1.5,2.0,2.0,4
Forfar Athletic,8,3,3,2,4,5,-1,12,scotland4,0.38,0.75,-1,0.5,1.5,2.63,1.33,4
Stirling Albion,8,3,2,3,10,11,-1,11,scotland4,0.38,0.62,-1,1.25,1.38,2.63,1.61,5
Clyde,8,3,1,4,12,12,0,10,scotland4,0.38,0.5,0,1.5,1.25,2.63,2.0,6
Stranraer,8,2,1,5,8,11,-3,7,scotland4,0.25,0.38,-3,1.0,0.88,4.0,2.63,7
Bonnyrigg Rose,8,2,1,5,6,14,-8,7,scotland4,0.25,0.38,-8,0.75,0.88,4.0,2.63,7
Red Star,8,7,0,1,25,12,13,21,serbia,0.88,0.88,13,3.12,2.62,1.14,1.14,1
Partizan,8,5,2,1,16,8,8,17,serbia,0.62,0.88,8,2.0,2.12,1.61,1.14,2
IMT N. Beograd,8,4,2,2,13,11,2,14,serbia,0.5,0.75,2,1.62,1.75,2.0,1.33,3
OFK Beograd,8,4,1,3,16,13,3,13,serbia,0.5,0.62,3,2.0,1.62,2.0,1.61,4
Z. Pancevo,8,4,1,3,12,9,3,13,serbia,0.5,0.62,3,1.5,1.62,2.0,1.61,4
Backa Topola,8,4,1,3,13,11,2,13,serbia,0.5,0.62,2,1.62,1.62,2.0,1.61,4
S. Subotica,8,4,1,3,11,9,2,13,serbia,0.5,0.62,2,1.38,1.62,2.0,1.61,4
Vojvodina,8,4,0,4,13,16,-3,12,serbia,0.5,0.5,-3,1.62,1.5,2.0,2.0,5
Novi Pazar,8,3,2,3,12,11,1,11,serbia,0.38,0.62,1,1.5,1.38,2.63,1.61,6
T. Odzaci,8,3,0,5,8,14,-6,9,serbia,0.38,0.38,-6,1.0,1.12,2.63,2.63,7
Jedinstvo U.,8,2,2,4,11,12,-1,8,serbia,0.25,0.5,-1,1.38,1.0,4.0,2.0,8
Napredak,8,2,2,4,7,11,-4,8,serbia,0.25,0.5,-4,0.88,1.0,4.0,2.0,8
Mladost Lucani,8,1,3,4,6,13,-7,6,serbia,0.12,0.5,-7,0.75,0.75,8.33,2.0,9
Radnicki 1923,8,1,2,5,9,16,-7,5,serbia,0.12,0.38,-7,1.12,0.62,8.33,2.63,10
Cukaricki,8,1,2,5,8,15,-7,5,serbia,0.12,0.38,-7,1.0,0.62,8.33,2.63,10
Radnicki Nis,8,0,4,4,9,18,-9,4,serbia,0.0,0.5,-9,1.12,0.5,0.0,2.0,11
R. Surdulica,8,6,0,2,16,6,10,18,serbia2,0.75,0.75,10,2.0,2.25,1.33,1.33,1
Vozdovac,8,4,4,0,11,6,5,16,serbia2,0.5,1.0,5,1.38,2.0,2.0,1.0,2
Sloven Ruma,8,4,3,1,12,8,4,15,serbia2,0.5,0.88,4,1.5,1.88,2.0,1.14,3
Dubocica,8,4,1,3,14,10,4,13,serbia2,0.5,0.62,4,1.75,1.62,2.0,1.61,4
S. Mitrovica,8,3,4,1,7,4,3,13,serbia2,0.38,0.88,3,0.88,1.62,2.63,1.14,4
Graficar,8,3,4,1,11,9,2,13,serbia2,0.38,0.88,2,1.38,1.62,2.63,1.14,4
Mladost,8,3,3,2,8,9,-1,12,serbia2,0.38,0.75,-1,1.0,1.5,2.63,1.33,5
Zemun,8,3,2,3,8,9,-1,11,serbia2,0.38,0.62,-1,1.0,1.38,2.63,1.61,6
Trajal Krusevac,8,2,3,3,9,9,0,9,serbia2,0.25,0.62,0,1.12,1.12,4.0,1.61,7
Macva Sabac,8,2,3,3,7,9,-2,9,serbia2,0.25,0.62,-2,0.88,1.12,4.0,1.61,7
Javor Ivanjica,8,2,2,4,8,12,-4,8,serbia2,0.25,0.5,-4,1.0,1.0,4.0,2.0,8
Indija,8,2,1,5,9,12,-3,7,serbia2,0.25,0.38,-3,1.12,0.88,4.0,2.63,9
Borac Cacak,8,2,1,5,8,12,-4,7,serbia2,0.25,0.38,-4,1.0,0.88,4.0,2.63,9
Sloboda Uzice,8,2,1,5,5,11,-6,7,serbia2,0.25,0.38,-6,0.62,0.88,4.0,2.63,9
Smederevo,8,1,3,4,5,8,-3,6,serbia2,0.12,0.5,-3,0.62,0.75,8.33,2.0,10
Vrsac,8,1,3,4,3,9,-6,6,serbia2,0.12,0.5,-6,0.38,0.75,8.33,2.0,10
Lion City,8,6,2,0,23,4,19,20,singapore,0.75,1.0,19,2.88,2.5,1.33,1.0,1
Tampines Rovers,8,6,0,2,22,7,15,18,singapore,0.75,0.75,15,2.75,2.25,1.33,1.33,2
Geylang,8,4,1,3,20,15,5,13,singapore,0.5,0.62,5,2.5,1.62,2.0,1.61,3
Hougang,8,3,2,3,17,15,2,11,singapore,0.38,0.62,2,2.12,1.38,2.63,1.61,4
Khalsa,8,3,1,4,16,24,-8,10,singapore,0.38,0.5,-8,2.0,1.25,2.63,2.0,5
DPMM FC,8,2,2,4,8,11,-3,8,singapore,0.25,0.5,-3,1.0,1.0,4.0,2.0,6
A. Niigata (S),8,2,2,4,7,12,-5,8,singapore,0.25,0.5,-5,0.88,1.0,4.0,2.0,6
Young Lions,8,1,4,3,9,21,-12,7,singapore,0.12,0.62,-12,1.12,0.88,8.33,1.61,7
Tanjong Pagar,8,1,2,5,9,22,-13,5,singapore,0.12,0.38,-13,1.12,0.62,8.33,2.63,8
DAC Streda,8,4,4,0,17,10,7,16,slovakia,0.5,1.0,7,2.12,2.0,2.0,1.0,1
S. Bratislava,8,4,2,2,18,11,7,14,slovakia,0.5,0.75,7,2.25,1.75,2.0,1.33,2
Skalica,8,4,2,2,8,5,3,14,slovakia,0.5,0.75,3,1.0,1.75,2.0,1.33,2
Komarno,8,4,2,2,8,6,2,14,slovakia,0.5,0.75,2,1.0,1.75,2.0,1.33,2
FC Kosice,8,3,3,2,13,12,1,12,slovakia,0.38,0.75,1,1.62,1.5,2.63,1.33,3
Trencin,8,3,3,2,13,12,1,12,slovakia,0.38,0.75,1,1.62,1.5,2.63,1.33,3
Zilina,8,3,3,2,10,13,-3,12,slovakia,0.38,0.75,-3,1.25,1.5,2.63,1.33,3
Z. Michalovce,8,3,1,4,13,14,-1,10,slovakia,0.38,0.5,-1,1.62,1.25,2.63,2.0,4
Spartak Trnava,8,2,2,4,11,14,-3,8,slovakia,0.25,0.5,-3,1.38,1.0,4.0,2.0,5
Ruzomberok,8,2,1,5,8,13,-5,7,slovakia,0.25,0.38,-5,1.0,0.88,4.0,2.63,6
Podbrezova,8,0,5,3,7,11,-4,5,slovakia,0.0,0.62,-4,0.88,0.62,0.0,1.61,7
Banska Bystrica,8,1,2,5,11,16,-5,5,slovakia,0.12,0.38,-5,1.38,0.62,8.33,2.63,7
Zlate Moravce,8,6,2,0,15,4,11,20,slovakia2,0.75,1.0,11,1.88,2.5,1.33,1.0,1
Presov,8,6,1,1,13,4,9,19,slovakia2,0.75,0.88,9,1.62,2.38,1.33,1.14,2
Zvolen,8,5,1,2,14,7,7,16,slovakia2,0.62,0.75,7,1.75,2.0,1.61,1.33,3
P. Bystrica,8,4,2,2,11,6,5,14,slovakia2,0.5,0.75,5,1.38,1.75,2.0,1.33,4
Petrzalka,8,3,3,2,11,9,2,12,slovakia2,0.38,0.75,2,1.38,1.5,2.63,1.33,5
Puchov,8,3,2,3,13,13,0,11,slovakia2,0.38,0.62,0,1.62,1.38,2.63,1.61,6
S. Bratislava B,8,3,2,3,14,15,-1,11,slovakia2,0.38,0.62,-1,1.75,1.38,2.63,1.61,6
Samorin,8,3,1,4,6,10,-4,10,slovakia2,0.38,0.5,-4,0.75,1.25,2.63,2.0,7
L. Mikulas,8,2,3,3,13,10,3,9,slovakia2,0.25,0.62,3,1.62,1.12,4.0,1.61,8
Zilina B,8,3,0,5,10,15,-5,9,slovakia2,0.38,0.38,-5,1.25,1.12,2.63,2.63,8
S. Lubovna,8,2,1,5,6,10,-4,7,slovakia2,0.25,0.38,-4,0.75,0.88,4.0,2.63,9
Humenne,8,2,1,5,5,14,-9,7,slovakia2,0.25,0.38,-9,0.62,0.88,4.0,2.63,9
Pohronie,8,2,0,6,9,16,-7,6,slovakia2,0.25,0.25,-7,1.12,0.75,4.0,4.0,10
Malzenice,8,1,1,6,6,16,-10,4,slovakia2,0.12,0.25,-10,0.75,0.5,8.33,4.0,11
NK Olimpija,8,5,3,0,17,6,11,18,slovenia,0.62,1.0,11,2.12,2.25,1.61,1.0,1
Koper,8,5,2,1,17,10,7,17,slovenia,0.62,0.88,7,2.12,2.12,1.61,1.14,2
NK Celje,8,5,2,1,16,12,4,17,slovenia,0.62,0.88,4,2.0,2.12,1.61,1.14,2
Maribor,8,4,2,2,14,8,6,14,slovenia,0.5,0.75,6,1.75,1.75,2.0,1.33,3
Primorje,8,2,4,2,11,11,0,10,slovenia,0.25,0.75,0,1.38,1.25,4.0,1.33,4
Radomlje,8,3,1,4,11,16,-5,10,slovenia,0.38,0.5,-5,1.38,1.25,2.63,2.0,4
Nafta,8,2,3,3,15,20,-5,9,slovenia,0.25,0.62,-5,1.88,1.12,4.0,1.61,5
Domzale,8,2,2,4,10,12,-2,8,slovenia,0.25,0.5,-2,1.25,1.0,4.0,2.0,6
Mura,8,2,0,6,10,14,-4,6,slovenia,0.25,0.25,-4,1.25,0.75,4.0,4.0,7
Bravo,8,0,3,5,6,16,-10,3,slovenia,0.0,0.38,-10,0.75,0.38,0.0,2.63,8
Mamelodi S.,8,5,1,2,16,8,8,16,southafrica,0.62,0.75,8,2.0,2.0,1.61,1.33,1
Orlando Pirates,8,5,1,2,9,9,0,16,southafrica,0.62,0.75,0,1.12,2.0,1.61,1.33,1
Stellenbosch,8,4,3,1,8,5,3,15,southafrica,0.5,0.88,3,1.0,1.88,2.0,1.14,2
Magesi,8,5,0,3,7,7,0,15,southafrica,0.62,0.62,0,0.88,1.88,1.61,1.61,2
Marumo G.,8,4,2,2,10,7,3,14,southafrica,0.5,0.75,3,1.25,1.75,2.0,1.33,3
Sekhukhune,8,4,1,3,12,11,1,13,southafrica,0.5,0.62,1,1.5,1.62,2.0,1.61,4
TS Galaxy,8,3,3,2,12,9,3,12,southafrica,0.38,0.75,3,1.5,1.5,2.63,1.33,5
Chippa Utd,8,3,3,2,6,3,3,12,southafrica,0.38,0.75,3,0.75,1.5,2.63,1.33,5
Richards Bay,8,3,2,3,7,7,0,11,southafrica,0.38,0.62,0,0.88,1.38,2.63,1.61,6
AmaZulu,8,3,1,4,6,7,-1,10,southafrica,0.38,0.5,-1,0.75,1.25,2.63,2.0,7
Golden Arrows,8,2,3,3,5,7,-2,9,southafrica,0.25,0.62,-2,0.62,1.12,4.0,1.61,8
SuperSport Utd,8,1,5,2,8,8,0,8,southafrica,0.12,0.75,0,1.0,1.0,8.33,1.33,9
Polokwane,8,1,3,4,5,9,-4,6,southafrica,0.12,0.5,-4,0.62,0.75,8.33,2.0,10
Kaizer Chiefs,8,1,3,4,4,8,-4,6,southafrica,0.12,0.5,-4,0.5,0.75,8.33,2.0,10
Royal AM,8,1,2,5,9,13,-4,5,southafrica,0.12,0.38,-4,1.12,0.62,8.33,2.63,11
Cape Town City,8,0,3,5,3,9,-6,3,southafrica,0.0,0.38,-6,0.38,0.38,0.0,2.63,12
Black Leopards,8,5,3,0,14,7,7,18,southafrica2,0.62,1.0,7,1.75,2.25,1.61,1.0,1
Kruger United,8,4,2,2,10,10,0,14,southafrica2,0.5,0.75,0,1.25,1.75,2.0,1.33,2
Cape Town Spurs,8,3,4,1,11,5,6,13,southafrica2,0.38,0.88,6,1.38,1.62,2.63,1.14,3
Orbit College,8,3,4,1,7,3,4,13,southafrica2,0.38,0.88,4,0.88,1.62,2.63,1.14,3
Casric Stars,8,3,3,2,10,6,4,12,southafrica2,0.38,0.75,4,1.25,1.5,2.63,1.33,4
Durban City,8,3,3,2,8,5,3,12,southafrica2,0.38,0.75,3,1.0,1.5,2.63,1.33,4
Venda FC,8,3,3,2,8,5,3,12,southafrica2,0.38,0.75,3,1.0,1.5,2.63,1.33,4
Baroka,8,2,4,2,10,11,-1,10,southafrica2,0.25,0.75,-1,1.25,1.25,4.0,1.33,5
Leruma United,8,1,6,1,8,8,0,9,southafrica2,0.12,0.88,0,1.0,1.12,8.33,1.14,6
Pretoria U.,8,2,3,3,9,10,-1,9,southafrica2,0.25,0.62,-1,1.12,1.12,4.0,1.61,6
JDR Stars,8,1,5,2,7,10,-3,8,southafrica2,0.12,0.75,-3,0.88,1.0,8.33,1.33,7
Highbury,8,2,2,4,6,9,-3,8,southafrica2,0.25,0.5,-3,0.75,1.0,4.0,2.0,7
Milford,8,2,1,5,8,15,-7,7,southafrica2,0.25,0.38,-7,1.0,0.88,4.0,2.63,8
Pretoria C.,8,2,1,5,4,14,-10,7,southafrica2,0.25,0.38,-10,0.5,0.88,4.0,2.63,8
Hungry Lions,8,1,3,4,5,8,-3,6,southafrica2,0.12,0.5,-3,0.62,0.75,8.33,2.0,9
Upington City,8,1,3,4,3,7,-4,6,southafrica2,0.12,0.5,-4,0.38,0.75,8.33,2.0,9
Daejeon Citizen,8,5,2,1,14,9,5,17,southkorea,0.62,0.88,5,1.75,2.12,1.61,1.14,1
Pohang Steelers,8,4,3,1,10,8,2,15,southkorea,0.5,0.88,2,1.25,1.88,2.0,1.14,2
Jeonbuk Motors,8,4,2,2,11,7,4,14,southkorea,0.5,0.75,4,1.38,1.75,2.0,1.33,3
Gimcheon Sangmu,8,4,2,2,10,6,4,14,southkorea,0.5,0.75,4,1.25,1.75,2.0,1.33,3
Gwangju,8,4,2,2,10,8,2,14,southkorea,0.5,0.75,2,1.25,1.75,2.0,1.33,3
Anyang,8,4,0,4,10,9,1,12,southkorea,0.5,0.5,1,1.25,1.5,2.0,2.0,4
Seoul,8,2,4,2,7,7,0,10,southkorea,0.25,0.75,0,0.88,1.25,4.0,1.33,5
Gangwon,8,3,1,4,4,6,-2,10,southkorea,0.38,0.5,-2,0.5,1.25,2.63,2.0,5
Jeju Utd,8,2,2,4,6,9,-3,8,southkorea,0.25,0.5,-3,0.75,1.0,4.0,2.0,6
Ulsan,8,2,2,4,6,9,-3,8,southkorea,0.25,0.5,-3,0.75,1.0,4.0,2.0,6
Suwon City,8,1,3,4,7,11,-4,6,southkorea,0.12,0.5,-4,0.88,0.75,8.33,2.0,7
Daegu,8,0,1,7,5,14,-9,1,southkorea,0.0,0.12,-9,0.62,0.12,0.0,8.33,8
Incheon Utd,8,6,1,1,14,5,9,19,southkorea2,0.75,0.88,9,1.75,2.38,1.33,1.14,1
Jeonnam,8,4,3,1,9,6,3,15,southkorea2,0.5,0.88,3,1.12,1.88,2.0,1.14,2
Seoul E-Land,8,4,2,2,15,11,4,14,southkorea2,0.5,0.75,4,1.88,1.75,2.0,1.33,3
Suwon Bluewings,8,4,2,2,15,11,4,14,southkorea2,0.5,0.75,4,1.88,1.75,2.0,1.33,3
Busan IPark,8,4,2,2,13,9,4,14,southkorea2,0.5,0.75,4,1.62,1.75,2.0,1.33,3
Seongnam,8,3,4,1,8,6,2,13,southkorea2,0.38,0.88,2,1.0,1.62,2.63,1.14,4
Asan,8,2,5,1,9,5,4,11,southkorea2,0.25,0.88,4,1.12,1.38,4.0,1.14,5
Bucheon FC,8,3,2,3,11,12,-1,11,southkorea2,0.38,0.62,-1,1.38,1.38,2.63,1.61,5
Gyeongnam,8,3,2,3,10,11,-1,11,southkorea2,0.38,0.62,-1,1.25,1.38,2.63,1.61,5
Cheongju,8,3,1,4,10,13,-3,10,southkorea2,0.38,0.5,-3,1.25,1.25,2.63,2.0,6
Gimpo,8,2,2,4,9,9,0,8,southkorea2,0.25,0.5,0,1.12,1.0,4.0,2.0,7
Hwaseong,8,1,3,4,11,15,-4,6,southkorea2,0.12,0.5,-4,1.38,0.75,8.33,2.0,8
Ansan Greeners,8,1,1,6,6,16,-10,4,southkorea2,0.12,0.25,-10,0.75,0.5,8.33,4.0,9
Cheonan City,8,1,0,7,3,14,-11,3,southkorea2,0.12,0.12,-11,0.38,0.38,8.33,8.33,10
FC Barcelona,8,7,1,0,22,7,15,22,spain,0.88,1.0,15,2.75,2.75,1.14,1.0,1
Real Betis,8,6,1,1,18,9,9,19,spain,0.75,0.88,9,2.25,2.38,1.33,1.14,2
Real Madrid,8,6,0,2,12,8,4,18,spain,0.75,0.75,4,1.5,2.25,1.33,1.33,3
Valencia,8,4,4,0,12,8,4,16,spain,0.5,1.0,4,1.5,2.0,2.0,1.0,4
Celta Vigo,8,4,2,2,14,11,3,14,spain,0.5,0.75,3,1.75,1.75,2.0,1.33,5
Atletico Madrid,8,4,1,3,14,11,3,13,spain,0.5,0.62,3,1.75,1.62,2.0,1.61,6
Espanyol,8,3,3,2,11,6,5,12,spain,0.38,0.75,5,1.38,1.5,2.63,1.33,7
Athletic Bilbao,8,3,3,2,6,4,2,12,spain,0.38,0.75,2,0.75,1.5,2.63,1.33,7
Alaves,8,3,3,2,7,7,0,12,spain,0.38,0.75,0,0.88,1.5,2.63,1.33,7
Osasuna,8,3,3,2,11,12,-1,12,spain,0.38,0.75,-1,1.38,1.5,2.63,1.33,7
Villarreal,8,3,2,3,8,10,-2,11,spain,0.38,0.62,-2,1.0,1.38,2.63,1.61,8
Getafe,8,3,0,5,10,10,0,9,spain,0.38,0.38,0,1.25,1.12,2.63,2.63,9
Mallorca,8,2,3,3,7,7,0,9,spain,0.25,0.62,0,0.88,1.12,4.0,1.61,9
Las Palmas,8,2,3,3,9,10,-1,9,spain,0.25,0.62,-1,1.12,1.12,4.0,1.61,9
Real Sociedad,8,2,2,4,9,14,-5,8,spain,0.25,0.5,-5,1.12,1.0,4.0,2.0,10
Leganes,8,1,3,4,8,11,-3,6,spain,0.12,0.5,-3,1.0,0.75,8.33,2.0,11
Rayo Vallecano,8,1,3,4,8,16,-8,6,spain,0.12,0.5,-8,1.0,0.75,8.33,2.0,11
Sevilla FC,8,1,2,5,5,9,-4,5,spain,0.12,0.38,-4,0.62,0.62,8.33,2.63,12
Girona,8,0,4,4,8,15,-7,4,spain,0.0,0.5,-7,1.0,0.5,0.0,2.0,13
Valladolid,8,0,1,7,8,22,-14,1,spain,0.0,0.12,-14,1.0,0.12,0.0,8.33,14
Elche,8,5,3,0,13,6,7,18,spain2,0.62,1.0,7,1.62,2.25,1.61,1.0,1
Levante,8,5,1,2,18,10,8,16,spain2,0.62,0.75,8,2.25,2.0,1.61,1.33,2
Granada,8,5,1,2,14,7,7,16,spain2,0.62,0.75,7,1.75,2.0,1.61,1.33,2
Tenerife,8,4,3,1,11,6,5,15,spain2,0.5,0.88,5,1.38,1.88,2.0,1.14,3
Burgos,8,4,3,1,10,6,4,15,spain2,0.5,0.88,4,1.25,1.88,2.0,1.14,3
Albacete,8,4,2,2,14,10,4,14,spain2,0.5,0.75,4,1.75,1.75,2.0,1.33,4
Racing,8,4,2,2,13,10,3,14,spain2,0.5,0.75,3,1.62,1.75,2.0,1.33,4
Real Oviedo,8,3,3,2,8,5,3,12,spain2,0.38,0.75,3,1.0,1.5,2.63,1.33,5
Eibar,8,2,6,0,9,7,2,12,spain2,0.25,1.0,2,1.12,1.5,4.0,1.0,5
Deportivo,8,2,5,1,10,9,1,11,spain2,0.25,0.88,1,1.25,1.38,4.0,1.14,6
Cadiz,8,3,2,3,7,6,1,11,spain2,0.38,0.62,1,0.88,1.38,2.63,1.61,6
Mirandes,8,3,2,3,12,13,-1,11,spain2,0.38,0.62,-1,1.5,1.38,2.63,1.61,6
Almeria,8,3,1,4,12,15,-3,10,spain2,0.38,0.5,-3,1.5,1.25,2.63,2.0,7
Cordoba,8,1,6,1,8,8,0,9,spain2,0.12,0.88,0,1.0,1.12,8.33,1.14,8
Eldense,8,2,3,3,9,10,-1,9,spain2,0.25,0.62,-1,1.12,1.12,4.0,1.61,8
Sporting Gijon,8,2,2,4,10,13,-3,8,spain2,0.25,0.5,-3,1.25,1.0,4.0,2.0,9
Castellon,8,1,4,3,14,15,-1,7,spain2,0.12,0.62,-1,1.75,0.88,8.33,1.61,10
Malaga,8,2,1,5,6,10,-4,7,spain2,0.25,0.38,-4,0.75,0.88,4.0,2.63,10
Huesca,8,2,1,5,9,14,-5,7,spain2,0.25,0.38,-5,1.12,0.88,4.0,2.63,10
Real Zaragoza,8,1,3,4,10,19,-9,6,spain2,0.12,0.5,-9,1.25,0.75,8.33,2.0,11
Racing Ferrol,8,1,1,6,1,11,-10,4,spain2,0.12,0.25,-10,0.12,0.5,8.33,4.0,12
Cartagena,8,0,2,6,8,17,-9,2,spain2,0.0,0.25,-9,1.0,0.25,0.0,4.0,13
FC Andorra,8,4,3,1,12,5,7,15,spain3,0.5,0.88,7,1.5,1.88,2.0,1.14,1
Celta Vigo B,8,4,3,1,13,8,5,15,spain3,0.5,0.88,5,1.62,1.88,2.0,1.14,1
Ponferradina,8,5,0,3,12,11,1,15,spain3,0.62,0.62,1,1.5,1.88,1.61,1.61,1
Gimnastic T.,8,4,2,2,18,8,10,14,spain3,0.5,0.75,10,2.25,1.75,2.0,1.33,2
Ourense CF,8,4,2,2,9,7,2,14,spain3,0.5,0.75,2,1.12,1.75,2.0,1.33,2
Athletic B. B,8,3,4,1,11,8,3,13,spain3,0.38,0.88,3,1.38,1.62,2.63,1.14,3
Tarazona,8,3,4,1,7,4,3,13,spain3,0.38,0.88,3,0.88,1.62,2.63,1.14,3
Sestao River,8,3,3,2,14,12,2,12,spain3,0.38,0.75,2,1.75,1.5,2.63,1.33,4
Zamora,8,3,3,2,8,6,2,12,spain3,0.38,0.75,2,1.0,1.5,2.63,1.33,4
Lugo,8,4,0,4,7,10,-3,12,spain3,0.5,0.5,-3,0.88,1.5,2.0,2.0,4
FC Barcelona B,8,3,2,3,11,11,0,11,spain3,0.38,0.62,0,1.38,1.38,2.63,1.61,5
Real Sociedad B,8,3,2,3,6,6,0,11,spain3,0.38,0.62,0,0.75,1.38,2.63,1.61,5
Osasuna B,8,3,2,3,12,13,-1,11,spain3,0.38,0.62,-1,1.5,1.38,2.63,1.61,5
Gimnastica,8,2,4,2,8,12,-4,10,spain3,0.25,0.75,-4,1.0,1.25,4.0,1.33,6
Leonesa,8,2,3,3,6,9,-3,9,spain3,0.25,0.62,-3,0.75,1.12,4.0,1.61,7
Real Union,8,2,2,4,8,12,-4,8,spain3,0.25,0.5,-4,1.0,1.0,4.0,2.0,8
Barakaldo,8,1,3,4,9,12,-3,6,spain3,0.12,0.5,-3,1.12,0.75,8.33,2.0,9
Amorebieta,8,1,3,4,6,9,-3,6,spain3,0.12,0.5,-3,0.75,0.75,8.33,2.0,9
Arenteiro,8,1,3,4,5,8,-3,6,spain3,0.12,0.5,-3,0.62,0.75,8.33,2.0,9
Unionistas,8,1,2,5,3,11,-8,5,spain3,0.12,0.38,-8,0.38,0.62,8.33,2.63,10
Merida,8,5,2,1,13,9,4,17,spain4,0.62,0.88,4,1.62,2.12,1.61,1.14,1
Ceuta,8,4,4,0,11,6,5,16,spain4,0.5,1.0,5,1.38,2.0,2.0,1.0,2
Algeciras,8,4,3,1,12,7,5,15,spain4,0.5,0.88,5,1.5,1.88,2.0,1.14,3
Alcorcon,8,5,0,3,12,9,3,15,spain4,0.62,0.62,3,1.5,1.88,1.61,1.61,3
Real Murcia,8,4,2,2,11,6,5,14,spain4,0.5,0.75,5,1.38,1.75,2.0,1.33,4
Atletico M. B,8,3,3,2,10,7,3,12,spain4,0.38,0.75,3,1.25,1.5,2.63,1.33,5
Hercules,8,3,3,2,13,11,2,12,spain4,0.38,0.75,2,1.62,1.5,2.63,1.33,5
Real Betis B,8,3,3,2,9,7,2,12,spain4,0.38,0.75,2,1.12,1.5,2.63,1.33,5
UD Ibiza,8,3,2,3,10,9,1,11,spain4,0.38,0.62,1,1.25,1.38,2.63,1.61,6
Sevilla FC B,8,3,2,3,7,6,1,11,spain4,0.38,0.62,1,0.88,1.38,2.63,1.61,6
Sanluqueno,8,2,4,2,10,10,0,10,spain4,0.25,0.75,0,1.25,1.25,4.0,1.33,7
Marbella,8,3,1,4,8,11,-3,10,spain4,0.38,0.5,-3,1.0,1.25,2.63,2.0,7
Antequera,8,3,1,4,11,16,-5,10,spain4,0.38,0.5,-5,1.38,1.25,2.63,2.0,7
Real Madrid B,8,1,6,1,7,5,2,9,spain4,0.12,0.88,2,0.88,1.12,8.33,1.14,8
Fuenlabrada,8,2,3,3,11,10,1,9,spain4,0.25,0.62,1,1.38,1.12,4.0,1.61,8
Villarreal B,8,2,3,3,8,8,0,9,spain4,0.25,0.62,0,1.0,1.12,4.0,1.61,8
Yeclano,8,1,4,3,7,9,-2,7,spain4,0.12,0.62,-2,0.88,0.88,8.33,1.61,9
Recreativo H.,8,1,3,4,3,12,-9,6,spain4,0.12,0.5,-9,0.38,0.75,8.33,2.0,10
Intercity,8,1,2,5,5,12,-7,5,spain4,0.12,0.38,-7,0.62,0.62,8.33,2.63,11
Alcoyano,8,1,1,6,7,15,-8,4,spain4,0.12,0.25,-8,0.88,0.5,8.33,4.0,12
Rayo Cantabria,8,5,1,2,13,6,7,16,spain5,0.62,0.75,7,1.62,2.0,1.61,1.33,1
Pontevedra,8,5,1,2,13,10,3,16,spain5,0.62,0.75,3,1.62,2.0,1.61,1.33,1
Real Aviles,8,4,3,1,12,8,4,15,spain5,0.5,0.88,4,1.5,1.88,2.0,1.14,2
D. Fabril,8,4,2,2,14,8,6,14,spain5,0.5,0.75,6,1.75,1.75,2.0,1.33,3
Langreo,8,4,2,2,10,7,3,14,spain5,0.5,0.75,3,1.25,1.75,2.0,1.33,3
Numancia,8,4,1,3,14,7,7,13,spain5,0.5,0.62,7,1.75,1.62,2.0,1.61,4
Salamanca CF,8,4,1,3,11,8,3,13,spain5,0.5,0.62,3,1.38,1.62,2.0,1.61,4
Escobedo,8,3,3,2,11,7,4,12,spain5,0.38,0.75,4,1.38,1.5,2.63,1.33,5
Coruxo,8,3,3,2,9,7,2,12,spain5,0.38,0.75,2,1.12,1.5,2.63,1.33,5
Torrelavega,8,3,2,3,16,11,5,11,spain5,0.38,0.62,5,2.0,1.38,2.63,1.61,6
Bergantinos,8,3,2,3,11,12,-1,11,spain5,0.38,0.62,-1,1.38,1.38,2.63,1.61,6
Llanera,8,2,4,2,8,9,-1,10,spain5,0.25,0.75,-1,1.0,1.25,4.0,1.33,7
Compostela,8,3,1,4,9,11,-2,10,spain5,0.38,0.5,-2,1.12,1.25,2.63,2.0,7
Marino de L.,8,2,3,3,8,10,-2,9,spain5,0.25,0.62,-2,1.0,1.12,4.0,1.61,8
Valladolid B,8,3,0,5,10,15,-5,9,spain5,0.38,0.38,-5,1.25,1.12,2.63,2.63,8
Real Avila,8,2,2,4,7,10,-3,8,spain5,0.25,0.5,-3,0.88,1.0,4.0,2.0,9
Laredo,8,1,2,5,5,19,-14,5,spain5,0.12,0.38,-14,0.62,0.62,8.33,2.63,10
Guijuelo,8,1,0,7,4,19,-15,3,spain5,0.12,0.12,-15,0.5,0.38,8.33,8.33,11
Arenas Club,8,6,2,0,15,4,11,20,spain6,0.75,1.0,11,1.88,2.5,1.33,1.0,1
Alaves B,8,6,2,0,15,5,10,20,spain6,0.75,1.0,10,1.88,2.5,1.33,1.0,1
SD Logrones,8,6,2,0,13,5,8,20,spain6,0.75,1.0,8,1.62,2.5,1.33,1.0,1
Utebo,8,4,3,1,12,8,4,15,spain6,0.5,0.88,4,1.5,1.88,2.0,1.14,2
Teruel,8,4,2,2,11,6,5,14,spain6,0.5,0.75,5,1.38,1.75,2.0,1.33,3
Barbastro,8,4,1,3,10,7,3,13,spain6,0.5,0.62,3,1.25,1.62,2.0,1.61,4
Real Zaragoza B,8,4,1,3,11,9,2,13,spain6,0.5,0.62,2,1.38,1.62,2.0,1.61,4
UD Logrones,8,3,2,3,9,5,4,11,spain6,0.38,0.62,4,1.12,1.38,2.63,1.61,5
Tudelano,8,3,2,3,11,9,2,11,spain6,0.38,0.62,2,1.38,1.38,2.63,1.61,5
Calahorra,8,3,1,4,6,11,-5,10,spain6,0.38,0.5,-5,0.75,1.25,2.63,2.0,6
Eibar B,8,2,3,3,9,8,1,9,spain6,0.25,0.62,1,1.12,1.12,4.0,1.61,7
Anguiano,8,2,2,4,6,12,-6,8,spain6,0.25,0.5,-6,0.75,1.0,4.0,2.0,8
Gernika,8,2,2,4,6,15,-9,8,spain6,0.25,0.5,-9,0.75,1.0,4.0,2.0,8
Subiza,8,2,1,5,9,13,-4,7,spain6,0.25,0.38,-4,1.12,0.88,4.0,2.63,9
Alfaro,8,2,1,5,7,15,-8,7,spain6,0.25,0.38,-8,0.88,0.88,4.0,2.63,9
Real Sociedad C,8,2,0,6,8,15,-7,6,spain6,0.25,0.25,-7,1.0,0.75,4.0,4.0,10
Ejea,8,0,5,3,7,10,-3,5,spain6,0.0,0.62,-3,0.88,0.62,0.0,1.61,11
Izarra,8,1,0,7,7,15,-8,3,spain6,0.12,0.12,-8,0.88,0.38,8.33,8.33,12
Europa,8,7,1,0,13,3,10,22,spain7,0.88,1.0,10,1.62,2.75,1.14,1.0,1
Andratx,8,6,1,1,13,6,7,19,spain7,0.75,0.88,7,1.62,2.38,1.33,1.14,2
Sabadell,8,6,0,2,19,6,13,18,spain7,0.75,0.75,13,2.38,2.25,1.33,1.33,3
A. Baleares,8,5,3,0,14,5,9,18,spain7,0.62,1.0,9,1.75,2.25,1.61,1.0,3
Sant Andreu,8,4,2,2,18,11,7,14,spain7,0.5,0.75,7,2.25,1.75,2.0,1.33,4
Olot,8,4,2,2,11,7,4,14,spain7,0.5,0.75,4,1.38,1.75,2.0,1.33,4
SD Ibiza,8,4,1,3,11,9,2,13,spain7,0.5,0.62,2,1.38,1.62,2.0,1.61,5
Cornella,8,4,0,4,15,15,0,12,spain7,0.5,0.5,0,1.88,1.5,2.0,2.0,6
Torrent,8,3,2,3,11,9,2,11,spain7,0.38,0.62,2,1.38,1.38,2.63,1.61,7
Valencia B,8,3,2,3,11,10,1,11,spain7,0.38,0.62,1,1.38,1.38,2.63,1.61,7
Ilicitano,8,3,1,4,10,12,-2,10,spain7,0.38,0.5,-2,1.25,1.25,2.63,2.0,8
Terrassa,8,3,1,4,9,11,-2,10,spain7,0.38,0.5,-2,1.12,1.25,2.63,2.0,8
Espanyol B,8,2,3,3,7,7,0,9,spain7,0.25,0.62,0,0.88,1.12,4.0,1.61,9
Lleida,8,1,4,3,4,8,-4,7,spain7,0.12,0.62,-4,0.5,0.88,8.33,1.61,10
Mallorca B,8,2,1,5,9,15,-6,7,spain7,0.25,0.38,-6,1.12,0.88,4.0,2.63,10
Pena Deportiva,8,1,3,4,8,12,-4,6,spain7,0.12,0.5,-4,1.0,0.75,8.33,2.0,11
Badalona,8,0,1,7,4,22,-18,1,spain7,0.0,0.12,-18,0.5,0.12,0.0,8.33,12
Alzira,8,0,0,8,1,20,-19,0,spain7,0.0,0.0,-19,0.12,0.0,0.0,0.0,13
La Union,8,6,1,1,11,3,8,19,spain8,0.75,0.88,8,1.38,2.38,1.33,1.14,1
Antoniano,8,6,1,1,14,8,6,19,spain8,0.75,0.88,6,1.75,2.38,1.33,1.14,1
CD Estepona,8,6,1,1,11,6,5,19,spain8,0.75,0.88,5,1.38,2.38,1.33,1.14,1
Torremolinos,8,6,0,2,14,6,8,18,spain8,0.75,0.75,8,1.75,2.25,1.33,1.33,2
UCAM Murcia,8,4,2,2,12,8,4,14,spain8,0.5,0.75,4,1.5,1.75,2.0,1.33,3
Xerez D. FC,8,4,1,3,9,9,0,13,spain8,0.5,0.62,0,1.12,1.62,2.0,1.61,4
Aguilas CF,8,4,1,3,6,6,0,13,spain8,0.5,0.62,0,0.75,1.62,2.0,1.61,4
Villanovense,8,4,1,3,6,6,0,13,spain8,0.5,0.62,0,0.75,1.62,2.0,1.61,4
Xerez CD,8,3,1,4,10,9,1,10,spain8,0.38,0.5,1,1.25,1.25,2.63,2.0,5
Orihuela,8,3,1,4,5,8,-3,10,spain8,0.38,0.5,-3,0.62,1.25,2.63,2.0,5
Almeria B,8,3,1,4,8,13,-5,10,spain8,0.38,0.5,-5,1.0,1.25,2.63,2.0,5
D. Minera,8,3,0,5,13,12,1,9,spain8,0.38,0.38,1,1.62,1.12,2.63,2.63,6
Cadiz B,8,2,3,3,9,9,0,9,spain8,0.25,0.62,0,1.12,1.12,4.0,1.61,6
Linares,8,2,3,3,8,9,-1,9,spain8,0.25,0.62,-1,1.0,1.12,4.0,1.61,6
Don Benito,8,2,1,5,9,13,-4,7,spain8,0.25,0.38,-4,1.12,0.88,4.0,2.63,7
San Fernando,8,1,2,5,5,10,-5,5,spain8,0.12,0.38,-5,0.62,0.62,8.33,2.63,8
Linense,8,1,1,6,2,8,-6,4,spain8,0.12,0.25,-6,0.25,0.5,8.33,4.0,9
Granada B,8,1,0,7,2,12,-10,3,spain8,0.12,0.12,-10,0.25,0.38,8.33,8.33,10
S. Sebastian R.,8,6,2,0,14,4,10,20,spain9,0.75,1.0,10,1.75,2.5,1.33,1.0,1
Cacereno,8,5,3,0,15,6,9,18,spain9,0.62,1.0,9,1.88,2.25,1.61,1.0,2
Navalcarnero,8,5,1,2,12,7,5,16,spain9,0.62,0.75,5,1.5,2.0,1.61,1.33,3
Guadalajara,8,5,1,2,12,8,4,16,spain9,0.62,0.75,4,1.5,2.0,1.61,1.33,3
Talavera CF,8,3,3,2,10,5,5,12,spain9,0.38,0.75,5,1.25,1.5,2.63,1.33,4
CD Mostoles,8,4,0,4,18,15,3,12,spain9,0.5,0.5,3,2.25,1.5,2.0,2.0,4
Melilla,8,3,3,2,11,11,0,12,spain9,0.38,0.75,0,1.38,1.5,2.63,1.33,4
Real Madrid C,8,3,2,3,7,6,1,11,spain9,0.38,0.62,1,0.88,1.38,2.63,1.61,5
CD Coria,8,2,4,2,10,11,-1,10,spain9,0.25,0.75,-1,1.25,1.25,4.0,1.33,6
R. Majadahonda,8,2,4,2,2,4,-2,10,spain9,0.25,0.75,-2,0.25,1.25,4.0,1.33,6
Illescas,8,2,3,3,9,10,-1,9,spain9,0.25,0.62,-1,1.12,1.12,4.0,1.61,7
Colonia M.,8,2,3,3,8,13,-5,9,spain9,0.25,0.62,-5,1.0,1.12,4.0,1.61,7
Getafe B,8,2,2,4,10,11,-1,8,spain9,0.25,0.5,-1,1.25,1.0,4.0,2.0,8
Atletico Paso,8,2,2,4,8,12,-4,8,spain9,0.25,0.5,-4,1.0,1.0,4.0,2.0,8
Conquense,8,2,2,4,4,9,-5,8,spain9,0.25,0.5,-5,0.5,1.0,4.0,2.0,8
Union Adarve,8,1,3,4,2,5,-3,6,spain9,0.12,0.5,-3,0.25,0.75,8.33,2.0,9
Tenerife B,8,1,3,4,7,12,-5,6,spain9,0.12,0.5,-5,0.88,0.75,8.33,2.0,9
Yaiza,8,0,3,5,2,12,-10,3,spain9,0.0,0.38,-10,0.25,0.38,0.0,2.63,10
AIK,6,5,1,0,10,4,6,16,sweden,0.83,1.0,6,1.67,2.67,1.2,1.0,1
Mjallby,6,4,2,0,16,6,10,14,sweden,0.67,1.0,10,2.67,2.33,1.49,1.0,2
Hammarby,6,4,1,1,12,4,8,13,sweden,0.67,0.83,8,2.0,2.17,1.49,1.2,3
Elfsborg,6,3,1,2,10,9,1,10,sweden,0.5,0.67,1,1.67,1.67,2.0,1.49,4
Norrkoping,6,3,0,3,15,13,2,9,sweden,0.5,0.5,2,2.5,1.5,2.0,2.0,5
Degerfors,6,3,0,3,11,10,1,9,sweden,0.5,0.5,1,1.83,1.5,2.0,2.0,5
IFK Goteborg,5,3,0,2,7,9,-2,9,sweden,0.6,0.6,-2,1.4,1.8,1.67,1.67,5
Malmo FF,5,2,2,1,4,4,0,8,sweden,0.4,0.8,0,0.8,1.6,2.5,1.25,6
Brommapojkarna,5,2,1,2,7,7,0,7,sweden,0.4,0.6,0,1.4,1.4,2.5,1.67,7
Djurgarden,5,2,1,2,2,3,-1,7,sweden,0.4,0.6,-1,0.4,1.4,2.5,1.67,7
Hacken,6,2,1,3,9,12,-3,7,sweden,0.33,0.5,-3,1.5,1.17,3.03,2.0,7
GAIS,5,1,3,1,4,3,1,6,sweden,0.2,0.8,1,0.8,1.2,5.0,1.25,8
Sirius,6,1,2,3,7,11,-4,5,sweden,0.17,0.5,-4,1.17,0.83,5.88,2.0,9
Halmstad,6,1,1,4,3,13,-10,4,sweden,0.17,0.33,-10,0.5,0.67,5.88,3.03,10
Oster,5,1,0,4,5,7,-2,3,sweden,0.2,0.2,-2,1.0,0.6,5.0,5.0,11
Varnamo,6,0,0,6,5,12,-7,0,sweden,0.0,0.0,-7,0.83,0.0,0.0,0.0,12
Kalmar,5,4,1,0,11,2,9,13,sweden2,0.8,1.0,9,2.2,2.6,1.25,1.0,1
Varberg BoIS,5,3,2,0,13,4,9,11,sweden2,0.6,1.0,9,2.6,2.2,1.67,1.0,2
Landskrona,5,3,2,0,10,7,3,11,sweden2,0.6,1.0,3,2.0,2.2,1.67,1.0,2
Orgryte,5,2,2,1,7,4,3,8,sweden2,0.4,0.8,3,1.4,1.6,2.5,1.25,3
Ostersunds,5,2,2,1,8,8,0,8,sweden2,0.4,0.8,0,1.6,1.6,2.5,1.25,3
Brage,5,2,2,1,5,5,0,8,sweden2,0.4,0.8,0,1.0,1.6,2.5,1.25,3
GIF Sundsvall,5,2,1,2,5,4,1,7,sweden2,0.4,0.6,1,1.0,1.4,2.5,1.67,4
Vasteras,4,2,1,1,4,3,1,7,sweden2,0.5,0.75,1,1.0,1.75,2.0,1.33,4
Oddevold,5,2,1,2,7,7,0,7,sweden2,0.4,0.6,0,1.4,1.4,2.5,1.67,4
Sandviken,5,2,1,2,5,6,-1,7,sweden2,0.4,0.6,-1,1.0,1.4,2.5,1.67,4
Helsingborg,5,2,0,3,6,9,-3,6,sweden2,0.4,0.4,-3,1.2,1.2,2.5,2.5,5
Falkenberg,4,1,2,1,6,5,1,5,sweden2,0.25,0.75,1,1.5,1.25,4.0,1.33,6
Utsikten,4,1,0,3,6,7,-1,3,sweden2,0.25,0.25,-1,1.5,0.75,4.0,4.0,7
Trelleborg,5,1,0,4,1,8,-7,3,sweden2,0.2,0.2,-7,0.2,0.6,5.0,5.0,7
Umea,5,0,1,4,2,9,-7,1,sweden2,0.0,0.2,-7,0.4,0.2,0.0,5.0,8
Orebro,4,0,0,4,1,9,-8,0,sweden2,0.0,0.0,-8,0.25,0.0,0.0,0.0,9
FC Basel,8,6,1,1,19,4,15,19,switzerland,0.75,0.88,15,2.38,2.38,1.33,1.14,1
BSC Young Boys,8,5,1,2,10,9,1,16,switzerland,0.62,0.75,1,1.25,2.0,1.61,1.33,2
Servette,8,4,1,3,11,8,3,13,switzerland,0.5,0.62,3,1.38,1.62,2.0,1.61,3
Winterthur,8,4,1,3,10,7,3,13,switzerland,0.5,0.62,3,1.25,1.62,2.0,1.61,3
FC Zurich,8,3,2,3,12,14,-2,11,switzerland,0.38,0.62,-2,1.5,1.38,2.63,1.61,4
St. Gallen,8,3,2,3,7,10,-3,11,switzerland,0.38,0.62,-3,0.88,1.38,2.63,1.61,4
Grasshopper,8,3,1,4,10,11,-1,10,switzerland,0.38,0.5,-1,1.25,1.25,2.63,2.0,5
Lausanne Sport,8,3,1,4,9,11,-2,10,switzerland,0.38,0.5,-2,1.12,1.25,2.63,2.0,5
Luzern,8,2,3,3,17,13,4,9,switzerland,0.25,0.62,4,2.12,1.12,4.0,1.61,6
Yverdon,8,2,3,3,10,16,-6,9,switzerland,0.25,0.62,-6,1.25,1.12,4.0,1.61,6
Lugano,8,2,1,5,6,13,-7,7,switzerland,0.25,0.38,-7,0.75,0.88,4.0,2.63,7
Sion,8,1,3,4,6,11,-5,6,switzerland,0.12,0.5,-5,0.75,0.75,8.33,2.0,8
Thun,8,6,1,1,18,5,13,19,switzerland2,0.75,0.88,13,2.25,2.38,1.33,1.14,1
Vaduz,8,4,2,2,13,9,4,14,switzerland2,0.5,0.75,4,1.62,1.75,2.0,1.33,2
Etoile Carouge,8,3,3,2,16,8,8,12,switzerland2,0.38,0.75,8,2.0,1.5,2.63,1.33,3
Wil,8,3,3,2,14,17,-3,12,switzerland2,0.38,0.75,-3,1.75,1.5,2.63,1.33,3
Lausanne Ouchy,8,3,2,3,10,8,2,11,switzerland2,0.38,0.62,2,1.25,1.38,2.63,1.61,4
Aarau,8,1,7,0,13,11,2,10,switzerland2,0.12,1.0,2,1.62,1.25,8.33,1.0,5
Neuchatel Xamax,8,2,2,4,13,11,2,8,switzerland2,0.25,0.5,2,1.62,1.0,4.0,2.0,6
Schaffhausen,8,2,2,4,10,17,-7,8,switzerland2,0.25,0.5,-7,1.25,1.0,4.0,2.0,6
Bellinzona,8,2,2,4,9,21,-12,8,switzerland2,0.25,0.5,-12,1.12,1.0,4.0,2.0,6
Stade Nyonnais,8,2,0,6,6,15,-9,6,switzerland2,0.25,0.25,-9,0.75,0.75,4.0,4.0,7
Bangkok Utd,8,7,1,0,19,5,14,22,thailand,0.88,1.0,14,2.38,2.75,1.14,1.0,1
Ratchaburi,8,6,0,2,24,13,11,18,thailand,0.75,0.75,11,3.0,2.25,1.33,1.33,2
Pathum Utd,8,5,2,1,15,10,5,17,thailand,0.62,0.88,5,1.88,2.12,1.61,1.14,3
Buriram Utd,8,5,1,2,17,9,8,16,thailand,0.62,0.75,8,2.12,2.0,1.61,1.33,4
Prachuap,8,4,1,3,14,9,5,13,thailand,0.5,0.62,5,1.75,1.62,2.0,1.61,5
Port FC,8,3,3,2,13,12,1,12,thailand,0.38,0.75,1,1.62,1.5,2.63,1.33,6
Chiangrai Utd,8,3,1,4,13,13,0,10,thailand,0.38,0.5,0,1.62,1.25,2.63,2.0,7
Rayong,8,3,1,4,13,13,0,10,thailand,0.38,0.5,0,1.62,1.25,2.63,2.0,7
Muang Thong Utd,8,3,1,4,12,14,-2,10,thailand,0.38,0.5,-2,1.5,1.25,2.63,2.0,7
Lamphun Warrior,8,2,3,3,8,9,-1,9,thailand,0.25,0.62,-1,1.0,1.12,4.0,1.61,8
Uthai Thani,8,1,5,2,7,8,-1,8,thailand,0.12,0.75,-1,0.88,1.0,8.33,1.33,9
Sukhothai,8,1,4,3,15,18,-3,7,thailand,0.12,0.62,-3,1.88,0.88,8.33,1.61,10
Khon Kaen Utd,8,2,1,5,10,22,-12,7,thailand,0.25,0.38,-12,1.25,0.88,4.0,2.63,10
Nakhon Pathom,8,1,3,4,8,14,-6,6,thailand,0.12,0.5,-6,1.0,0.75,8.33,2.0,11
N. Bua Pitchaya,8,1,3,4,6,12,-6,6,thailand,0.12,0.5,-6,0.75,0.75,8.33,2.0,11
N. Ratchasima,8,1,2,5,9,20,-11,5,thailand,0.12,0.38,-11,1.12,0.62,8.33,2.63,12
Chonburi,8,7,0,1,16,7,9,21,thailand2,0.88,0.88,9,2.0,2.62,1.14,1.14,1
Ayutthaya Utd,8,4,2,2,19,8,11,14,thailand2,0.5,0.75,11,2.38,1.75,2.0,1.33,2
Police Tero,8,4,2,2,12,11,1,14,thailand2,0.5,0.75,1,1.5,1.75,2.0,1.33,2
Kanchanaburi,8,3,4,1,17,10,7,13,thailand2,0.38,0.88,7,2.12,1.62,2.63,1.14,3
Chainat,8,4,1,3,13,10,3,13,thailand2,0.5,0.62,3,1.62,1.62,2.0,1.61,3
Chanthaburi,8,3,3,2,11,13,-2,12,thailand2,0.38,0.75,-2,1.38,1.5,2.63,1.33,4
Mahasarakham,8,2,5,1,9,7,2,11,thailand2,0.25,0.88,2,1.12,1.38,4.0,1.14,5
Chiangmai Utd,8,3,2,3,10,10,0,11,thailand2,0.38,0.62,0,1.25,1.38,2.63,1.61,5
Nakhon Si,8,3,2,3,9,9,0,11,thailand2,0.38,0.62,0,1.12,1.38,2.63,1.61,5
Lampang,8,3,2,3,9,10,-1,11,thailand2,0.38,0.62,-1,1.12,1.38,2.63,1.61,5
Phrae Utd,8,2,4,2,16,12,4,10,thailand2,0.25,0.75,4,2.0,1.25,4.0,1.33,6
Kasetsart,8,2,3,3,8,9,-1,9,thailand2,0.25,0.62,-1,1.0,1.12,4.0,1.61,7
Bangkok FC,8,2,3,3,12,15,-3,9,thailand2,0.25,0.62,-3,1.5,1.12,4.0,1.61,7
Trat FC,8,2,2,4,10,12,-2,8,thailand2,0.25,0.5,-2,1.25,1.0,4.0,2.0,8
Sisaket Utd,8,2,1,5,5,14,-9,7,thailand2,0.25,0.38,-9,0.62,0.88,4.0,2.63,9
Pattaya United,8,1,1,6,5,18,-13,4,thailand2,0.12,0.25,-13,0.62,0.5,8.33,4.0,10
Suphanburi,8,0,3,5,9,19,-10,3,thailand2,0.0,0.38,-10,1.12,0.38,0.0,2.63,11
Samut Prakan,0,0,0,0,0,0,0,0,thailand2,0.0,0.0,0,0.0,0.0,0.0,0.0,12
Fenerbahce,8,5,3,0,20,8,12,18,turkey,0.62,1.0,12,2.5,2.25,1.61,1.0,1
Konyaspor,8,6,0,2,11,6,5,18,turkey,0.75,0.75,5,1.38,2.25,1.33,1.33,1
Galatasaray,8,5,2,1,19,7,12,17,turkey,0.62,0.88,12,2.38,2.12,1.61,1.14,2
Kayserispor,8,5,1,2,15,7,8,16,turkey,0.62,0.75,8,1.88,2.0,1.61,1.33,3
Basaksehir,8,5,0,3,10,9,1,15,turkey,0.62,0.62,1,1.25,1.88,1.61,1.61,4
Trabzonspor,8,4,1,3,13,11,2,13,turkey,0.5,0.62,2,1.62,1.62,2.0,1.61,5
Gaziantep,8,4,1,3,11,10,1,13,turkey,0.5,0.62,1,1.38,1.62,2.0,1.61,5
Antalyaspor,8,4,1,3,8,13,-5,13,turkey,0.5,0.62,-5,1.0,1.62,2.0,1.61,5
Besiktas,8,3,2,3,12,9,3,11,turkey,0.38,0.62,3,1.5,1.38,2.63,1.61,6
Kasimpasa,8,3,2,3,12,10,2,11,turkey,0.38,0.62,2,1.5,1.38,2.63,1.61,6
Bodrumspor,8,3,2,3,7,8,-1,11,turkey,0.38,0.62,-1,0.88,1.38,2.63,1.61,6
Sivasspor,8,3,1,4,15,13,2,10,turkey,0.38,0.5,2,1.88,1.25,2.63,2.0,7
Eyupspor,8,3,1,4,13,14,-1,10,turkey,0.38,0.5,-1,1.62,1.25,2.63,2.0,7
Rizespor,8,3,1,4,9,11,-2,10,turkey,0.38,0.5,-2,1.12,1.25,2.63,2.0,7
Samsunspor,8,2,2,4,8,12,-4,8,turkey,0.25,0.5,-4,1.0,1.0,4.0,2.0,8
Alanyaspor,8,2,0,6,11,16,-5,6,turkey,0.25,0.25,-5,1.38,0.75,4.0,4.0,9
Hatayspor,8,2,0,6,9,20,-11,6,turkey,0.25,0.25,-11,1.12,0.75,4.0,4.0,9
Goztepe,8,0,5,3,7,11,-4,5,turkey,0.0,0.62,-4,0.88,0.62,0.0,1.61,10
Adana Demirspor,8,0,1,7,6,23,-17,1,turkey,0.0,0.12,-17,0.75,0.12,0.0,8.33,11
Igdir,8,4,4,0,23,3,20,16,turkey2,0.5,1.0,20,2.88,2.0,2.0,1.0,1
Istanbulspor,8,5,0,3,19,9,10,15,turkey2,0.62,0.62,10,2.38,1.88,1.61,1.61,2
Umraniyespor,8,4,3,1,12,3,9,15,turkey2,0.5,0.88,9,1.5,1.88,2.0,1.14,2
Erokspor,8,4,3,1,15,9,6,15,turkey2,0.5,0.88,6,1.88,1.88,2.0,1.14,2
Genclerbirligi,8,4,2,2,13,9,4,14,turkey2,0.5,0.75,4,1.62,1.75,2.0,1.33,3
Bandirmaspor,8,3,5,0,11,7,4,14,turkey2,0.38,1.0,4,1.38,1.75,2.63,1.0,3
Boluspor,8,4,2,2,13,10,3,14,turkey2,0.5,0.75,3,1.62,1.75,2.0,1.33,3
F. Karagumruk,8,4,2,2,8,5,3,14,turkey2,0.5,0.75,3,1.0,1.75,2.0,1.33,3
Amed SK,8,4,2,2,8,8,0,14,turkey2,0.5,0.75,0,1.0,1.75,2.0,1.33,3
Erzurum BB,8,4,1,3,11,7,4,13,turkey2,0.5,0.62,4,1.38,1.62,2.0,1.61,4
Sakaryaspor,8,4,1,3,13,13,0,13,turkey2,0.5,0.62,0,1.62,1.62,2.0,1.61,4
Kocaelispor,8,3,3,2,22,14,8,12,turkey2,0.38,0.75,8,2.75,1.5,2.63,1.33,5
Corum,8,3,3,2,14,13,1,12,turkey2,0.38,0.75,1,1.75,1.5,2.63,1.33,5
Manisa BB,8,3,2,3,13,11,2,11,turkey2,0.38,0.62,2,1.62,1.38,2.63,1.61,6
Keciorengucu,8,3,0,5,12,12,0,9,turkey2,0.38,0.38,0,1.5,1.12,2.63,2.63,7
Sanliurfaspor,8,2,1,5,9,15,-6,7,turkey2,0.25,0.38,-6,1.12,0.88,4.0,2.63,8
Pendikspor,8,1,2,5,6,14,-8,5,turkey2,0.12,0.38,-8,0.75,0.62,8.33,2.63,9
Ankaragucu,8,1,2,5,7,17,-10,5,turkey2,0.12,0.38,-10,0.88,0.62,8.33,2.63,9
Adanaspor,8,1,0,7,7,19,-12,3,turkey2,0.12,0.12,-12,0.88,0.38,8.33,8.33,10
Y. Malatyaspor,8,0,0,8,2,40,-38,0,turkey2,0.0,0.0,-38,0.25,0.0,0.0,0.0,11
B. Petrolspor,8,6,1,1,16,4,12,19,turkey3,0.75,0.88,12,2.0,2.38,1.33,1.14,1
Sariyer,8,6,1,1,17,7,10,19,turkey3,0.75,0.88,10,2.12,2.38,1.33,1.14,1
B. Anadolu,8,5,2,1,16,10,6,17,turkey3,0.62,0.88,6,2.0,2.12,1.61,1.14,2
Trabzon FK,8,5,1,2,13,5,8,16,turkey3,0.62,0.75,8,1.62,2.0,1.61,1.33,3
Kastamonuspor,8,4,3,1,12,9,3,15,turkey3,0.5,0.88,3,1.5,1.88,2.0,1.14,4
Ankaraspor,8,4,2,2,14,6,8,14,turkey3,0.5,0.75,8,1.75,1.75,2.0,1.33,5
Adana,8,4,2,2,12,7,5,14,turkey3,0.5,0.75,5,1.5,1.75,2.0,1.33,5
Inegolspor,8,3,2,3,13,11,2,11,turkey3,0.38,0.62,2,1.62,1.38,2.63,1.61,6
Kepez Belediyes,8,3,1,4,10,11,-1,10,turkey3,0.38,0.5,-1,1.25,1.25,2.63,2.0,7
Altay,8,3,1,4,10,14,-4,10,turkey3,0.38,0.5,-4,1.25,1.25,2.63,2.0,7
Fethiyespor,8,3,1,4,6,12,-6,10,turkey3,0.38,0.5,-6,0.75,1.25,2.63,2.0,7
Iskenderun,8,2,3,3,13,13,0,9,turkey3,0.25,0.62,0,1.62,1.12,4.0,1.61,8
24 Erzincanspor,8,2,2,4,11,14,-3,8,turkey3,0.25,0.5,-3,1.38,1.0,4.0,2.0,9
Altinordu,8,2,2,4,7,13,-6,8,turkey3,0.25,0.5,-6,0.88,1.0,4.0,2.0,9
Kirklarelispor,8,2,1,5,11,14,-3,7,turkey3,0.25,0.38,-3,1.38,0.88,4.0,2.63,10
Isparta Davrazs,8,2,1,5,11,19,-8,7,turkey3,0.25,0.38,-8,1.38,0.88,4.0,2.63,10
Karakopru,8,2,0,6,8,11,-3,6,turkey3,0.25,0.25,-3,1.0,0.75,4.0,4.0,11
Afyonspor,8,0,0,8,0,24,-24,0,turkey3,0.0,0.0,-24,0.0,0.0,0.0,0.0,12
Karacabey,8,6,1,1,14,5,9,19,turkey4,0.75,0.88,9,1.75,2.38,1.33,1.14,1
Elazigspor,8,6,0,2,15,5,10,18,turkey4,0.75,0.75,10,1.88,2.25,1.33,1.33,2
Yeni Mersin,8,5,2,1,20,4,16,17,turkey4,0.62,0.88,16,2.5,2.12,1.61,1.14,3
Serik Belediyes,8,5,1,2,28,12,16,16,turkey4,0.62,0.75,16,3.5,2.0,1.61,1.33,4
Karaman,8,4,4,0,12,6,6,16,turkey4,0.5,1.0,6,1.5,2.0,2.0,1.0,4
Erbaaspor,8,5,0,3,20,14,6,15,turkey4,0.62,0.62,6,2.5,1.88,1.61,1.61,5
Aksaray B.,8,4,2,2,15,13,2,14,turkey4,0.5,0.75,2,1.88,1.75,2.0,1.33,6
Van Spor,8,4,2,2,11,9,2,14,turkey4,0.5,0.75,2,1.38,1.75,2.0,1.33,6
Beyoglu Yeni C.,8,4,1,3,17,10,7,13,turkey4,0.5,0.62,7,2.12,1.62,2.0,1.61,7
Menemen B.,8,4,1,3,10,9,1,13,turkey4,0.5,0.62,1,1.25,1.62,2.0,1.61,7
Diyarbekirspor,8,4,1,3,9,10,-1,13,turkey4,0.5,0.62,-1,1.12,1.62,2.0,1.61,7
A. Demirspor,8,3,2,3,16,14,2,11,turkey4,0.38,0.62,2,2.0,1.38,2.63,1.61,8
Somaspor,8,3,1,4,11,15,-4,10,turkey4,0.38,0.5,-4,1.38,1.25,2.63,2.0,9
Arnavutkoy B.,8,2,1,5,13,19,-6,7,turkey4,0.25,0.38,-6,1.62,0.88,4.0,2.63,10
Bucaspor,8,2,0,6,9,20,-11,6,turkey4,0.25,0.25,-11,1.12,0.75,4.0,4.0,11
Derince,8,1,1,6,9,22,-13,4,turkey4,0.12,0.25,-13,1.12,0.5,8.33,4.0,12
Giresunspor,8,0,0,8,6,23,-17,0,turkey4,0.0,0.0,-17,0.75,0.0,0.0,0.0,13
Nazillispor,8,0,0,8,4,29,-25,0,turkey4,0.0,0.0,-25,0.5,0.0,0.0,0.0,13
Musspor,8,7,1,0,22,6,16,22,turkey5,0.88,1.0,16,2.75,2.75,1.14,1.0,1
Bursaspor,8,6,1,1,19,6,13,19,turkey5,0.75,0.88,13,2.38,2.38,1.33,1.14,2
Karsiyaka,8,5,1,2,20,9,11,16,turkey5,0.62,0.75,11,2.5,2.0,1.61,1.33,3
Kutahyaspor,8,4,2,2,16,15,1,14,turkey5,0.5,0.75,1,2.0,1.75,2.0,1.33,4
Anadolu U.,8,4,2,2,10,9,1,14,turkey5,0.5,0.75,1,1.25,1.75,2.0,1.33,4
Artvin Hopaspor,8,4,1,3,12,7,5,13,turkey5,0.5,0.62,5,1.5,1.62,2.0,1.61,5
Duzcespor,8,4,1,3,8,10,-2,13,turkey5,0.5,0.62,-2,1.0,1.62,2.0,1.61,5
Silifke,8,4,0,4,11,11,0,12,turkey5,0.5,0.5,0,1.38,1.5,2.0,2.0,6
Ergene Velimese,8,4,0,4,8,15,-7,12,turkey5,0.5,0.5,-7,1.0,1.5,2.0,2.0,6
Tokat,8,3,2,3,12,8,4,11,turkey5,0.38,0.62,4,1.5,1.38,2.63,1.61,7
Kusadasispor,8,2,2,4,6,13,-7,8,turkey5,0.25,0.5,-7,0.75,1.0,4.0,2.0,8
K. Bulvarspor,8,2,2,4,10,20,-10,8,turkey5,0.25,0.5,-10,1.25,1.0,4.0,2.0,8
Kirsehir B.,8,1,3,4,4,10,-6,6,turkey5,0.12,0.5,-6,0.5,0.75,8.33,2.0,9
Kahramanmar.,8,1,2,5,4,8,-4,5,turkey5,0.12,0.38,-4,0.5,0.62,8.33,2.63,10
Elaziz K.,8,0,4,4,5,10,-5,4,turkey5,0.0,0.5,-5,0.62,0.5,0.0,2.0,11
Viven Bornova,8,1,0,7,7,17,-10,3,turkey5,0.12,0.12,-10,0.88,0.38,8.33,8.33,12
Tire 2021 FK,8,7,1,0,21,2,19,22,turkey6,0.88,1.0,19,2.62,2.75,1.14,1.0,1
Beykoz Ishaklis,8,6,0,2,20,8,12,18,turkey6,0.75,0.75,12,2.5,2.25,1.33,1.33,2
Mazidagi,8,5,2,1,19,5,14,17,turkey6,0.62,0.88,14,2.38,2.12,1.61,1.14,3
Muglaspor,8,5,1,2,14,6,8,16,turkey6,0.62,0.75,8,1.75,2.0,1.61,1.33,4
Cayelispor,8,4,3,1,12,5,7,15,turkey6,0.5,0.88,7,1.5,1.88,2.0,1.14,5
Balikesirspor,8,4,2,2,14,8,6,14,turkey6,0.5,0.75,6,1.75,1.75,2.0,1.33,6
Turk Metal 1963,8,4,2,2,16,13,3,14,turkey6,0.5,0.75,3,2.0,1.75,2.0,1.33,6
Inegol Kafkas,8,3,2,3,13,8,5,11,turkey6,0.38,0.62,5,1.62,1.38,2.63,1.61,7
Amasyaspor,8,3,2,3,13,11,2,11,turkey6,0.38,0.62,2,1.62,1.38,2.63,1.61,7
Usakspor,8,2,4,2,8,9,-1,10,turkey6,0.25,0.75,-1,1.0,1.25,4.0,1.33,8
Silivrispor,8,2,2,4,11,12,-1,8,turkey6,0.25,0.5,-1,1.38,1.0,4.0,2.0,9
Etimesgut,8,2,2,4,10,14,-4,8,turkey6,0.25,0.5,-4,1.25,1.0,4.0,2.0,9
Kelkit,8,2,1,5,10,15,-5,7,turkey6,0.25,0.38,-5,1.25,0.88,4.0,2.63,10
Fatsa B.,8,1,1,6,4,19,-15,4,turkey6,0.12,0.25,-15,0.5,0.5,8.33,4.0,11
Nevsehirspor,8,0,2,6,3,32,-29,2,turkey6,0.0,0.25,-29,0.38,0.25,0.0,4.0,12
Adiyaman,8,0,0,8,0,24,-24,0,turkey6,0.0,0.0,-24,0.0,0.0,0.0,0.0,13
Aliaga FAS,8,7,1,0,21,5,16,22,turkey7,0.88,1.0,16,2.62,2.75,1.14,1.0,1
Ayvalikgucu,8,5,3,0,11,4,7,18,turkey7,0.62,1.0,7,1.38,2.25,1.61,1.0,2
Corluspor,8,4,3,1,18,9,9,15,turkey7,0.5,0.88,9,2.25,1.88,2.0,1.14,3
Yozgat Bld Bozo,8,4,1,3,15,14,1,13,turkey7,0.5,0.62,1,1.88,1.62,2.0,1.61,4
Kucukcekmece,8,3,3,2,11,8,3,12,turkey7,0.38,0.75,3,1.38,1.5,2.63,1.33,5
Orduspor,8,3,2,3,16,8,8,11,turkey7,0.38,0.62,8,2.0,1.38,2.63,1.61,6
Alanya 1221,8,3,2,3,14,11,3,11,turkey7,0.38,0.62,3,1.75,1.38,2.63,1.61,6
Pazarspor,8,3,2,3,13,11,2,11,turkey7,0.38,0.62,2,1.62,1.38,2.63,1.61,6
Efeler 09,8,2,5,1,6,5,1,11,turkey7,0.25,0.88,1,0.75,1.38,4.0,1.14,6
Cankaya FK,8,3,1,4,11,21,-10,10,turkey7,0.38,0.5,-10,1.38,1.25,2.63,2.0,7
K. Idmanyurdu,8,2,3,3,8,9,-1,9,turkey7,0.25,0.62,-1,1.0,1.12,4.0,1.61,8
1923 M.,8,2,3,3,11,13,-2,9,turkey7,0.25,0.62,-2,1.38,1.12,4.0,1.61,8
Bayburt,8,2,3,3,5,12,-7,9,turkey7,0.25,0.62,-7,0.62,1.12,4.0,1.61,8
Osmaniyespor,8,2,0,6,11,24,-13,6,turkey7,0.25,0.25,-13,1.38,0.75,4.0,4.0,9
1922 Konyaspor,8,1,2,5,9,15,-6,5,turkey7,0.12,0.38,-6,1.12,0.62,8.33,2.63,10
Viransehir,8,1,0,7,4,15,-11,3,turkey7,0.12,0.12,-11,0.5,0.38,8.33,8.33,11
Sebat G.,8,6,1,1,20,10,10,19,turkey8,0.75,0.88,10,2.5,2.38,1.33,1.14,1
Kirikkale B.,8,6,1,1,15,9,6,19,turkey8,0.75,0.88,6,1.88,2.38,1.33,1.14,1
Mardin BB,8,5,3,0,22,10,12,18,turkey8,0.62,1.0,12,2.75,2.25,1.61,1.0,2
Agri 1970,8,5,3,0,11,6,5,18,turkey8,0.62,1.0,5,1.38,2.25,1.61,1.0,2
Z. Komurspor,8,5,2,1,12,5,7,17,turkey8,0.62,0.88,7,1.5,2.12,1.61,1.14,3
K. Istiklalspor,8,5,1,2,19,11,8,16,turkey8,0.62,0.75,8,2.38,2.0,1.61,1.33,4
Erciyes,8,3,1,4,12,16,-4,10,turkey8,0.38,0.5,-4,1.5,1.25,2.63,2.0,5
Nigde Belediyes,8,2,2,4,8,11,-3,8,turkey8,0.25,0.5,-3,1.0,1.0,4.0,2.0,6
Edirnespor,8,2,2,4,12,16,-4,8,turkey8,0.25,0.5,-4,1.5,1.0,4.0,2.0,6
Tepecik,8,2,2,4,10,15,-5,8,turkey8,0.25,0.5,-5,1.25,1.0,4.0,2.0,6
Turgutluspor,8,2,2,4,9,15,-6,8,turkey8,0.25,0.5,-6,1.12,1.0,4.0,2.0,6
Polatli B.,8,2,1,5,9,13,-4,7,turkey8,0.25,0.38,-4,1.12,0.88,4.0,2.63,7
Orduspor 1967,8,2,1,5,10,16,-6,7,turkey8,0.25,0.38,-6,1.25,0.88,4.0,2.63,7
Denizlispor,8,0,6,2,7,9,-2,6,turkey8,0.0,0.75,-2,0.88,0.75,0.0,1.33,8
Nilufer B.,8,1,2,5,4,9,-5,5,turkey8,0.12,0.38,-5,0.5,0.62,8.33,2.63,9
Coruhlu,8,1,0,7,11,20,-9,3,turkey8,0.12,0.12,-9,1.38,0.38,8.33,8.33,10
Al Wasl,8,6,1,1,18,7,11,19,uae,0.75,0.88,11,2.25,2.38,1.33,1.14,1
Shabab Al Ahli,8,5,3,0,15,4,11,18,uae,0.62,1.0,11,1.88,2.25,1.61,1.0,2
Al Wahda,8,4,4,0,16,9,7,16,uae,0.5,1.0,7,2.0,2.0,2.0,1.0,3
Khorfakkan,8,5,1,2,10,9,1,16,uae,0.62,0.75,1,1.25,2.0,1.61,1.33,3
Al Ain,8,4,1,3,14,8,6,13,uae,0.5,0.62,6,1.75,1.62,2.0,1.61,4
Al Sharjah,8,3,2,3,9,6,3,11,uae,0.38,0.62,3,1.12,1.38,2.63,1.61,5
Al Jazira,8,3,2,3,12,16,-4,11,uae,0.38,0.62,-4,1.5,1.38,2.63,1.61,5
Al Bataeh,8,2,4,2,8,9,-1,10,uae,0.25,0.75,-1,1.0,1.25,4.0,1.33,6
Bani Yas,8,3,1,4,8,15,-7,10,uae,0.38,0.5,-7,1.0,1.25,2.63,2.0,6
Al Nasr,8,2,2,4,8,10,-2,8,uae,0.25,0.5,-2,1.0,1.0,4.0,2.0,7
Ajman,8,2,2,4,8,15,-7,8,uae,0.25,0.5,-7,1.0,1.0,4.0,2.0,7
Dibba Al Hisn,8,2,1,5,11,13,-2,7,uae,0.25,0.38,-2,1.38,0.88,4.0,2.63,8
Ittihad Kalba,8,2,1,5,7,11,-4,7,uae,0.25,0.38,-4,0.88,0.88,4.0,2.63,8
Al Urooba,8,1,1,6,8,18,-10,4,uae,0.12,0.25,-10,1.0,0.5,8.33,4.0,9
Oleksandria,8,6,1,1,12,5,7,19,ukraine,0.75,0.88,7,1.5,2.38,1.33,1.14,1
Dynamo Kyiv,8,5,3,0,16,6,10,18,ukraine,0.62,1.0,10,2.0,2.25,1.61,1.0,2
Karpaty Lviv,8,4,4,0,13,5,8,16,ukraine,0.5,1.0,8,1.62,2.0,2.0,1.0,3
Shakhtar,8,4,3,1,16,9,7,15,ukraine,0.5,0.88,7,2.0,1.88,2.0,1.14,4
Polessya,8,3,4,1,10,9,1,13,ukraine,0.38,0.88,1,1.25,1.62,2.63,1.14,5
Veres,8,4,1,3,11,12,-1,13,ukraine,0.5,0.62,-1,1.38,1.62,2.0,1.61,5
Zorya Luhansk,8,4,1,3,11,13,-2,13,ukraine,0.5,0.62,-2,1.38,1.62,2.0,1.61,5
Kolos Kovalivka,8,3,1,4,11,9,2,10,ukraine,0.38,0.5,2,1.38,1.25,2.63,2.0,6
Rukh Lviv,8,3,1,4,6,10,-4,10,ukraine,0.38,0.5,-4,0.75,1.25,2.63,2.0,6
Inhulets,8,2,2,4,4,5,-1,8,ukraine,0.25,0.5,-1,0.5,1.0,4.0,2.0,7
Vorskla Poltava,8,2,2,4,7,9,-2,8,ukraine,0.25,0.5,-2,0.88,1.0,4.0,2.0,7
Kryvbas KR,8,2,2,4,6,8,-2,8,ukraine,0.25,0.5,-2,0.75,1.0,4.0,2.0,7
Obolon,8,2,2,4,5,13,-8,8,ukraine,0.25,0.5,-8,0.62,1.0,4.0,2.0,7
Livyi Bereh,8,2,1,5,5,9,-4,7,ukraine,0.25,0.38,-4,0.62,0.88,4.0,2.63,8
LNZ Cherkasy,8,1,2,5,4,9,-5,5,ukraine,0.12,0.38,-5,0.5,0.62,8.33,2.63,9
Chornomorets,8,1,0,7,4,14,-10,3,ukraine,0.12,0.12,-10,0.5,0.38,8.33,8.33,10
Dnipro-1,0,0,0,0,0,0,0,0,ukraine,0.0,0.0,0,0.0,0.0,0.0,0.0,11
Liverpool M.,8,5,3,0,14,4,10,18,uruguay,0.62,1.0,10,1.75,2.25,1.61,1.0,1
Nacional,8,5,2,1,17,7,10,17,uruguay,0.62,0.88,10,2.12,2.12,1.61,1.14,2
Juventud,8,5,1,2,13,8,5,16,uruguay,0.62,0.75,5,1.62,2.0,1.61,1.33,3
Racing CM,8,5,1,2,9,4,5,16,uruguay,0.62,0.75,5,1.12,2.0,1.61,1.33,3
Boston River,8,5,0,3,10,9,1,15,uruguay,0.62,0.62,1,1.25,1.88,1.61,1.61,4
Defensor S.,8,3,3,2,9,7,2,12,uruguay,0.38,0.75,2,1.12,1.5,2.63,1.33,5
Penarol,8,4,0,4,9,11,-2,12,uruguay,0.5,0.5,-2,1.12,1.5,2.0,2.0,5
Cerro,8,2,4,2,9,9,0,10,uruguay,0.25,0.75,0,1.12,1.25,4.0,1.33,6
Progreso,8,2,4,2,7,8,-1,10,uruguay,0.25,0.75,-1,0.88,1.25,4.0,1.33,6
Plaza Colonia,8,2,3,3,5,6,-1,9,uruguay,0.25,0.62,-1,0.62,1.12,4.0,1.61,7
Montevideo City,8,2,3,3,8,12,-4,9,uruguay,0.25,0.62,-4,1.0,1.12,4.0,1.61,7
Cerro Largo,8,2,3,3,4,9,-5,9,uruguay,0.25,0.62,-5,0.5,1.12,4.0,1.61,7
River Plate,8,2,1,5,4,8,-4,7,uruguay,0.25,0.38,-4,0.5,0.88,4.0,2.63,8
Miramar Misione,8,1,2,5,7,15,-8,5,uruguay,0.12,0.38,-8,0.88,0.62,8.33,2.63,9
Wanderers,8,0,4,4,7,12,-5,4,uruguay,0.0,0.5,-5,0.88,0.5,0.0,2.0,10
Danubio,8,0,4,4,6,11,-5,4,uruguay,0.0,0.5,-5,0.75,0.5,0.0,2.0,10
Nacional,7,5,1,1,18,5,13,16,uruguay2,0.71,0.86,13,2.57,2.29,1.41,1.16,1
Penarol,7,4,2,1,10,5,5,14,uruguay2,0.57,0.86,5,1.43,2.0,1.75,1.16,2
Danubio,7,4,2,1,11,11,0,14,uruguay2,0.57,0.86,0,1.57,2.0,1.75,1.16,2
Wanderers,7,4,1,2,11,9,2,13,uruguay2,0.57,0.71,2,1.57,1.86,1.75,1.41,3
Defensor S.,7,3,2,2,7,5,2,11,uruguay2,0.43,0.71,2,1.0,1.57,2.33,1.41,4
Cerro Largo,7,3,2,2,6,7,-1,11,uruguay2,0.43,0.71,-1,0.86,1.57,2.33,1.41,4
Cerro,7,3,1,3,8,5,3,10,uruguay2,0.43,0.57,3,1.14,1.43,2.33,1.75,5
Fenix,7,3,1,3,10,9,1,10,uruguay2,0.43,0.57,1,1.43,1.43,2.33,1.75,5
Miramar Misione,7,3,1,3,7,10,-3,10,uruguay2,0.43,0.57,-3,1.0,1.43,2.33,1.75,5
River Plate,7,2,2,3,8,9,-1,8,uruguay2,0.29,0.57,-1,1.14,1.14,3.45,1.75,6
Progreso,7,2,2,3,8,11,-3,8,uruguay2,0.29,0.57,-3,1.14,1.14,3.45,1.75,6
Rampla Juniors,7,2,2,3,8,12,-4,8,uruguay2,0.29,0.57,-4,1.14,1.14,3.45,1.75,6
Boston River,7,2,1,4,6,8,-2,7,uruguay2,0.29,0.43,-2,0.86,1.0,3.45,2.33,7
Racing CM,7,1,3,3,8,10,-2,6,uruguay2,0.14,0.57,-2,1.14,0.86,7.14,1.75,8
D. Maldonado,7,1,3,3,5,9,-4,6,uruguay2,0.14,0.57,-4,0.71,0.86,7.14,1.75,8
Liverpool M.,7,1,0,6,4,10,-6,3,uruguay2,0.14,0.14,-6,0.57,0.43,7.14,7.14,9
Cincinnati,8,6,1,1,13,8,5,19,usa,0.75,0.88,5,1.62,2.38,1.33,1.14,1
Vancouver,8,5,2,1,14,5,9,17,usa,0.62,0.88,9,1.75,2.12,1.61,1.14,2
Inter Miami,8,5,2,1,14,8,6,17,usa,0.62,0.88,6,1.75,2.12,1.61,1.14,2
Nashville SC,8,5,0,3,19,11,8,15,usa,0.62,0.62,8,2.38,1.88,1.61,1.61,3
Portland,8,4,3,1,18,11,7,15,usa,0.5,0.88,7,2.25,1.88,2.0,1.14,3
Charlotte,8,5,0,3,12,6,6,15,usa,0.62,0.62,6,1.5,1.88,1.61,1.61,3
Columbus Crew,8,4,3,1,9,6,3,15,usa,0.5,0.88,3,1.12,1.88,2.0,1.14,3
Colorado Rapids,8,4,2,2,11,11,0,14,usa,0.5,0.75,0,1.38,1.75,2.0,1.33,4
Orlando City,8,3,4,1,12,6,6,13,usa,0.38,0.88,6,1.5,1.62,2.63,1.14,5
Philadelphia,8,4,1,3,11,6,5,13,usa,0.5,0.62,5,1.38,1.62,2.0,1.61,5
Minnesota Utd,8,3,4,1,11,9,2,13,usa,0.38,0.88,2,1.38,1.62,2.63,1.14,5
New York City,8,4,1,3,10,10,0,13,usa,0.5,0.62,0,1.25,1.62,2.0,1.61,5
Austin,8,4,1,3,6,9,-3,13,usa,0.5,0.62,-3,0.75,1.62,2.0,1.61,5
Seattle,8,3,3,2,11,8,3,12,usa,0.38,0.75,3,1.38,1.5,2.63,1.33,6
New York RB,8,3,3,2,9,8,1,12,usa,0.38,0.75,1,1.12,1.5,2.63,1.33,6
New England,8,4,0,4,7,7,0,12,usa,0.5,0.5,0,0.88,1.5,2.0,2.0,6
Dallas,8,3,2,3,9,10,-1,11,usa,0.38,0.62,-1,1.12,1.38,2.63,1.61,7
Chicago Fire,8,3,2,3,14,16,-2,11,usa,0.38,0.62,-2,1.75,1.38,2.63,1.61,7
Houston Dynamo,8,2,4,2,8,8,0,10,usa,0.25,0.75,0,1.0,1.25,4.0,1.33,8
San Diego,8,3,1,4,14,15,-1,10,usa,0.38,0.5,-1,1.75,1.25,2.63,2.0,8
Real Salt Lake,8,3,0,5,9,11,-2,9,usa,0.38,0.38,-2,1.12,1.12,2.63,2.63,9
St. Louis City,8,2,2,4,7,8,-1,8,usa,0.25,0.5,-1,0.88,1.0,4.0,2.0,10
Los Angeles FC,8,2,2,4,13,16,-3,8,usa,0.25,0.5,-3,1.62,1.0,4.0,2.0,10
Sporting KC,8,2,1,5,15,18,-3,7,usa,0.25,0.38,-3,1.88,0.88,4.0,2.63,11
DC United,8,2,1,5,7,18,-11,7,usa,0.25,0.38,-11,0.88,0.88,4.0,2.63,11
Toronto,8,1,3,4,4,8,-4,6,usa,0.12,0.5,-4,0.5,0.75,8.33,2.0,12
Atlanta Utd,8,1,3,4,8,15,-7,6,usa,0.12,0.5,-7,1.0,0.75,8.33,2.0,12
SJ Earthquakes,8,1,1,6,14,18,-4,4,usa,0.12,0.25,-4,1.75,0.5,8.33,4.0,13
CF Montreal,8,0,3,5,2,10,-8,3,usa,0.0,0.38,-8,0.25,0.38,0.0,2.63,14
Loudoun Utd,7,6,0,1,13,6,7,18,usa2,0.86,0.86,7,1.86,2.57,1.16,1.16,1
San Antonio,7,5,0,2,13,9,4,15,usa2,0.71,0.71,4,1.86,2.14,1.41,1.41,2
New Mexico,6,5,0,1,8,4,4,15,usa2,0.83,0.83,4,1.33,2.5,1.2,1.2,2
Louisville City,6,4,2,0,10,4,6,14,usa2,0.67,1.0,6,1.67,2.33,1.49,1.0,3
Monterey Bay,8,4,2,2,11,6,5,14,usa2,0.5,0.75,5,1.38,1.75,2.0,1.33,3
Detroit City,7,4,2,1,11,7,4,14,usa2,0.57,0.86,4,1.57,2.0,1.75,1.16,3
Charleston,6,4,0,2,11,7,4,12,usa2,0.67,0.67,4,1.83,2.0,1.49,1.49,4
FC Tulsa,6,4,0,2,8,4,4,12,usa2,0.67,0.67,4,1.33,2.0,1.49,1.49,4
El Paso,7,2,3,2,12,13,-1,9,usa2,0.29,0.71,-1,1.71,1.29,3.45,1.41,5
North Carolina,7,2,2,3,8,9,-1,8,usa2,0.29,0.57,-1,1.14,1.14,3.45,1.75,6
Las Vegas L.,6,2,2,2,5,7,-2,8,usa2,0.33,0.67,-2,0.83,1.33,3.03,1.49,6
Lexington,7,1,4,2,8,8,0,7,usa2,0.14,0.71,0,1.14,1.0,7.14,1.41,7
Pittsburgh,6,2,1,3,6,7,-1,7,usa2,0.33,0.5,-1,1.0,1.17,3.03,2.0,7
Orange County,6,2,1,3,8,11,-3,7,usa2,0.33,0.5,-3,1.33,1.17,3.03,2.0,7
Oakland Roots,7,2,1,4,9,13,-4,7,usa2,0.29,0.43,-4,1.29,1.0,3.45,2.33,7
Sacramento R.,6,1,3,2,8,9,-1,6,usa2,0.17,0.67,-1,1.33,1.0,5.88,1.49,8
Colorado S.,7,1,3,3,12,14,-2,6,usa2,0.14,0.57,-2,1.71,0.86,7.14,1.75,8
Phoenix Rising,7,1,3,3,13,16,-3,6,usa2,0.14,0.57,-3,1.86,0.86,7.14,1.75,8
Miami FC,6,2,0,4,6,10,-4,6,usa2,0.33,0.33,-4,1.0,1.0,3.03,3.03,8
Indy Eleven,5,1,2,2,9,10,-1,5,usa2,0.2,0.6,-1,1.8,1.0,5.0,1.67,9
Birmingham L.,6,1,2,3,7,10,-3,5,usa2,0.17,0.5,-3,1.17,0.83,5.88,2.0,9
Rhode Island,5,1,1,3,5,8,-3,4,usa2,0.2,0.4,-3,1.0,0.8,5.0,2.5,10
Tampa Bay,6,1,0,5,5,9,-4,3,usa2,0.17,0.17,-4,0.83,0.5,5.88,5.88,11
Hartford A.,5,1,0,4,2,7,-5,3,usa2,0.2,0.2,-5,0.4,0.6,5.0,5.0,11
Naples,7,4,2,1,9,3,6,14,usa3,0.57,0.86,6,1.29,2.0,1.75,1.16,1
Spokane V.,6,3,2,1,12,5,7,11,usa3,0.5,0.83,7,2.0,1.83,2.0,1.2,2
One Knoxville,4,3,1,0,6,2,4,10,usa3,0.75,1.0,4,1.5,2.5,1.33,1.0,3
Richmond K.,7,3,1,3,14,12,2,10,usa3,0.43,0.57,2,2.0,1.43,2.33,1.75,3
Charlotte I.,5,2,2,1,5,4,1,8,usa3,0.4,0.8,1,1.0,1.6,2.5,1.25,4
Tormenta,6,2,1,3,11,13,-2,7,usa3,0.33,0.5,-2,1.83,1.17,3.03,2.0,5
Greenville,6,2,1,3,5,7,-2,7,usa3,0.33,0.5,-2,0.83,1.17,3.03,2.0,5
Chattanooga RW,5,1,3,1,6,6,0,6,usa3,0.2,0.8,0,1.2,1.2,5.0,1.25,6
Alta,5,2,0,3,7,9,-2,6,usa3,0.4,0.4,-2,1.4,1.2,2.5,2.5,6
Westchester SC,4,1,2,1,8,8,0,5,usa3,0.25,0.75,0,2.0,1.25,4.0,1.33,7
Forward Madison,4,1,2,1,4,5,-1,5,usa3,0.25,0.75,-1,1.0,1.25,4.0,1.33,7
Union Omaha,3,1,0,2,3,5,-2,3,usa3,0.33,0.33,-2,1.0,1.0,3.03,3.03,8
Portland Hearts,3,0,2,1,1,2,-1,2,usa3,0.0,0.67,-1,0.33,0.67,0.0,1.49,9
Texoma,5,0,1,4,3,13,-10,1,usa3,0.0,0.2,-10,0.6,0.2,0.0,5.0,10
Carabobo,8,5,3,0,6,1,5,18,venezuela,0.62,1.0,5,0.75,2.25,1.61,1.0,1
D. La Guaira,8,5,2,1,14,7,7,17,venezuela,0.62,0.88,7,1.75,2.12,1.61,1.14,2
UCV,8,5,2,1,9,4,5,17,venezuela,0.62,0.88,5,1.12,2.12,1.61,1.14,2
Monagas,8,4,2,2,15,11,4,14,venezuela,0.5,0.75,4,1.88,1.75,2.0,1.33,3
D. Tachira,8,3,4,1,13,8,5,13,venezuela,0.38,0.88,5,1.62,1.62,2.63,1.14,4
A. Anzoategui,8,3,4,1,10,7,3,13,venezuela,0.38,0.88,3,1.25,1.62,2.63,1.14,4
Puerto Cabello,8,3,3,2,6,5,1,12,venezuela,0.38,0.75,1,0.75,1.5,2.63,1.33,5
Metropolitanos,8,2,3,3,11,13,-2,9,venezuela,0.25,0.62,-2,1.38,1.12,4.0,1.61,6
Rayo Zuliano,8,3,0,5,9,11,-2,9,venezuela,0.38,0.38,-2,1.12,1.12,2.63,2.63,6
Caracas,8,2,3,3,9,12,-3,9,venezuela,0.25,0.62,-3,1.12,1.12,4.0,1.61,6
Portuguesa,8,2,2,4,9,12,-3,8,venezuela,0.25,0.5,-3,1.12,1.0,4.0,2.0,7
Yaracuyanos,8,1,2,5,8,16,-8,5,venezuela,0.12,0.38,-8,1.0,0.62,8.33,2.63,8
Zamora,8,1,1,6,5,10,-5,4,venezuela,0.12,0.25,-5,0.62,0.5,8.33,4.0,9
E. Merida,8,1,1,6,10,17,-7,4,venezuela,0.12,0.25,-7,1.25,0.5,8.33,4.0,9
Nasaf Qarshi,7,5,2,0,14,3,11,17,uzbekistan,0.71,1.0,11,2.0,2.43,1.41,1.0,1
AGMK,6,5,1,0,11,4,7,16,uzbekistan,0.83,1.0,7,1.83,2.67,1.2,1.0,2
Bunyodkor,6,3,3,0,9,3,6,12,uzbekistan,0.5,1.0,6,1.5,2.0,2.0,1.0,3
D. Samarqand,6,3,3,0,5,2,3,12,uzbekistan,0.5,1.0,3,0.83,2.0,2.0,1.0,3
Navbahor,7,3,2,2,12,8,4,11,uzbekistan,0.43,0.71,4,1.71,1.57,2.33,1.41,4
Pakhtakor,7,3,0,4,12,8,4,9,uzbekistan,0.43,0.43,4,1.71,1.29,2.33,2.33,5
Andijan,7,2,3,2,9,9,0,9,uzbekistan,0.29,0.71,0,1.29,1.29,3.45,1.41,5
Neftchi,6,2,3,1,9,9,0,9,uzbekistan,0.33,0.83,0,1.5,1.5,3.03,1.2,5
Kokand-1912,7,2,3,2,4,5,-1,9,uzbekistan,0.29,0.71,-1,0.57,1.29,3.45,1.41,5
Sogdiana,7,2,1,4,8,9,-1,7,uzbekistan,0.29,0.43,-1,1.14,1.0,3.45,2.33,6
Xorazm,6,2,1,3,5,6,-1,7,uzbekistan,0.33,0.5,-1,0.83,1.17,3.03,2.0,6
Termez Surkhon,7,2,1,4,5,9,-4,7,uzbekistan,0.29,0.43,-4,0.71,1.0,3.45,2.33,6
Qizilqum,6,2,1,3,4,9,-5,7,uzbekistan,0.33,0.5,-5,0.67,1.17,3.03,2.0,6
Mashal,7,2,1,4,3,11,-8,7,uzbekistan,0.29,0.43,-8,0.43,1.0,3.45,2.33,6
Buxoro,7,2,0,5,8,12,-4,6,uzbekistan,0.29,0.29,-4,1.14,0.86,3.45,3.45,7
Shurtan,7,0,1,6,1,12,-11,1,uzbekistan,0.0,0.14,-11,0.14,0.14,0.0,7.14,8
Ha Noi,8,6,2,0,18,5,13,20,vietnam,0.75,1.0,13,2.25,2.5,1.33,1.0,1
Nam Dinh,8,5,3,0,14,5,9,18,vietnam,0.62,1.0,9,1.75,2.25,1.61,1.0,2
Cong An Nhan,8,3,4,1,14,11,3,13,vietnam,0.38,0.88,3,1.75,1.62,2.63,1.14,3
Hong Linh Ha T.,8,3,4,1,8,6,2,13,vietnam,0.38,0.88,2,1.0,1.62,2.63,1.14,3
Hai Phong,8,4,1,3,6,5,1,13,vietnam,0.5,0.62,1,0.75,1.62,2.0,1.61,3
Viettel,8,3,2,3,11,13,-2,11,vietnam,0.38,0.62,-2,1.38,1.38,2.63,1.61,4
Song Lam Nghe,8,2,4,2,7,7,0,10,vietnam,0.25,0.75,0,0.88,1.25,4.0,1.33,5
Quang Nam,8,2,3,3,11,11,0,9,vietnam,0.25,0.62,0,1.38,1.12,4.0,1.61,6
Gia Lai,8,2,2,4,9,11,-2,8,vietnam,0.25,0.5,-2,1.12,1.0,4.0,2.0,7
Ho Chi Minh,8,1,5,2,7,9,-2,8,vietnam,0.12,0.75,-2,0.88,1.0,8.33,1.33,7
Binh Duong,8,2,2,4,8,16,-8,8,vietnam,0.25,0.5,-8,1.0,1.0,4.0,2.0,7
Thanh Hoa,8,1,4,3,8,10,-2,7,vietnam,0.12,0.62,-2,1.0,0.88,8.33,1.61,8
Da Nang,8,1,4,3,7,9,-2,7,vietnam,0.12,0.62,-2,0.88,0.88,8.33,1.61,8
Binh Dinh,8,1,1,6,5,12,-7,4,vietnam,0.12,0.25,-7,0.62,0.5,8.33,4.0,9
Phu Dong,8,7,1,0,17,1,16,22,vietnam2,0.88,1.0,16,2.12,2.75,1.14,1.0,1
PVF-CAND,8,6,1,1,17,7,10,19,vietnam2,0.75,0.88,10,2.12,2.38,1.33,1.14,2
Binh Phuoc,8,6,1,1,15,5,10,19,vietnam2,0.75,0.88,10,1.88,2.38,1.33,1.14,2
Ba Ria Vung Tau,8,3,2,3,6,15,-9,11,vietnam2,0.38,0.62,-9,0.75,1.38,2.63,1.61,3
Dong Nai,8,2,3,3,5,3,2,9,vietnam2,0.25,0.62,2,0.62,1.12,4.0,1.61,4
Ho Chi Minh B,8,2,3,3,7,10,-3,9,vietnam2,0.25,0.62,-3,0.88,1.12,4.0,1.61,4
Dong Thap,8,2,2,4,7,7,0,8,vietnam2,0.25,0.5,0,0.88,1.0,4.0,2.0,5
S. Khanh Hoa,8,2,1,5,5,11,-6,7,vietnam2,0.25,0.38,-6,0.62,0.88,4.0,2.63,6
Long An,8,1,3,4,2,9,-7,6,vietnam2,0.12,0.5,-7,0.25,0.75,8.33,2.0,7
Hue,8,2,0,6,6,15,-9,6,vietnam2,0.25,0.25,-9,0.75,0.75,4.0,4.0,7
Hoa Binh,8,0,5,3,5,9,-4,5,vietnam2,0.0,0.62,-4,0.62,0.62,0.0,1.61,8
The New Saints,8,7,0,1,21,4,17,21,wales,0.88,0.88,17,2.62,2.62,1.14,1.14,1
Flint,8,6,1,1,18,11,7,19,wales,0.75,0.88,7,2.25,2.38,1.33,1.14,2
Barry,8,5,1,2,18,11,7,16,wales,0.62,0.75,7,2.25,2.0,1.61,1.33,3
Connahs Quay,8,4,1,3,13,7,6,13,wales,0.5,0.62,6,1.62,1.62,2.0,1.61,4
Penybont,8,4,1,3,13,14,-1,13,wales,0.5,0.62,-1,1.62,1.62,2.0,1.61,4
Caernarfon,8,3,1,4,14,14,0,10,wales,0.38,0.5,0,1.75,1.25,2.63,2.0,5
Briton Ferry,8,3,1,4,9,15,-6,10,wales,0.38,0.5,-6,1.12,1.25,2.63,2.0,5
Cardiff MU,8,2,3,3,8,13,-5,9,wales,0.25,0.62,-5,1.0,1.12,4.0,1.61,6
Haverfordwest,8,1,4,3,7,13,-6,7,wales,0.12,0.62,-6,0.88,0.88,8.33,1.61,7
Newtown,8,1,3,4,10,16,-6,6,wales,0.12,0.5,-6,1.25,0.75,8.33,2.0,8
Bala Town,8,1,2,5,7,16,-9,5,wales,0.12,0.38,-9,0.88,0.62,8.33,2.63,9
Aberystwyth,8,1,1,6,6,14,-8,4,wales,0.12,0.25,-8,0.75,0.5,8.33,4.0,10
