Equipe,GP,W,D,L,GF,GA,GD,Pts_Overall,Liga,PIO,PIO_HA,GD_Overall,GF_AVG_Overall,PPG_Overall,Odd_Justa_MO,Odd_Justa_HA,Rank_Overall
Skenderbeu K.,8,4,2,2,13,7,6,14,Albania - Abissnet Superiore,0.5,0.75,6,1.62,1.75,2.0,1.33,1
Teuta Durres,8,2,5,1,4,3,1,11,Albania - Abissnet Superiore,0.25,0.88,1,0.5,1.38,4.0,1.14,2
Dinamo Tirana,8,3,2,3,11,13,-2,11,Albania - Abissnet Superiore,0.38,0.62,-2,1.38,1.38,2.63,1.61,2
Vllaznia S.,8,2,4,2,10,7,3,10,Albania - Abissnet Superiore,0.25,0.75,3,1.25,1.25,4.0,1.33,3
KF Tirana,8,2,4,2,13,11,2,10,Albania - Abissnet Superiore,0.25,0.75,2,1.62,1.25,4.0,1.33,3
Egnatia R.,8,2,4,2,10,8,2,10,Albania - Abissnet Superiore,0.25,0.75,2,1.25,1.25,4.0,1.33,3
Partizani T.,8,3,1,4,4,9,-5,10,Albania - Abissnet Superiore,0.38,0.5,-5,0.5,1.25,2.63,2.0,3
Bylis,8,2,2,4,5,11,-6,8,Albania - Abissnet Superiore,0.25,0.5,-6,0.62,1.0,4.0,2.0,4
Laci,8,0,3,5,5,12,-7,3,Albania - Abissnet Superiore,0.0,0.38,-7,0.62,0.38,0.0,2.63,5
CR Belouizdad,8,5,2,1,15,4,11,17,Algeria - Ligue 1,0.62,0.88,11,1.88,2.12,1.61,1.14,1
MC Alger,8,5,2,1,14,8,6,17,Algeria - Ligue 1,0.62,0.88,6,1.75,2.12,1.61,1.14,1
El Bayadh,8,4,4,0,5,1,4,16,Algeria - Ligue 1,0.5,1.0,4,0.62,2.0,2.0,1.0,2
USM Alger,8,3,4,1,9,4,5,13,Algeria - Ligue 1,0.38,0.88,5,1.12,1.62,2.63,1.14,3
JS Kabylie,8,3,4,1,9,7,2,13,Algeria - Ligue 1,0.38,0.88,2,1.12,1.62,2.63,1.14,3
JS Saoura,8,4,0,4,10,8,2,12,Algeria - Ligue 1,0.5,0.5,2,1.25,1.5,2.0,2.0,4
ASO Chlef,8,3,3,2,8,6,2,12,Algeria - Ligue 1,0.38,0.75,2,1.0,1.5,2.63,1.33,4
ES Setif,8,3,3,2,4,3,1,12,Algeria - Ligue 1,0.38,0.75,1,0.5,1.5,2.63,1.33,4
Mostaganem,8,2,4,2,5,4,1,10,Algeria - Ligue 1,0.25,0.75,1,0.62,1.25,4.0,1.33,5
O. Akbou,8,1,5,2,5,6,-1,8,Algeria - Ligue 1,0.12,0.75,-1,0.62,1.0,8.33,1.33,6
Paradou AC,8,2,2,4,7,11,-4,8,Algeria - Ligue 1,0.25,0.5,-4,0.88,1.0,4.0,2.0,6
Biskra,8,1,4,3,2,6,-4,7,Algeria - Ligue 1,0.12,0.62,-4,0.25,0.88,8.33,1.61,7
CS Constantine,8,1,3,4,6,10,-4,6,Algeria - Ligue 1,0.12,0.5,-4,0.75,0.75,8.33,2.0,8
NC Magra,8,1,3,4,4,10,-6,6,Algeria - Ligue 1,0.12,0.5,-6,0.5,0.75,8.33,2.0,8
MC Oran,8,2,0,6,5,12,-7,6,Algeria - Ligue 1,0.25,0.25,-7,0.62,0.75,4.0,4.0,8
Khenchela,8,1,1,6,6,18,-12,4,Algeria - Ligue 1,0.12,0.25,-12,0.75,0.5,8.33,4.0,9
Boca Juniors,8,7,0,1,15,4,11,21,Argentina - Liga Profesional,0.88,0.88,11,1.88,2.62,1.14,1.14,1
Huracan,8,6,2,0,13,4,9,20,Argentina - Liga Profesional,0.75,1.0,9,1.62,2.5,1.33,1.0,2
Independiente,8,4,4,0,13,4,9,16,Argentina - Liga Profesional,0.5,1.0,9,1.62,2.0,2.0,1.0,3
Argentinos Jrs,8,4,3,1,12,7,5,15,Argentina - Liga Profesional,0.5,0.88,5,1.5,1.88,2.0,1.14,4
Tigre,8,5,0,3,12,8,4,15,Argentina - Liga Profesional,0.62,0.62,4,1.5,1.88,1.61,1.61,4
Rosario Central,8,4,3,1,9,6,3,15,Argentina - Liga Profesional,0.5,0.88,3,1.12,1.88,2.0,1.14,4
San Lorenzo,8,4,2,2,8,7,1,14,Argentina - Liga Profesional,0.5,0.75,1,1.0,1.75,2.0,1.33,5
River Plate,8,3,4,1,8,6,2,13,Argentina - Liga Profesional,0.38,0.88,2,1.0,1.62,2.63,1.14,6
Barracas C.,8,3,3,2,9,7,2,12,Argentina - Liga Profesional,0.38,0.75,2,1.12,1.5,2.63,1.33,7
Newells,8,3,3,2,8,6,2,12,Argentina - Liga Profesional,0.38,0.75,2,1.0,1.5,2.63,1.33,7
Sarmiento,8,2,5,1,7,6,1,11,Argentina - Liga Profesional,0.25,0.88,1,0.88,1.38,4.0,1.14,8
Racing Club,8,3,1,4,13,11,2,10,Argentina - Liga Profesional,0.38,0.5,2,1.62,1.25,2.63,2.0,9
Platense,8,2,4,2,6,5,1,10,Argentina - Liga Profesional,0.25,0.75,1,0.75,1.25,4.0,1.33,9
Union Santa Fe,8,3,1,4,6,7,-1,10,Argentina - Liga Profesional,0.38,0.5,-1,0.75,1.25,2.63,2.0,9
I. Rivadavia,8,2,4,2,8,10,-2,10,Argentina - Liga Profesional,0.25,0.75,-2,1.0,1.25,4.0,1.33,9
D. Riestra,8,2,4,2,4,6,-2,10,Argentina - Liga Profesional,0.25,0.75,-2,0.5,1.25,4.0,1.33,9
Lanus,8,1,6,1,7,5,2,9,Argentina - Liga Profesional,0.12,0.88,2,0.88,1.12,8.33,1.14,10
T. de Cordoba,8,1,6,1,5,4,1,9,Argentina - Liga Profesional,0.12,0.88,1,0.62,1.12,8.33,1.14,10
Estudiantes,8,2,3,3,10,10,0,9,Argentina - Liga Profesional,0.25,0.62,0,1.25,1.12,4.0,1.61,10
Aldosivi,8,2,3,3,12,14,-2,9,Argentina - Liga Profesional,0.25,0.62,-2,1.5,1.12,4.0,1.61,10
Gimnasia,8,2,3,3,5,7,-2,9,Argentina - Liga Profesional,0.25,0.62,-2,0.62,1.12,4.0,1.61,10
Godoy Cruz,8,1,6,1,5,8,-3,9,Argentina - Liga Profesional,0.12,0.88,-3,0.62,1.12,8.33,1.14,10
Belgrano,8,2,3,3,7,12,-5,9,Argentina - Liga Profesional,0.25,0.62,-5,0.88,1.12,4.0,1.61,10
Central Cordoba,8,2,2,4,10,11,-1,8,Argentina - Liga Profesional,0.25,0.5,-1,1.25,1.0,4.0,2.0,11
Defensa y J.,8,2,2,4,5,13,-8,8,Argentina - Liga Profesional,0.25,0.5,-8,0.62,1.0,4.0,2.0,11
Instituto,8,2,1,5,8,13,-5,7,Argentina - Liga Profesional,0.25,0.38,-5,1.0,0.88,4.0,2.63,12
Velez Sarsfield,8,2,1,5,4,9,-5,7,Argentina - Liga Profesional,0.25,0.38,-5,0.5,0.88,4.0,2.63,12
A. Tucuman,8,1,1,6,7,12,-5,4,Argentina - Liga Profesional,0.12,0.25,-5,0.88,0.5,8.33,4.0,13
Banfield,8,0,3,5,4,12,-8,3,Argentina - Liga Profesional,0.0,0.38,-8,0.5,0.38,0.0,2.63,14
Quilmes,8,5,2,1,11,4,7,17,Argentina - Primera Nacional,0.62,0.88,7,1.38,2.12,1.61,1.14,1
G. Mendoza,8,4,4,0,10,3,7,16,Argentina - Primera Nacional,0.5,1.0,7,1.25,2.0,2.0,1.0,2
E. Rio Cuarto,8,5,1,2,10,5,5,16,Argentina - Primera Nacional,0.62,0.75,5,1.25,2.0,1.61,1.33,2
Atlanta,8,4,4,0,8,3,5,16,Argentina - Primera Nacional,0.5,1.0,5,1.0,2.0,2.0,1.0,2
SM Tucuman,8,4,4,0,7,2,5,16,Argentina - Primera Nacional,0.5,1.0,5,0.88,2.0,2.0,1.0,2
D. de Belgrano,8,4,3,1,9,4,5,15,Argentina - Primera Nacional,0.5,0.88,5,1.12,1.88,2.0,1.14,3
Chacarita J.,8,4,2,2,11,5,6,14,Argentina - Primera Nacional,0.5,0.75,6,1.38,1.75,2.0,1.33,4
Atletico Mitre,8,4,2,2,8,3,5,14,Argentina - Primera Nacional,0.5,0.75,5,1.0,1.75,2.0,1.33,4
Gimnasia Jujuy,8,4,2,2,8,3,5,14,Argentina - Primera Nacional,0.5,0.75,5,1.0,1.75,2.0,1.33,4
Ferro Carril,8,4,2,2,7,3,4,14,Argentina - Primera Nacional,0.5,0.75,4,0.88,1.75,2.0,1.33,4
D. Madryn,8,3,4,1,5,3,2,13,Argentina - Primera Nacional,0.38,0.88,2,0.62,1.62,2.63,1.14,5
Chaco For Ever,8,4,1,3,8,7,1,13,Argentina - Primera Nacional,0.5,0.62,1,1.0,1.62,2.0,1.61,5
Los Andes,8,3,3,2,8,6,2,12,Argentina - Primera Nacional,0.38,0.75,2,1.0,1.5,2.63,1.33,6
Agropecuario,8,4,0,4,9,10,-1,12,Argentina - Primera Nacional,0.5,0.5,-1,1.12,1.5,2.0,2.0,6
Racing Cordoba,8,3,3,2,9,11,-2,12,Argentina - Primera Nacional,0.38,0.75,-2,1.12,1.5,2.63,1.33,6
Tristan Suarez,8,2,5,1,5,4,1,11,Argentina - Primera Nacional,0.25,0.88,1,0.62,1.38,4.0,1.14,7
CA Estudiantes,8,3,2,3,6,7,-1,11,Argentina - Primera Nacional,0.38,0.62,-1,0.75,1.38,2.63,1.61,7
San Telmo,8,3,2,3,6,10,-4,11,Argentina - Primera Nacional,0.38,0.62,-4,0.75,1.38,2.63,1.61,7
San Miguel,8,2,4,2,8,6,2,10,Argentina - Primera Nacional,0.25,0.75,2,1.0,1.25,4.0,1.33,8
All Boys,8,3,1,4,11,10,1,10,Argentina - Primera Nacional,0.38,0.5,1,1.38,1.25,2.63,2.0,8
Colon Santa Fe,8,3,1,4,7,8,-1,10,Argentina - Primera Nacional,0.38,0.5,-1,0.88,1.25,2.63,2.0,8
Deportivo Moron,8,2,3,3,6,5,1,9,Argentina - Primera Nacional,0.25,0.62,1,0.75,1.12,4.0,1.61,9
Nueva Chicago,8,2,3,3,8,8,0,9,Argentina - Primera Nacional,0.25,0.62,0,1.0,1.12,4.0,1.61,9
Gimnasia y Tiro,8,2,3,3,4,5,-1,9,Argentina - Primera Nacional,0.25,0.62,-1,0.5,1.12,4.0,1.61,9
Central Norte,8,2,3,3,7,9,-2,9,Argentina - Primera Nacional,0.25,0.62,-2,0.88,1.12,4.0,1.61,9
Deportivo Maipu,8,2,3,3,7,9,-2,9,Argentina - Primera Nacional,0.25,0.62,-2,0.88,1.12,4.0,1.61,9
Almagro,8,2,3,3,6,8,-2,9,Argentina - Primera Nacional,0.25,0.62,-2,0.75,1.12,4.0,1.61,9
Patronato,8,2,3,3,6,8,-2,9,Argentina - Primera Nacional,0.25,0.62,-2,0.75,1.12,4.0,1.61,9
Temperley,8,3,0,5,6,11,-5,9,Argentina - Primera Nacional,0.38,0.38,-5,0.75,1.12,2.63,2.63,9
Argentino Merlo,8,6,1,1,15,6,9,19,Argentina - Primera B,0.75,0.88,9,1.88,2.38,1.33,1.14,1
A. Quilmes,8,5,2,1,12,4,8,17,Argentina - Primera B,0.62,0.88,8,1.5,2.12,1.61,1.14,2
Comunicaciones,8,5,2,1,12,6,6,17,Argentina - Primera B,0.62,0.88,6,1.5,2.12,1.61,1.14,2
Villa Dalmine,8,5,2,1,7,2,5,17,Argentina - Primera B,0.62,0.88,5,0.88,2.12,1.61,1.14,2
Deportivo Merlo,8,4,3,1,8,4,4,15,Argentina - Primera B,0.5,0.88,4,1.0,1.88,2.0,1.14,3
Excursionistas,8,4,2,2,16,9,7,14,Argentina - Primera B,0.5,0.75,7,2.0,1.75,2.0,1.33,4
D. Armenio,8,4,1,3,13,8,5,13,Argentina - Primera B,0.5,0.62,5,1.62,1.62,2.0,1.61,5
Colegiales,8,4,1,3,9,7,2,13,Argentina - Primera B,0.5,0.62,2,1.12,1.62,2.0,1.61,5
Midland,8,3,3,2,10,7,3,12,Argentina - Primera B,0.38,0.75,3,1.25,1.5,2.63,1.33,6
Sacachispas,8,3,2,3,4,6,-2,11,Argentina - Primera B,0.38,0.62,-2,0.5,1.38,2.63,1.61,7
Liniers,8,2,4,2,5,5,0,10,Argentina - Primera B,0.25,0.75,0,0.62,1.25,4.0,1.33,8
S. Italiano,8,2,3,3,9,9,0,9,Argentina - Primera B,0.25,0.62,0,1.12,1.12,4.0,1.61,9
Flandria,8,2,3,3,7,9,-2,9,Argentina - Primera B,0.25,0.62,-2,0.88,1.12,4.0,1.61,9
SM Burzaco,8,3,0,5,5,9,-4,9,Argentina - Primera B,0.38,0.38,-4,0.62,1.12,2.63,2.63,9
Dock Sud,8,2,2,4,5,8,-3,8,Argentina - Primera B,0.25,0.5,-3,0.62,1.0,4.0,2.0,10
Los Andes,8,2,2,4,5,9,-4,8,Argentina - Primera B,0.25,0.5,-4,0.62,1.0,4.0,2.0,10
Acassuso,8,2,2,4,5,12,-7,8,Argentina - Primera B,0.25,0.5,-7,0.62,1.0,4.0,2.0,10
UAI Urquiza,8,2,2,4,10,18,-8,8,Argentina - Primera B,0.25,0.5,-8,1.25,1.0,4.0,2.0,10
V. San Carlos,8,2,1,5,5,9,-4,7,Argentina - Primera B,0.25,0.38,-4,0.62,0.88,4.0,2.63,11
D. Laferrere,8,1,4,3,4,9,-5,7,Argentina - Primera B,0.12,0.62,-5,0.5,0.88,8.33,1.61,11
Canuelas,8,2,0,6,6,11,-5,6,Argentina - Primera B,0.25,0.25,-5,0.75,0.75,4.0,4.0,12
Fenix,8,1,1,6,5,12,-7,4,Argentina - Primera B,0.12,0.25,-7,0.62,0.5,8.33,4.0,13
G. Chivilcoy,5,3,2,0,5,2,3,11,Argentina - Torneo Federal,0.6,1.0,3,1.0,2.2,1.67,1.0,1
Olimpo Bahia B.,4,3,1,0,4,1,3,10,Argentina - Torneo Federal,0.75,1.0,3,1.0,2.5,1.33,1.0,2
Huracan Las H.,5,3,1,1,6,5,1,10,Argentina - Torneo Federal,0.6,0.8,1,1.2,2.0,1.67,1.25,2
Cipolletti,5,3,0,2,10,4,6,9,Argentina - Torneo Federal,0.6,0.6,6,2.0,1.8,1.67,1.67,3
Sarmiento DLB,5,3,0,2,9,5,4,9,Argentina - Torneo Federal,0.6,0.6,4,1.8,1.8,1.67,1.67,3
Douglas Haig,5,2,3,0,5,2,3,9,Argentina - Torneo Federal,0.4,1.0,3,1.0,1.8,2.5,1.0,3
D. Rincon,5,3,0,2,7,5,2,9,Argentina - Torneo Federal,0.6,0.6,2,1.4,1.8,1.67,1.67,3
Guillermo Brown,5,3,0,2,9,10,-1,9,Argentina - Torneo Federal,0.6,0.6,-1,1.8,1.8,1.67,1.67,3
I. Chivilcoy,5,2,2,1,7,3,4,8,Argentina - Torneo Federal,0.4,0.8,4,1.4,1.6,2.5,1.25,4
Ciudad Bolivar,4,2,2,0,6,2,4,8,Argentina - Torneo Federal,0.5,1.0,4,1.5,2.0,2.0,1.0,4
S. Belgrano,5,2,2,1,6,3,3,8,Argentina - Torneo Federal,0.4,0.8,3,1.2,1.6,2.5,1.25,4
S. Las Parejas,5,2,2,1,6,3,3,8,Argentina - Torneo Federal,0.4,0.8,3,1.2,1.6,2.5,1.25,4
Villa Mitre,5,2,2,1,6,3,3,8,Argentina - Torneo Federal,0.4,0.8,3,1.2,1.6,2.5,1.25,4
Juventud U. U.,4,2,2,0,4,2,2,8,Argentina - Torneo Federal,0.5,1.0,2,1.0,2.0,2.0,1.0,4
Sol de America,4,2,1,1,9,4,5,7,Argentina - Torneo Federal,0.5,0.75,5,2.25,1.75,2.0,1.33,5
Costa Brava,5,1,4,0,6,3,3,7,Argentina - Torneo Federal,0.2,1.0,3,1.2,1.4,5.0,1.0,5
SM Formosa,4,2,1,1,5,2,3,7,Argentina - Torneo Federal,0.5,0.75,3,1.25,1.75,2.0,1.33,5
Bartolomé Mitre,4,2,1,1,5,3,2,7,Argentina - Torneo Federal,0.5,0.75,2,1.25,1.75,2.0,1.33,5
Circulo D.,5,2,1,2,8,7,1,7,Argentina - Torneo Federal,0.4,0.6,1,1.6,1.4,2.5,1.67,5
Argentino MM,5,2,1,2,4,4,0,7,Argentina - Torneo Federal,0.4,0.6,0,0.8,1.4,2.5,1.67,5
A. Rafaela,5,2,1,2,7,8,-1,7,Argentina - Torneo Federal,0.4,0.6,-1,1.4,1.4,2.5,1.67,5
Santamarina,5,1,3,1,5,5,0,6,Argentina - Torneo Federal,0.2,0.8,0,1.0,1.2,5.0,1.25,6
D. Belgrano VR,5,1,3,1,2,3,-1,6,Argentina - Torneo Federal,0.2,0.8,-1,0.4,1.2,5.0,1.25,6
Sarmiento R.,5,2,0,3,5,7,-2,6,Argentina - Torneo Federal,0.4,0.4,-2,1.0,1.2,2.5,2.5,6
Crucero del N.,5,2,0,3,6,13,-7,6,Argentina - Torneo Federal,0.4,0.4,-7,1.2,1.2,2.5,2.5,6
SM Mendoza,4,1,2,1,6,6,0,5,Argentina - Torneo Federal,0.25,0.75,0,1.5,1.25,4.0,1.33,7
Gimnasia E.,5,1,2,2,1,5,-4,5,Argentina - Torneo Federal,0.2,0.6,-4,0.2,1.0,5.0,1.67,7
J. Antoniana,4,1,1,2,3,4,-1,4,Argentina - Torneo Federal,0.25,0.5,-1,0.75,1.0,4.0,2.0,8
Kimberley,5,1,1,3,2,4,-2,4,Argentina - Torneo Federal,0.2,0.4,-2,0.4,0.8,5.0,2.5,8
Noah,8,8,0,0,33,4,29,24,Armenia - Premier League,1.0,1.0,29,4.12,3.0,1.0,1.0,1
Van,8,5,3,0,12,4,8,18,Armenia - Premier League,0.62,1.0,8,1.5,2.25,1.61,1.0,2
Urartu,8,5,1,2,14,8,6,16,Armenia - Premier League,0.62,0.75,6,1.75,2.0,1.61,1.33,3
Ararat-Armenia,8,4,2,2,16,10,6,14,Armenia - Premier League,0.5,0.75,6,2.0,1.75,2.0,1.33,4
Pyunik,8,4,1,3,16,11,5,13,Armenia - Premier League,0.5,0.62,5,2.0,1.62,2.0,1.61,5
Ararat Yerevan,8,2,3,3,11,11,0,9,Armenia - Premier League,0.25,0.62,0,1.38,1.12,4.0,1.61,6
BKMA,8,2,3,3,8,12,-4,9,Armenia - Premier League,0.25,0.62,-4,1.0,1.12,4.0,1.61,6
West Armenia,8,3,0,5,8,24,-16,9,Armenia - Premier League,0.38,0.38,-16,1.0,1.12,2.63,2.63,6
Alashkert,8,0,4,4,5,12,-7,4,Armenia - Premier League,0.0,0.5,-7,0.62,0.5,0.0,2.0,7
Shirak,8,1,1,6,5,18,-13,4,Armenia - Premier League,0.12,0.25,-13,0.62,0.5,8.33,4.0,7
Gandzasar,8,0,1,7,4,21,-17,1,Armenia - Premier League,0.0,0.12,-17,0.5,0.12,0.0,8.33,8
Melbourne City,8,6,1,1,13,7,6,19,Australia - A-League,0.75,0.88,6,1.62,2.38,1.33,1.14,1
WS Wanderers,8,5,3,0,22,10,12,18,Australia - A-League,0.62,1.0,12,2.75,2.25,1.61,1.0,2
Western United,8,5,0,3,20,11,9,15,Australia - A-League,0.62,0.62,9,2.5,1.88,1.61,1.61,3
Auckland,8,3,5,0,20,11,9,14,Australia - A-League,0.38,1.0,9,2.5,1.75,2.63,1.0,4
Newcastle Jets,8,4,2,2,19,14,5,14,Australia - A-League,0.5,0.75,5,2.38,1.75,2.0,1.33,4
Melbourne V.,8,4,2,2,17,15,2,14,Australia - A-League,0.5,0.75,2,2.12,1.75,2.0,1.33,4
Sydney FC,8,3,4,1,17,12,5,13,Australia - A-League,0.38,0.88,5,2.12,1.62,2.63,1.14,5
Macarthur FC,8,2,2,4,17,18,-1,8,Australia - A-League,0.25,0.5,-1,2.12,1.0,4.0,2.0,6
Brisbane Roar,8,2,2,4,11,17,-6,8,Australia - A-League,0.25,0.5,-6,1.38,1.0,4.0,2.0,6
Perth Glory,8,1,2,5,9,16,-7,5,Australia - A-League,0.12,0.38,-7,1.12,0.62,8.33,2.63,7
Wellington,8,1,2,5,9,19,-10,5,Australia - A-League,0.12,0.38,-10,1.12,0.62,8.33,2.63,7
Central Coast,8,1,2,5,7,21,-14,5,Australia - A-League,0.12,0.38,-14,0.88,0.62,8.33,2.63,7
Adelaide Utd,8,0,2,6,16,27,-11,2,Australia - A-League,0.0,0.25,-11,2.0,0.25,0.0,4.0,8
Avondale,8,7,0,1,24,6,18,21,Australia - NPL Victoria,0.88,0.88,18,3.0,2.62,1.14,1.14,1
Oakleigh C.,8,7,0,1,21,5,16,21,Australia - NPL Victoria,0.88,0.88,16,2.62,2.62,1.14,1.14,1
Heidelberg Utd,8,6,1,1,22,8,14,19,Australia - NPL Victoria,0.75,0.88,14,2.75,2.38,1.33,1.14,2
Dandenong T.,8,6,1,1,18,9,9,19,Australia - NPL Victoria,0.75,0.88,9,2.25,2.38,1.33,1.14,2
Preston Lions,8,3,2,3,10,10,0,11,Australia - NPL Victoria,0.38,0.62,0,1.25,1.38,2.63,1.61,3
M. Victory B,8,3,2,3,13,15,-2,11,Australia - NPL Victoria,0.38,0.62,-2,1.62,1.38,2.63,1.61,3
Hume City,8,3,2,3,11,14,-3,11,Australia - NPL Victoria,0.38,0.62,-3,1.38,1.38,2.63,1.61,3
Green Gully,8,3,2,3,9,13,-4,11,Australia - NPL Victoria,0.38,0.62,-4,1.12,1.38,2.63,1.61,3
St. Albans,8,3,0,5,14,15,-1,9,Australia - NPL Victoria,0.38,0.38,-1,1.75,1.12,2.63,2.63,4
Dandenong City,8,2,2,4,11,14,-3,8,Australia - NPL Victoria,0.25,0.5,-3,1.38,1.0,4.0,2.0,5
Melbourne K.,8,2,0,6,8,16,-8,6,Australia - NPL Victoria,0.25,0.25,-8,1.0,0.75,4.0,4.0,6
Port Melbourne,8,2,0,6,6,21,-15,6,Australia - NPL Victoria,0.25,0.25,-15,0.75,0.75,4.0,4.0,6
Altona Magic,8,0,3,5,1,11,-10,3,Australia - NPL Victoria,0.0,0.38,-10,0.12,0.38,0.0,2.63,7
South Melbourne,8,0,3,5,5,16,-11,3,Australia - NPL Victoria,0.0,0.38,-11,0.62,0.38,0.0,2.63,7
Moreton City E.,4,4,0,0,10,4,6,12,Australia - NPL Queensland,1.0,1.0,6,2.5,3.0,1.0,1.0,1
Gold C. Knights,3,3,0,0,6,1,5,9,Australia - NPL Queensland,1.0,1.0,5,2.0,3.0,1.0,1.0,2
Gold C. Utd,4,3,0,1,6,4,2,9,Australia - NPL Queensland,0.75,0.75,2,1.5,2.25,1.33,1.33,2
Peninsula,4,2,1,1,8,3,5,7,Australia - NPL Queensland,0.5,0.75,5,2.0,1.75,2.0,1.33,3
Q. Lions,5,2,1,2,9,7,2,7,Australia - NPL Queensland,0.4,0.6,2,1.8,1.4,2.5,1.67,3
Olympic FC,3,2,0,1,6,2,4,6,Australia - NPL Queensland,0.67,0.67,4,2.0,2.0,1.49,1.49,4
Eastern Suburbs,3,1,2,0,6,4,2,5,Australia - NPL Queensland,0.33,1.0,2,2.0,1.67,3.03,1.0,5
Brisbane City,4,1,0,3,5,9,-4,3,Australia - NPL Queensland,0.25,0.25,-4,1.25,0.75,4.0,4.0,6
St George W.,5,0,2,3,4,10,-6,2,Australia - NPL Queensland,0.0,0.4,-6,0.8,0.4,0.0,2.5,7
Wynnum Wolves,3,0,1,2,3,7,-4,1,Australia - NPL Queensland,0.0,0.33,-4,1.0,0.33,0.0,3.03,8
SC Wanderers,3,0,1,2,2,6,-4,1,Australia - NPL Queensland,0.0,0.33,-4,0.67,0.33,0.0,3.03,8
Brisbane Roar B,3,0,0,3,1,9,-8,0,Australia - NPL Queensland,0.0,0.0,-8,0.33,0.0,0.0,0.0,9
Austria Wien,8,6,1,1,16,6,10,19,Austria - Bundesliga,0.75,0.88,10,2.0,2.38,1.33,1.14,1
Wolfsberger AC,8,5,1,2,19,11,8,16,Austria - Bundesliga,0.62,0.75,8,2.38,2.0,1.61,1.33,2
Salzburg,8,4,4,0,12,5,7,16,Austria - Bundesliga,0.5,1.0,7,1.5,2.0,2.0,1.0,2
BW Linz,8,5,1,2,13,9,4,16,Austria - Bundesliga,0.62,0.75,4,1.62,2.0,1.61,1.33,2
Sturm Graz,8,4,2,2,15,13,2,14,Austria - Bundesliga,0.5,0.75,2,1.88,1.75,2.0,1.33,3
LASK Linz,8,3,2,3,10,12,-2,11,Austria - Bundesliga,0.38,0.62,-2,1.25,1.38,2.63,1.61,4
Hartberg,8,2,3,3,7,13,-6,9,Austria - Bundesliga,0.25,0.62,-6,0.88,1.12,4.0,1.61,5
Rapid Wien,8,2,1,5,14,12,2,7,Austria - Bundesliga,0.25,0.38,2,1.75,0.88,4.0,2.63,6
Altach,8,1,4,3,8,15,-7,7,Austria - Bundesliga,0.12,0.62,-7,1.0,0.88,8.33,1.61,6
Tirol,8,1,3,4,9,13,-4,6,Austria - Bundesliga,0.12,0.5,-4,1.12,0.75,8.33,2.0,7
A. Klagenfurt,8,1,3,4,9,14,-5,6,Austria - Bundesliga,0.12,0.5,-5,1.12,0.75,8.33,2.0,7
Grazer AK,8,1,1,6,9,19,-10,4,Austria - Bundesliga,0.12,0.25,-10,1.12,0.5,8.33,4.0,8
Admira Wacker,8,6,2,0,18,9,9,20,Austria - 2. Liga,0.75,1.0,9,2.25,2.5,1.33,1.0,1
Ried,8,6,1,1,17,5,12,19,Austria - 2. Liga,0.75,0.88,12,2.12,2.38,1.33,1.14,2
St. Polten,8,4,3,1,15,9,6,15,Austria - 2. Liga,0.5,0.88,6,1.88,1.88,2.0,1.14,3
Liefering,8,5,0,3,14,8,6,15,Austria - 2. Liga,0.62,0.62,6,1.75,1.88,1.61,1.61,3
Stripfing,8,4,2,2,13,10,3,14,Austria - 2. Liga,0.5,0.75,3,1.62,1.75,2.0,1.33,4
First Vienna,8,4,1,3,14,12,2,13,Austria - 2. Liga,0.5,0.62,2,1.75,1.62,2.0,1.61,5
Bregenz,8,4,0,4,16,14,2,12,Austria - 2. Liga,0.5,0.5,2,2.0,1.5,2.0,2.0,6
Kapfenberger,8,3,2,3,17,16,1,11,Austria - 2. Liga,0.38,0.62,1,2.12,1.38,2.63,1.61,7
Sturm Graz B,8,3,2,3,9,9,0,11,Austria - 2. Liga,0.38,0.62,0,1.12,1.38,2.63,1.61,7
Voitsberg,8,3,1,4,10,11,-1,10,Austria - 2. Liga,0.38,0.5,-1,1.25,1.25,2.63,2.0,8
Rapid Wien B,8,3,1,4,10,15,-5,10,Austria - 2. Liga,0.38,0.5,-5,1.25,1.25,2.63,2.0,8
A. Lustenau,8,2,2,4,5,8,-3,8,Austria - 2. Liga,0.25,0.5,-3,0.62,1.0,4.0,2.0,9
Floridsdorfer,8,1,3,4,8,14,-6,6,Austria - 2. Liga,0.12,0.5,-6,1.0,0.75,8.33,2.0,10
SV Horn,8,1,2,5,4,11,-7,5,Austria - 2. Liga,0.12,0.38,-7,0.5,0.62,8.33,2.63,11
Amstetten,8,0,4,4,5,12,-7,4,Austria - 2. Liga,0.0,0.5,-7,0.62,0.5,0.0,2.0,12
Lafnitz,8,0,4,4,12,24,-12,4,Austria - 2. Liga,0.0,0.5,-12,1.5,0.5,0.0,2.0,12
Qarabag,8,6,2,0,16,4,12,20,Azerbaijan - Premier League,0.75,1.0,12,2.0,2.5,1.33,1.0,1
Zira,8,6,1,1,16,4,12,19,Azerbaijan - Premier League,0.75,0.88,12,2.0,2.38,1.33,1.14,2
Neftci,8,3,2,3,9,9,0,11,Azerbaijan - Premier League,0.38,0.62,0,1.12,1.38,2.63,1.61,3
Shamakhi,8,3,2,3,7,9,-2,11,Azerbaijan - Premier League,0.38,0.62,-2,0.88,1.38,2.63,1.61,3
Turan,8,3,2,3,7,10,-3,11,Azerbaijan - Premier League,0.38,0.62,-3,0.88,1.38,2.63,1.61,3
Kapaz,8,2,4,2,4,7,-3,10,Azerbaijan - Premier League,0.25,0.75,-3,0.5,1.25,4.0,1.33,4
Araz,8,1,5,2,7,8,-1,8,Azerbaijan - Premier League,0.12,0.75,-1,0.88,1.0,8.33,1.33,5
Sumqayit,8,2,1,5,9,14,-5,7,Azerbaijan - Premier League,0.25,0.38,-5,1.12,0.88,4.0,2.63,6
Sabah,8,0,5,3,8,11,-3,5,Azerbaijan - Premier League,0.0,0.62,-3,1.0,0.62,0.0,1.61,7
Sebail,8,0,4,4,3,10,-7,4,Azerbaijan - Premier League,0.0,0.5,-7,0.38,0.5,0.0,2.0,8
Al-Muharraq,8,7,0,1,21,6,15,21,Bahrain - Premier League,0.88,0.88,15,2.62,2.62,1.14,1.14,1
Khalidiya,8,6,2,0,18,8,10,20,Bahrain - Premier League,0.75,1.0,10,2.25,2.5,1.33,1.0,2
Malkiya,8,3,4,1,6,5,1,13,Bahrain - Premier League,0.38,0.88,1,0.75,1.62,2.63,1.14,3
Al Shabbab,8,3,3,2,11,9,2,12,Bahrain - Premier League,0.38,0.75,2,1.38,1.5,2.63,1.33,4
Al Riffa,8,3,2,3,11,11,0,11,Bahrain - Premier League,0.38,0.62,0,1.38,1.38,2.63,1.61,5
Sitra,8,2,4,2,9,7,2,10,Bahrain - Premier League,0.25,0.75,2,1.12,1.25,4.0,1.33,6
East Riffa,8,1,5,2,8,10,-2,8,Bahrain - Premier League,0.12,0.75,-2,1.0,1.0,8.33,1.33,7
Al Ahli M.,8,2,2,4,11,14,-3,8,Bahrain - Premier League,0.25,0.5,-3,1.38,1.0,4.0,2.0,7
Al-Najma,8,2,2,4,9,12,-3,8,Bahrain - Premier League,0.25,0.5,-3,1.12,1.0,4.0,2.0,7
AAli FC,8,1,3,4,8,15,-7,6,Bahrain - Premier League,0.12,0.5,-7,1.0,0.75,8.33,2.0,8
Manama,8,1,3,4,6,14,-8,6,Bahrain - Premier League,0.12,0.5,-8,0.75,0.75,8.33,2.0,8
Bahrain SC,8,1,2,5,8,17,-9,5,Bahrain - Premier League,0.12,0.38,-9,1.0,0.62,8.33,2.63,9
Mohammedan,8,7,0,1,18,5,13,21,Bangladesh - Premier League,0.88,0.88,13,2.25,2.62,1.14,1.14,1
Abahani,8,6,2,0,18,2,16,20,Bangladesh - Premier League,0.75,1.0,16,2.25,2.5,1.33,1.0,2
Bashundhara K.,8,4,2,2,19,6,13,14,Bangladesh - Premier League,0.5,0.75,13,2.38,1.75,2.0,1.33,3
Fortis,8,3,4,1,9,5,4,13,Bangladesh - Premier League,0.38,0.88,4,1.12,1.62,2.63,1.14,4
Rahmatgonj,8,4,0,4,20,12,8,12,Bangladesh - Premier League,0.5,0.5,8,2.5,1.5,2.0,2.0,5
B. Police,8,3,1,4,8,13,-5,10,Bangladesh - Premier League,0.38,0.5,-5,1.0,1.25,2.63,2.0,6
Fakirerpool,8,3,0,5,10,23,-13,9,Bangladesh - Premier League,0.38,0.38,-13,1.25,1.12,2.63,2.63,7
Brothers Union,8,2,2,4,9,9,0,8,Bangladesh - Premier League,0.25,0.5,0,1.12,1.0,4.0,2.0,8
Dhaka Wanderers,8,1,1,6,6,27,-21,4,Bangladesh - Premier League,0.12,0.25,-21,0.75,0.5,8.33,4.0,9
Chittagong,8,1,0,7,2,17,-15,3,Bangladesh - Premier League,0.12,0.12,-15,0.25,0.38,8.33,8.33,10
Slavia Mozyr,4,3,1,0,10,3,7,10,Belarus - Vysshaya Liga,0.75,1.0,7,2.5,2.5,1.33,1.0,1
Maxline,4,3,1,0,8,2,6,10,Belarus - Vysshaya Liga,0.75,1.0,6,2.0,2.5,1.33,1.0,1
FC Minsk,4,2,1,1,7,6,1,7,Belarus - Vysshaya Liga,0.5,0.75,1,1.75,1.75,2.0,1.33,2
BATE Borisov,4,2,1,1,2,1,1,7,Belarus - Vysshaya Liga,0.5,0.75,1,0.5,1.75,2.0,1.33,2
Neman Grodno,3,2,0,1,5,2,3,6,Belarus - Vysshaya Liga,0.67,0.67,3,1.67,2.0,1.49,1.49,3
Isloch,4,1,3,0,7,6,1,6,Belarus - Vysshaya Liga,0.25,1.0,1,1.75,1.5,4.0,1.0,3
T. Zhodino,4,1,3,0,3,2,1,6,Belarus - Vysshaya Liga,0.25,1.0,1,0.75,1.5,4.0,1.0,3
Dinamo Brest,4,1,2,1,5,5,0,5,Belarus - Vysshaya Liga,0.25,0.75,0,1.25,1.25,4.0,1.33,4
Gomel,4,1,2,1,2,2,0,5,Belarus - Vysshaya Liga,0.25,0.75,0,0.5,1.25,4.0,1.33,4
Vitebsk,4,1,1,2,6,6,0,4,Belarus - Vysshaya Liga,0.25,0.5,0,1.5,1.0,4.0,2.0,5
Slutsk,4,1,1,2,3,3,0,4,Belarus - Vysshaya Liga,0.25,0.5,0,0.75,1.0,4.0,2.0,5
Dinamo Minsk,3,1,1,1,1,3,-2,4,Belarus - Vysshaya Liga,0.33,0.67,-2,0.33,1.33,3.03,1.49,5
Naftan,4,1,1,2,4,8,-4,4,Belarus - Vysshaya Liga,0.25,0.5,-4,1.0,1.0,4.0,2.0,5
Arsenal D.,4,0,3,1,5,6,-1,3,Belarus - Vysshaya Liga,0.0,0.75,-1,1.25,0.75,0.0,1.33,6
Smorgon,4,0,1,3,1,6,-5,1,Belarus - Vysshaya Liga,0.0,0.25,-5,0.25,0.25,0.0,4.0,7
Molodechno,4,0,0,4,3,11,-8,0,Belarus - Vysshaya Liga,0.0,0.0,-8,0.75,0.0,0.0,0.0,8
BATE B,3,2,1,0,11,4,7,7,Belarus - First League,0.67,1.0,7,3.67,2.33,1.49,1.0,1
Volna Pinsk,3,2,1,0,9,6,3,7,Belarus - First League,0.67,1.0,3,3.0,2.33,1.49,1.0,1
Lida,3,2,0,1,9,6,3,6,Belarus - First League,0.67,0.67,3,3.0,2.0,1.49,1.49,2
Ostrovets,3,2,0,1,7,5,2,6,Belarus - First League,0.67,0.67,2,2.33,2.0,1.49,1.49,2
Slonim,3,2,0,1,4,4,0,6,Belarus - First League,0.67,0.67,0,1.33,2.0,1.49,1.49,2
Dinamo Minsk B,3,1,2,0,5,3,2,5,Belarus - First League,0.33,1.0,2,1.67,1.67,3.03,1.0,3
Bumprom,3,1,2,0,4,2,2,5,Belarus - First League,0.33,1.0,2,1.33,1.67,3.03,1.0,3
Niva,3,1,2,0,5,4,1,5,Belarus - First League,0.33,1.0,1,1.67,1.67,3.03,1.0,3
Uni X L. Minsk,3,1,1,1,5,4,1,4,Belarus - First League,0.33,0.67,1,1.67,1.33,3.03,1.49,4
ABFF U19,3,1,1,1,2,2,0,4,Belarus - First League,0.33,0.67,0,0.67,1.33,3.03,1.49,4
Dnepr Mogilev,3,1,1,1,5,7,-2,4,Belarus - First League,0.33,0.67,-2,1.67,1.33,3.03,1.49,4
Orsha,3,1,0,2,4,9,-5,3,Belarus - First League,0.33,0.33,-5,1.33,1.0,3.03,3.03,5
Gomel B,3,0,2,1,4,5,-1,2,Belarus - First League,0.0,0.67,-1,1.33,0.67,0.0,1.49,6
Lokomotiv Gomel,3,0,2,1,5,7,-2,2,Belarus - First League,0.0,0.67,-2,1.67,0.67,0.0,1.49,6
Baranovichi,2,0,1,1,3,4,-1,1,Belarus - First League,0.0,0.5,-1,1.5,0.5,0.0,2.0,7
Belshina,2,0,1,1,2,4,-2,1,Belarus - First League,0.0,0.5,-2,1.0,0.5,0.0,2.0,7
Osipovichy,3,0,1,2,4,7,-3,1,Belarus - First League,0.0,0.33,-3,1.33,0.33,0.0,3.03,7
Minsk B,3,0,0,3,3,8,-5,0,Belarus - First League,0.0,0.0,-5,1.0,0.0,0.0,0.0,8
KRC Genk,8,6,2,0,11,5,6,20,Belgium - Pro League,0.75,1.0,6,1.38,2.5,1.33,1.0,1
Royale Union SG,8,6,0,2,18,6,12,18,Belgium - Pro League,0.75,0.75,12,2.25,2.25,1.33,1.33,2
Anderlecht,8,5,0,3,12,6,6,15,Belgium - Pro League,0.62,0.62,6,1.5,1.88,1.61,1.61,3
Westerlo,8,4,2,2,13,10,3,14,Belgium - Pro League,0.5,0.75,3,1.62,1.75,2.0,1.33,4
Gent,8,3,4,1,10,8,2,13,Belgium - Pro League,0.38,0.88,2,1.25,1.62,2.63,1.14,5
Club Brugge,8,3,3,2,14,11,3,12,Belgium - Pro League,0.38,0.75,3,1.75,1.5,2.63,1.33,6
OH Leuven,8,3,3,2,9,9,0,12,Belgium - Pro League,0.38,0.75,0,1.12,1.5,2.63,1.33,6
KV Mechelen,8,3,2,3,9,11,-2,11,Belgium - Pro League,0.38,0.62,-2,1.12,1.38,2.63,1.61,7
Antwerp,8,2,4,2,7,8,-1,10,Belgium - Pro League,0.25,0.75,-1,0.88,1.25,4.0,1.33,8
Charleroi,8,2,3,3,13,10,3,9,Belgium - Pro League,0.25,0.62,3,1.62,1.12,4.0,1.61,9
Sint-Truiden,8,2,3,3,14,13,1,9,Belgium - Pro League,0.25,0.62,1,1.75,1.12,4.0,1.61,9
Kortrijk,8,2,2,4,11,13,-2,8,Belgium - Pro League,0.25,0.5,-2,1.38,1.0,4.0,2.0,10
Standard Liege,8,2,2,4,7,13,-6,8,Belgium - Pro League,0.25,0.5,-6,0.88,1.0,4.0,2.0,10
Cercle Brugge,8,0,5,3,6,12,-6,5,Belgium - Pro League,0.0,0.62,-6,0.75,0.62,0.0,1.61,11
Beerschot,8,1,2,5,5,13,-8,5,Belgium - Pro League,0.12,0.38,-8,0.62,0.62,8.33,2.63,11
Dender,8,1,1,6,6,17,-11,4,Belgium - Pro League,0.12,0.25,-11,0.75,0.5,8.33,4.0,12
Lokeren-Temse,8,7,0,1,13,5,8,21,Belgium - Challenger Pro League,0.88,0.88,8,1.62,2.62,1.14,1.14,1
La Louviere,8,6,2,0,18,5,13,20,Belgium - Challenger Pro League,0.75,1.0,13,2.25,2.5,1.33,1.0,2
RWDM,8,6,1,1,10,2,8,19,Belgium - Challenger Pro League,0.75,0.88,8,1.25,2.38,1.33,1.14,3
Beveren,8,6,1,1,16,9,7,19,Belgium - Challenger Pro League,0.75,0.88,7,2.0,2.38,1.33,1.14,3
Patro Eisden,8,3,3,2,8,7,1,12,Belgium - Challenger Pro League,0.38,0.75,1,1.0,1.5,2.63,1.33,4
Zulte-Waregem,8,3,2,3,11,9,2,11,Belgium - Challenger Pro League,0.38,0.62,2,1.38,1.38,2.63,1.61,5
RFC Liege,8,3,2,3,15,14,1,11,Belgium - Challenger Pro League,0.38,0.62,1,1.88,1.38,2.63,1.61,5
Eupen,8,3,2,3,9,12,-3,11,Belgium - Challenger Pro League,0.38,0.62,-3,1.12,1.38,2.63,1.61,5
Club Brugge B,8,3,1,4,11,10,1,10,Belgium - Challenger Pro League,0.38,0.5,1,1.38,1.25,2.63,2.0,6
Lierse K.,8,3,1,4,9,8,1,10,Belgium - Challenger Pro League,0.38,0.5,1,1.12,1.25,2.63,2.0,6
Lommel SK,8,3,1,4,7,11,-4,10,Belgium - Challenger Pro League,0.38,0.5,-4,0.88,1.25,2.63,2.0,6
Francs Borains,8,3,0,5,9,13,-4,9,Belgium - Challenger Pro League,0.38,0.38,-4,1.12,1.12,2.63,2.63,7
Anderlecht B,8,1,2,5,14,18,-4,5,Belgium - Challenger Pro League,0.12,0.38,-4,1.75,0.62,8.33,2.63,8
Seraing,8,0,3,5,7,17,-10,3,Belgium - Challenger Pro League,0.0,0.38,-10,0.88,0.38,0.0,2.63,9
KRC Genk B,8,0,1,7,3,15,-12,1,Belgium - Challenger Pro League,0.0,0.12,-12,0.38,0.12,0.0,8.33,10
Deinze,0,0,0,0,0,0,0,0,Belgium - Challenger Pro League,0.0,0.0,0,0.0,0.0,0.0,0.0,11
Always Ready,3,3,0,0,5,2,3,9,Bolivia - Primera Div. - Apertura,1.0,1.0,3,1.67,3.0,1.0,1.0,1
ABB,3,2,1,0,3,0,3,7,Bolivia - Primera Div. - Apertura,0.67,1.0,3,1.0,2.33,1.49,1.0,2
Bolivar,3,2,0,1,9,4,5,6,Bolivia - Primera Div. - Apertura,0.67,0.67,5,3.0,2.0,1.49,1.49,3
The Strongest,3,2,0,1,7,3,4,6,Bolivia - Primera Div. - Apertura,0.67,0.67,4,2.33,2.0,1.49,1.49,3
Aurora,3,2,0,1,9,6,3,6,Bolivia - Primera Div. - Apertura,0.67,0.67,3,3.0,2.0,1.49,1.49,3
Blooming,3,2,0,1,6,4,2,6,Bolivia - Primera Div. - Apertura,0.67,0.67,2,2.0,2.0,1.49,1.49,3
Gualberto V. SJ,3,2,0,1,5,5,0,6,Bolivia - Primera Div. - Apertura,0.67,0.67,0,1.67,2.0,1.49,1.49,3
U. de Vinto,3,1,1,1,5,4,1,4,Bolivia - Primera Div. - Apertura,0.33,0.67,1,1.67,1.33,3.03,1.49,4
Real Tomayapo,3,1,1,1,3,4,-1,4,Bolivia - Primera Div. - Apertura,0.33,0.67,-1,1.0,1.33,3.03,1.49,4
I. Petrolero,3,1,1,1,1,2,-1,4,Bolivia - Primera Div. - Apertura,0.33,0.67,-1,0.33,1.33,3.03,1.49,4
Nacional Potosi,3,1,0,2,3,3,0,3,Bolivia - Primera Div. - Apertura,0.33,0.33,0,1.0,1.0,3.03,3.03,5
Guabira,3,1,0,2,7,9,-2,3,Bolivia - Primera Div. - Apertura,0.33,0.33,-2,2.33,1.0,3.03,3.03,5
SA Bulo Bulo,3,1,0,2,2,4,-2,3,Bolivia - Primera Div. - Apertura,0.33,0.33,-2,0.67,1.0,3.03,3.03,5
Real Oruro,3,0,1,2,1,4,-3,1,Bolivia - Primera Div. - Apertura,0.0,0.33,-3,0.33,0.33,0.0,3.03,6
Oriente P.,3,0,1,2,2,7,-5,1,Bolivia - Primera Div. - Apertura,0.0,0.33,-5,0.67,0.33,0.0,3.03,6
Wilstermann,3,0,0,3,1,8,-7,0,Bolivia - Primera Div. - Apertura,0.0,0.0,-7,0.33,0.0,0.0,0.0,7
Bolivar,8,6,1,1,28,11,17,19,Bolivia - Primera Div. - Clausura,0.75,0.88,17,3.5,2.38,1.33,1.14,1
The Strongest,8,6,0,2,26,11,15,18,Bolivia - Primera Div. - Clausura,0.75,0.75,15,3.25,2.25,1.33,1.33,2
Always Ready,8,4,1,3,20,13,7,13,Bolivia - Primera Div. - Clausura,0.5,0.62,7,2.5,1.62,2.0,1.61,3
Gualberto V. SJ,8,4,1,3,18,12,6,13,Bolivia - Primera Div. - Clausura,0.5,0.62,6,2.25,1.62,2.0,1.61,3
Nacional Potosi,8,4,1,3,16,12,4,13,Bolivia - Primera Div. - Clausura,0.5,0.62,4,2.0,1.62,2.0,1.61,3
Royal Pari,8,4,1,3,11,10,1,13,Bolivia - Primera Div. - Clausura,0.5,0.62,1,1.38,1.62,2.0,1.61,3
Aurora,8,3,3,2,19,14,5,12,Bolivia - Primera Div. - Clausura,0.38,0.75,5,2.38,1.5,2.63,1.33,4
Real Tomayapo,8,4,0,4,14,12,2,12,Bolivia - Primera Div. - Clausura,0.5,0.5,2,1.75,1.5,2.0,2.0,4
Blooming,8,3,3,2,10,13,-3,12,Bolivia - Primera Div. - Clausura,0.38,0.75,-3,1.25,1.5,2.63,1.33,4
Guabira,8,3,2,3,10,10,0,11,Bolivia - Primera Div. - Clausura,0.38,0.62,0,1.25,1.38,2.63,1.61,5
Wilstermann,8,2,4,2,11,13,-2,10,Bolivia - Primera Div. - Clausura,0.25,0.75,-2,1.38,1.25,4.0,1.33,6
I. Petrolero,8,3,0,5,13,20,-7,9,Bolivia - Primera Div. - Clausura,0.38,0.38,-7,1.62,1.12,2.63,2.63,7
SA Bulo Bulo,8,2,2,4,14,22,-8,8,Bolivia - Primera Div. - Clausura,0.25,0.5,-8,1.75,1.0,4.0,2.0,8
Oriente P.,8,2,1,5,14,23,-9,7,Bolivia - Primera Div. - Clausura,0.25,0.38,-9,1.75,0.88,4.0,2.63,9
U. de Vinto,8,2,1,5,8,17,-9,7,Bolivia - Primera Div. - Clausura,0.25,0.38,-9,1.0,0.88,4.0,2.63,9
Santa Cruz,8,1,0,7,7,27,-20,3,Bolivia - Primera Div. - Clausura,0.12,0.12,-20,0.88,0.38,8.33,8.33,10
Flamengo,4,3,1,0,11,2,9,10,Brazil - Serie A,0.75,1.0,9,2.75,2.5,1.33,1.0,1
Palmeiras,4,3,1,0,5,1,4,10,Brazil - Serie A,0.75,1.0,4,1.25,2.5,1.33,1.0,1
Fluminense,4,3,0,1,5,3,2,9,Brazil - Serie A,0.75,0.75,2,1.25,2.25,1.33,1.33,2
Ceara,4,2,1,1,7,5,2,7,Brazil - Serie A,0.5,0.75,2,1.75,1.75,2.0,1.33,3
Bragantino,4,2,1,1,5,4,1,7,Brazil - Serie A,0.5,0.75,1,1.25,1.75,2.0,1.33,3
Vasco da Gama,4,2,0,2,6,7,-1,6,Brazil - Serie A,0.5,0.5,-1,1.5,1.5,2.0,2.0,4
Juventude,4,2,0,2,4,9,-5,6,Brazil - Serie A,0.5,0.5,-5,1.0,1.5,2.0,2.0,4
Mirassol,4,1,2,1,7,5,2,5,Brazil - Serie A,0.25,0.75,2,1.75,1.25,4.0,1.33,5
Internacional,4,1,2,1,4,2,2,5,Brazil - Serie A,0.25,0.75,2,1.0,1.25,4.0,1.33,5
Botafogo,4,1,2,1,4,3,1,5,Brazil - Serie A,0.25,0.75,1,1.0,1.25,4.0,1.33,5
Fortaleza,4,1,2,1,4,3,1,5,Brazil - Serie A,0.25,0.75,1,1.0,1.25,4.0,1.33,5
Santos,4,1,1,2,5,5,0,4,Brazil - Serie A,0.25,0.5,0,1.25,1.0,4.0,2.0,6
Sao Paulo,4,0,4,0,3,3,0,4,Brazil - Serie A,0.0,1.0,0,0.75,1.0,0.0,1.0,6
Corinthians,4,1,1,2,4,5,-1,4,Brazil - Serie A,0.25,0.5,-1,1.0,1.0,4.0,2.0,6
Vitoria,4,1,1,2,5,7,-2,4,Brazil - Serie A,0.25,0.5,-2,1.25,1.0,4.0,2.0,6
Cruzeiro,3,1,1,1,3,5,-2,4,Brazil - Serie A,0.33,0.67,-2,1.0,1.33,3.03,1.49,6
Bahia,3,0,3,0,4,4,0,3,Brazil - Serie A,0.0,1.0,0,1.33,1.0,0.0,1.0,7
Gremio,4,1,0,3,3,9,-6,3,Brazil - Serie A,0.25,0.25,-6,0.75,0.75,4.0,4.0,7
Atletico MG,4,0,2,2,3,6,-3,2,Brazil - Serie A,0.0,0.5,-3,0.75,0.5,0.0,2.0,8
Sport Recife,4,0,1,3,2,6,-4,1,Brazil - Serie A,0.0,0.25,-4,0.5,0.25,0.0,4.0,9
Cuiaba,3,2,1,0,5,3,2,7,Brazil - Serie B,0.67,1.0,2,1.67,2.33,1.49,1.0,1
Coritiba,3,2,1,0,3,1,2,7,Brazil - Serie B,0.67,1.0,2,1.0,2.33,1.49,1.0,1
CRB,2,2,0,0,3,1,2,6,Brazil - Serie B,1.0,1.0,2,1.5,3.0,1.0,1.0,2
Goias,2,2,0,0,3,1,2,6,Brazil - Serie B,1.0,1.0,2,1.5,3.0,1.0,1.0,2
Athletico PR,3,2,0,1,5,4,1,6,Brazil - Serie B,0.67,0.67,1,1.67,2.0,1.49,1.49,2
Avai,3,1,2,0,4,3,1,5,Brazil - Serie B,0.33,1.0,1,1.33,1.67,3.03,1.0,3
Novorizontino,3,1,2,0,2,1,1,5,Brazil - Serie B,0.33,1.0,1,0.67,1.67,3.03,1.0,3
Atletico GO,2,1,1,0,5,3,2,4,Brazil - Serie B,0.5,1.0,2,2.5,2.0,2.0,1.0,4
Remo,2,1,1,0,3,1,2,4,Brazil - Serie B,0.5,1.0,2,1.5,2.0,2.0,1.0,4
Chapecoense,3,1,0,2,3,3,0,3,Brazil - Serie B,0.33,0.33,0,1.0,1.0,3.03,3.03,5
Vila Nova,2,1,0,1,1,1,0,3,Brazil - Serie B,0.5,0.5,0,0.5,1.5,2.0,2.0,5
Operario PR,3,1,0,2,3,4,-1,3,Brazil - Serie B,0.33,0.33,-1,1.0,1.0,3.03,3.03,5
America MG,2,1,0,1,1,2,-1,3,Brazil - Serie B,0.5,0.5,-1,0.5,1.5,2.0,2.0,5
Ferroviaria,2,0,2,0,1,1,0,2,Brazil - Serie B,0.0,1.0,0,0.5,1.0,0.0,1.0,6
Botafogo SP,2,0,1,1,1,2,-1,1,Brazil - Serie B,0.0,0.5,-1,0.5,0.5,0.0,2.0,7
Amazonas,2,0,1,1,0,1,-1,1,Brazil - Serie B,0.0,0.5,-1,0.0,0.5,0.0,2.0,7
Criciuma,2,0,0,2,2,4,-2,0,Brazil - Serie B,0.0,0.0,-2,1.0,0.0,0.0,0.0,8
Volta Redonda,2,0,0,2,0,2,-2,0,Brazil - Serie B,0.0,0.0,-2,0.0,0.0,0.0,0.0,8
Athletic Club,2,0,0,2,3,6,-3,0,Brazil - Serie B,0.0,0.0,-3,1.5,0.0,0.0,0.0,8
Paysandu,3,0,0,3,1,5,-4,0,Brazil - Serie B,0.0,0.0,-4,0.33,0.0,0.0,0.0,8
Botafogo PB,1,1,0,0,3,0,3,3,Brazil - Serie C,1.0,1.0,3,3.0,3.0,1.0,1.0,1
Londrina,1,1,0,0,3,1,2,3,Brazil - Serie C,1.0,1.0,2,3.0,3.0,1.0,1.0,1
Maringa,1,1,0,0,3,2,1,3,Brazil - Serie C,1.0,1.0,1,3.0,3.0,1.0,1.0,1
Itabaiana,1,1,0,0,2,1,1,3,Brazil - Serie C,1.0,1.0,1,2.0,3.0,1.0,1.0,1
Caxias,1,1,0,0,1,0,1,3,Brazil - Serie C,1.0,1.0,1,1.0,3.0,1.0,1.0,1
ABC,1,0,1,0,1,1,0,1,Brazil - Serie C,0.0,1.0,0,1.0,1.0,0.0,1.0,2
Anapolis,1,0,1,0,1,1,0,1,Brazil - Serie C,0.0,1.0,0,1.0,1.0,0.0,1.0,2
CSA,1,0,1,0,1,1,0,1,Brazil - Serie C,0.0,1.0,0,1.0,1.0,0.0,1.0,2
Figueirense,1,0,1,0,1,1,0,1,Brazil - Serie C,0.0,1.0,0,1.0,1.0,0.0,1.0,2
Ponte Preta,1,0,1,0,1,1,0,1,Brazil - Serie C,0.0,1.0,0,1.0,1.0,0.0,1.0,2
Sao Bernardo,1,0,1,0,1,1,0,1,Brazil - Serie C,0.0,1.0,0,1.0,1.0,0.0,1.0,2
Brusque,1,0,1,0,0,0,0,1,Brazil - Serie C,0.0,1.0,0,0.0,1.0,0.0,1.0,2
Ituano,1,0,1,0,0,0,0,1,Brazil - Serie C,0.0,1.0,0,0.0,1.0,0.0,1.0,2
Retro,1,0,1,0,0,0,0,1,Brazil - Serie C,0.0,1.0,0,0.0,1.0,0.0,1.0,2
Tombense,1,0,1,0,0,0,0,1,Brazil - Serie C,0.0,1.0,0,0.0,1.0,0.0,1.0,2
Guarani,1,0,0,1,2,3,-1,0,Brazil - Serie C,0.0,0.0,-1,2.0,0.0,0.0,0.0,3
Nautico,1,0,0,1,1,2,-1,0,Brazil - Serie C,0.0,0.0,-1,1.0,0.0,0.0,0.0,3
Floresta,1,0,0,1,0,1,-1,0,Brazil - Serie C,0.0,0.0,-1,0.0,0.0,0.0,0.0,3
Ypiranga,1,0,0,1,1,3,-2,0,Brazil - Serie C,0.0,0.0,-2,1.0,0.0,0.0,0.0,3
Confianca,1,0,0,1,0,3,-3,0,Brazil - Serie C,0.0,0.0,-3,0.0,0.0,0.0,0.0,3
Agua Santa,0,0,0,0,0,0,0,0,Brazil - Serie D,0.0,0.0,0,0.0,0.0,0.0,0.0,1
Aguia de Maraba,0,0,0,0,0,0,0,0,Brazil - Serie D,0.0,0.0,0,0.0,0.0,0.0,0.0,1
Altos,0,0,0,0,0,0,0,0,Brazil - Serie D,0.0,0.0,0,0.0,0.0,0.0,0.0,1
America RN,0,0,0,0,0,0,0,0,Brazil - Serie D,0.0,0.0,0,0.0,0.0,0.0,0.0,1
Aparecidense,0,0,0,0,0,0,0,0,Brazil - Serie D,0.0,0.0,0,0.0,0.0,0.0,0.0,1
ASA,0,0,0,0,0,0,0,0,Brazil - Serie D,0.0,0.0,0,0.0,0.0,0.0,0.0,1
Azuriz,0,0,0,0,0,0,0,0,Brazil - Serie D,0.0,0.0,0,0.0,0.0,0.0,0.0,1
Barcelona BA,0,0,0,0,0,0,0,0,Brazil - Serie D,0.0,0.0,0,0.0,0.0,0.0,0.0,1
Barra FC,0,0,0,0,0,0,0,0,Brazil - Serie D,0.0,0.0,0,0.0,0.0,0.0,0.0,1
Boavista,0,0,0,0,0,0,0,0,Brazil - Serie D,0.0,0.0,0,0.0,0.0,0.0,0.0,1
Brasil de P.,0,0,0,0,0,0,0,0,Brazil - Serie D,0.0,0.0,0,0.0,0.0,0.0,0.0,1
Capital,0,0,0,0,0,0,0,0,Brazil - Serie D,0.0,0.0,0,0.0,0.0,0.0,0.0,1
Cascavel,0,0,0,0,0,0,0,0,Brazil - Serie D,0.0,0.0,0,0.0,0.0,0.0,0.0,1
Ceilandia,0,0,0,0,0,0,0,0,Brazil - Serie D,0.0,0.0,0,0.0,0.0,0.0,0.0,1
Central,0,0,0,0,0,0,0,0,Brazil - Serie D,0.0,0.0,0,0.0,0.0,0.0,0.0,1
CFRJ . Marica,0,0,0,0,0,0,0,0,Brazil - Serie D,0.0,0.0,0,0.0,0.0,0.0,0.0,1
Cianorte,0,0,0,0,0,0,0,0,Brazil - Serie D,0.0,0.0,0,0.0,0.0,0.0,0.0,1
EC Sao Jose,0,0,0,0,0,0,0,0,Brazil - Serie D,0.0,0.0,0,0.0,0.0,0.0,0.0,1
Ferroviario,0,0,0,0,0,0,0,0,Brazil - Serie D,0.0,0.0,0,0.0,0.0,0.0,0.0,1
GAS,0,0,0,0,0,0,0,0,Brazil - Serie D,0.0,0.0,0,0.0,0.0,0.0,0.0,1
Goianesia,0,0,0,0,0,0,0,0,Brazil - Serie D,0.0,0.0,0,0.0,0.0,0.0,0.0,1
Goiania,0,0,0,0,0,0,0,0,Brazil - Serie D,0.0,0.0,0,0.0,0.0,0.0,0.0,1
Goiatuba EC,0,0,0,0,0,0,0,0,Brazil - Serie D,0.0,0.0,0,0.0,0.0,0.0,0.0,1
Guarany de Bage,0,0,0,0,0,0,0,0,Brazil - Serie D,0.0,0.0,0,0.0,0.0,0.0,0.0,1
Horizonte,0,0,0,0,0,0,0,0,Brazil - Serie D,0.0,0.0,0,0.0,0.0,0.0,0.0,1
Humaita,0,0,0,0,0,0,0,0,Brazil - Serie D,0.0,0.0,0,0.0,0.0,0.0,0.0,1
Iguatu,0,0,0,0,0,0,0,0,Brazil - Serie D,0.0,0.0,0,0.0,0.0,0.0,0.0,1
Imperatriz,0,0,0,0,0,0,0,0,Brazil - Serie D,0.0,0.0,0,0.0,0.0,0.0,0.0,1
Independencia,0,0,0,0,0,0,0,0,Brazil - Serie D,0.0,0.0,0,0.0,0.0,0.0,0.0,1
Flamengo,8,7,1,0,22,0,22,22,Brazil - Carioca,0.88,1.0,22,2.75,2.75,1.14,1.0,1
Fluminense,8,4,3,1,12,7,5,15,Brazil - Carioca,0.5,0.88,5,1.5,1.88,2.0,1.14,2
Vasco da Gama,8,4,2,2,11,7,4,14,Brazil - Carioca,0.5,0.75,4,1.38,1.75,2.0,1.33,3
Volta Redonda,8,4,2,2,11,10,1,14,Brazil - Carioca,0.5,0.75,1,1.38,1.75,2.0,1.33,3
Sampaio Correa,8,3,3,2,11,9,2,12,Brazil - Carioca,0.38,0.75,2,1.38,1.5,2.63,1.33,4
Madureira,8,3,2,3,7,5,2,11,Brazil - Carioca,0.38,0.62,2,0.88,1.38,2.63,1.61,5
Boavista,8,1,7,0,7,5,2,10,Brazil - Carioca,0.12,1.0,2,0.88,1.25,8.33,1.0,6
Botafogo,8,3,1,4,7,8,-1,10,Brazil - Carioca,0.38,0.5,-1,0.88,1.25,2.63,2.0,6
Nova Iguacu,8,2,3,3,4,7,-3,9,Brazil - Carioca,0.25,0.62,-3,0.5,1.12,4.0,1.61,7
CFRJ . Marica,8,1,2,5,7,15,-8,5,Brazil - Carioca,0.12,0.38,-8,0.88,0.62,8.33,2.63,8
Portuguesa RJ,8,1,1,6,9,21,-12,4,Brazil - Carioca,0.12,0.25,-12,1.12,0.5,8.33,4.0,9
Bangu,8,0,3,5,4,18,-14,3,Brazil - Carioca,0.0,0.38,-14,0.5,0.38,0.0,2.63,10
Atletico MG,8,4,4,0,9,2,7,16,Brazil - Mineiro,0.5,1.0,7,1.12,2.0,2.0,1.0,1
Tombense,8,5,1,2,8,5,3,16,Brazil - Mineiro,0.62,0.75,3,1.0,2.0,1.61,1.33,1
Betim,8,4,3,1,12,5,7,15,Brazil - Mineiro,0.5,0.88,7,1.5,1.88,2.0,1.14,2
America MG,8,3,4,1,14,5,9,13,Brazil - Mineiro,0.38,0.88,9,1.75,1.62,2.63,1.14,3
Athletic Club,8,4,0,4,12,12,0,12,Brazil - Mineiro,0.5,0.5,0,1.5,1.5,2.0,2.0,4
Cruzeiro,8,3,2,3,11,9,2,11,Brazil - Mineiro,0.38,0.62,2,1.38,1.38,2.63,1.61,5
Democrata GV,8,3,2,3,8,9,-1,11,Brazil - Mineiro,0.38,0.62,-1,1.0,1.38,2.63,1.61,5
Uberlandia,8,2,3,3,10,10,0,9,Brazil - Mineiro,0.25,0.62,0,1.25,1.12,4.0,1.61,6
Itabirito,8,2,2,4,7,11,-4,8,Brazil - Mineiro,0.25,0.5,-4,0.88,1.0,4.0,2.0,7
Pouso Alegre,8,2,2,4,7,15,-8,8,Brazil - Mineiro,0.25,0.5,-8,0.88,1.0,4.0,2.0,7
Aymores,8,1,4,3,3,5,-2,7,Brazil - Mineiro,0.12,0.62,-2,0.38,0.88,8.33,1.61,8
Villa Nova,8,1,1,6,4,17,-13,4,Brazil - Mineiro,0.12,0.25,-13,0.5,0.5,8.33,4.0,9
Anapolis,8,6,0,2,13,6,7,18,Brazil - Goiano,0.75,0.75,7,1.62,2.25,1.33,1.33,1
Vila Nova,8,4,3,1,8,5,3,15,Brazil - Goiano,0.5,0.88,3,1.0,1.88,2.0,1.14,2
Atletico GO,8,4,2,2,10,6,4,14,Brazil - Goiano,0.5,0.75,4,1.25,1.75,2.0,1.33,3
CRAC,8,4,2,2,7,4,3,14,Brazil - Goiano,0.5,0.75,3,0.88,1.75,2.0,1.33,3
Goias,8,4,2,2,7,5,2,14,Brazil - Goiano,0.5,0.75,2,0.88,1.75,2.0,1.33,3
Goianesia,8,2,4,2,11,9,2,10,Brazil - Goiano,0.25,0.75,2,1.38,1.25,4.0,1.33,4
ABECAT Ouvidore,8,3,1,4,8,10,-2,10,Brazil - Goiano,0.38,0.5,-2,1.0,1.25,2.63,2.0,4
Goiatuba EC,8,2,4,2,4,6,-2,10,Brazil - Goiano,0.25,0.75,-2,0.5,1.25,4.0,1.33,4
Jataiense,8,3,0,5,10,10,0,9,Brazil - Goiano,0.38,0.38,0,1.25,1.12,2.63,2.63,5
Goiania,8,2,1,5,8,14,-6,7,Brazil - Goiano,0.25,0.38,-6,1.0,0.88,4.0,2.63,6
Aparecidense,8,1,3,4,4,7,-3,6,Brazil - Goiano,0.12,0.5,-3,0.5,0.75,8.33,2.0,7
Inhumas,8,1,2,5,5,13,-8,5,Brazil - Goiano,0.12,0.38,-8,0.62,0.62,8.33,2.63,8
Santa Cruz,8,6,1,1,13,3,10,19,Brazil - Pernambucano,0.75,0.88,10,1.62,2.38,1.33,1.14,1
Nautico,8,5,0,3,14,8,6,15,Brazil - Pernambucano,0.62,0.62,6,1.75,1.88,1.61,1.61,2
Sport Recife,8,4,2,2,16,7,9,14,Brazil - Pernambucano,0.5,0.75,9,2.0,1.75,2.0,1.33,3
Maguary PE,8,4,2,2,10,9,1,14,Brazil - Pernambucano,0.5,0.75,1,1.25,1.75,2.0,1.33,3
Retro,8,3,3,2,7,7,0,12,Brazil - Pernambucano,0.38,0.75,0,0.88,1.5,2.63,1.33,4
Decisao,8,3,3,2,10,11,-1,12,Brazil - Pernambucano,0.38,0.75,-1,1.25,1.5,2.63,1.33,4
Jaguar,8,3,1,4,10,16,-6,10,Brazil - Pernambucano,0.38,0.5,-6,1.25,1.25,2.63,2.0,5
Central,8,2,2,4,8,9,-1,8,Brazil - Pernambucano,0.25,0.5,-1,1.0,1.0,4.0,2.0,6
Afogados,8,0,4,4,4,12,-8,4,Brazil - Pernambucano,0.0,0.5,-8,0.5,0.5,0.0,2.0,7
Petrolina,8,0,2,6,3,13,-10,2,Brazil - Pernambucano,0.0,0.25,-10,0.38,0.25,0.0,4.0,8
Corinthians,8,5,3,0,13,7,6,18,Brazil - Paulista,0.62,1.0,6,1.62,2.25,1.61,1.0,1
Palmeiras,8,4,4,0,15,6,9,16,Brazil - Paulista,0.5,1.0,9,1.88,2.0,2.0,1.0,2
Ponte Preta,8,5,1,2,9,6,3,16,Brazil - Paulista,0.62,0.75,3,1.12,2.0,1.61,1.33,2
Santos,8,4,2,2,15,8,7,14,Brazil - Paulista,0.5,0.75,7,1.88,1.75,2.0,1.33,3
Bragantino,8,4,2,2,10,5,5,14,Brazil - Paulista,0.5,0.75,5,1.25,1.75,2.0,1.33,3
Sao Bernardo,8,4,2,2,12,11,1,14,Brazil - Paulista,0.5,0.75,1,1.5,1.75,2.0,1.33,3
Novorizontino,8,3,4,1,8,6,2,13,Brazil - Paulista,0.38,0.88,2,1.0,1.62,2.63,1.14,4
Portuguesa,8,2,5,1,12,10,2,11,Brazil - Paulista,0.25,0.88,2,1.5,1.38,4.0,1.14,5
Velo Clube,8,2,4,2,10,10,0,10,Brazil - Paulista,0.25,0.75,0,1.25,1.25,4.0,1.33,6
Sao Paulo,8,2,3,3,12,11,1,9,Brazil - Paulista,0.25,0.62,1,1.5,1.12,4.0,1.61,7
Botafogo SP,8,2,3,3,8,10,-2,9,Brazil - Paulista,0.25,0.62,-2,1.0,1.12,4.0,1.61,7
Mirassol,8,2,1,5,10,17,-7,7,Brazil - Paulista,0.25,0.38,-7,1.25,0.88,4.0,2.63,8
Guarani,8,1,3,4,10,13,-3,6,Brazil - Paulista,0.12,0.5,-3,1.25,0.75,8.33,2.0,9
Agua Santa,8,0,4,4,5,13,-8,4,Brazil - Paulista,0.0,0.5,-8,0.62,0.5,0.0,2.0,10
Noroeste,8,0,3,5,9,16,-7,3,Brazil - Paulista,0.0,0.38,-7,1.12,0.38,0.0,2.63,11
Inter Limeira,8,0,3,5,5,15,-10,3,Brazil - Paulista,0.0,0.38,-10,0.62,0.38,0.0,2.63,11
Treze,8,5,2,1,17,7,10,17,Brazil - Paraibano,0.62,0.88,10,2.12,2.12,1.61,1.14,1
Sousa,8,5,2,1,12,3,9,17,Brazil - Paraibano,0.62,0.88,9,1.5,2.12,1.61,1.14,1
Botafogo PB,8,5,1,2,15,6,9,16,Brazil - Paraibano,0.62,0.75,9,1.88,2.0,1.61,1.33,2
Serra Branca,8,4,2,2,20,8,12,14,Brazil - Paraibano,0.5,0.75,12,2.5,1.75,2.0,1.33,3
Campinense,8,4,2,2,14,9,5,14,Brazil - Paraibano,0.5,0.75,5,1.75,1.75,2.0,1.33,3
Pombal,8,2,3,3,7,8,-1,9,Brazil - Paraibano,0.25,0.62,-1,0.88,1.12,4.0,1.61,4
Nacional Patos,8,2,3,3,13,17,-4,9,Brazil - Paraibano,0.25,0.62,-4,1.62,1.12,4.0,1.61,4
EC de Patos,8,2,1,5,11,16,-5,7,Brazil - Paraibano,0.25,0.38,-5,1.38,0.88,4.0,2.63,5
Auto Esporte,8,1,3,4,8,15,-7,6,Brazil - Paraibano,0.12,0.5,-7,1.0,0.75,8.33,2.0,6
Picuiense,8,0,1,7,5,33,-28,1,Brazil - Paraibano,0.0,0.12,-28,0.62,0.12,0.0,8.33,7
Santa Catarina,8,4,3,1,14,9,5,15,Brazil - Catarinense,0.5,0.88,5,1.75,1.88,2.0,1.14,1
Brusque,8,4,2,2,12,6,6,14,Brazil - Catarinense,0.5,0.75,6,1.5,1.75,2.0,1.33,2
Avai,8,4,1,3,12,6,6,13,Brazil - Catarinense,0.5,0.62,6,1.5,1.62,2.0,1.61,3
Criciuma,8,3,4,1,10,4,6,13,Brazil - Catarinense,0.38,0.88,6,1.25,1.62,2.63,1.14,3
Figueirense,8,4,1,3,16,11,5,13,Brazil - Catarinense,0.5,0.62,5,2.0,1.62,2.0,1.61,3
Barra FC,8,3,3,2,6,7,-1,12,Brazil - Catarinense,0.38,0.75,-1,0.75,1.5,2.63,1.33,4
Marcilio Dias,8,2,4,2,7,8,-1,10,Brazil - Catarinense,0.25,0.75,-1,0.88,1.25,4.0,1.33,5
Concordia,8,3,1,4,8,15,-7,10,Brazil - Catarinense,0.38,0.5,-7,1.0,1.25,2.63,2.0,5
Chapecoense,8,1,6,1,10,9,1,9,Brazil - Catarinense,0.12,0.88,1,1.25,1.12,8.33,1.14,6
Joinville,8,2,3,3,9,14,-5,9,Brazil - Catarinense,0.25,0.62,-5,1.12,1.12,4.0,1.61,6
Caravaggio,8,2,1,5,5,12,-7,7,Brazil - Catarinense,0.25,0.38,-7,0.62,0.88,4.0,2.63,7
Hercilio Luz,8,1,2,5,6,13,-7,5,Brazil - Catarinense,0.12,0.38,-7,0.75,0.62,8.33,2.63,8
Internacional,8,6,2,0,16,4,12,20,Brazil - Gaucho,0.75,1.0,12,2.0,2.5,1.33,1.0,1
Juventude,8,6,1,1,14,6,8,19,Brazil - Gaucho,0.75,0.88,8,1.75,2.38,1.33,1.14,2
Gremio,8,5,2,1,19,3,16,17,Brazil - Gaucho,0.62,0.88,16,2.38,2.12,1.61,1.14,3
Caxias,8,4,2,2,8,9,-1,14,Brazil - Gaucho,0.5,0.75,-1,1.0,1.75,2.0,1.33,4
Ypiranga,8,3,3,2,6,6,0,12,Brazil - Gaucho,0.38,0.75,0,0.75,1.5,2.63,1.33,5
Guarany de Bage,8,2,3,3,6,6,0,9,Brazil - Gaucho,0.25,0.62,0,0.75,1.12,4.0,1.61,6
Sao Luiz,8,2,3,3,7,13,-6,9,Brazil - Gaucho,0.25,0.62,-6,0.88,1.12,4.0,1.61,6
Brasil de P.,8,1,4,3,5,10,-5,7,Brazil - Gaucho,0.12,0.62,-5,0.62,0.88,8.33,1.61,7
Monsoon,8,2,1,5,7,14,-7,7,Brazil - Gaucho,0.25,0.38,-7,0.88,0.88,4.0,2.63,7
Pelotas,8,1,3,4,6,13,-7,6,Brazil - Gaucho,0.12,0.5,-7,0.75,0.75,8.33,2.0,8
EC Sao Jose,8,0,5,3,5,10,-5,5,Brazil - Gaucho,0.0,0.62,-5,0.62,0.62,0.0,1.61,9
Avenida,8,0,3,5,4,9,-5,3,Brazil - Gaucho,0.0,0.38,-5,0.5,0.38,0.0,2.63,10
Arda,8,5,3,0,21,4,17,18,Bulgaria - Parva Liga,0.62,1.0,17,2.62,2.25,1.61,1.0,1
CSKA Sofia,8,5,3,0,13,4,9,18,Bulgaria - Parva Liga,0.62,1.0,9,1.62,2.25,1.61,1.0,1
Ludogorets,8,5,2,1,14,4,10,17,Bulgaria - Parva Liga,0.62,0.88,10,1.75,2.12,1.61,1.14,2
Levski Sofia,8,3,4,1,13,9,4,13,Bulgaria - Parva Liga,0.38,0.88,4,1.62,1.62,2.63,1.14,3
Spartak Varna,8,4,1,3,10,11,-1,13,Bulgaria - Parva Liga,0.5,0.62,-1,1.25,1.62,2.0,1.61,3
CSKA 1948 Sofia,8,4,0,4,13,10,3,12,Bulgaria - Parva Liga,0.5,0.5,3,1.62,1.5,2.0,2.0,4
Slavia Sofia,8,3,3,2,18,16,2,12,Bulgaria - Parva Liga,0.38,0.75,2,2.25,1.5,2.63,1.33,4
Lok. Plovdiv,8,3,2,3,5,6,-1,11,Bulgaria - Parva Liga,0.38,0.62,-1,0.62,1.38,2.63,1.61,5
Cherno More,8,2,5,1,8,10,-2,11,Bulgaria - Parva Liga,0.25,0.88,-2,1.0,1.38,4.0,1.14,5
Beroe,8,3,1,4,9,10,-1,10,Bulgaria - Parva Liga,0.38,0.5,-1,1.12,1.25,2.63,2.0,6
Septemvri Sofia,8,3,1,4,12,15,-3,10,Bulgaria - Parva Liga,0.38,0.5,-3,1.5,1.25,2.63,2.0,6
Lokomotiv Sofia,8,3,0,5,9,14,-5,9,Bulgaria - Parva Liga,0.38,0.38,-5,1.12,1.12,2.63,2.63,7
Botev Plovdiv,8,1,4,3,8,14,-6,7,Bulgaria - Parva Liga,0.12,0.62,-6,1.0,0.88,8.33,1.61,8
Botev Vratsa,8,1,2,5,4,11,-7,5,Bulgaria - Parva Liga,0.12,0.38,-7,0.5,0.62,8.33,2.63,9
L. Krumovgrad,8,1,2,5,2,11,-9,5,Bulgaria - Parva Liga,0.12,0.38,-9,0.25,0.62,8.33,2.63,9
Hebar,8,1,1,6,4,14,-10,4,Bulgaria - Parva Liga,0.12,0.25,-10,0.5,0.5,8.33,4.0,10
Forge,2,2,0,0,3,0,3,6,Canada - Premier League,1.0,1.0,3,1.5,3.0,1.0,1.0,1
A. Ottawa,2,1,1,0,6,3,3,4,Canada - Premier League,0.5,1.0,3,3.0,2.0,2.0,1.0,2
HFX Wanderers,2,1,1,0,4,3,1,4,Canada - Premier League,0.5,1.0,1,2.0,2.0,2.0,1.0,2
York Utd,2,1,0,1,3,2,1,3,Canada - Premier League,0.5,0.5,1,1.5,1.5,2.0,2.0,3
Pacific,2,1,0,1,2,2,0,3,Canada - Premier League,0.5,0.5,0,1.0,1.5,2.0,2.0,3
Cavalry,1,0,0,1,0,1,-1,0,Canada - Premier League,0.0,0.0,-1,0.0,0.0,0.0,0.0,4
Valour,1,0,0,1,0,2,-2,0,Canada - Premier League,0.0,0.0,-2,0.0,0.0,0.0,0.0,4
Vancouver FC,2,0,0,2,1,6,-5,0,Canada - Premier League,0.0,0.0,-5,0.5,0.0,0.0,0.0,4
Palestino,7,5,1,1,12,5,7,16,Chile - Primera Division,0.71,0.86,7,1.71,2.29,1.41,1.16,1
Coquimbo Unido,7,4,3,0,9,3,6,15,Chile - Primera Division,0.57,1.0,6,1.29,2.14,1.75,1.0,2
Huachipato,7,4,2,1,12,5,7,14,Chile - Primera Division,0.57,0.86,7,1.71,2.0,1.75,1.16,3
Audax Italiano,7,4,1,2,13,9,4,13,Chile - Primera Division,0.57,0.71,4,1.86,1.86,1.75,1.41,4
U. Catolica,6,3,2,1,8,5,3,11,Chile - Primera Division,0.5,0.83,3,1.33,1.83,2.0,1.2,5
Union La Calera,7,3,1,3,9,6,3,10,Chile - Primera Division,0.43,0.57,3,1.29,1.43,2.33,1.75,6
OHiggins,7,2,4,1,7,5,2,10,Chile - Primera Division,0.29,0.86,2,1.0,1.43,3.45,1.16,6
La Serena,7,3,1,3,8,11,-3,10,Chile - Primera Division,0.43,0.57,-3,1.14,1.43,2.33,1.75,6
Cobresal,7,2,3,2,9,8,1,9,Chile - Primera Division,0.29,0.71,1,1.29,1.29,3.45,1.41,7
U. de Chile,5,2,1,2,8,5,3,7,Chile - Primera Division,0.4,0.6,3,1.6,1.4,2.5,1.67,8
Colo-Colo,5,2,1,2,7,5,2,7,Chile - Primera Division,0.4,0.6,2,1.4,1.4,2.5,1.67,8
Union Espanola,6,2,0,4,8,10,-2,6,Chile - Primera Division,0.33,0.33,-2,1.33,1.0,3.03,3.03,9
Nublense,7,1,3,3,5,14,-9,6,Chile - Primera Division,0.14,0.57,-9,0.71,0.86,7.14,1.75,9
D. Limache,7,1,2,4,9,13,-4,5,Chile - Primera Division,0.14,0.43,-4,1.29,0.71,7.14,2.33,10
Everton,7,1,2,4,5,11,-6,5,Chile - Primera Division,0.14,0.43,-6,0.71,0.71,7.14,2.33,10
D. Iquique,7,0,1,6,4,18,-14,1,Chile - Primera Division,0.0,0.14,-14,0.57,0.14,0.0,7.14,11
S. Wanderers,6,4,1,1,9,5,4,13,Chile - Primera B,0.67,0.83,4,1.5,2.17,1.49,1.2,1
Copiapo,6,3,2,1,10,5,5,11,Chile - Primera B,0.5,0.83,5,1.67,1.83,2.0,1.2,2
San Marcos,6,3,1,2,8,6,2,10,Chile - Primera B,0.5,0.67,2,1.33,1.67,2.0,1.49,3
U. Concepcion,6,3,1,2,6,4,2,10,Chile - Primera B,0.5,0.67,2,1.0,1.67,2.0,1.49,3
Recoleta,6,3,1,2,6,7,-1,10,Chile - Primera B,0.5,0.67,-1,1.0,1.67,2.0,1.49,3
Cobreloa,6,2,3,1,9,7,2,9,Chile - Primera B,0.33,0.83,2,1.5,1.5,3.03,1.2,4
Curico Unido,6,2,3,1,7,6,1,9,Chile - Primera B,0.33,0.83,1,1.17,1.5,3.03,1.2,4
San Luis,6,2,3,1,7,6,1,9,Chile - Primera B,0.33,0.83,1,1.17,1.5,3.03,1.2,4
S. Morning,6,2,2,2,6,5,1,8,Chile - Primera B,0.33,0.67,1,1.0,1.33,3.03,1.49,5
Rangers,6,2,2,2,7,7,0,8,Chile - Primera B,0.33,0.67,0,1.17,1.33,3.03,1.49,5
Antofagasta,6,2,2,2,7,10,-3,8,Chile - Primera B,0.33,0.67,-3,1.17,1.33,3.03,1.49,5
Magallanes,6,2,1,3,6,6,0,7,Chile - Primera B,0.33,0.5,0,1.0,1.17,3.03,2.0,6
Concepcion,6,2,1,3,8,10,-2,7,Chile - Primera B,0.33,0.5,-2,1.33,1.17,3.03,2.0,6
Deportes Temuco,6,1,2,3,7,10,-3,5,Chile - Primera B,0.17,0.5,-3,1.17,0.83,5.88,2.0,7
CD Santa Cruz,6,1,1,4,5,10,-5,4,Chile - Primera B,0.17,0.33,-5,0.83,0.67,5.88,3.03,8
U. San Felipe,6,0,2,4,3,7,-4,2,Chile - Primera B,0.0,0.33,-4,0.5,0.33,0.0,3.03,9
S. Shenhua,7,5,2,0,17,10,7,17,China - Super League,0.71,1.0,7,2.43,2.43,1.41,1.0,1
Shandong T.,7,5,1,1,19,9,10,16,China - Super League,0.71,0.86,10,2.71,2.29,1.41,1.16,2
Shanghai Port,6,4,2,0,15,7,8,14,China - Super League,0.67,1.0,8,2.5,2.33,1.49,1.0,3
Chengdu,7,4,2,1,10,4,6,14,China - Super League,0.57,0.86,6,1.43,2.0,1.75,1.16,3
Beijing Guoan,6,2,4,0,13,9,4,10,China - Super League,0.33,1.0,4,2.17,1.67,3.03,1.0,4
Tianjin T.,7,2,4,1,11,12,-1,10,China - Super League,0.29,0.86,-1,1.57,1.43,3.45,1.16,4
Zhejiang,7,2,3,2,13,9,4,9,China - Super League,0.29,0.71,4,1.86,1.29,3.45,1.41,5
Qingdao West C.,6,2,3,1,13,14,-1,9,China - Super League,0.33,0.83,-1,2.17,1.5,3.03,1.2,5
Dalian Yingbo,7,2,3,2,7,9,-2,9,China - Super League,0.29,0.71,-2,1.0,1.29,3.45,1.41,5
Meizhou Hakka,7,2,2,3,14,15,-1,8,China - Super League,0.29,0.57,-1,2.0,1.14,3.45,1.75,6
Yunnan Yukun,7,2,2,3,9,13,-4,8,China - Super League,0.29,0.57,-4,1.29,1.14,3.45,1.75,6
Sichuan Jiuniu,7,2,0,5,9,18,-9,6,China - Super League,0.29,0.29,-9,1.29,0.86,3.45,3.45,7
Wuhan Three T.,7,1,2,4,9,16,-7,5,China - Super League,0.14,0.43,-7,1.29,0.71,7.14,2.33,8
Henan SL,6,1,1,4,7,10,-3,4,China - Super League,0.17,0.33,-3,1.17,0.67,5.88,3.03,9
Changchun Yatai,7,1,1,5,7,13,-6,4,China - Super League,0.14,0.29,-6,1.0,0.57,7.14,3.45,9
Qingdao Hainiu,7,0,2,5,5,10,-5,2,China - Super League,0.0,0.29,-5,0.71,0.29,0.0,3.45,10
S. Gongfu,4,3,1,0,8,2,6,10,China - League One,0.75,1.0,6,2.0,2.5,1.33,1.0,1
Chongqing T.,4,3,1,0,8,3,5,10,China - League One,0.75,1.0,5,2.0,2.5,1.33,1.0,1
Liaoning Tieren,4,3,0,1,8,3,5,9,China - League One,0.75,0.75,5,2.0,2.25,1.33,1.33,2
Guangdong GZP,4,2,1,1,7,3,4,7,China - League One,0.5,0.75,4,1.75,1.75,2.0,1.33,3
Nantong Zhiyun,4,2,1,1,3,2,1,7,China - League One,0.5,0.75,1,0.75,1.75,2.0,1.33,3
Suzhou Dongwu,4,1,3,0,2,0,2,6,China - League One,0.25,1.0,2,0.5,1.5,4.0,1.0,4
Shenzhen J.,4,2,0,2,5,6,-1,6,China - League One,0.5,0.5,-1,1.25,1.5,2.0,2.0,4
Nanjing City,4,1,2,1,3,3,0,5,China - League One,0.25,0.75,0,0.75,1.25,4.0,1.33,5
Heilongjiang IC,4,1,2,1,5,6,-1,5,China - League One,0.25,0.75,-1,1.25,1.25,4.0,1.33,5
Dalian Kuncheng,4,1,2,1,2,3,-1,5,China - League One,0.25,0.75,-1,0.5,1.25,4.0,1.33,5
Shaanxi Union,4,1,1,2,5,5,0,4,China - League One,0.25,0.5,0,1.25,1.0,4.0,2.0,6
Shanghai Jiadin,4,1,1,2,3,5,-2,4,China - League One,0.25,0.5,-2,0.75,1.0,4.0,2.0,6
Qingdao RL,4,0,3,1,2,3,-1,3,China - League One,0.0,0.75,-1,0.5,0.75,0.0,1.33,7
Foshan Nanshi,4,1,0,3,3,7,-4,3,China - League One,0.25,0.25,-4,0.75,0.75,4.0,4.0,7
Guangxi Baoyun,4,0,1,3,0,6,-6,1,China - League One,0.0,0.25,-6,0.0,0.25,0.0,4.0,8
Yanbian Longdin,4,0,1,3,2,9,-7,1,China - League One,0.0,0.25,-7,0.5,0.25,0.0,4.0,8
Guangzhou Dande,5,4,0,1,10,3,7,12,China - League Two,0.8,0.8,7,2.0,2.4,1.25,1.25,1
Wenzhou Pro.,5,3,2,0,7,2,5,11,China - League Two,0.6,1.0,5,1.4,2.2,1.67,1.0,2
Changchun Xidu,5,3,1,1,6,3,3,10,China - League Two,0.6,0.8,3,1.2,2.0,1.67,1.25,3
Guizhou Zhuchen,5,3,1,1,6,4,2,10,China - League Two,0.6,0.8,2,1.2,2.0,1.67,1.25,3
Wuxi Wugou,5,2,3,0,7,2,5,9,China - League Two,0.4,1.0,5,1.4,1.8,2.5,1.0,4
Haikou M.,5,2,3,0,6,3,3,9,China - League Two,0.4,1.0,3,1.2,1.8,2.5,1.0,4
Shandong T. B,5,2,3,0,6,3,3,9,China - League Two,0.4,1.0,3,1.2,1.8,2.5,1.0,4
Langfang Glory,5,2,3,0,6,4,2,9,China - League Two,0.4,1.0,2,1.2,1.8,2.5,1.0,4
Jiangxi Lushan,5,2,3,0,5,3,2,9,China - League Two,0.4,1.0,2,1.0,1.8,2.5,1.0,4
Chengdu Rongche,5,2,2,1,6,4,2,8,China - League Two,0.4,0.8,2,1.2,1.6,2.5,1.25,5
Guangxi H.,5,2,2,1,4,3,1,8,China - League Two,0.4,0.8,1,0.8,1.6,2.5,1.25,5
Ganzhou Ruishi,5,1,4,0,4,3,1,7,China - League Two,0.2,1.0,1,0.8,1.4,5.0,1.0,6
Shanghai Port B,5,2,0,3,8,6,2,6,China - League Two,0.4,0.4,2,1.6,1.2,2.5,2.5,7
Rizhao Yuqi,5,1,3,1,3,3,0,6,China - League Two,0.2,0.8,0,0.6,1.2,5.0,1.25,7
Nantong Haimen,5,1,3,1,4,7,-3,6,China - League Two,0.2,0.8,-3,0.8,1.2,5.0,1.25,7
Shenzhen 2028,5,1,2,2,2,4,-2,5,China - League Two,0.2,0.6,-2,0.4,1.0,5.0,1.67,8
Beijing IT,5,1,1,3,4,5,-1,4,China - League Two,0.2,0.4,-1,0.8,0.8,5.0,2.5,9
Xian Ronghai,5,0,4,1,1,6,-5,4,China - League Two,0.0,0.8,-5,0.2,0.8,0.0,1.25,9
Wuhan Three Tow,5,0,3,2,2,4,-2,3,China - League Two,0.0,0.6,-2,0.4,0.6,0.0,1.67,10
Quanzhou Yassin,5,0,3,2,1,4,-3,3,China - League Two,0.0,0.6,-3,0.2,0.6,0.0,1.67,10
Hubei Istar,5,0,3,2,1,5,-4,3,China - League Two,0.0,0.6,-4,0.2,0.6,0.0,1.67,10
Taian Tiankuang,5,0,1,4,2,6,-4,1,China - League Two,0.0,0.2,-4,0.4,0.2,0.0,5.0,11
Guangdong Mingt,5,0,1,4,2,9,-7,1,China - League Two,0.0,0.2,-7,0.4,0.2,0.0,5.0,11
Guangxi Lanhang,5,0,1,4,1,8,-7,1,China - League Two,0.0,0.2,-7,0.2,0.2,0.0,5.0,11
Junior,8,5,3,0,11,6,5,18,Colombia - Primera A - Apertura,0.62,1.0,5,1.38,2.25,1.61,1.0,1
A. Nacional,8,4,3,1,11,7,4,15,Colombia - Primera A - Apertura,0.5,0.88,4,1.38,1.88,2.0,1.14,2
A. Bucaramanga,8,4,2,2,12,6,6,14,Colombia - Primera A - Apertura,0.5,0.75,6,1.5,1.75,2.0,1.33,3
Millonarios,8,4,2,2,10,5,5,14,Colombia - Primera A - Apertura,0.5,0.75,5,1.25,1.75,2.0,1.33,3
Deportes Tolima,8,4,2,2,13,9,4,14,Colombia - Primera A - Apertura,0.5,0.75,4,1.62,1.75,2.0,1.33,3
I. Medelin,8,3,4,1,7,3,4,13,Colombia - Primera A - Apertura,0.38,0.88,4,0.88,1.62,2.63,1.14,4
America de Cali,8,3,3,2,9,6,3,12,Colombia - Primera A - Apertura,0.38,0.75,3,1.12,1.5,2.63,1.33,5
D. Pereira,8,3,3,2,10,8,2,12,Colombia - Primera A - Apertura,0.38,0.75,2,1.25,1.5,2.63,1.33,5
Once Caldas,8,3,2,3,9,6,3,11,Colombia - Primera A - Apertura,0.38,0.62,3,1.12,1.38,2.63,1.61,6
Santa Fe,8,3,2,3,9,10,-1,11,Colombia - Primera A - Apertura,0.38,0.62,-1,1.12,1.38,2.63,1.61,6
Deportivo Pasto,8,2,4,2,8,8,0,10,Colombia - Primera A - Apertura,0.25,0.75,0,1.0,1.25,4.0,1.33,7
A. Petrolera,8,3,1,4,5,9,-4,10,Colombia - Primera A - Apertura,0.38,0.5,-4,0.62,1.25,2.63,2.0,7
Deportivo Cali,8,1,6,1,7,7,0,9,Colombia - Primera A - Apertura,0.12,0.88,0,0.88,1.12,8.33,1.14,8
Llaneros,8,3,0,5,5,7,-2,9,Colombia - Primera A - Apertura,0.38,0.38,-2,0.62,1.12,2.63,2.63,8
Envigado,8,2,2,4,6,14,-8,8,Colombia - Primera A - Apertura,0.25,0.5,-8,0.75,1.0,4.0,2.0,9
R. Aguilas,8,1,4,3,4,6,-2,7,Colombia - Primera A - Apertura,0.12,0.62,-2,0.5,0.88,8.33,1.61,10
La Equidad,8,1,2,5,5,12,-7,5,Colombia - Primera A - Apertura,0.12,0.38,-7,0.62,0.62,8.33,2.63,11
Boyaca Chico,8,0,5,3,4,13,-9,5,Colombia - Primera A - Apertura,0.0,0.62,-9,0.5,0.62,0.0,1.61,11
Union Magdalena,8,0,4,4,7,11,-4,4,Colombia - Primera A - Apertura,0.0,0.5,-4,0.88,0.5,0.0,2.0,12
Fortaleza CEIF,8,0,3,5,3,16,-13,3,Colombia - Primera A - Apertura,0.0,0.38,-13,0.38,0.38,0.0,2.63,13
I. Medelin,8,5,2,1,15,6,9,17,Colombia - Primera A - Clausura,0.62,0.88,9,1.88,2.12,1.61,1.14,1
Millonarios,8,5,2,1,11,4,7,17,Colombia - Primera A - Clausura,0.62,0.88,7,1.38,2.12,1.61,1.14,1
Junior,8,4,3,1,11,4,7,15,Colombia - Primera A - Clausura,0.5,0.88,7,1.38,1.88,2.0,1.14,2
Santa Fe,8,4,3,1,12,6,6,15,Colombia - Primera A - Clausura,0.5,0.88,6,1.5,1.88,2.0,1.14,2
D. Pereira,8,4,3,1,12,9,3,15,Colombia - Primera A - Clausura,0.5,0.88,3,1.5,1.88,2.0,1.14,2
Deportes Tolima,8,4,2,2,9,4,5,14,Colombia - Primera A - Clausura,0.5,0.75,5,1.12,1.75,2.0,1.33,3
Deportivo Pasto,8,4,1,3,14,11,3,13,Colombia - Primera A - Clausura,0.5,0.62,3,1.75,1.62,2.0,1.61,4
A. Nacional,8,3,4,1,9,7,2,13,Colombia - Primera A - Clausura,0.38,0.88,2,1.12,1.62,2.63,1.14,4
A. Bucaramanga,8,3,3,2,12,7,5,12,Colombia - Primera A - Clausura,0.38,0.75,5,1.5,1.5,2.63,1.33,5
America de Cali,8,3,2,3,10,10,0,11,Colombia - Primera A - Clausura,0.38,0.62,0,1.25,1.38,2.63,1.61,6
Fortaleza CEIF,8,3,1,4,9,8,1,10,Colombia - Primera A - Clausura,0.38,0.5,1,1.12,1.25,2.63,2.0,7
La Equidad,8,2,3,3,12,13,-1,9,Colombia - Primera A - Clausura,0.25,0.62,-1,1.5,1.12,4.0,1.61,8
Patriotas,8,2,2,4,12,14,-2,8,Colombia - Primera A - Clausura,0.25,0.5,-2,1.5,1.0,4.0,2.0,9
Deportivo Cali,8,2,2,4,5,9,-4,8,Colombia - Primera A - Clausura,0.25,0.5,-4,0.62,1.0,4.0,2.0,9
A. Petrolera,8,2,2,4,7,12,-5,8,Colombia - Primera A - Clausura,0.25,0.5,-5,0.88,1.0,4.0,2.0,9
Jaguares de C.,8,2,2,4,7,14,-7,8,Colombia - Primera A - Clausura,0.25,0.5,-7,0.88,1.0,4.0,2.0,9
Envigado,8,2,1,5,5,9,-4,7,Colombia - Primera A - Clausura,0.25,0.38,-4,0.62,0.88,4.0,2.63,10
Boyaca Chico,8,2,1,5,5,15,-10,7,Colombia - Primera A - Clausura,0.25,0.38,-10,0.62,0.88,4.0,2.63,10
Once Caldas,8,1,2,5,4,12,-8,5,Colombia - Primera A - Clausura,0.12,0.38,-8,0.5,0.62,8.33,2.63,11
R. Aguilas,8,1,1,6,4,15,-11,4,Colombia - Primera A - Clausura,0.12,0.25,-11,0.5,0.5,8.33,4.0,12
Saprissa,8,5,2,1,13,7,6,17,Costa Rica - Primera Div. - Apertura,0.62,0.88,6,1.62,2.12,1.61,1.14,1
Alajuelense,8,5,1,2,13,6,7,16,Costa Rica - Primera Div. - Apertura,0.62,0.75,7,1.62,2.0,1.61,1.33,2
Santos Guapiles,8,5,1,2,14,8,6,16,Costa Rica - Primera Div. - Apertura,0.62,0.75,6,1.75,2.0,1.61,1.33,2
Guanacasteca,8,4,1,3,11,11,0,13,Costa Rica - Primera Div. - Apertura,0.5,0.62,0,1.38,1.62,2.0,1.61,3
Herediano,8,3,3,2,11,9,2,12,Costa Rica - Primera Div. - Apertura,0.38,0.75,2,1.38,1.5,2.63,1.33,4
San Carlos,8,2,5,1,11,11,0,11,Costa Rica - Primera Div. - Apertura,0.25,0.88,0,1.38,1.38,4.0,1.14,5
Cartagines,8,3,1,4,15,18,-3,10,Costa Rica - Primera Div. - Apertura,0.38,0.5,-3,1.88,1.25,2.63,2.0,6
Zeledon,8,3,1,4,9,12,-3,10,Costa Rica - Primera Div. - Apertura,0.38,0.5,-3,1.12,1.25,2.63,2.0,6
M. Liberia,8,2,2,4,9,11,-2,8,Costa Rica - Primera Div. - Apertura,0.25,0.5,-2,1.12,1.0,4.0,2.0,7
Sporting SJ,8,2,1,5,10,11,-1,7,Costa Rica - Primera Div. - Apertura,0.25,0.38,-1,1.25,0.88,4.0,2.63,8
Santa Ana,8,2,1,5,7,11,-4,7,Costa Rica - Primera Div. - Apertura,0.25,0.38,-4,0.88,0.88,4.0,2.63,8
Puntarenas,8,2,1,5,8,16,-8,7,Costa Rica - Primera Div. - Apertura,0.25,0.38,-8,1.0,0.88,4.0,2.63,8
Banik Ostrava,8,6,1,1,17,6,11,19,CzechRepublic - 1. Liga,0.75,0.88,11,2.12,2.38,1.33,1.14,1
Slavia Prague,8,6,1,1,15,4,11,19,CzechRepublic - 1. Liga,0.75,0.88,11,1.88,2.38,1.33,1.14,1
Slovan Liberec,8,5,3,0,13,2,11,18,CzechRepublic - 1. Liga,0.62,1.0,11,1.62,2.25,1.61,1.0,2
Viktoria Plzen,8,5,1,2,13,7,6,16,CzechRepublic - 1. Liga,0.62,0.75,6,1.62,2.0,1.61,1.33,3
Sparta Prague,8,5,1,2,14,10,4,16,CzechRepublic - 1. Liga,0.62,0.75,4,1.75,2.0,1.61,1.33,3
Jablonec,8,4,3,1,11,6,5,15,CzechRepublic - 1. Liga,0.5,0.88,5,1.38,1.88,2.0,1.14,4
Karvina,8,4,2,2,11,14,-3,14,CzechRepublic - 1. Liga,0.5,0.75,-3,1.38,1.75,2.0,1.33,5
Hradec Kralove,8,3,3,2,13,10,3,12,CzechRepublic - 1. Liga,0.38,0.75,3,1.62,1.5,2.63,1.33,6
Sigma Olomouc,8,3,2,3,13,9,4,11,CzechRepublic - 1. Liga,0.38,0.62,4,1.62,1.38,2.63,1.61,7
Dukla Praha,8,2,4,2,6,7,-1,10,CzechRepublic - 1. Liga,0.25,0.75,-1,0.75,1.25,4.0,1.33,8
Teplice,8,2,3,3,6,8,-2,9,CzechRepublic - 1. Liga,0.25,0.62,-2,0.75,1.12,4.0,1.61,9
Bohemians,8,1,3,4,6,11,-5,6,CzechRepublic - 1. Liga,0.12,0.5,-5,0.75,0.75,8.33,2.0,10
Slovacko,8,1,2,5,5,17,-12,5,CzechRepublic - 1. Liga,0.12,0.38,-12,0.62,0.62,8.33,2.63,11
Pardubice,8,1,1,6,4,16,-12,4,CzechRepublic - 1. Liga,0.12,0.25,-12,0.5,0.5,8.33,4.0,12
Mlada Boleslav,8,1,0,7,7,15,-8,3,CzechRepublic - 1. Liga,0.12,0.12,-8,0.88,0.38,8.33,8.33,13
C. Budejovice,8,0,1,7,7,18,-11,1,CzechRepublic - 1. Liga,0.0,0.12,-11,0.88,0.12,0.0,8.33,14
Viborg,8,5,2,1,19,13,6,17,Denmark - Superligaen,0.62,0.88,6,2.38,2.12,1.61,1.14,1
Brondby IF,8,4,3,1,17,12,5,15,Denmark - Superligaen,0.5,0.88,5,2.12,1.88,2.0,1.14,2
FC Kobenhavn,8,4,2,2,9,7,2,14,Denmark - Superligaen,0.5,0.75,2,1.12,1.75,2.0,1.33,3
Silkeborg,8,4,1,3,17,10,7,13,Denmark - Superligaen,0.5,0.62,7,2.12,1.62,2.0,1.61,4
FC Midtjylland,8,4,1,3,13,10,3,13,Denmark - Superligaen,0.5,0.62,3,1.62,1.62,2.0,1.61,4
Nordsjaelland,8,4,0,4,14,12,2,12,Denmark - Superligaen,0.5,0.5,2,1.75,1.5,2.0,2.0,5
Randers FC,8,3,2,3,14,15,-1,11,Denmark - Superligaen,0.38,0.62,-1,1.75,1.38,2.63,1.61,6
SonderjyskE,8,3,1,4,10,13,-3,10,Denmark - Superligaen,0.38,0.5,-3,1.25,1.25,2.63,2.0,7
AGF Aarhus,8,2,3,3,13,11,2,9,Denmark - Superligaen,0.25,0.62,2,1.62,1.12,4.0,1.61,8
Lyngby,8,2,3,3,7,9,-2,9,Denmark - Superligaen,0.25,0.62,-2,0.88,1.12,4.0,1.61,8
Vejle BK,8,2,3,3,13,16,-3,9,Denmark - Superligaen,0.25,0.62,-3,1.62,1.12,4.0,1.61,8
Aalborg BK,8,1,3,4,8,17,-9,6,Denmark - Superligaen,0.12,0.5,-9,1.0,0.75,8.33,2.0,9
Hillerod,8,4,3,1,10,4,6,15,Denmark - 1st Division,0.5,0.88,6,1.25,1.88,2.0,1.14,1
AC Horsens,8,5,0,3,14,14,0,15,Denmark - 1st Division,0.62,0.62,0,1.75,1.88,1.61,1.61,1
Odense BK,8,3,4,1,14,7,7,13,Denmark - 1st Division,0.38,0.88,7,1.75,1.62,2.63,1.14,2
Fredericia,8,4,1,3,9,6,3,13,Denmark - 1st Division,0.5,0.62,3,1.12,1.62,2.0,1.61,2
Kolding IF,8,4,1,3,12,10,2,13,Denmark - 1st Division,0.5,0.62,2,1.5,1.62,2.0,1.61,2
B 93,8,3,4,1,12,11,1,13,Denmark - 1st Division,0.38,0.88,1,1.5,1.62,2.63,1.14,2
Hvidovre,8,3,2,3,7,9,-2,11,Denmark - 1st Division,0.38,0.62,-2,0.88,1.38,2.63,1.61,3
HB Koge,8,2,4,2,8,10,-2,10,Denmark - 1st Division,0.25,0.75,-2,1.0,1.25,4.0,1.33,4
Roskilde,8,2,3,3,11,11,0,9,Denmark - 1st Division,0.25,0.62,0,1.38,1.12,4.0,1.61,5
Hobro,8,2,3,3,7,9,-2,9,Denmark - 1st Division,0.25,0.62,-2,0.88,1.12,4.0,1.61,5
Esbjerg,8,2,0,6,7,14,-7,6,Denmark - 1st Division,0.25,0.25,-7,0.88,0.75,4.0,4.0,6
Vendsyssel,8,0,3,5,5,12,-7,3,Denmark - 1st Division,0.0,0.38,-7,0.62,0.38,0.0,2.63,7
AB Copenhagen,8,5,1,2,20,11,9,16,Denmark - 2nd Division,0.62,0.75,9,2.5,2.0,1.61,1.33,1
Aarhus Fremad,8,5,1,2,12,3,9,16,Denmark - 2nd Division,0.62,0.75,9,1.5,2.0,1.61,1.33,1
Middelfart,8,5,1,2,12,9,3,16,Denmark - 2nd Division,0.62,0.75,3,1.5,2.0,1.61,1.33,1
Skive,8,4,2,2,9,6,3,14,Denmark - 2nd Division,0.5,0.75,3,1.12,1.75,2.0,1.33,2
Naestved,8,4,1,3,10,9,1,13,Denmark - 2nd Division,0.5,0.62,1,1.25,1.62,2.0,1.61,3
BK Frem,8,3,2,3,9,7,2,11,Denmark - 2nd Division,0.38,0.62,2,1.12,1.38,2.63,1.61,4
Ishoj,8,3,2,3,8,9,-1,11,Denmark - 2nd Division,0.38,0.62,-1,1.0,1.38,2.63,1.61,4
Fremad Amager,8,3,1,4,10,11,-1,10,Denmark - 2nd Division,0.38,0.5,-1,1.25,1.25,2.63,2.0,5
Hellerup IK,8,3,0,5,6,16,-10,9,Denmark - 2nd Division,0.38,0.38,-10,0.75,1.12,2.63,2.63,6
Helsingor,8,1,5,2,9,11,-2,8,Denmark - 2nd Division,0.12,0.75,-2,1.12,1.0,8.33,1.33,7
Nykobing,8,1,2,5,8,13,-5,5,Denmark - 2nd Division,0.12,0.38,-5,1.0,0.62,8.33,2.63,8
Thisted,8,1,2,5,8,16,-8,5,Denmark - 2nd Division,0.12,0.38,-8,1.0,0.62,8.33,2.63,8
I. del Valle,8,4,3,1,16,7,9,15,Ecuador - Liga Pro 1st Stage,0.5,0.88,9,2.0,1.88,2.0,1.14,1
Cuniburo,8,4,3,1,15,8,7,15,Ecuador - Liga Pro 1st Stage,0.5,0.88,7,1.88,1.88,2.0,1.14,1
Barcelona SC,7,5,0,2,12,10,2,15,Ecuador - Liga Pro 1st Stage,0.71,0.71,2,1.71,2.14,1.41,1.41,1
Orense,8,4,1,3,9,12,-3,13,Ecuador - Liga Pro 1st Stage,0.5,0.62,-3,1.12,1.62,2.0,1.61,2
U. Catolica,8,3,3,2,14,8,6,12,Ecuador - Liga Pro 1st Stage,0.38,0.75,6,1.75,1.5,2.63,1.33,3
Mushuc Runa,8,3,3,2,10,7,3,12,Ecuador - Liga Pro 1st Stage,0.38,0.75,3,1.25,1.5,2.63,1.33,3
Aucas,8,3,3,2,12,10,2,12,Ecuador - Liga Pro 1st Stage,0.38,0.75,2,1.5,1.5,2.63,1.33,3
Libertad,8,3,3,2,13,12,1,12,Ecuador - Liga Pro 1st Stage,0.38,0.75,1,1.62,1.5,2.63,1.33,3
LDU Quito,7,3,2,2,10,4,6,11,Ecuador - Liga Pro 1st Stage,0.43,0.71,6,1.43,1.57,2.33,1.41,4
D. Cuenca,8,3,1,4,6,10,-4,10,Ecuador - Liga Pro 1st Stage,0.38,0.5,-4,0.75,1.25,2.63,2.0,5
Macara,8,2,3,3,5,6,-1,9,Ecuador - Liga Pro 1st Stage,0.25,0.62,-1,0.62,1.12,4.0,1.61,6
Manta,8,2,3,3,13,16,-3,9,Ecuador - Liga Pro 1st Stage,0.25,0.62,-3,1.62,1.12,4.0,1.61,6
Emelec,8,1,4,3,5,11,-6,7,Ecuador - Liga Pro 1st Stage,0.12,0.62,-6,0.62,0.88,8.33,1.61,7
Tecnico U.,8,1,3,4,7,12,-5,6,Ecuador - Liga Pro 1st Stage,0.12,0.5,-5,0.88,0.75,8.33,2.0,8
Delfin,8,1,3,4,5,15,-10,6,Ecuador - Liga Pro 1st Stage,0.12,0.5,-10,0.62,0.75,8.33,2.0,8
El Nacional,8,1,2,5,8,12,-4,5,Ecuador - Liga Pro 1st Stage,0.12,0.38,-4,1.0,0.62,8.33,2.63,9
Cumbaya,5,3,2,0,10,3,7,11,Ecuador - Serie B,0.6,1.0,7,2.0,2.2,1.67,1.0,1
Nueve Octubre,4,2,2,0,4,2,2,8,Ecuador - Serie B,0.5,1.0,2,1.0,2.0,2.0,1.0,2
Leones Norte,5,1,4,0,7,5,2,7,Ecuador - Serie B,0.2,1.0,2,1.4,1.4,5.0,1.0,3
San Antonio,5,2,1,2,4,5,-1,7,Ecuador - Serie B,0.4,0.6,-1,0.8,1.4,2.5,1.67,3
Gualaceo,4,1,3,0,7,6,1,6,Ecuador - Serie B,0.25,1.0,1,1.75,1.5,4.0,1.0,4
Vinotinto,4,2,0,2,5,5,0,6,Ecuador - Serie B,0.5,0.5,0,1.25,1.5,2.0,2.0,4
Vargas Torres,5,1,3,1,4,4,0,6,Ecuador - Serie B,0.2,0.8,0,0.8,1.2,5.0,1.25,4
22 de Julio,5,1,3,1,3,6,-3,6,Ecuador - Serie B,0.2,0.8,-3,0.6,1.2,5.0,1.25,4
Guayaquil City,4,1,1,2,5,4,1,4,Ecuador - Serie B,0.25,0.5,1,1.25,1.0,4.0,2.0,5
I. Juniors,5,1,1,3,6,9,-3,4,Ecuador - Serie B,0.2,0.4,-3,1.2,0.8,5.0,2.5,5
Imbabura,5,0,3,2,5,8,-3,3,Ecuador - Serie B,0.0,0.6,-3,1.0,0.6,0.0,1.67,6
Chacaritas,5,0,3,2,4,7,-3,3,Ecuador - Serie B,0.0,0.6,-3,0.8,0.6,0.0,1.67,6
Pyramids FC,8,6,2,0,13,4,9,20,Egypt - Premier League,0.75,1.0,9,1.62,2.5,1.33,1.0,1
Zamalek,8,5,3,0,14,3,11,18,Egypt - Premier League,0.62,1.0,11,1.75,2.25,1.61,1.0,2
El Gouna,8,5,2,1,11,4,7,17,Egypt - Premier League,0.62,0.88,7,1.38,2.12,1.61,1.14,3
Al Ahly,8,5,2,1,12,6,6,17,Egypt - Premier League,0.62,0.88,6,1.5,2.12,1.61,1.14,3
Al Masry,8,4,3,1,13,4,9,15,Egypt - Premier League,0.5,0.88,9,1.62,1.88,2.0,1.14,4
National Bank,8,4,3,1,14,9,5,15,Egypt - Premier League,0.5,0.88,5,1.75,1.88,2.0,1.14,4
Ghazl El M.,8,4,0,4,8,9,-1,12,Egypt - Premier League,0.5,0.5,-1,1.0,1.5,2.0,2.0,5
Pharco,8,3,2,3,6,7,-1,11,Egypt - Premier League,0.38,0.62,-1,0.75,1.38,2.63,1.61,6
ZED FC,8,2,4,2,11,8,3,10,Egypt - Premier League,0.25,0.75,3,1.38,1.25,4.0,1.33,7
El Geish,8,2,3,3,6,8,-2,9,Egypt - Premier League,0.25,0.62,-2,0.75,1.12,4.0,1.61,8
Ceramica C.,8,2,2,4,11,11,0,8,Egypt - Premier League,0.25,0.5,0,1.38,1.0,4.0,2.0,9
ENPPI,8,2,2,4,6,12,-6,8,Egypt - Premier League,0.25,0.5,-6,0.75,1.0,4.0,2.0,9
Petrojet,8,2,2,4,9,16,-7,8,Egypt - Premier League,0.25,0.5,-7,1.12,1.0,4.0,2.0,9
Haras El Hodood,8,2,1,5,7,12,-5,7,Egypt - Premier League,0.25,0.38,-5,0.88,0.88,4.0,2.63,10
Ismaily,8,1,3,4,3,12,-9,6,Egypt - Premier League,0.12,0.5,-9,0.38,0.75,8.33,2.0,11
Smouha,8,2,0,6,3,12,-9,6,Egypt - Premier League,0.25,0.25,-9,0.38,0.75,4.0,4.0,11
Modern Sport,8,1,2,5,8,12,-4,5,Egypt - Premier League,0.12,0.38,-4,1.0,0.62,8.33,2.63,12
Al Ittihad,8,1,2,5,6,12,-6,5,Egypt - Premier League,0.12,0.38,-6,0.75,0.62,8.33,2.63,12
Liverpool,8,6,1,1,16,8,8,19,Premier League,0.75,0.88,8,2.0,2.38,1.33,1.14,2
Newcastle Utd,8,6,0,2,19,11,8,18,Premier League,0.75,0.75,8,2.38,2.25,1.33,1.33,3
Aston Villa,8,5,2,1,15,9,6,17,Premier League,0.62,0.88,6,1.88,2.12,1.61,1.14,4
Wolverhampton,8,5,1,2,13,9,4,16,Premier League,0.62,0.75,4,1.62,2.0,1.61,1.33,5
Manchester City,8,4,2,2,14,7,7,14,Premier League,0.5,0.75,7,1.75,1.75,2.0,1.33,7
Brighton,8,4,2,2,16,11,5,14,Premier League,0.5,0.75,5,2.0,1.75,2.0,1.33,7
Arsenal,8,3,4,1,8,5,3,13,Premier League,0.38,0.88,3,1.0,1.62,2.63,1.14,8
Crystal Palace,8,4,1,3,13,15,-2,13,Premier League,0.5,0.62,-2,1.62,1.62,2.0,1.61,8
Brentford,8,3,3,2,10,6,4,12,Premier League,0.38,0.75,4,1.25,1.5,2.63,1.33,9
Fulham,8,4,0,4,11,11,0,12,Premier League,0.5,0.5,0,1.38,1.5,2.0,2.0,9
Chelsea,8,3,2,3,9,8,1,11,Premier League,0.38,0.62,1,1.12,1.38,2.63,1.61,10
Everton,8,2,5,1,9,8,1,11,Premier League,0.25,0.88,1,1.12,1.38,4.0,1.14,10
Tottenham,8,3,1,4,12,12,0,10,Premier League,0.38,0.5,0,1.5,1.25,2.63,2.0,11
Nottm Forest,8,3,1,4,11,11,0,10,Premier League,0.38,0.5,0,1.38,1.25,2.63,2.0,11
Manchester Utd,8,2,3,3,10,11,-1,9,Premier League,0.25,0.62,-1,1.25,1.12,4.0,1.61,12
Bournemouth,8,2,2,4,11,12,-1,8,Premier League,0.25,0.5,-1,1.38,1.0,4.0,2.0,13
West Ham Utd,8,2,2,4,7,8,-1,8,Premier League,0.25,0.5,-1,0.88,1.0,4.0,2.0,13
Ipswich Town,8,1,2,5,11,18,-7,5,Premier League,0.12,0.38,-7,1.38,0.62,8.33,2.63,16
Leicester City,8,0,1,7,2,19,-17,1,Premier League,0.0,0.12,-17,0.25,0.12,0.0,8.33,17
Southampton,8,0,1,7,5,23,-18,1,Premier League,0.0,0.12,-18,0.62,0.12,0.0,8.33,17
Burnley,8,6,2,0,14,4,10,20,Premier League,0.75,1.0,10,1.75,2.5,1.33,1.0,1
Bristol City,8,4,3,1,11,7,4,15,Premier League,0.5,0.88,4,1.38,1.88,2.0,1.14,6
Millwall,8,5,0,3,7,7,0,15,Premier League,0.62,0.62,0,0.88,1.88,1.61,1.61,6
Derby County,8,4,2,2,11,7,4,14,Premier League,0.5,0.75,4,1.38,1.75,2.0,1.33,7
Swansea City,8,4,2,2,8,5,3,14,Premier League,0.5,0.75,3,1.0,1.75,2.0,1.33,7
Sunderland,8,4,2,2,7,7,0,14,Premier League,0.5,0.75,0,0.88,1.75,2.0,1.33,7
Leeds Utd,8,3,4,1,11,8,3,13,Premier League,0.38,0.88,3,1.38,1.62,2.63,1.14,8
Sheffield Utd,8,4,1,3,9,7,2,13,Premier League,0.5,0.62,2,1.12,1.62,2.0,1.61,8
Middlesbrough,8,4,1,3,7,5,2,13,Premier League,0.5,0.62,2,0.88,1.62,2.0,1.61,8
Coventry City,8,4,1,3,13,12,1,13,Premier League,0.5,0.62,1,1.62,1.62,2.0,1.61,8
Stoke City,8,3,3,2,9,7,2,12,Premier League,0.38,0.75,2,1.12,1.5,2.63,1.33,9
Hull City,8,3,3,2,8,6,2,12,Premier League,0.38,0.75,2,1.0,1.5,2.63,1.33,9
Luton Town,8,3,3,2,6,8,-2,12,Premier League,0.38,0.75,-2,0.75,1.5,2.63,1.33,9
Oxford Utd,8,3,1,4,9,11,-2,10,Premier League,0.38,0.5,-2,1.12,1.25,2.63,2.0,11
Plymouth,8,3,1,4,8,14,-6,10,Premier League,0.38,0.5,-6,1.0,1.25,2.63,2.0,11
West Brom,8,2,3,3,7,8,-1,9,Premier League,0.25,0.62,-1,0.88,1.12,4.0,1.61,12
Sheffield Wed,8,2,2,4,10,10,0,8,Premier League,0.25,0.5,0,1.25,1.0,4.0,2.0,13
Watford,8,2,2,4,5,7,-2,8,Premier League,0.25,0.5,-2,0.62,1.0,4.0,2.0,13
Portsmouth,8,2,1,5,7,10,-3,7,Premier League,0.25,0.38,-3,0.88,0.88,4.0,2.63,14
Preston,8,1,4,3,7,10,-3,7,Premier League,0.12,0.62,-3,0.88,0.88,8.33,1.61,14
QP Rangers,8,1,3,4,9,12,-3,6,Premier League,0.12,0.5,-3,1.12,0.75,8.33,2.0,15
Cardiff City,8,1,3,4,8,11,-3,6,Premier League,0.12,0.5,-3,1.0,0.75,8.33,2.0,15
Norwich City,8,1,3,4,8,11,-3,6,Premier League,0.12,0.5,-3,1.0,0.75,8.33,2.0,15
Blackburn,8,1,2,5,6,11,-5,5,Premier League,0.12,0.38,-5,0.75,0.62,8.33,2.63,16
Birmingham City,8,6,1,1,19,10,9,19,League One,0.75,0.88,9,2.38,2.38,1.33,1.14,1
Stockport,8,5,2,1,12,4,8,17,League One,0.62,0.88,8,1.5,2.12,1.61,1.14,2
Wrexham,8,5,2,1,10,4,6,17,League One,0.62,0.88,6,1.25,2.12,1.61,1.14,2
Charlton,8,5,2,1,12,7,5,17,League One,0.62,0.88,5,1.5,2.12,1.61,1.14,2
Blackpool,8,5,1,2,14,6,8,16,League One,0.62,0.75,8,1.75,2.0,1.61,1.33,3
Reading,8,4,3,1,11,7,4,15,League One,0.5,0.88,4,1.38,1.88,2.0,1.14,4
Wycombe,8,4,2,2,7,5,2,14,League One,0.5,0.75,2,0.88,1.75,2.0,1.33,5
Leyton Orient,8,4,1,3,11,9,2,13,League One,0.5,0.62,2,1.38,1.62,2.0,1.61,6
Lincoln City,8,3,3,2,13,6,7,12,League One,0.38,0.75,7,1.62,1.5,2.63,1.33,7
Exeter City,8,3,3,2,8,8,0,12,League One,0.38,0.75,0,1.0,1.5,2.63,1.33,7
Peterborough,8,3,2,3,11,13,-2,11,League One,0.38,0.62,-2,1.38,1.38,2.63,1.61,8
Northampton,8,2,4,2,9,8,1,10,League One,0.25,0.75,1,1.12,1.25,4.0,1.33,9
Burton Albion,8,3,1,4,10,11,-1,10,League One,0.38,0.5,-1,1.25,1.25,2.63,2.0,9
Rotherham,8,3,1,4,9,13,-4,10,League One,0.38,0.5,-4,1.12,1.25,2.63,2.0,9
Bolton,8,3,0,5,8,12,-4,9,League One,0.38,0.38,-4,1.0,1.12,2.63,2.63,10
Wigan Athletic,8,1,5,2,4,5,-1,8,League One,0.12,0.75,-1,0.5,1.0,8.33,1.33,11
Mansfield,8,2,2,4,9,12,-3,8,League One,0.25,0.5,-3,1.12,1.0,4.0,2.0,11
Stevenage,8,2,2,4,7,10,-3,8,League One,0.25,0.5,-3,0.88,1.0,4.0,2.0,11
Crawley Town,8,2,1,5,12,17,-5,7,League One,0.25,0.38,-5,1.5,0.88,4.0,2.63,12
Cambridge Utd,8,1,3,4,6,9,-3,6,League One,0.12,0.5,-3,0.75,0.75,8.33,2.0,13
Huddersfield,8,2,0,6,7,13,-6,6,League One,0.25,0.25,-6,0.88,0.75,4.0,4.0,13
Bristol Rovers,8,2,0,6,7,15,-8,6,League One,0.25,0.25,-8,0.88,0.75,4.0,4.0,13
Barnsley,8,1,2,5,10,17,-7,5,League One,0.12,0.38,-7,1.25,0.62,8.33,2.63,14
Shrewsbury,8,0,3,5,3,13,-10,3,League One,0.0,0.38,-10,0.38,0.38,0.0,2.63,15
Port Vale,8,6,0,2,16,5,11,18,League Two,0.75,0.75,11,2.0,2.25,1.33,1.33,1
Chesterfield,8,5,2,1,13,7,6,17,League Two,0.62,0.88,6,1.62,2.12,1.61,1.14,2
Colchester Utd,8,5,1,2,12,8,4,16,League Two,0.62,0.75,4,1.5,2.0,1.61,1.33,3
Tranmere,8,4,3,1,15,8,7,15,League Two,0.5,0.88,7,1.88,1.88,2.0,1.14,4
Barrow,8,4,3,1,13,6,7,15,League Two,0.5,0.88,7,1.62,1.88,2.0,1.14,4
Swindon Town,8,3,4,1,18,13,5,13,League Two,0.38,0.88,5,2.25,1.62,2.63,1.14,5
Grimsby,8,4,1,3,11,10,1,13,League Two,0.5,0.62,1,1.38,1.62,2.0,1.61,5
Salford City,8,3,4,1,12,12,0,13,League Two,0.38,0.88,0,1.5,1.62,2.63,1.14,5
AFC Wimbledon,8,3,3,2,11,9,2,12,League Two,0.38,0.75,2,1.38,1.5,2.63,1.33,6
Gillingham,8,2,6,0,8,6,2,12,League Two,0.25,1.0,2,1.0,1.5,4.0,1.0,6
Doncaster,8,2,5,1,12,8,4,11,League Two,0.25,0.88,4,1.5,1.38,4.0,1.14,7
Fleetwood,8,3,2,3,13,15,-2,11,League Two,0.38,0.62,-2,1.62,1.38,2.63,1.61,7
Bradford,8,3,1,4,13,10,3,10,League Two,0.38,0.5,3,1.62,1.25,2.63,2.0,8
Notts County,8,3,1,4,9,8,1,10,League Two,0.38,0.5,1,1.12,1.25,2.63,2.0,8
Carlisle Utd,8,3,1,4,11,13,-2,10,League Two,0.38,0.5,-2,1.38,1.25,2.63,2.0,8
Morecambe,8,3,1,4,8,10,-2,10,League Two,0.38,0.5,-2,1.0,1.25,2.63,2.0,8
Harrogate,8,2,4,2,7,9,-2,10,League Two,0.25,0.75,-2,0.88,1.25,4.0,1.33,8
Bromley,8,2,2,4,12,15,-3,8,League Two,0.25,0.5,-3,1.5,1.0,4.0,2.0,9
Accrington,8,1,4,3,10,14,-4,7,League Two,0.12,0.62,-4,1.25,0.88,8.33,1.61,10
Cheltenham,8,2,1,5,8,14,-6,7,League Two,0.25,0.38,-6,1.0,0.88,4.0,2.63,10
Milton Keynes,8,2,1,5,7,17,-10,7,League Two,0.25,0.38,-10,0.88,0.88,4.0,2.63,10
Crewe Alexandra,8,1,3,4,7,12,-5,6,League Two,0.12,0.5,-5,0.88,0.75,8.33,2.0,11
Walsall,8,0,5,3,9,14,-5,5,League Two,0.0,0.62,-5,1.12,0.62,0.0,1.61,12
Newport,8,1,1,6,7,16,-9,4,League Two,0.12,0.25,-9,0.88,0.5,8.33,4.0,13
Barnet,8,6,1,1,16,4,12,19,England - National League,0.75,0.88,12,2.0,2.38,1.33,1.14,1
Tamworth,8,6,1,1,20,10,10,19,England - National League,0.75,0.88,10,2.5,2.38,1.33,1.14,1
Boston Utd,8,6,0,2,13,9,4,18,England - National League,0.75,0.75,4,1.62,2.25,1.33,1.33,2
York City,8,5,1,2,21,8,13,16,England - National League,0.62,0.75,13,2.62,2.0,1.61,1.33,3
Wealdstone,8,4,2,2,10,11,-1,14,England - National League,0.5,0.75,-1,1.25,1.75,2.0,1.33,4
Braintree Town,8,4,1,3,15,13,2,13,England - National League,0.5,0.62,2,1.88,1.62,2.0,1.61,5
Aldershot Town,8,4,1,3,14,18,-4,13,England - National League,0.5,0.62,-4,1.75,1.62,2.0,1.61,5
Hartlepool,8,3,3,2,12,9,3,12,England - National League,0.38,0.75,3,1.5,1.5,2.63,1.33,6
Woking,8,3,3,2,8,7,1,12,England - National League,0.38,0.75,1,1.0,1.5,2.63,1.33,6
Southend Utd,8,3,3,2,10,11,-1,12,England - National League,0.38,0.75,-1,1.25,1.5,2.63,1.33,6
Maidenhead Utd,8,3,2,3,11,8,3,11,England - National League,0.38,0.62,3,1.38,1.38,2.63,1.61,7
Rochdale,8,2,3,3,13,11,2,9,England - National League,0.25,0.62,2,1.62,1.12,4.0,1.61,8
Oldham,8,2,3,3,8,7,1,9,England - National League,0.25,0.62,1,1.0,1.12,4.0,1.61,8
Dagenham & R.,8,2,3,3,6,8,-2,9,England - National League,0.25,0.62,-2,0.75,1.12,4.0,1.61,8
Solihull Moors,8,2,3,3,7,11,-4,9,England - National League,0.25,0.62,-4,0.88,1.12,4.0,1.61,8
Yeovil Town,8,3,0,5,7,13,-6,9,England - National League,0.38,0.38,-6,0.88,1.12,2.63,2.63,8
Ebbsfleet Utd,8,2,2,4,15,16,-1,8,England - National League,0.25,0.5,-1,1.88,1.0,4.0,2.0,9
Halifax Town,8,2,2,4,5,7,-2,8,England - National League,0.25,0.5,-2,0.62,1.0,4.0,2.0,9
Forest Green,8,2,2,4,10,14,-4,8,England - National League,0.25,0.5,-4,1.25,1.0,4.0,2.0,9
Sutton Utd,8,2,2,4,8,14,-6,8,England - National League,0.25,0.5,-6,1.0,1.0,4.0,2.0,9
Eastleigh,8,1,3,4,8,15,-7,6,England - National League,0.12,0.5,-7,1.0,0.75,8.33,2.0,10
Gateshead FC,8,2,0,6,8,17,-9,6,England - National League,0.25,0.25,-9,1.0,0.75,4.0,4.0,10
Altrincham,8,1,2,5,6,12,-6,5,England - National League,0.12,0.38,-6,0.75,0.62,8.33,2.63,11
AFC Fylde,8,1,0,7,5,12,-7,3,England - National League,0.12,0.12,-7,0.62,0.38,8.33,8.33,12
Kidderminster,8,6,2,0,19,3,16,20,England - National L. North,0.75,1.0,16,2.38,2.5,1.33,1.0,1
Scunthorpe,8,6,0,2,12,3,9,18,England - National L. North,0.75,0.75,9,1.5,2.25,1.33,1.33,2
Spennymoor,8,6,0,2,16,8,8,18,England - National L. North,0.75,0.75,8,2.0,2.25,1.33,1.33,2
Buxton,8,5,2,1,16,4,12,17,England - National L. North,0.62,0.88,12,2.0,2.12,1.61,1.14,3
Kings Lynn,8,5,2,1,10,5,5,17,England - National L. North,0.62,0.88,5,1.25,2.12,1.61,1.14,3
Brackley Town,8,5,1,2,9,4,5,16,England - National L. North,0.62,0.75,5,1.12,2.0,1.61,1.33,4
Oxford City,8,4,3,1,14,7,7,15,England - National L. North,0.5,0.88,7,1.75,1.88,2.0,1.14,5
Marine,8,4,3,1,8,7,1,15,England - National L. North,0.5,0.88,1,1.0,1.88,2.0,1.14,5
Scarborough,8,4,1,3,11,9,2,13,England - National L. North,0.5,0.62,2,1.38,1.62,2.0,1.61,6
Chorley,8,3,3,2,11,8,3,12,England - National L. North,0.38,0.75,3,1.38,1.5,2.63,1.33,7
Chester,8,3,3,2,13,12,1,12,England - National L. North,0.38,0.75,1,1.62,1.5,2.63,1.33,7
Darlington,8,3,3,2,15,15,0,12,England - National L. North,0.38,0.75,0,1.88,1.5,2.63,1.33,7
Hereford Utd,8,3,2,3,13,10,3,11,England - National L. North,0.38,0.62,3,1.62,1.38,2.63,1.61,8
Radcliffe,8,3,2,3,8,8,0,11,England - National L. North,0.38,0.62,0,1.0,1.38,2.63,1.61,8
Alfreton Town,8,2,4,2,6,7,-1,10,England - National L. North,0.25,0.75,-1,0.75,1.25,4.0,1.33,9
Rushall,8,2,3,3,7,10,-3,9,England - National L. North,0.25,0.62,-3,0.88,1.12,4.0,1.61,10
Peterborough S.,8,2,2,4,9,12,-3,8,England - National L. North,0.25,0.5,-3,1.12,1.0,4.0,2.0,11
Curzon,8,2,2,4,7,14,-7,8,England - National L. North,0.25,0.5,-7,0.88,1.0,4.0,2.0,11
South Shields,8,2,1,5,7,13,-6,7,England - National L. North,0.25,0.38,-6,0.88,0.88,4.0,2.63,12
Needham Market,8,2,0,6,7,17,-10,6,England - National L. North,0.25,0.25,-10,0.88,0.75,4.0,4.0,13
Leamington,8,1,2,5,3,7,-4,5,England - National L. North,0.12,0.38,-4,0.38,0.62,8.33,2.63,14
Southport,8,1,2,5,4,10,-6,5,England - National L. North,0.12,0.38,-6,0.5,0.62,8.33,2.63,14
Warrington,8,1,0,7,6,16,-10,3,England - National L. North,0.12,0.12,-10,0.75,0.38,8.33,8.33,15
Farsley Celtic,8,0,0,8,6,25,-19,0,England - National L. North,0.0,0.0,-19,0.75,0.0,0.0,0.0,16
Eastbourne,8,6,1,1,17,5,12,19,England - National L. South,0.75,0.88,12,2.12,2.38,1.33,1.14,1
Truro City,8,6,1,1,16,8,8,19,England - National L. South,0.75,0.88,8,2.0,2.38,1.33,1.14,1
Torquay Utd,8,6,1,1,12,5,7,19,England - National L. South,0.75,0.88,7,1.5,2.38,1.33,1.14,1
Worthing,8,5,0,3,15,7,8,15,England - National L. South,0.62,0.62,8,1.88,1.88,1.61,1.61,2
Maidstone Utd,8,4,3,1,14,6,8,15,England - National L. South,0.5,0.88,8,1.75,1.88,2.0,1.14,2
Enfield Town,8,4,3,1,10,8,2,15,England - National L. South,0.5,0.88,2,1.25,1.88,2.0,1.14,2
Weston-s.-Mare,8,4,2,2,12,6,6,14,England - National L. South,0.5,0.75,6,1.5,1.75,2.0,1.33,3
Dorking,8,3,4,1,12,8,4,13,England - National L. South,0.38,0.88,4,1.5,1.62,2.63,1.14,4
Chesham Utd,8,4,1,3,11,12,-1,13,England - National L. South,0.5,0.62,-1,1.38,1.62,2.0,1.61,4
Bath City,8,3,3,2,12,5,7,12,England - National L. South,0.38,0.75,7,1.5,1.5,2.63,1.33,5
Boreham Wood,8,4,0,4,11,9,2,12,England - National L. South,0.5,0.5,2,1.38,1.5,2.0,2.0,5
Hemel Hempstead,8,3,3,2,9,11,-2,12,England - National L. South,0.38,0.75,-2,1.12,1.5,2.63,1.33,5
Weymouth,8,2,3,3,11,12,-1,9,England - National L. South,0.25,0.62,-1,1.38,1.12,4.0,1.61,6
St Albans,8,2,3,3,7,8,-1,9,England - National L. South,0.25,0.62,-1,0.88,1.12,4.0,1.61,6
Slough Town,8,2,3,3,10,14,-4,9,England - National L. South,0.25,0.62,-4,1.25,1.12,4.0,1.61,6
Tonbridge,8,3,0,5,5,12,-7,9,England - National L. South,0.38,0.38,-7,0.62,1.12,2.63,2.63,6
Chelmsford City,8,2,2,4,8,10,-2,8,England - National L. South,0.25,0.5,-2,1.0,1.0,4.0,2.0,7
Salisbury,8,2,2,4,9,13,-4,8,England - National L. South,0.25,0.5,-4,1.12,1.0,4.0,2.0,7
Farnborough,8,2,1,5,8,13,-5,7,England - National L. South,0.25,0.38,-5,1.0,0.88,4.0,2.63,8
Hornchurch,8,1,3,4,8,14,-6,6,England - National L. South,0.12,0.5,-6,1.0,0.75,8.33,2.0,9
Aveley,8,1,2,5,6,12,-6,5,England - National L. South,0.12,0.38,-6,0.75,0.62,8.33,2.63,10
Welling Utd,8,1,2,5,9,18,-9,5,England - National L. South,0.12,0.38,-9,1.12,0.62,8.33,2.63,10
Chippenham,8,1,1,6,4,18,-14,4,England - National L. South,0.12,0.25,-14,0.5,0.5,8.33,4.0,11
Hampton & R.,8,1,0,7,8,17,-9,3,England - National L. South,0.12,0.12,-9,1.0,0.38,8.33,8.33,12
Chatham Town,8,6,1,1,13,3,10,19,England - Isthmian league,0.75,0.88,10,1.62,2.38,1.33,1.14,1
Chichester City,8,6,0,2,15,7,8,18,England - Isthmian league,0.75,0.75,8,1.88,2.25,1.33,1.33,2
Horsham,8,6,0,2,12,6,6,18,England - Isthmian league,0.75,0.75,6,1.5,2.25,1.33,1.33,2
Cray Valley PM,8,5,2,1,15,9,6,17,England - Isthmian league,0.62,0.88,6,1.88,2.12,1.61,1.14,3
Dover Athletic,8,5,1,2,12,7,5,16,England - Isthmian league,0.62,0.75,5,1.5,2.0,1.61,1.33,4
Dartford,8,5,1,2,13,9,4,16,England - Isthmian league,0.62,0.75,4,1.62,2.0,1.61,1.33,4
Lewes,8,5,1,2,13,11,2,16,England - Isthmian league,0.62,0.75,2,1.62,2.0,1.61,1.33,4
Cray Wanderers,8,5,0,3,19,10,9,15,England - Isthmian league,0.62,0.62,9,2.38,1.88,1.61,1.61,5
Billericay Town,8,5,0,3,20,12,8,15,England - Isthmian league,0.62,0.62,8,2.5,1.88,1.61,1.61,5
Wingate & F.,8,4,2,2,12,10,2,14,England - Isthmian league,0.5,0.75,2,1.5,1.75,2.0,1.33,6
Hashtag United,8,3,3,2,17,14,3,12,England - Isthmian league,0.38,0.75,3,2.12,1.5,2.63,1.33,7
Bognor Regis,8,3,2,3,9,12,-3,11,England - Isthmian league,0.38,0.62,-3,1.12,1.38,2.63,1.61,8
Carshalton,8,3,1,4,15,17,-2,10,England - Isthmian league,0.38,0.5,-2,1.88,1.25,2.63,2.0,9
Whitehawk,8,3,0,5,11,9,2,9,England - Isthmian league,0.38,0.38,2,1.38,1.12,2.63,2.63,10
Canvey Island,8,2,3,3,8,7,1,9,England - Isthmian league,0.25,0.62,1,1.0,1.12,4.0,1.61,10
Cheshunt,8,3,0,5,9,11,-2,9,England - Isthmian league,0.38,0.38,-2,1.12,1.12,2.63,2.63,10
Folkestone,8,2,2,4,8,13,-5,8,England - Isthmian league,0.25,0.5,-5,1.0,1.0,4.0,2.0,11
Hastings Utd,8,2,1,5,6,13,-7,7,England - Isthmian league,0.25,0.38,-7,0.75,0.88,4.0,2.63,12
Potters Bar,8,2,1,5,5,13,-8,7,England - Isthmian league,0.25,0.38,-8,0.62,0.88,4.0,2.63,12
Hendon,8,1,3,4,10,17,-7,6,England - Isthmian league,0.12,0.5,-7,1.25,0.75,8.33,2.0,13
Dulwich Hamlet,8,1,1,6,6,15,-9,4,England - Isthmian league,0.12,0.25,-9,0.75,0.5,8.33,4.0,14
Bowers & Pitsea,8,1,0,7,4,20,-16,3,England - Isthmian league,0.12,0.12,-16,0.5,0.38,8.33,8.33,15
Macclesfield,8,8,0,0,24,5,19,24,England - Northern league,1.0,1.0,19,3.0,3.0,1.0,1.0,1
Stockton Town,8,7,1,0,13,4,9,22,England - Northern league,0.88,1.0,9,1.62,2.75,1.14,1.0,2
Prescot Cables,8,6,1,1,10,5,5,19,England - Northern league,0.75,0.88,5,1.25,2.38,1.33,1.14,3
Worksop Town,8,6,0,2,23,9,14,18,England - Northern league,0.75,0.75,14,2.88,2.25,1.33,1.33,4
Leek Town,8,5,2,1,14,7,7,17,England - Northern league,0.62,0.88,7,1.75,2.12,1.61,1.14,5
Bamber Bridge,8,4,1,3,14,8,6,13,England - Northern league,0.5,0.62,6,1.75,1.62,2.0,1.61,6
Ilkeston Town,8,3,4,1,11,6,5,13,England - Northern league,0.38,0.88,5,1.38,1.62,2.63,1.14,6
Gainsborough,8,4,1,3,11,9,2,13,England - Northern league,0.5,0.62,2,1.38,1.62,2.0,1.61,6
Guiseley,8,3,4,1,9,7,2,13,England - Northern league,0.38,0.88,2,1.12,1.62,2.63,1.14,6
Morpeth Town,8,3,4,1,9,10,-1,13,England - Northern league,0.38,0.88,-1,1.12,1.62,2.63,1.14,6
Hyde Utd,8,4,1,3,11,13,-2,13,England - Northern league,0.5,0.62,-2,1.38,1.62,2.0,1.61,6
FC United,8,3,2,3,10,12,-2,11,England - Northern league,0.38,0.62,-2,1.25,1.38,2.63,1.61,7
Whitby Town,8,3,1,4,10,12,-2,10,England - Northern league,0.38,0.5,-2,1.25,1.25,2.63,2.0,8
Rylands,8,2,3,3,9,10,-1,9,England - Northern league,0.25,0.62,-1,1.12,1.12,4.0,1.61,9
Matlock,8,2,2,4,10,10,0,8,England - Northern league,0.25,0.5,0,1.25,1.0,4.0,2.0,10
Ashton Utd,8,2,2,4,10,11,-1,8,England - Northern league,0.25,0.5,-1,1.25,1.0,4.0,2.0,10
Workington,8,2,1,5,13,13,0,7,England - Northern league,0.25,0.38,0,1.62,0.88,4.0,2.63,11
Lancaster City,8,2,1,5,9,15,-6,7,England - Northern league,0.25,0.38,-6,1.12,0.88,4.0,2.63,11
Basford Utd,8,1,3,4,7,13,-6,6,England - Northern league,0.12,0.5,-6,0.88,0.75,8.33,2.0,12
Mickleover,8,1,3,4,6,18,-12,6,England - Northern league,0.12,0.5,-12,0.75,0.75,8.33,2.0,12
Hebburn Town,8,0,2,6,4,14,-10,2,England - Northern league,0.0,0.25,-10,0.5,0.25,0.0,4.0,13
Blyth Spartans,8,0,0,8,8,27,-19,0,England - Northern league,0.0,0.0,-19,1.0,0.0,0.0,0.0,14
Bedford Town,8,6,2,0,17,6,11,20,England - Southern Central,0.75,1.0,11,2.12,2.5,1.33,1.0,1
Spalding United,8,5,2,1,16,9,7,17,England - Southern Central,0.62,0.88,7,2.0,2.12,1.61,1.14,2
Halesowen Town,8,4,4,0,8,3,5,16,England - Southern Central,0.5,1.0,5,1.0,2.0,2.0,1.0,3
Stamford,8,4,3,1,9,8,1,15,England - Southern Central,0.5,0.88,1,1.12,1.88,2.0,1.14,4
Telford Utd,8,3,5,0,13,6,7,14,England - Southern Central,0.38,1.0,7,1.62,1.75,2.63,1.0,5
Harborough Town,8,3,4,1,15,8,7,13,England - Southern Central,0.38,0.88,7,1.88,1.62,2.63,1.14,6
Kettering Town,8,3,4,1,11,8,3,13,England - Southern Central,0.38,0.88,3,1.38,1.62,2.63,1.14,6
Barwell,8,4,1,3,16,14,2,13,England - Southern Central,0.5,0.62,2,2.0,1.62,2.0,1.61,6
AFC Sudbury,8,4,1,3,10,9,1,13,England - Southern Central,0.5,0.62,1,1.25,1.62,2.0,1.61,6
Banbury Utd,8,3,3,2,8,7,1,12,England - Southern Central,0.38,0.75,1,1.0,1.5,2.63,1.33,7
Stourbridge,8,3,3,2,8,7,1,12,England - Southern Central,0.38,0.75,1,1.0,1.5,2.63,1.33,7
Royston,8,2,5,1,10,8,2,11,England - Southern Central,0.25,0.88,2,1.25,1.38,4.0,1.14,8
Stratford Town,8,2,4,2,8,8,0,10,England - Southern Central,0.25,0.75,0,1.0,1.25,4.0,1.33,9
St. Ives Town,8,2,3,3,13,15,-2,9,England - Southern Central,0.25,0.62,-2,1.62,1.12,4.0,1.61,10
Bromsgrove,8,2,2,4,11,12,-1,8,England - Southern Central,0.25,0.5,-1,1.38,1.0,4.0,2.0,11
Leiston,8,2,2,4,9,12,-3,8,England - Southern Central,0.25,0.5,-3,1.12,1.0,4.0,2.0,11
B. Stortford,8,2,2,4,9,17,-8,8,England - Southern Central,0.25,0.5,-8,1.12,1.0,4.0,2.0,11
Redditch Utd,8,1,4,3,4,7,-3,7,England - Southern Central,0.12,0.62,-3,0.5,0.88,8.33,1.61,12
Alvechurch,8,1,3,4,4,8,-4,6,England - Southern Central,0.12,0.5,-4,0.5,0.75,8.33,2.0,13
Biggleswade,8,1,2,5,8,13,-5,5,England - Southern Central,0.12,0.38,-5,1.0,0.62,8.33,2.63,14
Hitchin Town,8,0,4,4,11,15,-4,4,England - Southern Central,0.0,0.5,-4,1.38,0.5,0.0,2.0,15
Lowestoft,8,0,2,6,7,21,-14,2,England - Southern Central,0.0,0.25,-14,0.88,0.25,0.0,4.0,16
Levadia,7,6,1,0,15,5,10,19,Estonia - Meistriliiga,0.86,1.0,10,2.14,2.71,1.16,1.0,1
Paide,7,6,0,1,15,3,12,18,Estonia - Meistriliiga,0.86,0.86,12,2.14,2.57,1.16,1.16,2
Flora,7,4,2,1,15,5,10,14,Estonia - Meistriliiga,0.57,0.86,10,2.14,2.0,1.75,1.16,3
Narva Trans,7,4,1,2,9,6,3,13,Estonia - Meistriliiga,0.57,0.71,3,1.29,1.86,1.75,1.41,4
Nomme Kalju,7,3,1,3,12,10,2,10,Estonia - Meistriliiga,0.43,0.57,2,1.71,1.43,2.33,1.75,5
Vaprus,7,2,2,3,10,9,1,8,Estonia - Meistriliiga,0.29,0.57,1,1.43,1.14,3.45,1.75,6
Harju JK,7,2,1,4,6,15,-9,7,Estonia - Meistriliiga,0.29,0.43,-9,0.86,1.0,3.45,2.33,7
Tammeka,7,1,1,5,8,16,-8,4,Estonia - Meistriliiga,0.14,0.29,-8,1.14,0.57,7.14,3.45,8
Tallinna Kalev,7,1,1,5,7,17,-10,4,Estonia - Meistriliiga,0.14,0.29,-10,1.0,0.57,7.14,3.45,8
Kuressaare,7,1,0,6,6,17,-11,3,Estonia - Meistriliiga,0.14,0.14,-11,0.86,0.43,7.14,7.14,9
Nomme Utd,6,5,0,1,11,5,6,15,Estonia - Esiliiga,0.83,0.83,6,1.83,2.5,1.2,1.2,1
Viimsi,6,4,1,1,16,6,10,13,Estonia - Esiliiga,0.67,0.83,10,2.67,2.17,1.49,1.2,2
Elva,6,4,1,1,15,10,5,13,Estonia - Esiliiga,0.67,0.83,5,2.5,2.17,1.49,1.2,2
Tartu Welco,6,3,2,1,12,10,2,11,Estonia - Esiliiga,0.5,0.83,2,2.0,1.83,2.0,1.2,3
Levadia B,6,3,1,2,10,8,2,10,Estonia - Esiliiga,0.5,0.67,2,1.67,1.67,2.0,1.49,4
Nomme Kalju B,6,3,0,3,8,12,-4,9,Estonia - Esiliiga,0.5,0.5,-4,1.33,1.5,2.0,2.0,5
Flora B,6,2,2,2,10,9,1,8,Estonia - Esiliiga,0.33,0.67,1,1.67,1.33,3.03,1.49,6
FC Tallinn,6,1,1,4,7,12,-5,4,Estonia - Esiliiga,0.17,0.33,-5,1.17,0.67,5.88,3.03,7
Tallinna K. B,6,0,2,4,5,14,-9,2,Estonia - Esiliiga,0.0,0.33,-9,0.83,0.33,0.0,3.03,8
Tammeka B,6,0,0,6,6,14,-8,0,Estonia - Esiliiga,0.0,0.0,-8,1.0,0.0,0.0,0.0,9
Klaksvik,6,6,0,0,16,3,13,18,FaroeIslands - Premier League,1.0,1.0,13,2.67,3.0,1.0,1.0,1
NSI Runavik,5,5,0,0,27,5,22,15,FaroeIslands - Premier League,1.0,1.0,22,5.4,3.0,1.0,1.0,2
HB Torshavn,6,4,0,2,14,10,4,12,FaroeIslands - Premier League,0.67,0.67,4,2.33,2.0,1.49,1.49,3
B36 Torshavn,6,3,1,2,10,10,0,10,FaroeIslands - Premier League,0.5,0.67,0,1.67,1.67,2.0,1.49,4
Streymur,6,2,1,3,7,11,-4,7,FaroeIslands - Premier League,0.33,0.5,-4,1.17,1.17,3.03,2.0,5
Suduroy,5,2,0,3,3,9,-6,6,FaroeIslands - Premier League,0.4,0.4,-6,0.6,1.2,2.5,2.5,6
Vikingur,6,1,2,3,5,8,-3,5,FaroeIslands - Premier League,0.17,0.5,-3,0.83,0.83,5.88,2.0,7
TB Tvoroyri,6,1,2,3,6,11,-5,5,FaroeIslands - Premier League,0.17,0.5,-5,1.0,0.83,5.88,2.0,7
B68 Toftir,6,1,1,4,5,18,-13,4,FaroeIslands - Premier League,0.17,0.33,-13,0.83,0.67,5.88,3.03,8
07 Vestur,6,0,1,5,5,13,-8,1,FaroeIslands - Premier League,0.0,0.17,-8,0.83,0.17,0.0,5.88,9
Skala,6,5,1,0,16,2,14,16,FaroeIslands - 1. Deild,0.83,1.0,14,2.67,2.67,1.2,1.0,1
Vikingur B,6,4,0,2,14,8,6,12,FaroeIslands - 1. Deild,0.67,0.67,6,2.33,2.0,1.49,1.49,2
B71 Sandur,6,4,0,2,8,8,0,12,FaroeIslands - 1. Deild,0.67,0.67,0,1.33,2.0,1.49,1.49,2
AB Argir,5,3,2,0,10,3,7,11,FaroeIslands - 1. Deild,0.6,1.0,7,2.0,2.2,1.67,1.0,3
Klaksvik B,6,3,1,2,9,8,1,10,FaroeIslands - 1. Deild,0.5,0.67,1,1.5,1.67,2.0,1.49,4
Streymur B,5,3,0,2,7,5,2,9,FaroeIslands - 1. Deild,0.6,0.6,2,1.4,1.8,1.67,1.67,5
NSI Runavik B,6,2,1,3,12,12,0,7,FaroeIslands - 1. Deild,0.33,0.5,0,2.0,1.17,3.03,2.0,6
IF Fuglafjordur,6,1,2,3,8,11,-3,5,FaroeIslands - 1. Deild,0.17,0.5,-3,1.33,0.83,5.88,2.0,7
B36 Torshavn B,6,0,1,5,4,19,-15,1,FaroeIslands - 1. Deild,0.0,0.17,-15,0.67,0.17,0.0,5.88,8
07 Vestur B,6,0,0,6,6,18,-12,0,FaroeIslands - 1. Deild,0.0,0.0,-12,1.0,0.0,0.0,0.0,9
Ilves,2,2,0,0,5,3,2,6,Finland - Veikkausliiga,1.0,1.0,2,2.5,3.0,1.0,1.0,1
SJK,2,2,0,0,2,0,2,6,Finland - Veikkausliiga,1.0,1.0,2,1.0,3.0,1.0,1.0,1
Inter Turku,2,1,1,0,4,1,3,4,Finland - Veikkausliiga,0.5,1.0,3,2.0,2.0,2.0,1.0,2
VPS,2,1,1,0,6,5,1,4,Finland - Veikkausliiga,0.5,1.0,1,3.0,2.0,2.0,1.0,2
KuPS,2,1,1,0,2,1,1,4,Finland - Veikkausliiga,0.5,1.0,1,1.0,2.0,2.0,1.0,2
Jaro,2,1,0,1,3,2,1,3,Finland - Veikkausliiga,0.5,0.5,1,1.5,1.5,2.0,2.0,3
Haka,2,1,0,1,3,3,0,3,Finland - Veikkausliiga,0.5,0.5,0,1.5,1.5,2.0,2.0,3
Mariehamn,2,1,0,1,1,2,-1,3,Finland - Veikkausliiga,0.5,0.5,-1,0.5,1.5,2.0,2.0,3
KTP,2,0,1,1,2,3,-1,1,Finland - Veikkausliiga,0.0,0.5,-1,1.0,0.5,0.0,2.0,4
Oulu,2,0,0,2,3,5,-2,0,Finland - Veikkausliiga,0.0,0.0,-2,1.5,0.0,0.0,0.0,5
HJK Helsinki,2,0,0,2,2,4,-2,0,Finland - Veikkausliiga,0.0,0.0,-2,1.0,0.0,0.0,0.0,5
Gnistan,2,0,0,2,2,6,-4,0,Finland - Veikkausliiga,0.0,0.0,-4,1.0,0.0,0.0,0.0,5
Ekenas IF,0,0,0,0,0,0,0,0,Finland - Ykkosliga,0.0,0.0,0,0.0,0.0,0.0,0.0,1
JaPS,0,0,0,0,0,0,0,0,Finland - Ykkosliga,0.0,0.0,0,0.0,0.0,0.0,0.0,1
JIPPO,0,0,0,0,0,0,0,0,Finland - Ykkosliga,0.0,0.0,0,0.0,0.0,0.0,0.0,1
KaPa,0,0,0,0,0,0,0,0,Finland - Ykkosliga,0.0,0.0,0,0.0,0.0,0.0,0.0,1
Klubi-04,0,0,0,0,0,0,0,0,Finland - Ykkosliga,0.0,0.0,0,0.0,0.0,0.0,0.0,1
Lahti,0,0,0,0,0,0,0,0,Finland - Ykkosliga,0.0,0.0,0,0.0,0.0,0.0,0.0,1
PK-35,0,0,0,0,0,0,0,0,Finland - Ykkosliga,0.0,0.0,0,0.0,0.0,0.0,0.0,1
SalPa,0,0,0,0,0,0,0,0,Finland - Ykkosliga,0.0,0.0,0,0.0,0.0,0.0,0.0,1
SJK Akatemia,0,0,0,0,0,0,0,0,Finland - Ykkosliga,0.0,0.0,0,0.0,0.0,0.0,0.0,1
TPS,0,0,0,0,0,0,0,0,Finland - Ykkosliga,0.0,0.0,0,0.0,0.0,0.0,0.0,1
PKKU,1,1,0,0,5,0,5,3,Finland - Ykkonen,1.0,1.0,5,5.0,3.0,1.0,1.0,1
Inter Turku B,1,1,0,0,4,0,4,3,Finland - Ykkonen,1.0,1.0,4,4.0,3.0,1.0,1.0,1
Atlantis,1,1,0,0,2,0,2,3,Finland - Ykkonen,1.0,1.0,2,2.0,3.0,1.0,1.0,1
KuPS Ak.,1,1,0,0,2,1,1,3,Finland - Ykkonen,1.0,1.0,1,2.0,3.0,1.0,1.0,1
Jazz Pori,1,1,0,0,1,0,1,3,Finland - Ykkonen,1.0,1.0,1,1.0,3.0,1.0,1.0,1
KPV Kokkola,1,0,1,0,2,2,0,1,Finland - Ykkonen,0.0,1.0,0,2.0,1.0,0.0,1.0,2
OLS Oulu,1,0,1,0,2,2,0,1,Finland - Ykkonen,0.0,1.0,0,2.0,1.0,0.0,1.0,2
JJK,1,0,0,1,1,2,-1,0,Finland - Ykkonen,0.0,0.0,-1,1.0,0.0,0.0,0.0,3
EPS,1,0,0,1,0,1,-1,0,Finland - Ykkonen,0.0,0.0,-1,0.0,0.0,0.0,0.0,3
Tampere Utd,1,0,0,1,0,2,-2,0,Finland - Ykkonen,0.0,0.0,-2,0.0,0.0,0.0,0.0,3
Mikkelin,1,0,0,1,0,4,-4,0,Finland - Ykkonen,0.0,0.0,-4,0.0,0.0,0.0,0.0,3
Rovaniemi,1,0,0,1,0,5,-5,0,Finland - Ykkonen,0.0,0.0,-5,0.0,0.0,0.0,0.0,3
GrIFK,0,0,0,0,0,0,0,0,Finland - Kakkonen Group A,0.0,0.0,0,0.0,0.0,0.0,0.0,1
HaPK,0,0,0,0,0,0,0,0,Finland - Kakkonen Group A,0.0,0.0,0,0.0,0.0,0.0,0.0,1
Honka,0,0,0,0,0,0,0,0,Finland - Kakkonen Group A,0.0,0.0,0,0.0,0.0,0.0,0.0,1
JPS,0,0,0,0,0,0,0,0,Finland - Kakkonen Group A,0.0,0.0,0,0.0,0.0,0.0,0.0,1
MYPA,0,0,0,0,0,0,0,0,Finland - Kakkonen Group A,0.0,0.0,0,0.0,0.0,0.0,0.0,1
PEPO,0,0,0,0,0,0,0,0,Finland - Kakkonen Group A,0.0,0.0,0,0.0,0.0,0.0,0.0,1
PuiU Helsinki,0,0,0,0,0,0,0,0,Finland - Kakkonen Group A,0.0,0.0,0,0.0,0.0,0.0,0.0,1
Reipas,0,0,0,0,0,0,0,0,Finland - Kakkonen Group A,0.0,0.0,0,0.0,0.0,0.0,0.0,1
Vaajakoski,0,0,0,0,0,0,0,0,Finland - Kakkonen Group A,0.0,0.0,0,0.0,0.0,0.0,0.0,1
VJS,0,0,0,0,0,0,0,0,Finland - Kakkonen Group A,0.0,0.0,0,0.0,0.0,0.0,0.0,1
TPV,1,1,0,0,3,2,1,3,Finland - Kakkonen Group B,1.0,1.0,1,3.0,3.0,1.0,1.0,1
Atlantis B,0,0,0,0,0,0,0,0,Finland - Kakkonen Group B,0.0,0.0,0,0.0,0.0,0.0,0.0,2
HJS,0,0,0,0,0,0,0,0,Finland - Kakkonen Group B,0.0,0.0,0,0.0,0.0,0.0,0.0,2
HPS,0,0,0,0,0,0,0,0,Finland - Kakkonen Group B,0.0,0.0,0,0.0,0.0,0.0,0.0,2
Ilves B,0,0,0,0,0,0,0,0,Finland - Kakkonen Group B,0.0,0.0,0,0.0,0.0,0.0,0.0,2
MuSa,0,0,0,0,0,0,0,0,Finland - Kakkonen Group B,0.0,0.0,0,0.0,0.0,0.0,0.0,2
NJS,0,0,0,0,0,0,0,0,Finland - Kakkonen Group B,0.0,0.0,0,0.0,0.0,0.0,0.0,2
P-Iirot,0,0,0,0,0,0,0,0,Finland - Kakkonen Group B,0.0,0.0,0,0.0,0.0,0.0,0.0,2
PPJ,0,0,0,0,0,0,0,0,Finland - Kakkonen Group B,0.0,0.0,0,0.0,0.0,0.0,0.0,2
Kiffen,1,0,0,1,2,3,-1,0,Finland - Kakkonen Group B,0.0,0.0,-1,2.0,0.0,0.0,0.0,2
GBK Kokkola,0,0,0,0,0,0,0,0,Finland - Kakkonen Group C,0.0,0.0,0,0.0,0.0,0.0,0.0,1
JBK,0,0,0,0,0,0,0,0,Finland - Kakkonen Group C,0.0,0.0,0,0.0,0.0,0.0,0.0,1
JS Hercules,0,0,0,0,0,0,0,0,Finland - Kakkonen Group C,0.0,0.0,0,0.0,0.0,0.0,0.0,1
Kuopion Elo,0,0,0,0,0,0,0,0,Finland - Kakkonen Group C,0.0,0.0,0,0.0,0.0,0.0,0.0,1
Narpes Kraft,0,0,0,0,0,0,0,0,Finland - Kakkonen Group C,0.0,0.0,0,0.0,0.0,0.0,0.0,1
OsPa,0,0,0,0,0,0,0,0,Finland - Kakkonen Group C,0.0,0.0,0,0.0,0.0,0.0,0.0,1
SJK Akatemia B,0,0,0,0,0,0,0,0,Finland - Kakkonen Group C,0.0,0.0,0,0.0,0.0,0.0,0.0,1
TP-47,0,0,0,0,0,0,0,0,Finland - Kakkonen Group C,0.0,0.0,0,0.0,0.0,0.0,0.0,1
VIFK,0,0,0,0,0,0,0,0,Finland - Kakkonen Group C,0.0,0.0,0,0.0,0.0,0.0,0.0,1
VPS B,0,0,0,0,0,0,0,0,Finland - Kakkonen Group C,0.0,0.0,0,0.0,0.0,0.0,0.0,1
Paris SG,8,8,0,0,26,7,19,24,France - Ligue 1,1.0,1.0,19,3.25,3.0,1.0,1.0,1
Strasbourg,8,6,2,0,13,5,8,20,France - Ligue 1,0.75,1.0,8,1.62,2.5,1.33,1.0,2
Lyon,8,6,0,2,21,13,8,18,France - Ligue 1,0.75,0.75,8,2.62,2.25,1.33,1.33,3
Monaco,8,5,1,2,20,7,13,16,France - Ligue 1,0.62,0.75,13,2.5,2.0,1.61,1.33,4
Lille,8,5,0,3,10,9,1,15,France - Ligue 1,0.62,0.62,1,1.25,1.88,1.61,1.61,5
Auxerre,8,4,2,2,11,7,4,14,France - Ligue 1,0.5,0.75,4,1.38,1.75,2.0,1.33,6
Brest,8,3,4,1,14,10,4,13,France - Ligue 1,0.38,0.88,4,1.75,1.62,2.63,1.14,7
Rennes,8,4,0,4,14,9,5,12,France - Ligue 1,0.5,0.5,5,1.75,1.5,2.0,2.0,8
Nice,8,3,2,3,13,11,2,11,France - Ligue 1,0.38,0.62,2,1.62,1.38,2.63,1.61,9
Le Havre,8,3,1,4,15,22,-7,10,France - Ligue 1,0.38,0.5,-7,1.88,1.25,2.63,2.0,10
Marseille,8,3,0,5,12,16,-4,9,France - Ligue 1,0.38,0.38,-4,1.5,1.12,2.63,2.63,11
Lens,8,3,0,5,7,12,-5,9,France - Ligue 1,0.38,0.38,-5,0.88,1.12,2.63,2.63,11
Nantes,8,3,0,5,9,17,-8,9,France - Ligue 1,0.38,0.38,-8,1.12,1.12,2.63,2.63,11
Toulouse,8,2,1,5,15,14,1,7,France - Ligue 1,0.25,0.38,1,1.88,0.88,4.0,2.63,12
Reims,8,2,1,5,5,9,-4,7,France - Ligue 1,0.25,0.38,-4,0.62,0.88,4.0,2.63,12
Angers,8,2,1,5,6,15,-9,7,France - Ligue 1,0.25,0.38,-9,0.75,0.88,4.0,2.63,12
Saint-Etienne,8,1,3,4,12,22,-10,6,France - Ligue 1,0.12,0.5,-10,1.5,0.75,8.33,2.0,13
Montpellier,8,0,0,8,1,18,-17,0,France - Ligue 1,0.0,0.0,-17,0.12,0.0,0.0,0.0,14
Metz,8,6,1,1,21,9,12,19,France - Ligue 2,0.75,0.88,12,2.62,2.38,1.33,1.14,1
Lorient,8,6,0,2,19,7,12,18,France - Ligue 2,0.75,0.75,12,2.38,2.25,1.33,1.33,2
Paris FC,8,6,0,2,15,11,4,18,France - Ligue 2,0.75,0.75,4,1.88,2.25,1.33,1.33,2
AC Ajaccio,8,4,2,2,11,8,3,14,France - Ligue 2,0.5,0.75,3,1.38,1.75,2.0,1.33,3
SC Bastia,8,4,2,2,11,10,1,14,France - Ligue 2,0.5,0.75,1,1.38,1.75,2.0,1.33,3
Rodez Aveyron,8,3,4,1,17,9,8,13,France - Ligue 2,0.38,0.88,8,2.12,1.62,2.63,1.14,4
USL Dunkerque,8,4,0,4,12,13,-1,12,France - Ligue 2,0.5,0.5,-1,1.5,1.5,2.0,2.0,5
Red Star,8,3,2,3,10,8,2,11,France - Ligue 2,0.38,0.62,2,1.25,1.38,2.63,1.61,6
Martigues,8,3,1,4,8,9,-1,10,France - Ligue 2,0.38,0.5,-1,1.0,1.25,2.63,2.0,7
Guingamp,8,3,1,4,10,13,-3,10,France - Ligue 2,0.38,0.5,-3,1.25,1.25,2.63,2.0,7
Grenoble,8,2,3,3,11,10,1,9,France - Ligue 2,0.25,0.62,1,1.38,1.12,4.0,1.61,8
Laval,8,3,0,5,8,13,-5,9,France - Ligue 2,0.38,0.38,-5,1.0,1.12,2.63,2.63,8
Pau FC,8,2,3,3,8,18,-10,9,France - Ligue 2,0.25,0.62,-10,1.0,1.12,4.0,1.61,8
Troyes,8,2,2,4,7,7,0,8,France - Ligue 2,0.25,0.5,0,0.88,1.0,4.0,2.0,9
Amiens,8,2,2,4,8,13,-5,8,France - Ligue 2,0.25,0.5,-5,1.0,1.0,4.0,2.0,9
Annecy,8,2,2,4,7,13,-6,8,France - Ligue 2,0.25,0.5,-6,0.88,1.0,4.0,2.0,9
Caen,8,1,3,4,10,14,-4,6,France - Ligue 2,0.12,0.5,-4,1.25,0.75,8.33,2.0,10
Clermont,8,0,4,4,5,13,-8,4,France - Ligue 2,0.0,0.5,-8,0.62,0.5,0.0,2.0,11
Le Mans,8,6,1,1,10,5,5,19,France - National,0.75,0.88,5,1.25,2.38,1.33,1.14,1
Nancy,8,5,1,2,11,6,5,16,France - National,0.62,0.75,5,1.38,2.0,1.61,1.33,2
Boulogne,8,4,3,1,14,9,5,15,France - National,0.5,0.88,5,1.75,1.88,2.0,1.14,3
Bourg-en-Bresse,8,4,1,3,7,5,2,13,France - National,0.5,0.62,2,0.88,1.62,2.0,1.61,4
Dijon,8,3,3,2,9,8,1,12,France - National,0.38,0.75,1,1.12,1.5,2.63,1.33,5
Nimes,8,3,2,3,9,8,1,11,France - National,0.38,0.62,1,1.12,1.38,2.63,1.61,6
Rouen,8,3,2,3,12,13,-1,11,France - National,0.38,0.62,-1,1.5,1.38,2.63,1.61,6
Chateauroux,8,3,2,3,10,11,-1,11,France - National,0.38,0.62,-1,1.25,1.38,2.63,1.61,6
Concarneau,8,2,4,2,12,11,1,10,France - National,0.25,0.75,1,1.5,1.25,4.0,1.33,7
Villefranche,8,2,3,3,10,10,0,9,France - National,0.25,0.62,0,1.25,1.12,4.0,1.61,8
Valenciennes,8,2,3,3,7,7,0,9,France - National,0.25,0.62,0,0.88,1.12,4.0,1.61,8
Aubagne,8,2,3,3,7,8,-1,9,France - National,0.25,0.62,-1,0.88,1.12,4.0,1.61,8
Sochaux,8,2,3,3,7,9,-2,9,France - National,0.25,0.62,-2,0.88,1.12,4.0,1.61,8
Versailles,8,1,5,2,10,12,-2,8,France - National,0.12,0.75,-2,1.25,1.0,8.33,1.33,9
Quevilly Rouen,8,2,2,4,5,9,-4,8,France - National,0.25,0.5,-4,0.62,1.0,4.0,2.0,9
Orleans,8,1,4,3,10,12,-2,7,France - National,0.12,0.62,-2,1.25,0.88,8.33,1.61,10
Paris 13 A.,8,1,3,4,7,11,-4,6,France - National,0.12,0.5,-4,0.88,0.75,8.33,2.0,11
Iberia,8,6,2,0,14,3,11,20,Georgia - Erovnuli Liga,0.75,1.0,11,1.75,2.5,1.33,1.0,1
Dinamo Batumi,8,5,3,0,10,3,7,18,Georgia - Erovnuli Liga,0.62,1.0,7,1.25,2.25,1.61,1.0,2
Dila Gori,8,5,2,1,14,5,9,17,Georgia - Erovnuli Liga,0.62,0.88,9,1.75,2.12,1.61,1.14,3
Dinamo Tbilisi,8,3,2,3,9,7,2,11,Georgia - Erovnuli Liga,0.38,0.62,2,1.12,1.38,2.63,1.61,4
Gagra,8,3,1,4,6,10,-4,10,Georgia - Erovnuli Liga,0.38,0.5,-4,0.75,1.25,2.63,2.0,5
Telavi,8,3,1,4,6,13,-7,10,Georgia - Erovnuli Liga,0.38,0.5,-7,0.75,1.25,2.63,2.0,5
Samgurali,8,2,2,4,7,8,-1,8,Georgia - Erovnuli Liga,0.25,0.5,-1,0.88,1.0,4.0,2.0,6
Torpedo Kutaisi,8,2,2,4,9,11,-2,8,Georgia - Erovnuli Liga,0.25,0.5,-2,1.12,1.0,4.0,2.0,6
Kolkheti Poti,8,1,2,5,3,12,-9,5,Georgia - Erovnuli Liga,0.12,0.38,-9,0.38,0.62,8.33,2.63,7
Gareji Sagarejo,8,1,1,6,4,10,-6,4,Georgia - Erovnuli Liga,0.12,0.25,-6,0.5,0.5,8.33,4.0,8
Spaeri,7,5,2,0,18,9,9,17,Georgia - Erovnuli Liga 2,0.71,1.0,9,2.57,2.43,1.41,1.0,1
Rustavi,7,3,3,1,10,8,2,12,Georgia - Erovnuli Liga 2,0.43,0.86,2,1.43,1.71,2.33,1.16,2
Merani Martvili,7,3,1,3,12,14,-2,10,Georgia - Erovnuli Liga 2,0.43,0.57,-2,1.71,1.43,2.33,1.75,3
Gonio,7,2,3,2,9,8,1,9,Georgia - Erovnuli Liga 2,0.29,0.71,1,1.29,1.29,3.45,1.41,4
Bolnisi,7,2,2,3,6,7,-1,8,Georgia - Erovnuli Liga 2,0.29,0.57,-1,0.86,1.14,3.45,1.75,5
L. Tbilisi,7,1,4,2,10,10,0,7,Georgia - Erovnuli Liga 2,0.14,0.71,0,1.43,1.0,7.14,1.41,6
Samtredia,7,1,4,2,7,8,-1,7,Georgia - Erovnuli Liga 2,0.14,0.71,-1,1.0,1.0,7.14,1.41,6
D. Tbilisi B,7,1,4,2,8,10,-2,7,Georgia - Erovnuli Liga 2,0.14,0.71,-2,1.14,1.0,7.14,1.41,6
Meshakhte,7,1,4,2,5,8,-3,7,Georgia - Erovnuli Liga 2,0.14,0.71,-3,0.71,1.0,7.14,1.41,6
Iberia B,7,1,3,3,7,10,-3,6,Georgia - Erovnuli Liga 2,0.14,0.57,-3,1.0,0.86,7.14,1.75,7
Leverkusen,8,5,2,1,14,7,7,17,Germany - Bundesliga,0.62,0.88,7,1.75,2.12,1.61,1.14,1
Bayern Munich,8,4,3,1,18,10,8,15,Germany - Bundesliga,0.5,0.88,8,2.25,1.88,2.0,1.14,2
FC Augsburg,8,4,3,1,9,5,4,15,Germany - Bundesliga,0.5,0.88,4,1.12,1.88,2.0,1.14,2
FSV Mainz,8,4,2,2,13,10,3,14,Germany - Bundesliga,0.5,0.75,3,1.62,1.75,2.0,1.33,3
Dortmund,8,4,1,3,17,9,8,13,Germany - Bundesliga,0.5,0.62,8,2.12,1.62,2.0,1.61,4
Monchengladbach,8,4,1,3,13,12,1,13,Germany - Bundesliga,0.5,0.62,1,1.62,1.62,2.0,1.61,4
Freiburg,8,3,3,2,12,9,3,12,Germany - Bundesliga,0.38,0.75,3,1.5,1.5,2.63,1.33,5
RB Leipzig,8,3,3,2,11,8,3,12,Germany - Bundesliga,0.38,0.75,3,1.38,1.5,2.63,1.33,5
Hoffenheim,8,3,3,2,10,8,2,12,Germany - Bundesliga,0.38,0.75,2,1.25,1.5,2.63,1.33,5
Werder Bremen,8,4,0,4,13,15,-2,12,Germany - Bundesliga,0.5,0.5,-2,1.62,1.5,2.0,2.0,5
E. Frankfurt,8,4,0,4,12,14,-2,12,Germany - Bundesliga,0.5,0.5,-2,1.5,1.5,2.0,2.0,5
Union Berlin,8,3,2,3,7,12,-5,11,Germany - Bundesliga,0.38,0.62,-5,0.88,1.38,2.63,1.61,6
Wolfsburg,8,2,2,4,8,10,-2,8,Germany - Bundesliga,0.25,0.5,-2,1.0,1.0,4.0,2.0,7
Sankt Pauli,8,2,2,4,7,11,-4,8,Germany - Bundesliga,0.25,0.5,-4,0.88,1.0,4.0,2.0,7
Heidenheim,8,2,2,4,7,13,-6,8,Germany - Bundesliga,0.25,0.5,-6,0.88,1.0,4.0,2.0,7
Bochum,8,2,1,5,9,16,-7,7,Germany - Bundesliga,0.25,0.38,-7,1.12,0.88,4.0,2.63,8
Stuttgart,8,1,2,5,13,15,-2,5,Germany - Bundesliga,0.12,0.38,-2,1.62,0.62,8.33,2.63,9
Holstein Kiel,8,1,2,5,7,16,-9,5,Germany - Bundesliga,0.12,0.38,-9,0.88,0.62,8.33,2.63,9
Elversberg,8,4,3,1,16,3,13,15,Germany - 2. Bundesliga,0.5,0.88,13,2.0,1.88,2.0,1.14,1
Hamburger SV,8,4,2,2,16,8,8,14,Germany - 2. Bundesliga,0.5,0.75,8,2.0,1.75,2.0,1.33,2
FC Nurnberg,8,4,1,3,10,8,2,13,Germany - 2. Bundesliga,0.5,0.62,2,1.25,1.62,2.0,1.61,3
Schalke 04,8,4,1,3,11,12,-1,13,Germany - 2. Bundesliga,0.5,0.62,-1,1.38,1.62,2.0,1.61,3
Dusseldorf,8,4,1,3,10,12,-2,13,Germany - 2. Bundesliga,0.5,0.62,-2,1.25,1.62,2.0,1.61,3
Braunschweig,8,3,3,2,12,15,-3,12,Germany - 2. Bundesliga,0.38,0.75,-3,1.5,1.5,2.63,1.33,4
Paderborn,8,3,2,3,14,11,3,11,Germany - 2. Bundesliga,0.38,0.62,3,1.75,1.38,2.63,1.61,5
Magdeburg,8,3,2,3,11,9,2,11,Germany - 2. Bundesliga,0.38,0.62,2,1.38,1.38,2.63,1.61,5
Hertha Berlin,8,3,2,3,12,11,1,11,Germany - 2. Bundesliga,0.38,0.62,1,1.5,1.38,2.63,1.61,5
Karlsruher SC,8,3,2,3,8,10,-2,11,Germany - 2. Bundesliga,0.38,0.62,-2,1.0,1.38,2.63,1.61,5
FC Koln,8,3,2,3,7,9,-2,11,Germany - 2. Bundesliga,0.38,0.62,-2,0.88,1.38,2.63,1.61,5
Darmstadt,8,3,1,4,10,10,0,10,Germany - 2. Bundesliga,0.38,0.5,0,1.25,1.25,2.63,2.0,6
Hannover 96,8,2,4,2,7,8,-1,10,Germany - 2. Bundesliga,0.25,0.75,-1,0.88,1.25,4.0,1.33,6
Greuther Furth,8,2,3,3,10,12,-2,9,Germany - 2. Bundesliga,0.25,0.62,-2,1.25,1.12,4.0,1.61,7
Ulm,8,2,3,3,5,7,-2,9,Germany - 2. Bundesliga,0.25,0.62,-2,0.62,1.12,4.0,1.61,7
Preuss. Munster,8,2,2,4,5,7,-2,8,Germany - 2. Bundesliga,0.25,0.5,-2,0.62,1.0,4.0,2.0,8
Kaiserslautern,8,2,2,4,11,14,-3,8,Germany - 2. Bundesliga,0.25,0.5,-3,1.38,1.0,4.0,2.0,8
Regensburg,8,2,2,4,5,14,-9,8,Germany - 2. Bundesliga,0.25,0.5,-9,0.62,1.0,4.0,2.0,8
1860 Munchen,8,6,1,1,16,4,12,19,Germany - 3. Liga,0.75,0.88,12,2.0,2.38,1.33,1.14,1
Bielefeld,8,6,1,1,18,8,10,19,Germany - 3. Liga,0.75,0.88,10,2.25,2.38,1.33,1.14,1
Hansa Rostock,8,5,1,2,14,5,9,16,Germany - 3. Liga,0.62,0.75,9,1.75,2.0,1.61,1.33,2
RW Essen,8,5,1,2,10,8,2,16,Germany - 3. Liga,0.62,0.75,2,1.25,2.0,1.61,1.33,2
Dynamo Dresden,8,4,3,1,12,6,6,15,Germany - 3. Liga,0.5,0.88,6,1.5,1.88,2.0,1.14,3
Alemannia A.,8,4,1,3,11,7,4,13,Germany - 3. Liga,0.5,0.62,4,1.38,1.62,2.0,1.61,4
Osnabruck,8,4,1,3,7,6,1,13,Germany - 3. Liga,0.5,0.62,1,0.88,1.62,2.0,1.61,4
FC Ingolstadt,8,3,3,2,17,16,1,12,Germany - 3. Liga,0.38,0.75,1,2.12,1.5,2.63,1.33,5
Saarbrucken,8,3,3,2,9,9,0,12,Germany - 3. Liga,0.38,0.75,0,1.12,1.5,2.63,1.33,5
Verl,8,4,0,4,11,15,-4,12,Germany - 3. Liga,0.5,0.5,-4,1.38,1.5,2.0,2.0,5
Mannheim,8,3,2,3,8,11,-3,11,Germany - 3. Liga,0.38,0.62,-3,1.0,1.38,2.63,1.61,6
Dortmund B,8,2,4,2,9,7,2,10,Germany - 3. Liga,0.25,0.75,2,1.12,1.25,4.0,1.33,7
VfB Stuttgart B,8,3,1,4,12,14,-2,10,Germany - 3. Liga,0.38,0.5,-2,1.5,1.25,2.63,2.0,7
Viktoria Koln,8,3,1,4,10,12,-2,10,Germany - 3. Liga,0.38,0.5,-2,1.25,1.25,2.63,2.0,7
Erzgebirge Aue,8,3,0,5,9,14,-5,9,Germany - 3. Liga,0.38,0.38,-5,1.12,1.12,2.63,2.63,8
Hannover 96 B,8,1,4,3,15,18,-3,7,Germany - 3. Liga,0.12,0.62,-3,1.88,0.88,8.33,1.61,9
Energie Cottbus,8,2,1,5,8,16,-8,7,Germany - 3. Liga,0.25,0.38,-8,1.0,0.88,4.0,2.63,9
Wehen Wiesbaden,8,1,3,4,8,14,-6,6,Germany - 3. Liga,0.12,0.5,-6,1.0,0.75,8.33,2.0,10
Unterhaching,8,1,2,5,9,14,-5,5,Germany - 3. Liga,0.12,0.38,-5,1.12,0.62,8.33,2.63,11
Sandhausen,8,0,1,7,8,17,-9,1,Germany - 3. Liga,0.0,0.12,-9,1.0,0.12,0.0,8.33,12
Samartex,8,5,2,1,12,5,7,17,Ghana - Premier League,0.62,0.88,7,1.5,2.12,1.61,1.14,1
Nations,8,5,1,2,8,3,5,16,Ghana - Premier League,0.62,0.75,5,1.0,2.0,1.61,1.33,2
Bibiani GS,8,5,1,2,8,6,2,16,Ghana - Premier League,0.62,0.75,2,1.0,2.0,1.61,1.33,2
Dreams,8,5,1,2,7,6,1,16,Ghana - Premier League,0.62,0.75,1,0.88,2.0,1.61,1.33,2
Aduana Stars,8,4,2,2,8,6,2,14,Ghana - Premier League,0.5,0.75,2,1.0,1.75,2.0,1.33,3
Accra Lions,8,4,1,3,11,8,3,13,Ghana - Premier League,0.5,0.62,3,1.38,1.62,2.0,1.61,4
Asante Kotoko,8,3,4,1,7,6,1,13,Ghana - Premier League,0.38,0.88,1,0.88,1.62,2.63,1.14,4
Medeama,8,4,0,4,13,8,5,12,Ghana - Premier League,0.5,0.5,5,1.62,1.5,2.0,2.0,5
Heart of Lions,8,3,2,3,9,7,2,11,Ghana - Premier League,0.38,0.62,2,1.12,1.38,2.63,1.61,6
Karela,8,3,2,3,7,6,1,11,Ghana - Premier League,0.38,0.62,1,0.88,1.38,2.63,1.61,6
Berekum Chelsea,8,3,1,4,10,8,2,10,Ghana - Premier League,0.38,0.5,2,1.25,1.25,2.63,2.0,7
Holy Stars,8,3,1,4,9,8,1,10,Ghana - Premier League,0.38,0.5,1,1.12,1.25,2.63,2.0,7
Bechem Utd,8,3,1,4,9,9,0,10,Ghana - Premier League,0.38,0.5,0,1.12,1.25,2.63,2.0,7
Young Apostles,8,2,3,3,5,7,-2,9,Ghana - Premier League,0.25,0.62,-2,0.62,1.12,4.0,1.61,8
Hearts of Oak,8,2,2,4,5,7,-2,8,Ghana - Premier League,0.25,0.5,-2,0.62,1.0,4.0,2.0,9
Vision,8,1,4,3,6,9,-3,7,Ghana - Premier League,0.12,0.62,-3,0.75,0.88,8.33,1.61,10
Legon Cities,8,1,2,5,4,11,-7,5,Ghana - Premier League,0.12,0.38,-7,0.5,0.62,8.33,2.63,11
Nsoatreman,8,1,0,7,1,19,-18,3,Ghana - Premier League,0.12,0.12,-18,0.12,0.38,8.33,8.33,12
St Josephs,8,6,1,1,22,5,17,19,Gibraltar - Premier Division,0.75,0.88,17,2.75,2.38,1.33,1.14,1
Lincoln RI,8,6,1,1,20,5,15,19,Gibraltar - Premier Division,0.75,0.88,15,2.5,2.38,1.33,1.14,1
Manchester 62,8,5,1,2,20,7,13,16,Gibraltar - Premier Division,0.62,0.75,13,2.5,2.0,1.61,1.33,2
Europa FC,8,4,1,3,14,12,2,13,Gibraltar - Premier Division,0.5,0.62,2,1.75,1.62,2.0,1.61,3
Magpies,8,4,0,4,16,13,3,12,Gibraltar - Premier Division,0.5,0.5,3,2.0,1.5,2.0,2.0,4
College 1975,8,3,1,4,13,13,0,10,Gibraltar - Premier Division,0.38,0.5,0,1.62,1.25,2.63,2.0,5
Lions FC,8,3,1,4,9,13,-4,10,Gibraltar - Premier Division,0.38,0.5,-4,1.12,1.25,2.63,2.0,5
Lynx,8,3,1,4,10,22,-12,10,Gibraltar - Premier Division,0.38,0.5,-12,1.25,1.25,2.63,2.0,5
Glacis Utd,8,2,0,6,13,24,-11,6,Gibraltar - Premier Division,0.25,0.25,-11,1.62,0.75,4.0,4.0,6
Europa Point,8,0,2,6,7,28,-21,2,Gibraltar - Premier Division,0.0,0.25,-21,0.88,0.25,0.0,4.0,7
Mons Calpe,8,0,1,7,7,25,-18,1,Gibraltar - Premier Division,0.0,0.12,-18,0.88,0.12,0.0,8.33,8
Olympiakos,8,6,1,1,15,6,9,19,Greece - Super League,0.75,0.88,9,1.88,2.38,1.33,1.14,1
Levadiakos,8,5,1,2,14,6,8,16,Greece - Super League,0.62,0.75,8,1.75,2.0,1.61,1.33,2
PAOK,8,5,0,3,22,10,12,15,Greece - Super League,0.62,0.62,12,2.75,1.88,1.61,1.61,3
Aris,8,4,3,1,9,6,3,15,Greece - Super League,0.5,0.88,3,1.12,1.88,2.0,1.14,3
Panathinaikos,8,4,1,3,14,13,1,13,Greece - Super League,0.5,0.62,1,1.75,1.62,2.0,1.61,4
Atromitos,8,4,1,3,9,8,1,13,Greece - Super League,0.5,0.62,1,1.12,1.62,2.0,1.61,4
OFI Crete,8,4,0,4,13,14,-1,12,Greece - Super League,0.5,0.5,-1,1.62,1.5,2.0,2.0,5
Panaitolikos,8,3,2,3,6,6,0,11,Greece - Super League,0.38,0.62,0,0.75,1.38,2.63,1.61,6
AEK Athens,8,3,1,4,13,9,4,10,Greece - Super League,0.38,0.5,4,1.62,1.25,2.63,2.0,7
A. Kallithea,8,3,1,4,10,13,-3,10,Greece - Super League,0.38,0.5,-3,1.25,1.25,2.63,2.0,7
Asteras T.,8,3,1,4,7,11,-4,10,Greece - Super League,0.38,0.5,-4,0.88,1.25,2.63,2.0,7
Panserraikos,8,3,1,4,8,17,-9,10,Greece - Super League,0.38,0.5,-9,1.0,1.25,2.63,2.0,7
Lamia,8,2,1,5,5,17,-12,7,Greece - Super League,0.25,0.38,-12,0.62,0.88,4.0,2.63,8
Volos,8,1,3,4,5,8,-3,6,Greece - Super League,0.12,0.5,-3,0.62,0.75,8.33,2.0,9
Malacateco,8,6,0,2,15,5,10,18,Guatemala - Liga Nacional - Apertura,0.75,0.75,10,1.88,2.25,1.33,1.33,1
Xelaju,8,5,2,1,16,5,11,17,Guatemala - Liga Nacional - Apertura,0.62,0.88,11,2.0,2.12,1.61,1.14,2
Municipal,8,4,2,2,13,13,0,14,Guatemala - Liga Nacional - Apertura,0.5,0.75,0,1.62,1.75,2.0,1.33,3
Coban Imperial,8,4,1,3,13,9,4,13,Guatemala - Liga Nacional - Apertura,0.5,0.62,4,1.62,1.62,2.0,1.61,4
Antigua GFC,8,3,3,2,14,11,3,12,Guatemala - Liga Nacional - Apertura,0.38,0.75,3,1.75,1.5,2.63,1.33,5
Xinabajul,8,3,2,3,15,14,1,11,Guatemala - Liga Nacional - Apertura,0.38,0.62,1,1.88,1.38,2.63,1.61,6
Comunicaciones,8,3,2,3,12,13,-1,11,Guatemala - Liga Nacional - Apertura,0.38,0.62,-1,1.5,1.38,2.63,1.61,6
Guastatoya,8,2,4,2,12,10,2,10,Guatemala - Liga Nacional - Apertura,0.25,0.75,2,1.5,1.25,4.0,1.33,7
Mixco,8,3,1,4,7,11,-4,10,Guatemala - Liga Nacional - Apertura,0.38,0.5,-4,0.88,1.25,2.63,2.0,7
Achuapa,8,2,3,3,6,10,-4,9,Guatemala - Liga Nacional - Apertura,0.25,0.62,-4,0.75,1.12,4.0,1.61,8
Marquense,8,0,3,5,4,16,-12,3,Guatemala - Liga Nacional - Apertura,0.0,0.38,-12,0.5,0.38,0.0,2.63,9
Zacapa Tellioz,8,0,2,6,3,14,-11,2,Guatemala - Liga Nacional - Apertura,0.0,0.25,-11,0.38,0.25,0.0,4.0,10
Olimpia,8,6,2,0,16,4,12,20,Honduras - Liga Nacional - Apertura,0.75,1.0,12,2.0,2.5,1.33,1.0,1
Genesis,8,4,3,1,16,8,8,15,Honduras - Liga Nacional - Apertura,0.5,0.88,8,2.0,1.88,2.0,1.14,2
Motagua,8,4,2,2,18,14,4,14,Honduras - Liga Nacional - Apertura,0.5,0.75,4,2.25,1.75,2.0,1.33,3
Olancho,8,3,4,1,15,10,5,13,Honduras - Liga Nacional - Apertura,0.38,0.88,5,1.88,1.62,2.63,1.14,4
Marathon,8,2,4,2,9,8,1,10,Honduras - Liga Nacional - Apertura,0.25,0.75,1,1.12,1.25,4.0,1.33,5
Juticalpa,8,2,2,4,7,14,-7,8,Honduras - Liga Nacional - Apertura,0.25,0.5,-7,0.88,1.0,4.0,2.0,6
UPNFM,8,2,2,4,6,16,-10,8,Honduras - Liga Nacional - Apertura,0.25,0.5,-10,0.75,1.0,4.0,2.0,6
Real Espana,8,1,4,3,6,7,-1,7,Honduras - Liga Nacional - Apertura,0.12,0.62,-1,0.75,0.88,8.33,1.61,7
Real Sociedad,8,1,3,4,10,17,-7,6,Honduras - Liga Nacional - Apertura,0.12,0.5,-7,1.25,0.75,8.33,2.0,8
Victoria,8,1,2,5,13,18,-5,5,Honduras - Liga Nacional - Apertura,0.12,0.38,-5,1.62,0.62,8.33,2.63,9
LM Warriors,8,6,1,1,20,13,7,19,Hong Kong - Premier League,0.75,0.88,7,2.5,2.38,1.33,1.14,1
Eastern,8,5,2,1,22,12,10,17,Hong Kong - Premier League,0.62,0.88,10,2.75,2.12,1.61,1.14,2
Tai Po,8,5,1,2,27,16,11,16,Hong Kong - Premier League,0.62,0.75,11,3.38,2.0,1.61,1.33,3
Kitchee,8,4,0,4,16,13,3,12,Hong Kong - Premier League,0.5,0.5,3,2.0,1.5,2.0,2.0,4
North District,8,4,0,4,16,22,-6,12,Hong Kong - Premier League,0.5,0.5,-6,2.0,1.5,2.0,2.0,4
HK Rangers,8,3,2,3,13,12,1,11,Hong Kong - Premier League,0.38,0.62,1,1.62,1.38,2.63,1.61,5
Southern D.,8,2,2,4,12,13,-1,8,Hong Kong - Premier League,0.25,0.5,-1,1.5,1.0,4.0,2.0,6
Kowloon City,8,2,1,5,15,24,-9,7,Hong Kong - Premier League,0.25,0.38,-9,1.88,0.88,4.0,2.63,7
Hong Kong FC,8,0,1,7,5,20,-15,1,Hong Kong - Premier League,0.0,0.12,-15,0.62,0.12,0.0,8.33,8
Paks,8,6,2,0,21,8,13,20,Hungary - NB I,0.75,1.0,13,2.62,2.5,1.33,1.0,1
Gyor,8,5,3,0,11,4,7,18,Hungary - NB I,0.62,1.0,7,1.38,2.25,1.61,1.0,2
Ferencvaros,8,5,2,1,15,6,9,17,Hungary - NB I,0.62,0.88,9,1.88,2.12,1.61,1.14,3
Puskas A.,8,4,2,2,13,10,3,14,Hungary - NB I,0.5,0.75,3,1.62,1.75,2.0,1.33,4
MTK Budapest,8,3,2,3,16,12,4,11,Hungary - NB I,0.38,0.62,4,2.0,1.38,2.63,1.61,5
Zalaegerszegi,8,2,3,3,7,9,-2,9,Hungary - NB I,0.25,0.62,-2,0.88,1.12,4.0,1.61,6
Nyiregyhaza,8,2,2,4,3,9,-6,8,Hungary - NB I,0.25,0.5,-6,0.38,1.0,4.0,2.0,7
DVTK,8,2,2,4,7,15,-8,8,Hungary - NB I,0.25,0.5,-8,0.88,1.0,4.0,2.0,7
Debrecen,8,2,1,5,13,13,0,7,Hungary - NB I,0.25,0.38,0,1.62,0.88,4.0,2.63,8
Kecskemeti TE,8,1,3,4,14,18,-4,6,Hungary - NB I,0.12,0.5,-4,1.75,0.75,8.33,2.0,9
Fehervar,8,1,3,4,7,12,-5,6,Hungary - NB I,0.12,0.5,-5,0.88,0.75,8.33,2.0,9
Ujpest,8,1,3,4,8,19,-11,6,Hungary - NB I,0.12,0.5,-11,1.0,0.75,8.33,2.0,9
Kisvarda,8,8,0,0,21,9,12,24,Hungary - NB II,1.0,1.0,12,2.62,3.0,1.0,1.0,1
Honved,8,6,0,2,18,10,8,18,Hungary - NB II,0.75,0.75,8,2.25,2.25,1.33,1.33,2
Vasas,8,5,1,2,13,7,6,16,Hungary - NB II,0.62,0.75,6,1.62,2.0,1.61,1.33,3
Szentlorinc,8,3,5,0,13,6,7,14,Hungary - NB II,0.38,1.0,7,1.62,1.75,2.63,1.0,4
Kazincbarcika,8,3,4,1,8,5,3,13,Hungary - NB II,0.38,0.88,3,1.0,1.62,2.63,1.14,5
Szeged,8,3,3,2,9,9,0,12,Hungary - NB II,0.38,0.75,0,1.12,1.5,2.63,1.33,6
Kozarmisleny,8,4,0,4,10,14,-4,12,Hungary - NB II,0.5,0.5,-4,1.25,1.5,2.0,2.0,6
Mezokovesd,8,3,2,3,9,7,2,11,Hungary - NB II,0.38,0.62,2,1.12,1.38,2.63,1.61,7
Csakvari,8,3,1,4,11,12,-1,10,Hungary - NB II,0.38,0.5,-1,1.38,1.25,2.63,2.0,8
Ajka,8,3,1,4,8,10,-2,10,Hungary - NB II,0.38,0.5,-2,1.0,1.25,2.63,2.0,8
Bekescsaba,8,2,2,4,7,10,-3,8,Hungary - NB II,0.25,0.5,-3,0.88,1.0,4.0,2.0,9
Tatabanya,8,2,2,4,7,13,-6,8,Hungary - NB II,0.25,0.5,-6,0.88,1.0,4.0,2.0,9
BVSC,8,1,3,4,8,11,-3,6,Hungary - NB II,0.12,0.5,-3,1.0,0.75,8.33,2.0,10
Soroksar,8,1,3,4,10,15,-5,6,Hungary - NB II,0.12,0.5,-5,1.25,0.75,8.33,2.0,10
Gyirmot,8,0,5,3,5,11,-6,5,Hungary - NB II,0.0,0.62,-6,0.62,0.62,0.0,1.61,11
Budafoki,8,1,0,7,10,18,-8,3,Hungary - NB II,0.12,0.12,-8,1.25,0.38,8.33,8.33,12
Vikingur R.,2,2,0,0,6,0,6,6,Iceland - Besta deild,1.0,1.0,6,3.0,3.0,1.0,1.0,1
Stjarnan,2,2,0,0,4,2,2,6,Iceland - Besta deild,1.0,1.0,2,2.0,3.0,1.0,1.0,1
Vestri,2,1,1,0,2,1,1,4,Iceland - Besta deild,0.5,1.0,1,1.0,2.0,2.0,1.0,2
Fram,2,1,0,1,4,3,1,3,Iceland - Besta deild,0.5,0.5,1,2.0,1.5,2.0,2.0,3
Breidablik,2,1,0,1,4,4,0,3,Iceland - Besta deild,0.5,0.5,0,2.0,1.5,2.0,2.0,3
IA Akranes,2,1,0,1,2,2,0,3,Iceland - Besta deild,0.5,0.5,0,1.0,1.5,2.0,2.0,3
KR Reykjavik,2,0,2,0,5,5,0,2,Iceland - Besta deild,0.0,1.0,0,2.5,1.0,0.0,1.0,4
Valur,2,0,2,0,4,4,0,2,Iceland - Besta deild,0.0,1.0,0,2.0,1.0,0.0,1.0,4
Afturelding,2,0,1,1,0,2,-2,1,Iceland - Besta deild,0.0,0.5,-2,0.0,0.5,0.0,2.0,5
IBV,2,0,1,1,0,2,-2,1,Iceland - Besta deild,0.0,0.5,-2,0.0,0.5,0.0,2.0,5
KA Akureyri,2,0,1,1,2,6,-4,1,Iceland - Besta deild,0.0,0.5,-4,1.0,0.5,0.0,2.0,5
Hafnarfjordur,2,0,0,2,1,3,-2,0,Iceland - Besta deild,0.0,0.0,-2,0.5,0.0,0.0,0.0,6
Afturelding,8,6,1,1,18,7,11,19,Iceland - 1. Deild,0.75,0.88,11,2.25,2.38,1.33,1.14,1
Keflavik,8,5,2,1,17,9,8,17,Iceland - 1. Deild,0.62,0.88,8,2.12,2.12,1.61,1.14,2
Leiknir R.,8,4,4,0,18,10,8,16,Iceland - 1. Deild,0.5,1.0,8,2.25,2.0,2.0,1.0,3
IBV,8,4,2,2,22,12,10,14,Iceland - 1. Deild,0.5,0.75,10,2.75,1.75,2.0,1.33,4
IR Reykjavik,8,3,4,1,10,10,0,13,Iceland - 1. Deild,0.38,0.88,0,1.25,1.62,2.63,1.14,5
Throttur R.,8,3,2,3,15,12,3,11,Iceland - 1. Deild,0.38,0.62,3,1.88,1.38,2.63,1.61,6
Grindavik,8,2,3,3,18,19,-1,9,Iceland - 1. Deild,0.25,0.62,-1,2.25,1.12,4.0,1.61,7
Thor Akureyri,8,2,3,3,11,16,-5,9,Iceland - 1. Deild,0.25,0.62,-5,1.38,1.12,4.0,1.61,7
Njardvik,8,1,5,2,8,11,-3,8,Iceland - 1. Deild,0.12,0.75,-3,1.0,1.0,8.33,1.33,8
Fjolnir,8,1,3,4,6,14,-8,6,Iceland - 1. Deild,0.12,0.5,-8,0.75,0.75,8.33,2.0,9
Dalvik / Reynir,8,1,1,6,10,25,-15,4,Iceland - 1. Deild,0.12,0.25,-15,1.25,0.5,8.33,4.0,10
Grotta,8,1,0,7,9,17,-8,3,Iceland - 1. Deild,0.12,0.12,-8,1.12,0.38,8.33,8.33,11
Throttur Vogar,8,6,2,0,29,7,22,20,Iceland - 2. Deild,0.75,1.0,22,3.62,2.5,1.33,1.0,1
Selfoss,8,6,1,1,22,12,10,19,Iceland - 2. Deild,0.75,0.88,10,2.75,2.38,1.33,1.14,2
Volsungur,8,5,3,0,21,7,14,18,Iceland - 2. Deild,0.62,1.0,14,2.62,2.25,1.61,1.0,3
V. Olafsvik,8,5,1,2,19,13,6,16,Iceland - 2. Deild,0.62,0.75,6,2.38,2.0,1.61,1.33,4
Haukar,8,3,1,4,16,14,2,10,Iceland - 2. Deild,0.38,0.5,2,2.0,1.25,2.63,2.0,5
Fjardabyggd/L.,8,3,1,4,23,24,-1,10,Iceland - 2. Deild,0.38,0.5,-1,2.88,1.25,2.63,2.0,5
AEggir,8,2,4,2,9,12,-3,10,Iceland - 2. Deild,0.25,0.75,-3,1.12,1.25,4.0,1.33,5
Hottur/Huginn,8,3,0,5,11,23,-12,9,Iceland - 2. Deild,0.38,0.38,-12,1.38,1.12,2.63,2.63,6
KFG,8,2,2,4,12,16,-4,8,Iceland - 2. Deild,0.25,0.5,-4,1.5,1.0,4.0,2.0,7
Reynir,8,2,1,5,11,16,-5,7,Iceland - 2. Deild,0.25,0.38,-5,1.38,0.88,4.0,2.63,8
Fjallabyggd,8,2,1,5,12,22,-10,7,Iceland - 2. Deild,0.25,0.38,-10,1.5,0.88,4.0,2.63,8
Kormakur/Hvot,8,0,1,7,5,24,-19,1,Iceland - 2. Deild,0.0,0.12,-19,0.62,0.12,0.0,8.33,9
Mohun Bagan,8,6,2,0,16,2,14,20,India - Super League,0.75,1.0,14,2.0,2.5,1.33,1.0,1
Goa,8,6,0,2,13,7,6,18,India - Super League,0.75,0.75,6,1.62,2.25,1.33,1.33,2
NorthEast Utd,8,4,2,2,15,7,8,14,India - Super League,0.5,0.75,8,1.88,1.75,2.0,1.33,3
East Bengal,8,4,2,2,11,11,0,14,India - Super League,0.5,0.75,0,1.38,1.75,2.0,1.33,3
Mumbai City,8,3,3,2,10,6,4,12,India - Super League,0.38,0.75,4,1.25,1.5,2.63,1.33,4
Odisha FC,8,3,3,2,13,11,2,12,India - Super League,0.38,0.75,2,1.62,1.5,2.63,1.33,4
Bengaluru,8,3,1,4,11,10,1,10,India - Super League,0.38,0.5,1,1.38,1.25,2.63,2.0,5
Chennaiyin,8,3,1,4,11,12,-1,10,India - Super League,0.38,0.5,-1,1.38,1.25,2.63,2.0,5
Jamshedpur,8,3,1,4,12,16,-4,10,India - Super League,0.38,0.5,-4,1.5,1.25,2.63,2.0,5
Kerala Blasters,8,2,3,3,7,10,-3,9,India - Super League,0.25,0.62,-3,0.88,1.12,4.0,1.61,6
Punjab,8,2,2,4,11,15,-4,8,India - Super League,0.25,0.5,-4,1.38,1.0,4.0,2.0,7
Hyderabad,8,2,2,4,10,16,-6,8,India - Super League,0.25,0.5,-6,1.25,1.0,4.0,2.0,7
Mohammedan,8,0,2,6,4,19,-15,2,India - Super League,0.0,0.25,-15,0.5,0.25,0.0,4.0,8
Gokulam,8,6,0,2,23,14,9,18,India - I-League,0.75,0.75,9,2.88,2.25,1.33,1.33,1
Inter Kashi,8,4,3,1,14,11,3,15,India - I-League,0.5,0.88,3,1.75,1.88,2.0,1.14,2
Churchill B.,8,3,5,0,18,9,9,14,India - I-League,0.38,1.0,9,2.25,1.75,2.63,1.0,3
Real Kashmir,8,4,2,2,12,12,0,14,India - I-League,0.5,0.75,0,1.5,1.75,2.0,1.33,3
Rajasthan,8,4,0,4,16,13,3,12,India - I-League,0.5,0.5,3,2.0,1.5,2.0,2.0,4
Sreenidi Deccan,8,3,3,2,11,10,1,12,India - I-League,0.38,0.75,1,1.38,1.5,2.63,1.33,4
Dempo,8,3,2,3,24,17,7,11,India - I-League,0.38,0.62,7,3.0,1.38,2.63,1.61,5
Aizawl,8,3,2,3,16,15,1,11,India - I-League,0.38,0.62,1,2.0,1.38,2.63,1.61,5
SC Bengaluru,8,2,2,4,11,18,-7,8,India - I-League,0.25,0.5,-7,1.38,1.0,4.0,2.0,6
Namdhari,8,2,1,5,8,14,-6,7,India - I-League,0.25,0.38,-6,1.0,0.88,4.0,2.63,7
Shillong Lajong,8,1,3,4,12,23,-11,6,India - I-League,0.12,0.5,-11,1.5,0.75,8.33,2.0,8
Delhi FC,8,1,1,6,7,16,-9,4,India - I-League,0.12,0.25,-9,0.88,0.5,8.33,4.0,9
Malut United,8,5,3,0,14,6,8,18,Indonesia - Liga 1,0.62,1.0,8,1.75,2.25,1.61,1.0,1
Dewa Utd,8,5,1,2,14,6,8,16,Indonesia - Liga 1,0.62,0.75,8,1.75,2.0,1.61,1.33,2
Persib,8,4,3,1,15,10,5,15,Indonesia - Liga 1,0.5,0.88,5,1.88,1.88,2.0,1.14,3
Madura Utd,8,4,3,1,10,6,4,15,Indonesia - Liga 1,0.5,0.88,4,1.25,1.88,2.0,1.14,3
Arema,8,4,2,2,19,13,6,14,Indonesia - Liga 1,0.5,0.75,6,2.38,1.75,2.0,1.33,4
PSBS Biak N.,8,3,4,1,9,6,3,13,Indonesia - Liga 1,0.38,0.88,3,1.12,1.62,2.63,1.14,5
Borneo,8,4,1,3,8,9,-1,13,Indonesia - Liga 1,0.5,0.62,-1,1.0,1.62,2.0,1.61,5
PSM,8,3,3,2,10,7,3,12,Indonesia - Liga 1,0.38,0.75,3,1.25,1.5,2.63,1.33,6
Persebaya S.,8,3,3,2,10,8,2,12,Indonesia - Liga 1,0.38,0.75,2,1.25,1.5,2.63,1.33,6
Persis Solo,8,3,3,2,11,10,1,12,Indonesia - Liga 1,0.38,0.75,1,1.38,1.5,2.63,1.33,6
Barito Putera,8,3,2,3,13,13,0,11,Indonesia - Liga 1,0.38,0.62,0,1.62,1.38,2.63,1.61,7
Persita,8,2,2,4,8,11,-3,8,Indonesia - Liga 1,0.25,0.5,-3,1.0,1.0,4.0,2.0,8
Semen Padang,8,2,2,4,9,18,-9,8,Indonesia - Liga 1,0.25,0.5,-9,1.12,1.0,4.0,2.0,8
Bali Utd,8,1,4,3,7,11,-4,7,Indonesia - Liga 1,0.12,0.62,-4,0.88,0.88,8.33,1.61,9
Persija,8,1,3,4,9,12,-3,6,Indonesia - Liga 1,0.12,0.5,-3,1.12,0.75,8.33,2.0,10
Persik Kediri,8,0,5,3,6,11,-5,5,Indonesia - Liga 1,0.0,0.62,-5,0.75,0.62,0.0,1.61,11
PSIS Semarang,8,0,4,4,7,12,-5,4,Indonesia - Liga 1,0.0,0.5,-5,0.88,0.5,0.0,2.0,12
PSS Sleman,8,1,0,7,8,19,-11,3,Indonesia - Liga 1,0.12,0.12,-11,1.0,0.38,8.33,8.33,13
Tractor Sazi,8,6,2,0,13,4,9,20,Iran - Pro League,0.75,1.0,9,1.62,2.5,1.33,1.0,1
Persepolis,8,5,2,1,10,5,5,17,Iran - Pro League,0.62,0.88,5,1.25,2.12,1.61,1.14,2
Malavan,8,5,1,2,11,6,5,16,Iran - Pro League,0.62,0.75,5,1.38,2.0,1.61,1.33,3
Sepahan,8,3,5,0,11,5,6,14,Iran - Pro League,0.38,1.0,6,1.38,1.75,2.63,1.0,4
Shams A. Qazvin,8,3,2,3,10,9,1,11,Iran - Pro League,0.38,0.62,1,1.25,1.38,2.63,1.61,5
Zob Ahan,8,3,2,3,9,9,0,11,Iran - Pro League,0.38,0.62,0,1.12,1.38,2.63,1.61,5
Foolad,8,3,2,3,8,9,-1,11,Iran - Pro League,0.38,0.62,-1,1.0,1.38,2.63,1.61,5
K. Khorramabad,8,3,2,3,5,7,-2,11,Iran - Pro League,0.38,0.62,-2,0.62,1.38,2.63,1.61,5
Gol Gohar,8,2,4,2,6,6,0,10,Iran - Pro League,0.25,0.75,0,0.75,1.25,4.0,1.33,6
Havadar,8,3,1,4,9,14,-5,10,Iran - Pro League,0.38,0.5,-5,1.12,1.25,2.63,2.0,6
Mes Rafsanjan,8,2,3,3,6,7,-1,9,Iran - Pro League,0.25,0.62,-1,0.75,1.12,4.0,1.61,7
Chadormalu,8,2,2,4,7,8,-1,8,Iran - Pro League,0.25,0.5,-1,0.88,1.0,4.0,2.0,8
Esteghlal,8,1,4,3,6,8,-2,7,Iran - Pro League,0.12,0.62,-2,0.75,0.88,8.33,1.61,9
Aluminium Arak,8,1,4,3,4,6,-2,7,Iran - Pro League,0.12,0.62,-2,0.5,0.88,8.33,1.61,9
E. Khuzestan,8,1,4,3,5,8,-3,7,Iran - Pro League,0.12,0.62,-3,0.62,0.88,8.33,1.61,9
N. Mazandaran,8,1,2,5,2,7,-5,5,Iran - Pro League,0.12,0.38,-5,0.25,0.62,8.33,2.63,10
Drogheda Utd,8,5,2,1,13,5,8,17,Ireland - Premier Division,0.62,0.88,8,1.62,2.12,1.61,1.14,1
Shamrock Rovers,8,5,2,1,12,5,7,17,Ireland - Premier Division,0.62,0.88,7,1.5,2.12,1.61,1.14,1
St. Patricks,8,5,1,2,14,7,7,16,Ireland - Premier Division,0.62,0.75,7,1.75,2.0,1.61,1.33,2
Galway Utd,8,4,3,1,10,6,4,15,Ireland - Premier Division,0.5,0.88,4,1.25,1.88,2.0,1.14,3
Shelbourne,8,3,4,1,7,5,2,13,Ireland - Premier Division,0.38,0.88,2,0.88,1.62,2.63,1.14,4
Derry City,8,3,2,3,7,9,-2,11,Ireland - Premier Division,0.38,0.62,-2,0.88,1.38,2.63,1.61,5
Bohemians,8,2,0,6,8,12,-4,6,Ireland - Premier Division,0.25,0.25,-4,1.0,0.75,4.0,4.0,6
Cork City,8,1,3,4,8,14,-6,6,Ireland - Premier Division,0.12,0.5,-6,1.0,0.75,8.33,2.0,6
Waterford,8,2,0,6,5,13,-8,6,Ireland - Premier Division,0.25,0.25,-8,0.62,0.75,4.0,4.0,6
Sligo Rovers,8,1,1,6,10,18,-8,4,Ireland - Premier Division,0.12,0.25,-8,1.25,0.5,8.33,4.0,7
Dundalk,8,7,1,0,14,4,10,22,Ireland - First Division,0.88,1.0,10,1.75,2.75,1.14,1.0,1
Bray Wanderers,8,5,0,3,8,12,-4,15,Ireland - First Division,0.62,0.62,-4,1.0,1.88,1.61,1.61,2
Wexford,8,4,1,3,12,10,2,13,Ireland - First Division,0.5,0.62,2,1.5,1.62,2.0,1.61,3
Treaty Utd,8,3,2,3,14,8,6,11,Ireland - First Division,0.38,0.62,6,1.75,1.38,2.63,1.61,4
Cobh Ramblers,8,3,2,3,12,8,4,11,Ireland - First Division,0.38,0.62,4,1.5,1.38,2.63,1.61,4
Finn Harps,8,2,3,3,12,10,2,9,Ireland - First Division,0.25,0.62,2,1.5,1.12,4.0,1.61,5
UC Dublin,8,2,3,3,5,6,-1,9,Ireland - First Division,0.25,0.62,-1,0.62,1.12,4.0,1.61,5
Longford Town,8,2,2,4,9,15,-6,8,Ireland - First Division,0.25,0.5,-6,1.12,1.0,4.0,2.0,6
Kerry,8,2,1,5,7,10,-3,7,Ireland - First Division,0.25,0.38,-3,0.88,0.88,4.0,2.63,7
Athlone Town,8,2,1,5,4,14,-10,7,Ireland - First Division,0.25,0.38,-10,0.5,0.88,4.0,2.63,7
M. Tel Aviv,8,6,1,1,19,7,12,19,Israel - Ligat HaAl,0.75,0.88,12,2.38,2.38,1.33,1.14,1
H. Beer Sheva,8,5,2,1,19,9,10,17,Israel - Ligat HaAl,0.62,0.88,10,2.38,2.12,1.61,1.14,2
H. Jerusalem,8,3,4,1,14,8,6,13,Israel - Ligat HaAl,0.38,0.88,6,1.75,1.62,2.63,1.14,3
Hapoel Haifa,8,4,1,3,12,15,-3,13,Israel - Ligat HaAl,0.5,0.62,-3,1.5,1.62,2.0,1.61,3
Ashdod,8,3,3,2,11,9,2,12,Israel - Ligat HaAl,0.38,0.75,2,1.38,1.5,2.63,1.33,4
Maccabi Haifa,8,2,4,2,14,15,-1,10,Israel - Ligat HaAl,0.25,0.75,-1,1.75,1.25,4.0,1.33,5
Kiryat Shmona,8,3,1,4,10,12,-2,10,Israel - Ligat HaAl,0.38,0.5,-2,1.25,1.25,2.63,2.0,5
M. Petah Tikva,8,3,0,5,10,10,0,9,Israel - Ligat HaAl,0.38,0.38,0,1.25,1.12,2.63,2.63,6
B. Jerusalem,8,2,3,3,11,13,-2,9,Israel - Ligat HaAl,0.25,0.62,-2,1.38,1.12,4.0,1.61,6
Sakhnin,8,3,0,5,8,13,-5,9,Israel - Ligat HaAl,0.38,0.38,-5,1.0,1.12,2.63,2.63,6
Ironi Tiberias,8,2,2,4,8,13,-5,8,Israel - Ligat HaAl,0.25,0.5,-5,1.0,1.0,4.0,2.0,7
Hapoel Hadera,8,2,2,4,7,12,-5,8,Israel - Ligat HaAl,0.25,0.5,-5,0.88,1.0,4.0,2.0,7
M. Bnei Raina,8,2,1,5,7,12,-5,7,Israel - Ligat HaAl,0.25,0.38,-5,0.88,0.88,4.0,2.63,8
Maccabi Netanya,8,1,3,4,6,12,-6,6,Israel - Ligat HaAl,0.12,0.5,-6,0.75,0.75,8.33,2.0,9
Hapoel Tel Aviv,8,7,1,0,20,1,19,22,Israel - Leumit League,0.88,1.0,19,2.5,2.75,1.14,1.0,1
H. Petah Tikva,8,7,1,0,10,1,9,22,Israel - Leumit League,0.88,1.0,9,1.25,2.75,1.14,1.0,1
H. Ironi Rishon,8,5,0,3,18,13,5,15,Israel - Leumit League,0.62,0.62,5,2.25,1.88,1.61,1.61,2
Maccabi Jaffa,8,4,3,1,11,9,2,15,Israel - Leumit League,0.5,0.88,2,1.38,1.88,2.0,1.14,2
Hapoel Raanana,8,3,3,2,6,5,1,12,Israel - Leumit League,0.38,0.75,1,0.75,1.5,2.63,1.33,3
H. Ramat Gan,8,3,2,3,15,7,8,11,Israel - Leumit League,0.38,0.62,8,1.88,1.38,2.63,1.61,4
Kafr Qasim,8,3,2,3,8,8,0,11,Israel - Leumit League,0.38,0.62,0,1.0,1.38,2.63,1.61,4
Hapoel Akko,8,3,2,3,9,10,-1,11,Israel - Leumit League,0.38,0.62,-1,1.12,1.38,2.63,1.61,4
H. Kfar Saba,8,3,1,4,6,8,-2,10,Israel - Leumit League,0.38,0.5,-2,0.75,1.25,2.63,2.0,5
H. Kfar Shalem,8,3,0,5,8,10,-2,9,Israel - Leumit League,0.38,0.38,-2,1.0,1.12,2.63,2.63,6
H. Umm al-Fahm,8,2,3,3,9,13,-4,9,Israel - Leumit League,0.25,0.62,-4,1.12,1.12,4.0,1.61,6
Bnei Yehuda,8,3,0,5,8,13,-5,9,Israel - Leumit League,0.38,0.38,-5,1.0,1.12,2.63,2.63,6
M. Herziliya,8,2,1,5,6,13,-7,7,Israel - Leumit League,0.25,0.38,-7,0.75,0.88,4.0,2.63,7
Hapoel Afula,8,1,3,4,5,8,-3,6,Israel - Leumit League,0.12,0.5,-3,0.62,0.75,8.33,2.0,8
H. Nof Hagalil,8,1,3,4,3,6,-3,6,Israel - Leumit League,0.12,0.5,-3,0.38,0.75,8.33,2.0,8
Ramat Hasharon,8,0,3,5,6,23,-17,3,Israel - Leumit League,0.0,0.38,-17,0.75,0.38,0.0,2.63,9
AS Roma,8,6,2,0,12,3,9,20,Italy - Serie A,0.75,1.0,9,1.5,2.5,1.33,1.0,1
Inter Milan,8,5,2,1,14,8,6,17,Italy - Serie A,0.62,0.88,6,1.75,2.12,1.61,1.14,2
Bologna,8,5,1,2,13,8,5,16,Italy - Serie A,0.62,0.75,5,1.62,2.0,1.61,1.33,3
Juventus,8,5,1,2,8,9,-1,16,Italy - Serie A,0.62,0.75,-1,1.0,2.0,1.61,1.33,3
Como,8,4,2,2,12,8,4,14,Italy - Serie A,0.5,0.75,4,1.5,1.75,2.0,1.33,4
Napoli,8,3,4,1,12,8,4,13,Italy - Serie A,0.38,0.88,4,1.5,1.62,2.63,1.14,5
Torino,8,3,3,2,11,9,2,12,Italy - Serie A,0.38,0.75,2,1.38,1.5,2.63,1.33,6
Genoa,8,3,3,2,7,5,2,12,Italy - Serie A,0.38,0.75,2,0.88,1.5,2.63,1.33,6
Atalanta,8,3,2,3,11,4,7,11,Italy - Serie A,0.38,0.62,7,1.38,1.38,2.63,1.61,7
Fiorentina,8,3,2,3,8,7,1,11,Italy - Serie A,0.38,0.62,1,1.0,1.38,2.63,1.61,7
Lazio,8,2,5,1,8,11,-3,11,Italy - Serie A,0.25,0.88,-3,1.0,1.38,4.0,1.14,7
AC Milan,8,3,1,4,15,13,2,10,Italy - Serie A,0.38,0.5,2,1.88,1.25,2.63,2.0,8
Udinese,8,3,1,4,7,9,-2,10,Italy - Serie A,0.38,0.5,-2,0.88,1.25,2.63,2.0,8
Hellas Verona,8,2,3,3,4,6,-2,9,Italy - Serie A,0.25,0.62,-2,0.5,1.12,4.0,1.61,9
Parma,8,1,5,2,7,7,0,8,Italy - Serie A,0.12,0.75,0,0.88,1.0,8.33,1.33,10
Venezia,8,1,5,2,3,5,-2,8,Italy - Serie A,0.12,0.75,-2,0.38,1.0,8.33,1.33,10
Cagliari,8,1,3,4,6,8,-2,6,Italy - Serie A,0.12,0.5,-2,0.75,0.75,8.33,2.0,11
Empoli,8,0,3,5,2,15,-13,3,Italy - Serie A,0.0,0.38,-13,0.25,0.38,0.0,2.63,12
Lecce,8,0,2,6,5,11,-6,2,Italy - Serie A,0.0,0.25,-6,0.62,0.25,0.0,4.0,13
Monza,8,0,2,6,4,17,-13,2,Italy - Serie A,0.0,0.25,-13,0.5,0.25,0.0,4.0,13
Sassuolo,8,5,2,1,17,9,8,17,Italy - Serie B,0.62,0.88,8,2.12,2.12,1.61,1.14,1
Frosinone,8,4,4,0,13,7,6,16,Italy - Serie B,0.5,1.0,6,1.62,2.0,2.0,1.0,2
Palermo,8,4,2,2,17,12,5,14,Italy - Serie B,0.5,0.75,5,2.12,1.75,2.0,1.33,3
Juve Stabia,8,4,2,2,11,8,3,14,Italy - Serie B,0.5,0.75,3,1.38,1.75,2.0,1.33,3
Pisa,8,4,1,3,15,9,6,13,Italy - Serie B,0.5,0.62,6,1.88,1.62,2.0,1.61,4
Cremonese,8,3,4,1,16,11,5,13,Italy - Serie B,0.38,0.88,5,2.0,1.62,2.63,1.14,4
Catanzaro,8,3,3,2,13,12,1,12,Italy - Serie B,0.38,0.75,1,1.62,1.5,2.63,1.33,5
Cesena,8,2,5,1,9,7,2,11,Italy - Serie B,0.25,0.88,2,1.12,1.38,4.0,1.14,6
Carrarese,8,2,5,1,13,12,1,11,Italy - Serie B,0.25,0.88,1,1.62,1.38,4.0,1.14,6
Bari,8,2,5,1,10,9,1,11,Italy - Serie B,0.25,0.88,1,1.25,1.38,4.0,1.14,6
Modena,8,3,2,3,10,10,0,11,Italy - Serie B,0.38,0.62,0,1.25,1.38,2.63,1.61,6
Sudtirol,8,2,4,2,12,10,2,10,Italy - Serie B,0.25,0.75,2,1.5,1.25,4.0,1.33,7
Spezia,8,2,4,2,9,8,1,10,Italy - Serie B,0.25,0.75,1,1.12,1.25,4.0,1.33,7
Mantova,8,2,3,3,11,12,-1,9,Italy - Serie B,0.25,0.62,-1,1.38,1.12,4.0,1.61,8
Salernitana,8,2,2,4,7,10,-3,8,Italy - Serie B,0.25,0.5,-3,0.88,1.0,4.0,2.0,9
Sampdoria,8,1,4,3,6,11,-5,7,Italy - Serie B,0.12,0.62,-5,0.75,0.88,8.33,1.61,10
Brescia,8,1,3,4,5,9,-4,6,Italy - Serie B,0.12,0.5,-4,0.62,0.75,8.33,2.0,11
Cosenza,8,1,3,4,5,17,-12,6,Italy - Serie B,0.12,0.5,-12,0.62,0.75,8.33,2.0,11
Cittadella,8,1,2,5,5,13,-8,5,Italy - Serie B,0.12,0.38,-8,0.62,0.62,8.33,2.63,12
Reggiana,8,0,4,4,8,16,-8,4,Italy - Serie B,0.0,0.5,-8,1.0,0.5,0.0,2.0,13
Vicenza,8,5,2,1,14,7,7,17,Italy - Serie C - Group A,0.62,0.88,7,1.75,2.12,1.61,1.14,1
FeralpiSalo,8,5,2,1,13,7,6,17,Italy - Serie C - Group A,0.62,0.88,6,1.62,2.12,1.61,1.14,1
Renate,8,5,2,1,12,7,5,17,Italy - Serie C - Group A,0.62,0.88,5,1.5,2.12,1.61,1.14,1
Giana Erminio,8,5,1,2,11,4,7,16,Italy - Serie C - Group A,0.62,0.75,7,1.38,2.0,1.61,1.33,2
Atalanta B,8,3,4,1,13,8,5,13,Italy - Serie C - Group A,0.38,0.88,5,1.62,1.62,2.63,1.14,3
Padova,8,4,1,3,12,9,3,13,Italy - Serie C - Group A,0.5,0.62,3,1.5,1.62,2.0,1.61,3
AlbinoLeffe,8,4,1,3,13,13,0,13,Italy - Serie C - Group A,0.5,0.62,0,1.62,1.62,2.0,1.61,3
Trento,8,3,3,2,8,6,2,12,Italy - Serie C - Group A,0.38,0.75,2,1.0,1.5,2.63,1.33,4
Virtus Verona,8,3,3,2,10,9,1,12,Italy - Serie C - Group A,0.38,0.75,1,1.25,1.5,2.63,1.33,4
Arzignano,8,4,0,4,9,10,-1,12,Italy - Serie C - Group A,0.5,0.5,-1,1.12,1.5,2.0,2.0,4
Lecco,8,2,5,1,6,5,1,11,Italy - Serie C - Group A,0.25,0.88,1,0.75,1.38,4.0,1.14,5
Pro Patria,8,2,4,2,5,5,0,10,Italy - Serie C - Group A,0.25,0.75,0,0.62,1.25,4.0,1.33,6
Alcione,8,2,3,3,6,8,-2,9,Italy - Serie C - Group A,0.25,0.62,-2,0.75,1.12,4.0,1.61,7
Novara,8,2,2,4,7,10,-3,8,Italy - Serie C - Group A,0.25,0.5,-3,0.88,1.0,4.0,2.0,8
Triestina,8,2,2,4,5,10,-5,8,Italy - Serie C - Group A,0.25,0.5,-5,0.62,1.0,4.0,2.0,8
Caldiero Terme,8,1,4,3,10,12,-2,7,Italy - Serie C - Group A,0.12,0.62,-2,1.25,0.88,8.33,1.61,9
Pro Vercelli,8,1,4,3,6,10,-4,7,Italy - Serie C - Group A,0.12,0.62,-4,0.75,0.88,8.33,1.61,9
Lumezzane,8,0,5,3,7,12,-5,5,Italy - Serie C - Group A,0.0,0.62,-5,0.88,0.62,0.0,1.61,10
Pergolettese,8,1,2,5,4,9,-5,5,Italy - Serie C - Group A,0.12,0.38,-5,0.5,0.62,8.33,2.63,10
Clodiense,8,1,0,7,8,18,-10,3,Italy - Serie C - Group A,0.12,0.12,-10,1.0,0.38,8.33,8.33,11
Entella,8,6,2,0,17,5,12,20,Italy - Serie C - Group B,0.75,1.0,12,2.12,2.5,1.33,1.0,1
Pineto,8,5,1,2,11,12,-1,16,Italy - Serie C - Group B,0.62,0.75,-1,1.38,2.0,1.61,1.33,2
Perugia,8,4,3,1,10,6,4,15,Italy - Serie C - Group B,0.5,0.88,4,1.25,1.88,2.0,1.14,3
Arezzo,8,5,0,3,8,4,4,15,Italy - Serie C - Group B,0.62,0.62,4,1.0,1.88,1.61,1.61,3
Rimini,8,4,1,3,11,9,2,13,Italy - Serie C - Group B,0.5,0.62,2,1.38,1.62,2.0,1.61,4
Ternana,8,4,1,3,9,7,2,13,Italy - Serie C - Group B,0.5,0.62,2,1.12,1.62,2.0,1.61,4
Pontedera,8,3,3,2,13,11,2,12,Italy - Serie C - Group B,0.38,0.75,2,1.62,1.5,2.63,1.33,5
Lucchese,8,3,3,2,14,14,0,12,Italy - Serie C - Group B,0.38,0.75,0,1.75,1.5,2.63,1.33,5
Athletic Carpi,8,3,3,2,8,8,0,12,Italy - Serie C - Group B,0.38,0.75,0,1.0,1.5,2.63,1.33,5
Pescara,8,3,2,3,13,9,4,11,Italy - Serie C - Group B,0.38,0.62,4,1.62,1.38,2.63,1.61,6
AC Milan B,8,3,2,3,9,9,0,11,Italy - Serie C - Group B,0.38,0.62,0,1.12,1.38,2.63,1.61,6
Gubbio,8,3,2,3,6,7,-1,11,Italy - Serie C - Group B,0.38,0.62,-1,0.75,1.38,2.63,1.61,6
Pianese,8,3,0,5,8,9,-1,9,Italy - Serie C - Group B,0.38,0.38,-1,1.0,1.12,2.63,2.63,7
Torres,8,2,3,3,7,8,-1,9,Italy - Serie C - Group B,0.25,0.62,-1,0.88,1.12,4.0,1.61,7
Legnago Salus,8,1,4,3,6,10,-4,7,Italy - Serie C - Group B,0.12,0.62,-4,0.75,0.88,8.33,1.61,8
Sestri Levante,8,2,1,5,10,15,-5,7,Italy - Serie C - Group B,0.25,0.38,-5,1.25,0.88,4.0,2.63,8
SPAL,8,1,4,3,6,11,-5,7,Italy - Serie C - Group B,0.12,0.62,-5,0.75,0.88,8.33,1.61,8
Campobasso,8,2,1,5,8,14,-6,7,Italy - Serie C - Group B,0.25,0.38,-6,1.0,0.88,4.0,2.63,8
Vis Pesaro,8,1,3,4,7,9,-2,6,Italy - Serie C - Group B,0.12,0.5,-2,0.88,0.75,8.33,2.0,9
Ascoli,8,1,3,4,4,8,-4,6,Italy - Serie C - Group B,0.12,0.5,-4,0.5,0.75,8.33,2.0,9
Avellino,8,8,0,0,13,4,9,24,Italy - Serie C - Group C,1.0,1.0,9,1.62,3.0,1.0,1.0,1
Crotone,8,5,2,1,16,10,6,17,Italy - Serie C - Group C,0.62,0.88,6,2.0,2.12,1.61,1.14,2
A. Cerignola,8,5,1,2,11,8,3,16,Italy - Serie C - Group C,0.62,0.75,3,1.38,2.0,1.61,1.33,3
Catania,8,4,3,1,12,5,7,15,Italy - Serie C - Group C,0.5,0.88,7,1.5,1.88,2.0,1.14,4
Monopoli,8,4,2,2,8,5,3,14,Italy - Serie C - Group C,0.5,0.75,3,1.0,1.75,2.0,1.33,5
Picerno,8,3,4,1,11,7,4,13,Italy - Serie C - Group C,0.38,0.88,4,1.38,1.62,2.63,1.14,6
Potenza,8,3,4,1,17,14,3,13,Italy - Serie C - Group C,0.38,0.88,3,2.12,1.62,2.63,1.14,6
Cavese,8,3,3,2,10,10,0,12,Italy - Serie C - Group C,0.38,0.75,0,1.25,1.5,2.63,1.33,7
Juventus U23,8,3,2,3,12,9,3,11,Italy - Serie C - Group C,0.38,0.62,3,1.5,1.38,2.63,1.61,8
Giugliano,8,2,3,3,16,14,2,9,Italy - Serie C - Group C,0.25,0.62,2,2.0,1.12,4.0,1.61,9
Benevento,8,1,6,1,9,8,1,9,Italy - Serie C - Group C,0.12,0.88,1,1.12,1.12,8.33,1.14,9
Casertana,8,2,2,4,11,8,3,8,Italy - Serie C - Group C,0.25,0.5,3,1.38,1.0,4.0,2.0,10
Altamura,8,2,2,4,9,13,-4,8,Italy - Serie C - Group C,0.25,0.5,-4,1.12,1.0,4.0,2.0,10
Latina,8,2,2,4,8,17,-9,8,Italy - Serie C - Group C,0.25,0.5,-9,1.0,1.0,4.0,2.0,10
ACR Messina,8,2,1,5,11,13,-2,7,Italy - Serie C - Group C,0.25,0.38,-2,1.38,0.88,4.0,2.63,11
Trapani,8,2,0,6,6,11,-5,6,Italy - Serie C - Group C,0.25,0.25,-5,0.75,0.75,4.0,4.0,12
Sorrento,8,1,2,5,5,17,-12,5,Italy - Serie C - Group C,0.12,0.38,-12,0.62,0.62,8.33,2.63,13
Foggia,8,1,1,6,10,19,-9,4,Italy - Serie C - Group C,0.12,0.25,-9,1.25,0.5,8.33,4.0,14
Taranto,0,0,0,0,0,0,0,0,Italy - Serie C - Group C,0.0,0.0,0,0.0,0.0,0.0,0.0,15
Turris,0,0,0,0,0,0,0,0,Italy - Serie C - Group C,0.0,0.0,0,0.0,0.0,0.0,0.0,15
Gozzano,8,6,2,0,15,6,9,20,Italy - Serie D - Group A,0.75,1.0,9,1.88,2.5,1.33,1.0,1
Lavagnese,8,6,1,1,12,6,6,19,Italy - Serie D - Group A,0.75,0.88,6,1.5,2.38,1.33,1.14,2
NovaRomentin,8,5,2,1,18,5,13,17,Italy - Serie D - Group A,0.62,0.88,13,2.25,2.12,1.61,1.14,3
Bra,8,5,2,1,12,6,6,17,Italy - Serie D - Group A,0.62,0.88,6,1.5,2.12,1.61,1.14,3
Oltrepo,8,5,1,2,9,5,4,16,Italy - Serie D - Group A,0.62,0.75,4,1.12,2.0,1.61,1.33,4
Vado,8,3,3,2,9,7,2,12,Italy - Serie D - Group A,0.38,0.75,2,1.12,1.5,2.63,1.33,5
Sanremese,8,3,3,2,6,5,1,12,Italy - Serie D - Group A,0.38,0.75,1,0.75,1.5,2.63,1.33,5
Ligorna,8,3,3,2,11,12,-1,12,Italy - Serie D - Group A,0.38,0.75,-1,1.38,1.5,2.63,1.33,5
Derthona,8,3,2,3,6,6,0,11,Italy - Serie D - Group A,0.38,0.62,0,0.75,1.38,2.63,1.61,6
Asti,8,2,4,2,7,5,2,10,Italy - Serie D - Group A,0.25,0.75,2,0.88,1.25,4.0,1.33,7
Saluzzo,8,2,4,2,9,8,1,10,Italy - Serie D - Group A,0.25,0.75,1,1.12,1.25,4.0,1.33,7
Chieri,8,1,5,2,8,8,0,8,Italy - Serie D - Group A,0.12,0.75,0,1.0,1.0,8.33,1.33,8
Citta di Varese,8,2,2,4,8,10,-2,8,Italy - Serie D - Group A,0.25,0.5,-2,1.0,1.0,4.0,2.0,8
Vogherese,8,1,5,2,5,7,-2,8,Italy - Serie D - Group A,0.12,0.75,-2,0.62,1.0,8.33,1.33,8
Borgaro Nobis,8,2,1,5,7,16,-9,7,Italy - Serie D - Group A,0.25,0.38,-9,0.88,0.88,4.0,2.63,9
Chisola,8,1,3,4,6,10,-4,6,Italy - Serie D - Group A,0.12,0.5,-4,0.75,0.75,8.33,2.0,10
Cairese,8,1,2,5,4,9,-5,5,Italy - Serie D - Group A,0.12,0.38,-5,0.5,0.62,8.33,2.63,11
Pro Imperia,8,1,1,6,6,16,-10,4,Italy - Serie D - Group A,0.12,0.25,-10,0.75,0.5,8.33,4.0,12
Fossano,8,1,0,7,5,16,-11,3,Italy - Serie D - Group A,0.12,0.12,-11,0.62,0.38,8.33,8.33,13
Albenga,0,0,0,0,0,0,0,0,Italy - Serie D - Group A,0.0,0.0,0,0.0,0.0,0.0,0.0,14
USD Casatese,8,6,1,1,17,5,12,19,Italy - Serie D - Group B,0.75,0.88,12,2.12,2.38,1.33,1.14,1
Pro Palazzolo,8,6,0,2,17,8,9,18,Italy - Serie D - Group B,0.75,0.75,9,2.12,2.25,1.33,1.33,2
F. Caratese,8,5,1,2,18,8,10,16,Italy - Serie D - Group B,0.62,0.75,10,2.25,2.0,1.61,1.33,3
Desenxano,8,5,1,2,10,5,5,16,Italy - Serie D - Group B,0.62,0.75,5,1.25,2.0,1.61,1.33,3
Ospitaletto,8,4,3,1,12,8,4,15,Italy - Serie D - Group B,0.5,0.88,4,1.5,1.88,2.0,1.14,4
Sondrio,8,5,0,3,10,6,4,15,Italy - Serie D - Group B,0.62,0.62,4,1.25,1.88,1.61,1.61,4
Varesina,8,4,2,2,16,12,4,14,Italy - Serie D - Group B,0.5,0.75,4,2.0,1.75,2.0,1.33,5
Club Milano,8,4,0,4,12,14,-2,12,Italy - Serie D - Group B,0.5,0.5,-2,1.5,1.5,2.0,2.0,6
Castellanzese,8,2,5,1,12,11,1,11,Italy - Serie D - Group B,0.25,0.88,1,1.5,1.38,4.0,1.14,7
Sangiuliano C.,8,3,2,3,10,10,0,11,Italy - Serie D - Group B,0.38,0.62,0,1.25,1.38,2.63,1.61,7
Pro Sesto,8,3,2,3,8,9,-1,11,Italy - Serie D - Group B,0.38,0.62,-1,1.0,1.38,2.63,1.61,7
Chievo,8,3,1,4,10,7,3,10,Italy - Serie D - Group B,0.38,0.5,3,1.25,1.25,2.63,2.0,8
Magenta,8,2,3,3,7,10,-3,9,Italy - Serie D - Group B,0.25,0.62,-3,0.88,1.12,4.0,1.61,9
Vigasio,8,3,0,5,7,10,-3,9,Italy - Serie D - Group B,0.38,0.38,-3,0.88,1.12,2.63,2.63,9
Breno,8,2,2,4,9,19,-10,8,Italy - Serie D - Group B,0.25,0.5,-10,1.12,1.0,4.0,2.0,10
Crema,8,2,1,5,12,14,-2,7,Italy - Serie D - Group B,0.25,0.38,-2,1.5,0.88,4.0,2.63,11
SantAngelo,8,1,4,3,8,10,-2,7,Italy - Serie D - Group B,0.12,0.62,-2,1.0,0.88,8.33,1.61,11
Ciliverghe,8,2,1,5,9,20,-11,7,Italy - Serie D - Group B,0.25,0.38,-11,1.12,0.88,4.0,2.63,11
Arconatese,8,1,3,4,9,15,-6,6,Italy - Serie D - Group B,0.12,0.5,-6,1.12,0.75,8.33,2.0,12
Fanfulla,8,1,2,5,6,13,-7,5,Italy - Serie D - Group B,0.12,0.38,-7,0.75,0.62,8.33,2.63,13
Real Calepina,8,5,3,0,12,5,7,18,Italy - Serie D - Group C,0.62,1.0,7,1.5,2.25,1.61,1.0,1
Brian Lignano,8,4,4,0,13,5,8,16,Italy - Serie D - Group C,0.5,1.0,8,1.62,2.0,2.0,1.0,2
Adriese,8,5,1,2,15,8,7,16,Italy - Serie D - Group C,0.62,0.75,7,1.88,2.0,1.61,1.33,2
Villa Alme,8,5,1,2,15,11,4,16,Italy - Serie D - Group C,0.62,0.75,4,1.88,2.0,1.61,1.33,2
Mestre,8,4,2,2,8,5,3,14,Italy - Serie D - Group C,0.5,0.75,3,1.0,1.75,2.0,1.33,3
Treviso,8,4,2,2,7,5,2,14,Italy - Serie D - Group C,0.5,0.75,2,0.88,1.75,2.0,1.33,3
Bassano Virtus,8,4,1,3,15,5,10,13,Italy - Serie D - Group C,0.5,0.62,10,1.88,1.62,2.0,1.61,4
D. Bellunesi,8,3,4,1,12,10,2,13,Italy - Serie D - Group C,0.38,0.88,2,1.5,1.62,2.63,1.14,4
Portogruaro,8,3,3,2,8,5,3,12,Italy - Serie D - Group C,0.38,0.75,3,1.0,1.5,2.63,1.33,5
Luparense,8,3,3,2,10,9,1,12,Italy - Serie D - Group C,0.38,0.75,1,1.25,1.5,2.63,1.33,5
Este,8,3,3,2,9,10,-1,12,Italy - Serie D - Group C,0.38,0.75,-1,1.12,1.5,2.63,1.33,5
Brusaporto,8,3,2,3,7,6,1,11,Italy - Serie D - Group C,0.38,0.62,1,0.88,1.38,2.63,1.61,6
Campodarsego,8,2,4,2,9,8,1,10,Italy - Serie D - Group C,0.25,0.75,1,1.12,1.25,4.0,1.33,7
Chions,8,2,3,3,8,10,-2,9,Italy - Serie D - Group C,0.25,0.62,-2,1.0,1.12,4.0,1.61,8
Cjarlins Muzane,8,2,3,3,10,15,-5,9,Italy - Serie D - Group C,0.25,0.62,-5,1.25,1.12,4.0,1.61,8
Ciserano,8,1,5,2,4,6,-2,8,Italy - Serie D - Group C,0.12,0.75,-2,0.5,1.0,8.33,1.33,9
Calvi Noale,8,2,1,5,9,13,-4,7,Italy - Serie D - Group C,0.25,0.38,-4,1.12,0.88,4.0,2.63,10
Lavis,8,1,0,7,5,20,-15,3,Italy - Serie D - Group C,0.12,0.12,-15,0.62,0.38,8.33,8.33,11
Caravaggio,8,0,2,6,7,16,-9,2,Italy - Serie D - Group C,0.0,0.25,-9,0.88,0.25,0.0,4.0,12
Montecchio M.,8,0,2,6,2,12,-10,2,Italy - Serie D - Group C,0.0,0.25,-10,0.25,0.25,0.0,4.0,12
Forli,8,8,0,0,19,5,14,24,Italy - Serie D - Group D,1.0,1.0,14,2.38,3.0,1.0,1.0,1
Ravenna,8,6,1,1,22,10,12,19,Italy - Serie D - Group D,0.75,0.88,12,2.75,2.38,1.33,1.14,2
Lentigione,8,6,1,1,16,4,12,19,Italy - Serie D - Group D,0.75,0.88,12,2.0,2.38,1.33,1.14,2
Zenith Prato,8,4,2,2,11,6,5,14,Italy - Serie D - Group D,0.5,0.75,5,1.38,1.75,2.0,1.33,3
Pistoiese,8,4,1,3,7,5,2,13,Italy - Serie D - Group D,0.5,0.62,2,0.88,1.62,2.0,1.61,4
Cittadella Vis,8,3,3,2,13,10,3,12,Italy - Serie D - Group D,0.38,0.75,3,1.62,1.5,2.63,1.33,5
Piacenza,8,3,3,2,10,7,3,12,Italy - Serie D - Group D,0.38,0.75,3,1.25,1.5,2.63,1.33,5
San Marino C.,8,3,3,2,14,12,2,12,Italy - Serie D - Group D,0.38,0.75,2,1.75,1.5,2.63,1.33,5
Imolese,8,3,3,2,10,8,2,12,Italy - Serie D - Group D,0.38,0.75,2,1.25,1.5,2.63,1.33,5
Tau Altopascio,8,2,4,2,10,9,1,10,Italy - Serie D - Group D,0.25,0.75,1,1.25,1.25,4.0,1.33,6
Prato,8,3,1,4,9,11,-2,10,Italy - Serie D - Group D,0.38,0.5,-2,1.12,1.25,2.63,2.0,6
Sasso Marconi,8,2,3,3,11,12,-1,9,Italy - Serie D - Group D,0.25,0.62,-1,1.38,1.12,4.0,1.61,7
Tuttocuoio,8,2,2,4,11,12,-1,8,Italy - Serie D - Group D,0.25,0.5,-1,1.38,1.0,4.0,2.0,8
Sammaurese,8,2,2,4,3,5,-2,8,Italy - Serie D - Group D,0.25,0.5,-2,0.38,1.0,4.0,2.0,8
Corticella,8,2,1,5,6,19,-13,7,Italy - Serie D - Group D,0.25,0.38,-13,0.75,0.88,4.0,2.63,9
Fiorenzuola,8,2,0,6,4,14,-10,6,Italy - Serie D - Group D,0.25,0.25,-10,0.5,0.75,4.0,4.0,10
Progresso,8,1,2,5,7,12,-5,5,Italy - Serie D - Group D,0.12,0.38,-5,0.88,0.62,8.33,2.63,11
United Riccione,8,0,0,8,1,23,-22,0,Italy - Serie D - Group D,0.0,0.0,-22,0.12,0.0,0.0,0.0,12
Flaminia,8,4,3,1,16,10,6,15,Italy - Serie D - Group E,0.5,0.88,6,2.0,1.88,2.0,1.14,1
Ostia Mare,8,4,3,1,14,11,3,15,Italy - Serie D - Group E,0.5,0.88,3,1.75,1.88,2.0,1.14,1
S. Trestina,8,4,3,1,8,5,3,15,Italy - Serie D - Group E,0.5,0.88,3,1.0,1.88,2.0,1.14,1
Orvietana,8,4,2,2,13,10,3,14,Italy - Serie D - Group E,0.5,0.75,3,1.62,1.75,2.0,1.33,2
Ghiviborgo,8,4,1,3,18,8,10,13,Italy - Serie D - Group E,0.5,0.62,10,2.25,1.62,2.0,1.61,3
Fulgens Foligno,8,3,4,1,13,10,3,13,Italy - Serie D - Group E,0.38,0.88,3,1.62,1.62,2.63,1.14,3
San Donato,8,4,1,3,10,7,3,13,Italy - Serie D - Group E,0.5,0.62,3,1.25,1.62,2.0,1.61,3
Livorno,8,3,3,2,16,17,-1,12,Italy - Serie D - Group E,0.38,0.75,-1,2.0,1.5,2.63,1.33,4
Seravezza,8,3,2,3,12,13,-1,11,Italy - Serie D - Group E,0.38,0.62,-1,1.5,1.38,2.63,1.61,5
T. Traiana,8,2,4,2,6,7,-1,10,Italy - Serie D - Group E,0.25,0.75,-1,0.75,1.25,4.0,1.33,6
Poggibonsi,8,3,1,4,3,6,-3,10,Italy - Serie D - Group E,0.38,0.5,-3,0.38,1.25,2.63,2.0,6
Grosseto,8,2,3,3,7,9,-2,9,Italy - Serie D - Group E,0.25,0.62,-2,0.88,1.12,4.0,1.61,7
FC Siena,8,2,3,3,7,10,-3,9,Italy - Serie D - Group E,0.25,0.62,-3,0.88,1.12,4.0,1.61,7
Montevarchi,8,1,5,2,6,7,-1,8,Italy - Serie D - Group E,0.12,0.75,-1,0.75,1.0,8.33,1.33,8
Gavorrano,8,1,4,3,7,12,-5,7,Italy - Serie D - Group E,0.12,0.62,-5,0.88,0.88,8.33,1.61,9
Sangiovannese,8,1,3,4,10,14,-4,6,Italy - Serie D - Group E,0.12,0.5,-4,1.25,0.75,8.33,2.0,10
Fezzanese,8,1,3,4,6,13,-7,6,Italy - Serie D - Group E,0.12,0.5,-7,0.75,0.75,8.33,2.0,10
Figline,8,1,2,5,2,8,-6,5,Italy - Serie D - Group E,0.12,0.38,-6,0.25,0.62,8.33,2.63,11
Teramo,8,5,0,3,13,9,4,15,Italy - Serie D - Group F,0.62,0.62,4,1.62,1.88,1.61,1.61,1
Sambenedettese,8,4,2,2,10,6,4,14,Italy - Serie D - Group F,0.5,0.75,4,1.25,1.75,2.0,1.33,2
Avezzano,8,4,2,2,11,9,2,14,Italy - Serie D - Group F,0.5,0.75,2,1.38,1.75,2.0,1.33,2
Termoli Calcio,8,3,4,1,10,10,0,13,Italy - Serie D - Group F,0.38,0.88,0,1.25,1.62,2.63,1.14,3
San Nicolo,8,4,1,3,9,10,-1,13,Italy - Serie D - Group F,0.5,0.62,-1,1.12,1.62,2.0,1.61,3
Sora,8,3,3,2,10,6,4,12,Italy - Serie D - Group F,0.38,0.75,4,1.25,1.5,2.63,1.33,4
Fossombrone,8,3,3,2,10,7,3,12,Italy - Serie D - Group F,0.38,0.75,3,1.25,1.5,2.63,1.33,4
LAquila,8,3,2,3,11,8,3,11,Italy - Serie D - Group F,0.38,0.62,3,1.38,1.38,2.63,1.61,5
Civitanovese,8,3,2,3,9,7,2,11,Italy - Serie D - Group F,0.38,0.62,2,1.12,1.38,2.63,1.61,5
Chieti,8,3,2,3,9,11,-2,11,Italy - Serie D - Group F,0.38,0.62,-2,1.12,1.38,2.63,1.61,5
Atletico Ascoli,8,2,4,2,8,8,0,10,Italy - Serie D - Group F,0.25,0.75,0,1.0,1.25,4.0,1.33,6
Isernia,8,3,1,4,8,9,-1,10,Italy - Serie D - Group F,0.38,0.5,-1,1.0,1.25,2.63,2.0,6
Recanatese,8,3,1,4,9,14,-5,10,Italy - Serie D - Group F,0.38,0.5,-5,1.12,1.25,2.63,2.0,6
Ancona 1905,8,2,3,3,10,11,-1,9,Italy - Serie D - Group F,0.25,0.62,-1,1.25,1.12,4.0,1.61,7
Roma City,8,2,3,3,9,10,-1,9,Italy - Serie D - Group F,0.25,0.62,-1,1.12,1.12,4.0,1.61,7
V. Senigallia,8,1,4,3,6,10,-4,7,Italy - Serie D - Group F,0.12,0.62,-4,0.75,0.88,8.33,1.61,8
Fermana,8,1,3,4,7,10,-3,6,Italy - Serie D - Group F,0.12,0.5,-3,0.88,0.75,8.33,2.0,9
Castelfidardo,8,1,3,4,4,9,-5,6,Italy - Serie D - Group F,0.12,0.5,-5,0.5,0.75,8.33,2.0,9
Guidonia,8,7,1,0,23,6,17,22,Italy - Serie D - Group G,0.88,1.0,17,2.88,2.75,1.14,1.0,1
Savoia,8,6,2,0,13,2,11,20,Italy - Serie D - Group G,0.75,1.0,11,1.62,2.5,1.33,1.0,2
Sarnese,8,5,3,0,12,6,6,18,Italy - Serie D - Group G,0.62,1.0,6,1.5,2.25,1.61,1.0,3
Olbia,8,4,2,2,13,7,6,14,Italy - Serie D - Group G,0.5,0.75,6,1.62,1.75,2.0,1.33,4
Gelbison,8,4,2,2,14,9,5,14,Italy - Serie D - Group G,0.5,0.75,5,1.75,1.75,2.0,1.33,4
Ilvamaddalena,8,4,1,3,13,8,5,13,Italy - Serie D - Group G,0.5,0.62,5,1.62,1.62,2.0,1.61,5
Paganese,8,4,1,3,11,7,4,13,Italy - Serie D - Group G,0.5,0.62,4,1.38,1.62,2.0,1.61,5
CynthiAlbalonga,8,4,1,3,9,11,-2,13,Italy - Serie D - Group G,0.5,0.62,-2,1.12,1.62,2.0,1.61,5
A. Lodigiani,8,3,3,2,13,11,2,12,Italy - Serie D - Group G,0.38,0.75,2,1.62,1.5,2.63,1.33,6
S. Ogliastra,8,3,3,2,13,14,-1,12,Italy - Serie D - Group G,0.38,0.75,-1,1.62,1.5,2.63,1.33,6
R. Monterotondo,8,3,1,4,7,12,-5,10,Italy - Serie D - Group G,0.38,0.5,-5,0.88,1.25,2.63,2.0,7
Trastevere,8,2,2,4,12,15,-3,8,Italy - Serie D - Group G,0.25,0.5,-3,1.5,1.0,4.0,2.0,8
Latte Dolce,8,2,2,4,10,14,-4,8,Italy - Serie D - Group G,0.25,0.5,-4,1.25,1.0,4.0,2.0,8
Cassino,8,2,1,5,7,11,-4,7,Italy - Serie D - Group G,0.25,0.38,-4,0.88,0.88,4.0,2.63,9
Anzio,8,1,3,4,6,14,-8,6,Italy - Serie D - Group G,0.12,0.5,-8,0.75,0.75,8.33,2.0,10
Atletico Uri,8,1,1,6,6,10,-4,4,Italy - Serie D - Group G,0.12,0.25,-4,0.75,0.5,8.33,4.0,11
Puteolana,8,0,3,5,6,18,-12,3,Italy - Serie D - Group G,0.0,0.38,-12,0.75,0.38,0.0,2.63,12
Terracina,8,0,2,6,7,20,-13,2,Italy - Serie D - Group G,0.0,0.25,-13,0.88,0.25,0.0,4.0,13
Casarano,8,6,2,0,20,7,13,20,Italy - Serie D - Group H,0.75,1.0,13,2.5,2.5,1.33,1.0,1
Citta di Fasano,8,5,2,1,17,8,9,17,Italy - Serie D - Group H,0.62,0.88,9,2.12,2.12,1.61,1.14,2
Nocerina,8,5,2,1,14,6,8,17,Italy - Serie D - Group H,0.62,0.88,8,1.75,2.12,1.61,1.14,2
Manfredonia,8,4,3,1,12,7,5,15,Italy - Serie D - Group H,0.5,0.88,5,1.5,1.88,2.0,1.14,3
Brindisi,8,4,2,2,15,11,4,14,Italy - Serie D - Group H,0.5,0.75,4,1.88,1.75,2.0,1.33,4
Ugento,8,4,1,3,11,10,1,13,Italy - Serie D - Group H,0.5,0.62,1,1.38,1.62,2.0,1.61,5
Francavilla,8,4,0,4,9,10,-1,12,Italy - Serie D - Group H,0.5,0.5,-1,1.12,1.5,2.0,2.0,6
V. Francavilla,8,2,5,1,14,10,4,11,Italy - Serie D - Group H,0.25,0.88,4,1.75,1.38,4.0,1.14,7
Ischia,8,2,4,2,5,6,-1,10,Italy - Serie D - Group H,0.25,0.75,-1,0.62,1.25,4.0,1.33,8
Gravina,8,2,3,3,8,8,0,9,Italy - Serie D - Group H,0.25,0.62,0,1.0,1.12,4.0,1.61,9
USD Palmese,8,2,3,3,10,11,-1,9,Italy - Serie D - Group H,0.25,0.62,-1,1.25,1.12,4.0,1.61,9
Martina Franca,8,2,3,3,7,8,-1,9,Italy - Serie D - Group H,0.25,0.62,-1,0.88,1.12,4.0,1.61,9
Matera,8,2,3,3,11,16,-5,9,Italy - Serie D - Group H,0.25,0.62,-5,1.38,1.12,4.0,1.61,9
Nardo,8,2,2,4,9,12,-3,8,Italy - Serie D - Group H,0.25,0.5,-3,1.12,1.0,4.0,2.0,10
Fidelis Andria,8,1,3,4,6,12,-6,6,Italy - Serie D - Group H,0.12,0.5,-6,0.75,0.75,8.33,2.0,11
Real Acerrana,8,1,2,5,5,12,-7,5,Italy - Serie D - Group H,0.12,0.38,-7,0.62,0.62,8.33,2.63,12
Costa DAmalfi,8,1,2,5,5,13,-8,5,Italy - Serie D - Group H,0.12,0.38,-8,0.62,0.62,8.33,2.63,12
Angri Calcio,8,1,2,5,7,18,-11,5,Italy - Serie D - Group H,0.12,0.38,-11,0.88,0.62,8.33,2.63,12
Reggina,8,8,0,0,19,5,14,24,Italy - Serie D - Group I,1.0,1.0,14,2.38,3.0,1.0,1.0,1
Siracusa,8,7,0,1,23,5,18,21,Italy - Serie D - Group I,0.88,0.88,18,2.88,2.62,1.14,1.14,2
Pompei,8,5,1,2,9,7,2,16,Italy - Serie D - Group I,0.62,0.75,2,1.12,2.0,1.61,1.33,3
Scafatese,8,5,0,3,16,9,7,15,Italy - Serie D - Group I,0.62,0.62,7,2.0,1.88,1.61,1.61,4
Sancataldese,8,4,2,2,10,9,1,14,Italy - Serie D - Group I,0.5,0.75,1,1.25,1.75,2.0,1.33,5
Acireale,8,3,4,1,12,9,3,13,Italy - Serie D - Group I,0.38,0.88,3,1.5,1.62,2.63,1.14,6
Nissa,8,3,2,3,13,14,-1,11,Italy - Serie D - Group I,0.38,0.62,-1,1.62,1.38,2.63,1.61,7
Paterno,8,3,2,3,7,10,-3,11,Italy - Serie D - Group I,0.38,0.62,-3,0.88,1.38,2.63,1.61,7
Ragusa,8,3,1,4,10,9,1,10,Italy - Serie D - Group I,0.38,0.5,1,1.25,1.25,2.63,2.0,8
Sambiase,8,3,1,4,7,8,-1,10,Italy - Serie D - Group I,0.38,0.5,-1,0.88,1.25,2.63,2.0,8
CD S. Agata,8,2,3,3,13,13,0,9,Italy - Serie D - Group I,0.25,0.62,0,1.62,1.12,4.0,1.61,9
Enna,8,2,2,4,5,10,-5,8,Italy - Serie D - Group I,0.25,0.5,-5,0.62,1.0,4.0,2.0,10
Vibonese,8,2,1,5,8,12,-4,7,Italy - Serie D - Group I,0.25,0.38,-4,1.0,0.88,4.0,2.63,11
Licata,8,2,1,5,6,13,-7,7,Italy - Serie D - Group I,0.25,0.38,-7,0.75,0.88,4.0,2.63,11
Igea Virtus,8,2,1,5,5,12,-7,7,Italy - Serie D - Group I,0.25,0.38,-7,0.62,0.88,4.0,2.63,11
CastrumFavara,8,1,3,4,7,12,-5,6,Italy - Serie D - Group I,0.12,0.5,-5,0.88,0.75,8.33,2.0,12
Locri 1909,8,1,0,7,8,15,-7,3,Italy - Serie D - Group I,0.12,0.12,-7,1.0,0.38,8.33,8.33,13
Akragas,0,0,0,0,0,0,0,0,Italy - Serie D - Group I,0.0,0.0,0,0.0,0.0,0.0,0.0,14
Juventus U20,8,6,0,2,19,12,7,18,Italy - Primavera 1,0.75,0.75,7,2.38,2.25,1.33,1.33,1
Roma U20,8,6,0,2,17,12,5,18,Italy - Primavera 1,0.75,0.75,5,2.12,2.25,1.33,1.33,1
Inter Milan U20,8,5,2,1,12,4,8,17,Italy - Primavera 1,0.62,0.88,8,1.5,2.12,1.61,1.14,2
H. Verona U20,8,5,1,2,15,4,11,16,Italy - Primavera 1,0.62,0.75,11,1.88,2.0,1.61,1.33,3
Cagliari U20,8,4,3,1,11,7,4,15,Italy - Primavera 1,0.5,0.88,4,1.38,1.88,2.0,1.14,4
Cesena U20,8,4,2,2,16,13,3,14,Italy - Primavera 1,0.5,0.75,3,2.0,1.75,2.0,1.33,5
Lazio U20,8,4,2,2,12,10,2,14,Italy - Primavera 1,0.5,0.75,2,1.5,1.75,2.0,1.33,5
Sassuolo U20,8,4,2,2,10,9,1,14,Italy - Primavera 1,0.5,0.75,1,1.25,1.75,2.0,1.33,5
Genoa U20,8,4,0,4,14,11,3,12,Italy - Primavera 1,0.5,0.5,3,1.75,1.5,2.0,2.0,6
Bologna U20,8,3,2,3,9,9,0,11,Italy - Primavera 1,0.38,0.62,0,1.12,1.38,2.63,1.61,7
Lecce U20,8,3,2,3,10,12,-2,11,Italy - Primavera 1,0.38,0.62,-2,1.25,1.38,2.63,1.61,7
Atalanta U20,8,3,1,4,12,9,3,10,Italy - Primavera 1,0.38,0.5,3,1.5,1.25,2.63,2.0,8
Milan U20,8,2,3,3,9,13,-4,9,Italy - Primavera 1,0.25,0.62,-4,1.12,1.12,4.0,1.61,9
Torino U20,8,2,2,4,12,14,-2,8,Italy - Primavera 1,0.25,0.5,-2,1.5,1.0,4.0,2.0,10
Fiorentina U20,8,2,1,5,14,14,0,7,Italy - Primavera 1,0.25,0.38,0,1.75,0.88,4.0,2.63,11
Cremonese U20,8,1,4,3,10,11,-1,7,Italy - Primavera 1,0.12,0.62,-1,1.25,0.88,8.33,1.61,11
Empoli U20,8,1,3,4,7,13,-6,6,Italy - Primavera 1,0.12,0.5,-6,0.88,0.75,8.33,2.0,12
Sampdoria U20,8,1,3,4,8,15,-7,6,Italy - Primavera 1,0.12,0.5,-7,1.0,0.75,8.33,2.0,12
Monza U20,8,1,2,5,12,21,-9,5,Italy - Primavera 1,0.12,0.38,-9,1.5,0.62,8.33,2.63,13
Udinese U20,8,1,1,6,5,21,-16,4,Italy - Primavera 1,0.12,0.25,-16,0.62,0.5,8.33,4.0,14
Mount Pleasant,8,6,1,1,14,2,12,19,Jamaica - Premier League,0.75,0.88,12,1.75,2.38,1.33,1.14,1
Tivoli Gardens,8,5,3,0,14,6,8,18,Jamaica - Premier League,0.62,1.0,8,1.75,2.25,1.61,1.0,2
Montego Bay,8,4,4,0,17,4,13,16,Jamaica - Premier League,0.5,1.0,13,2.12,2.0,2.0,1.0,3
Portmore Utd,8,5,1,2,7,3,4,16,Jamaica - Premier League,0.62,0.75,4,0.88,2.0,1.61,1.33,3
Waterhouse,8,4,2,2,11,9,2,14,Jamaica - Premier League,0.5,0.75,2,1.38,1.75,2.0,1.33,4
Cavalier,8,3,4,1,12,10,2,13,Jamaica - Premier League,0.38,0.88,2,1.5,1.62,2.63,1.14,5
Racing United,8,3,2,3,11,8,3,11,Jamaica - Premier League,0.38,0.62,3,1.38,1.38,2.63,1.61,6
Humble Lions,8,3,2,3,9,7,2,11,Jamaica - Premier League,0.38,0.62,2,1.12,1.38,2.63,1.61,6
Chapelton,8,3,2,3,6,11,-5,11,Jamaica - Premier League,0.38,0.62,-5,0.75,1.38,2.63,1.61,6
Arnett Gardens,8,2,4,2,16,12,4,10,Jamaica - Premier League,0.25,0.75,4,2.0,1.25,4.0,1.33,7
Harbour View,8,2,2,4,6,11,-5,8,Jamaica - Premier League,0.25,0.5,-5,0.75,1.0,4.0,2.0,8
Molynes Utd,8,1,2,5,4,16,-12,5,Jamaica - Premier League,0.12,0.38,-12,0.5,0.62,8.33,2.63,9
Vere Utd,8,0,1,7,4,15,-11,1,Jamaica - Premier League,0.0,0.12,-11,0.5,0.12,0.0,8.33,10
Dunbeholden,8,0,1,7,3,17,-14,1,Jamaica - Premier League,0.0,0.12,-14,0.38,0.12,0.0,8.33,10
Avispa Fukuoka,8,6,1,1,10,5,5,19,Japan - J1 League,0.75,0.88,5,1.25,2.38,1.33,1.14,1
Kyoto Sanga,8,5,1,2,12,8,4,16,Japan - J1 League,0.62,0.75,4,1.5,2.0,1.61,1.33,2
Fagiano Okayama,8,4,2,2,7,4,3,14,Japan - J1 League,0.5,0.75,3,0.88,1.75,2.0,1.33,3
Machida Zelvia,8,4,2,2,10,8,2,14,Japan - J1 League,0.5,0.75,2,1.25,1.75,2.0,1.33,3
Urawa RD,8,4,2,2,9,7,2,14,Japan - J1 League,0.5,0.75,2,1.12,1.75,2.0,1.33,3
S. Hiroshima,8,4,2,2,7,5,2,14,Japan - J1 League,0.5,0.75,2,0.88,1.75,2.0,1.33,3
Kashima Antlers,8,4,1,3,12,9,3,13,Japan - J1 League,0.5,0.62,3,1.5,1.62,2.0,1.61,4
Kashiwa Reysol,8,3,4,1,9,7,2,13,Japan - J1 League,0.38,0.88,2,1.12,1.62,2.63,1.14,4
Vissel Kobe,8,4,1,3,7,6,1,13,Japan - J1 League,0.5,0.62,1,0.88,1.62,2.0,1.61,4
K. Frontale,8,2,4,2,12,9,3,10,Japan - J1 League,0.25,0.75,3,1.5,1.25,4.0,1.33,5
Tokyo Verdy,8,2,4,2,7,7,0,10,Japan - J1 League,0.25,0.75,0,0.88,1.25,4.0,1.33,5
Gamba Osaka,8,3,1,4,7,9,-2,10,Japan - J1 League,0.38,0.5,-2,0.88,1.25,2.63,2.0,5
Cerezo Osaka,8,2,3,3,9,11,-2,9,Japan - J1 League,0.25,0.62,-2,1.12,1.12,4.0,1.61,6
Shimizu S-Pulse,8,2,2,4,10,11,-1,8,Japan - J1 League,0.25,0.5,-1,1.25,1.0,4.0,2.0,7
Yokohama FC,8,2,2,4,5,6,-1,8,Japan - J1 League,0.25,0.5,-1,0.62,1.0,4.0,2.0,7
Shonan Bellmare,8,2,2,4,6,12,-6,8,Japan - J1 League,0.25,0.5,-6,0.75,1.0,4.0,2.0,7
Albirex Niigata,8,1,4,3,9,11,-2,7,Japan - J1 League,0.12,0.62,-2,1.12,0.88,8.33,1.61,8
Nagoya G.,8,2,1,5,9,13,-4,7,Japan - J1 League,0.25,0.38,-4,1.12,0.88,4.0,2.63,8
Yokohama M.,8,1,3,4,9,12,-3,6,Japan - J1 League,0.12,0.5,-3,1.12,0.75,8.33,2.0,9
FC Tokyo,8,1,3,4,6,11,-5,6,Japan - J1 League,0.12,0.5,-5,0.75,0.75,8.33,2.0,9
JEF Utd Chiba,8,7,0,1,20,9,11,21,Japan - J2 League,0.88,0.88,11,2.5,2.62,1.14,1.14,1
FC Imabari,8,4,4,0,14,6,8,16,Japan - J2 League,0.5,1.0,8,1.75,2.0,2.0,1.0,2
Omiya Ardija,8,5,1,2,13,6,7,16,Japan - J2 League,0.62,0.75,7,1.62,2.0,1.61,1.33,2
Jubilo Iwata,8,4,2,2,9,8,1,14,Japan - J2 League,0.5,0.75,1,1.12,1.75,2.0,1.33,3
Sagan Tosu,8,4,1,3,8,9,-1,13,Japan - J2 League,0.5,0.62,-1,1.0,1.62,2.0,1.61,4
M. Yamagata,8,3,3,2,12,9,3,12,Japan - J2 League,0.38,0.75,3,1.5,1.5,2.63,1.33,5
Mito Hollyhock,8,3,3,2,12,9,3,12,Japan - J2 League,0.38,0.75,3,1.5,1.5,2.63,1.33,5
Fujieda MYFC,8,3,3,2,13,11,2,12,Japan - J2 League,0.38,0.75,2,1.62,1.5,2.63,1.33,5
Vegalta Sendai,8,3,3,2,9,7,2,12,Japan - J2 League,0.38,0.75,2,1.12,1.5,2.63,1.33,5
R. Kumamoto,8,3,3,2,9,9,0,12,Japan - J2 League,0.38,0.75,0,1.12,1.5,2.63,1.33,5
V-V. Nagasaki,8,3,2,3,13,13,0,11,Japan - J2 League,0.38,0.62,0,1.62,1.38,2.63,1.61,6
Tokushima V.,8,2,4,2,4,4,0,10,Japan - J2 League,0.25,0.75,0,0.5,1.25,4.0,1.33,7
Kataller Toyama,8,2,3,3,7,7,0,9,Japan - J2 League,0.25,0.62,0,0.88,1.12,4.0,1.61,8
Oita Trinita,8,1,6,1,6,7,-1,9,Japan - J2 League,0.12,0.88,-1,0.75,1.12,8.33,1.14,8
C. Sapporo,8,3,0,5,8,14,-6,9,Japan - J2 League,0.38,0.38,-6,1.0,1.12,2.63,2.63,8
Ventforet Kofu,8,2,2,4,7,10,-3,8,Japan - J2 League,0.25,0.5,-3,0.88,1.0,4.0,2.0,9
R. Yamaguchi,8,1,4,3,9,10,-1,7,Japan - J2 League,0.12,0.62,-1,1.12,0.88,8.33,1.61,10
Blaublitz Akita,8,2,0,6,9,18,-9,6,Japan - J2 League,0.25,0.25,-9,1.12,0.75,4.0,4.0,11
Ehime FC,8,0,3,5,7,15,-8,3,Japan - J2 League,0.0,0.38,-8,0.88,0.38,0.0,2.63,12
Iwaki,8,0,3,5,3,11,-8,3,Japan - J2 League,0.0,0.38,-8,0.38,0.38,0.0,2.63,12
Osaka,8,6,0,2,9,4,5,18,Japan - J3 League,0.75,0.75,5,1.12,2.25,1.33,1.33,1
Kagoshima Utd,8,4,3,1,16,9,7,15,Japan - J3 League,0.5,0.88,7,2.0,1.88,2.0,1.14,2
Tochigi City,8,4,3,1,14,8,6,15,Japan - J3 League,0.5,0.88,6,1.75,1.88,2.0,1.14,2
G. Kitakyushu,8,5,0,3,9,4,5,15,Japan - J3 League,0.62,0.62,5,1.12,1.88,1.61,1.61,2
T. Miyazaki,8,4,3,1,11,7,4,15,Japan - J3 League,0.5,0.88,4,1.38,1.88,2.0,1.14,2
Z. Kanazawa,8,4,2,2,12,9,3,14,Japan - J3 League,0.5,0.75,3,1.5,1.75,2.0,1.33,3
Fukushima Utd,8,4,2,2,14,12,2,14,Japan - J3 League,0.5,0.75,2,1.75,1.75,2.0,1.33,3
Nara Club,8,3,3,2,11,10,1,12,Japan - J3 League,0.38,0.75,1,1.38,1.5,2.63,1.33,4
V. Hachinohe,8,3,2,3,8,8,0,11,Japan - J3 League,0.38,0.62,0,1.0,1.38,2.63,1.61,5
Nagano Parceiro,8,3,1,4,10,13,-3,10,Japan - J3 League,0.38,0.5,-3,1.25,1.25,2.63,2.0,6
Kochi United,8,2,3,3,13,14,-1,9,Japan - J3 League,0.25,0.62,-1,1.62,1.12,4.0,1.61,7
Matsumoto Y.,7,2,3,2,7,9,-2,9,Japan - J3 League,0.29,0.71,-2,1.0,1.29,3.45,1.41,7
Kamatamare S.,8,2,3,3,6,8,-2,9,Japan - J3 League,0.25,0.62,-2,0.75,1.12,4.0,1.61,7
SC Sagamihara,8,2,3,3,6,10,-4,9,Japan - J3 League,0.25,0.62,-4,0.75,1.12,4.0,1.61,7
AC Numazu,8,1,5,2,7,7,0,8,Japan - J3 League,0.12,0.75,0,0.88,1.0,8.33,1.33,8
FC Ryukyu,8,2,2,4,7,8,-1,8,Japan - J3 League,0.25,0.5,-1,0.88,1.0,4.0,2.0,8
Tochigi SC,8,2,2,4,5,7,-2,8,Japan - J3 League,0.25,0.5,-2,0.62,1.0,4.0,2.0,8
Kusatsu,8,2,2,4,10,14,-4,8,Japan - J3 League,0.25,0.5,-4,1.25,1.0,4.0,2.0,8
Gainare Tottori,8,1,3,4,6,10,-4,6,Japan - J3 League,0.12,0.5,-4,0.75,0.75,8.33,2.0,9
Gifu,8,1,2,5,8,14,-6,5,Japan - J3 League,0.12,0.38,-6,1.0,0.62,8.33,2.63,10
Al Wihdat,8,6,1,1,17,4,13,19,Jordan - Premier League,0.75,0.88,13,2.12,2.38,1.33,1.14,1
Al Hussein,8,5,3,0,23,6,17,18,Jordan - Premier League,0.62,1.0,17,2.88,2.25,1.61,1.0,2
Al Jazeera,8,5,1,2,12,6,6,16,Jordan - Premier League,0.62,0.75,6,1.5,2.0,1.61,1.33,3
Al Faysali,8,4,4,0,10,5,5,16,Jordan - Premier League,0.5,1.0,5,1.25,2.0,2.0,1.0,3
Al Salt,8,4,2,2,12,6,6,14,Jordan - Premier League,0.5,0.75,6,1.5,1.75,2.0,1.33,4
Aqaba,8,4,2,2,9,10,-1,14,Jordan - Premier League,0.5,0.75,-1,1.12,1.75,2.0,1.33,4
Al Ramtha,8,3,2,3,7,10,-3,11,Jordan - Premier League,0.38,0.62,-3,0.88,1.38,2.63,1.61,5
Al Sareeh,8,3,0,5,8,13,-5,9,Jordan - Premier League,0.38,0.38,-5,1.0,1.12,2.63,2.63,6
Shabab Al Ordon,8,2,2,4,11,10,1,8,Jordan - Premier League,0.25,0.5,1,1.38,1.0,4.0,2.0,7
Maan,8,2,1,5,8,16,-8,7,Jordan - Premier League,0.25,0.38,-8,1.0,0.88,4.0,2.63,8
Al Ahli,8,0,2,6,1,14,-13,2,Jordan - Premier League,0.0,0.25,-13,0.12,0.25,0.0,4.0,9
Moghayer Al S.,8,0,1,7,3,17,-14,1,Jordan - Premier League,0.0,0.12,-14,0.38,0.12,0.0,8.33,10
Kairat Almaty,5,4,1,0,15,3,12,13,Kazakhstan - Premier League,0.8,1.0,12,3.0,2.6,1.25,1.0,1
Aktobe,4,3,1,0,10,2,8,10,Kazakhstan - Premier League,0.75,1.0,8,2.5,2.5,1.33,1.0,2
FC Astana,4,3,1,0,8,2,6,10,Kazakhstan - Premier League,0.75,1.0,6,2.0,2.5,1.33,1.0,2
Tobol,4,2,2,0,4,1,3,8,Kazakhstan - Premier League,0.5,1.0,3,1.0,2.0,2.0,1.0,3
Yelimay Semey,4,2,1,1,7,3,4,7,Kazakhstan - Premier League,0.5,0.75,4,1.75,1.75,2.0,1.33,4
Turan,4,2,0,2,7,6,1,6,Kazakhstan - Premier League,0.5,0.5,1,1.75,1.5,2.0,2.0,5
Zhenys,4,0,4,0,1,1,0,4,Kazakhstan - Premier League,0.0,1.0,0,0.25,1.0,0.0,1.0,6
Okzhetpes,4,1,1,2,4,6,-2,4,Kazakhstan - Premier League,0.25,0.5,-2,1.0,1.0,4.0,2.0,6
Zhetysu,4,0,3,1,1,4,-3,3,Kazakhstan - Premier League,0.0,0.75,-3,0.25,0.75,0.0,1.33,7
Atyrau,5,1,0,4,4,15,-11,3,Kazakhstan - Premier League,0.2,0.2,-11,0.8,0.6,5.0,5.0,7
Kyzylzhar,4,0,2,2,3,6,-3,2,Kazakhstan - Premier League,0.0,0.5,-3,0.75,0.5,0.0,2.0,8
Kaisar K.,4,0,2,2,3,8,-5,2,Kazakhstan - Premier League,0.0,0.5,-5,0.75,0.5,0.0,2.0,8
Ordabasy,4,0,2,2,1,6,-5,2,Kazakhstan - Premier League,0.0,0.5,-5,0.25,0.5,0.0,2.0,8
Ulytau,4,0,2,2,1,6,-5,2,Kazakhstan - Premier League,0.0,0.5,-5,0.25,0.5,0.0,2.0,8
Drita,8,5,2,1,14,6,8,17,Kosovo - Superliga,0.62,0.88,8,1.75,2.12,1.61,1.14,1
Ferizaj,8,5,0,3,14,11,3,15,Kosovo - Superliga,0.62,0.62,3,1.75,1.88,1.61,1.61,2
Gjilani,8,4,2,2,9,10,-1,14,Kosovo - Superliga,0.5,0.75,-1,1.12,1.75,2.0,1.33,3
Ballkani,8,4,1,3,11,9,2,13,Kosovo - Superliga,0.5,0.62,2,1.38,1.62,2.0,1.61,4
Llapi,8,3,3,2,7,3,4,12,Kosovo - Superliga,0.38,0.75,4,0.88,1.5,2.63,1.33,5
Malisheva,8,3,3,2,10,7,3,12,Kosovo - Superliga,0.38,0.75,3,1.25,1.5,2.63,1.33,5
Dukagjini,8,3,3,2,5,4,1,12,Kosovo - Superliga,0.38,0.75,1,0.62,1.5,2.63,1.33,5
Prishtina,8,0,6,2,7,9,-2,6,Kosovo - Superliga,0.0,0.75,-2,0.88,0.75,0.0,1.33,6
Suhareka,8,1,1,6,7,16,-9,4,Kosovo - Superliga,0.12,0.25,-9,0.88,0.5,8.33,4.0,7
Feronikeli,8,1,1,6,4,13,-9,4,Kosovo - Superliga,0.12,0.25,-9,0.5,0.5,8.33,4.0,7
Al Kuwait,8,6,2,0,24,4,20,20,Kuwait - Premier League,0.75,1.0,20,3.0,2.5,1.33,1.0,1
Al Arabi SC,8,4,4,0,12,6,6,16,Kuwait - Premier League,0.5,1.0,6,1.5,2.0,2.0,1.0,2
Al Qadsia,8,5,0,3,16,15,1,15,Kuwait - Premier League,0.62,0.62,1,2.0,1.88,1.61,1.61,3
Al Fahaheel,8,3,3,2,14,11,3,12,Kuwait - Premier League,0.38,0.75,3,1.75,1.5,2.63,1.33,4
Al Salmiyah,8,3,3,2,13,11,2,12,Kuwait - Premier League,0.38,0.75,2,1.62,1.5,2.63,1.33,4
Kazma,8,2,3,3,12,10,2,9,Kuwait - Premier League,0.25,0.62,2,1.5,1.12,4.0,1.61,5
Al Nasar,8,2,2,4,11,15,-4,8,Kuwait - Premier League,0.25,0.5,-4,1.38,1.0,4.0,2.0,6
Khaitan,8,1,3,4,5,8,-3,6,Kuwait - Premier League,0.12,0.5,-3,0.62,0.75,8.33,2.0,7
Al Tadhamon,8,2,0,6,5,18,-13,6,Kuwait - Premier League,0.25,0.25,-13,0.62,0.75,4.0,4.0,7
Yarmouk,8,0,3,5,4,20,-16,3,Kuwait - Premier League,0.0,0.38,-16,0.5,0.38,0.0,2.63,8
RFS,7,6,0,1,15,5,10,18,Latvia - Virsliga,0.86,0.86,10,2.14,2.57,1.16,1.16,1
Auda,7,4,1,2,11,6,5,13,Latvia - Virsliga,0.57,0.71,5,1.57,1.86,1.75,1.41,2
Riga FC,7,3,3,1,15,8,7,12,Latvia - Virsliga,0.43,0.86,7,2.14,1.71,2.33,1.16,3
Daugavpils,7,3,1,3,12,12,0,10,Latvia - Virsliga,0.43,0.57,0,1.71,1.43,2.33,1.75,4
Liepaja,7,3,1,3,12,13,-1,10,Latvia - Virsliga,0.43,0.57,-1,1.71,1.43,2.33,1.75,4
Metta,7,3,1,3,9,14,-5,10,Latvia - Virsliga,0.43,0.57,-5,1.29,1.43,2.33,1.75,4
FS Jelgava,7,2,2,3,8,8,0,8,Latvia - Virsliga,0.29,0.57,0,1.14,1.14,3.45,1.75,5
Super Nova,7,1,3,3,9,9,0,6,Latvia - Virsliga,0.14,0.57,0,1.29,0.86,7.14,1.75,6
Tukums,7,1,2,4,6,13,-7,5,Latvia - Virsliga,0.14,0.43,-7,0.86,0.71,7.14,2.33,7
Grobina,7,1,2,4,9,18,-9,5,Latvia - Virsliga,0.14,0.43,-9,1.29,0.71,7.14,2.33,7
Hegelmann L.,7,5,0,2,11,9,2,15,Lithuania - A Lyga,0.71,0.71,2,1.57,2.14,1.41,1.41,1
Suduva,7,4,1,2,7,8,-1,13,Lithuania - A Lyga,0.57,0.71,-1,1.0,1.86,1.75,1.41,2
Kauno Zalgiris,7,3,3,1,10,6,4,12,Lithuania - A Lyga,0.43,0.86,4,1.43,1.71,2.33,1.16,3
Zalgiris,7,3,3,1,10,7,3,12,Lithuania - A Lyga,0.43,0.86,3,1.43,1.71,2.33,1.16,3
Dziugas Telsiai,7,4,0,3,7,6,1,12,Lithuania - A Lyga,0.57,0.57,1,1.0,1.71,1.75,1.75,3
Siauliai,7,3,2,2,13,10,3,11,Lithuania - A Lyga,0.43,0.71,3,1.86,1.57,2.33,1.41,4
Riteriai,7,2,3,2,15,13,2,9,Lithuania - A Lyga,0.29,0.71,2,2.14,1.29,3.45,1.41,5
Panevezys,7,2,1,4,9,11,-2,7,Lithuania - A Lyga,0.29,0.43,-2,1.29,1.0,3.45,2.33,6
Banga,7,1,2,4,6,9,-3,5,Lithuania - A Lyga,0.14,0.43,-3,0.86,0.71,7.14,2.33,7
Dainava,7,0,1,6,6,15,-9,1,Lithuania - A Lyga,0.0,0.14,-9,0.86,0.14,0.0,7.14,8
TransINVEST,4,4,0,0,14,2,12,12,Lithuania - 1st League,1.0,1.0,12,3.5,3.0,1.0,1.0,1
BFA Vilnius,4,4,0,0,7,1,6,12,Lithuania - 1st League,1.0,1.0,6,1.75,3.0,1.0,1.0,1
Tauras,4,3,1,0,11,0,11,10,Lithuania - 1st League,0.75,1.0,11,2.75,2.5,1.33,1.0,2
Neptuna K.,4,3,0,1,11,4,7,9,Lithuania - 1st League,0.75,0.75,7,2.75,2.25,1.33,1.33,3
Atmosfera,4,2,1,1,5,6,-1,7,Lithuania - 1st League,0.5,0.75,-1,1.25,1.75,2.0,1.33,4
Babrungas,4,2,1,1,7,9,-2,7,Lithuania - 1st League,0.5,0.75,-2,1.75,1.75,2.0,1.33,4
Kauno Z. B,4,2,0,2,2,3,-1,6,Lithuania - 1st League,0.5,0.5,-1,0.5,1.5,2.0,2.0,5
Panevezys B,4,2,0,2,6,10,-4,6,Lithuania - 1st League,0.5,0.5,-4,1.5,1.5,2.0,2.0,5
Hegelmann B,4,1,2,1,5,5,0,5,Lithuania - 1st League,0.25,0.75,0,1.25,1.25,4.0,1.33,6
Nevezis,4,1,1,2,7,7,0,4,Lithuania - 1st League,0.25,0.5,0,1.75,1.0,4.0,2.0,7
Siauliai B,4,1,1,2,6,9,-3,4,Lithuania - 1st League,0.25,0.5,-3,1.5,1.0,4.0,2.0,7
Minija,4,1,0,3,2,9,-7,3,Lithuania - 1st League,0.25,0.25,-7,0.5,0.75,4.0,4.0,8
Zalgiris B,4,0,2,2,3,7,-4,2,Lithuania - 1st League,0.0,0.5,-4,0.75,0.5,0.0,2.0,9
Be1 NFA,4,0,2,2,2,7,-5,2,Lithuania - 1st League,0.0,0.5,-5,0.5,0.5,0.0,2.0,9
Jonava,4,0,1,3,0,3,-3,1,Lithuania - 1st League,0.0,0.25,-3,0.0,0.25,0.0,4.0,10
Ekranas,4,0,0,4,1,7,-6,0,Lithuania - 1st League,0.0,0.0,-6,0.25,0.0,0.0,0.0,11
Differdange,8,8,0,0,17,0,17,24,Luxembourg - National Division,1.0,1.0,17,2.12,3.0,1.0,1.0,1
Hostert,8,5,2,1,16,10,6,17,Luxembourg - National Division,0.62,0.88,6,2.0,2.12,1.61,1.14,2
Niedercorn,8,5,2,1,11,5,6,17,Luxembourg - National Division,0.62,0.88,6,1.38,2.12,1.61,1.14,2
UNA Strassen,8,5,1,2,17,7,10,16,Luxembourg - National Division,0.62,0.75,10,2.12,2.0,1.61,1.33,3
Dudelange,8,4,2,2,14,8,6,14,Luxembourg - National Division,0.5,0.75,6,1.75,1.75,2.0,1.33,4
Petange,8,4,2,2,10,7,3,14,Luxembourg - National Division,0.5,0.75,3,1.25,1.75,2.0,1.33,4
Hesperange,8,3,3,2,11,10,1,12,Luxembourg - National Division,0.38,0.75,1,1.38,1.5,2.63,1.33,5
Rodange,8,3,2,3,12,11,1,11,Luxembourg - National Division,0.38,0.62,1,1.5,1.38,2.63,1.61,6
V. Rosport,8,2,5,1,9,8,1,11,Luxembourg - National Division,0.25,0.88,1,1.12,1.38,4.0,1.14,6
Racing,8,3,1,4,9,8,1,10,Luxembourg - National Division,0.38,0.5,1,1.12,1.25,2.63,2.0,7
Mondorf,8,3,1,4,10,12,-2,10,Luxembourg - National Division,0.38,0.5,-2,1.25,1.25,2.63,2.0,7
Jeunesse Esch,8,1,3,4,9,13,-4,6,Luxembourg - National Division,0.12,0.5,-4,1.12,0.75,8.33,2.0,8
Bettembourg,8,2,0,6,8,15,-7,6,Luxembourg - National Division,0.25,0.25,-7,1.0,0.75,4.0,4.0,8
Wiltz,8,2,0,6,9,18,-9,6,Luxembourg - National Division,0.25,0.25,-9,1.12,0.75,4.0,4.0,8
Mondercange,8,1,2,5,5,15,-10,5,Luxembourg - National Division,0.12,0.38,-10,0.62,0.62,8.33,2.63,9
Fola Esch,8,0,0,8,3,23,-20,0,Luxembourg - National Division,0.0,0.0,-20,0.38,0.0,0.0,0.0,10
Johor Darul,8,8,0,0,31,1,30,24,Malaysia - Super League,1.0,1.0,30,3.88,3.0,1.0,1.0,1
Selangor,8,5,2,1,15,4,11,17,Malaysia - Super League,0.62,0.88,11,1.88,2.12,1.61,1.14,2
Kuching,8,4,3,1,14,7,7,15,Malaysia - Super League,0.5,0.88,7,1.75,1.88,2.0,1.14,3
Pulau Pinang,8,3,3,2,14,10,4,12,Malaysia - Super League,0.38,0.75,4,1.75,1.5,2.63,1.33,4
Pahang,8,3,2,3,14,13,1,11,Malaysia - Super League,0.38,0.62,1,1.75,1.38,2.63,1.61,5
Kuala Lumpur,8,3,2,3,10,10,0,11,Malaysia - Super League,0.38,0.62,0,1.25,1.38,2.63,1.61,5
Sabah,8,2,5,1,9,11,-2,11,Malaysia - Super League,0.25,0.88,-2,1.12,1.38,4.0,1.14,5
Negeri Sembilan,8,3,1,4,8,10,-2,10,Malaysia - Super League,0.38,0.5,-2,1.0,1.25,2.63,2.0,6
Perak,8,2,3,3,14,10,4,9,Malaysia - Super League,0.25,0.62,4,1.75,1.12,4.0,1.61,7
PDRM,8,3,0,5,10,13,-3,9,Malaysia - Super League,0.38,0.38,-3,1.25,1.12,2.63,2.63,7
Terengganu,8,2,2,4,12,10,2,8,Malaysia - Super League,0.25,0.5,2,1.5,1.0,4.0,2.0,8
Kedah,8,2,1,5,6,21,-15,7,Malaysia - Super League,0.25,0.38,-15,0.75,0.88,4.0,2.63,9
Kelantan United,8,0,0,8,2,40,-38,0,Malaysia - Super League,0.0,0.0,-38,0.25,0.0,0.0,0.0,10
Mosta,8,5,1,2,11,9,2,16,Malta - Premier League,0.62,0.75,2,1.38,2.0,1.61,1.33,1
Floriana,8,4,3,1,11,7,4,15,Malta - Premier League,0.5,0.88,4,1.38,1.88,2.0,1.14,2
Birkirkara,8,4,2,2,12,5,7,14,Malta - Premier League,0.5,0.75,7,1.5,1.75,2.0,1.33,3
Hibernians,8,4,2,2,13,12,1,14,Malta - Premier League,0.5,0.75,1,1.62,1.75,2.0,1.33,3
Marsaxlokk,8,4,1,3,13,6,7,13,Malta - Premier League,0.5,0.62,7,1.62,1.62,2.0,1.61,4
Sliema,8,4,0,4,13,12,1,12,Malta - Premier League,0.5,0.5,1,1.62,1.5,2.0,2.0,5
Hamrun Spartans,8,3,1,4,7,6,1,10,Malta - Premier League,0.38,0.5,1,0.88,1.25,2.63,2.0,6
Naxxar Lions,8,3,1,4,11,15,-4,10,Malta - Premier League,0.38,0.5,-4,1.38,1.25,2.63,2.0,6
Zabbar,8,2,2,4,10,9,1,8,Malta - Premier League,0.25,0.5,1,1.25,1.0,4.0,2.0,7
Gzira Utd,8,2,2,4,5,13,-8,8,Malta - Premier League,0.25,0.5,-8,0.62,1.0,4.0,2.0,7
Balzan,8,1,4,3,6,8,-2,7,Malta - Premier League,0.12,0.62,-2,0.75,0.88,8.33,1.61,8
Melita,8,1,3,4,10,20,-10,6,Malta - Premier League,0.12,0.5,-10,1.25,0.75,8.33,2.0,9
Cruz Azul,8,6,2,0,20,6,14,20,Mexico - Liga MX - Apertura,0.75,1.0,14,2.5,2.5,1.33,1.0,1
Toluca,8,5,2,1,21,7,14,17,Mexico - Liga MX - Apertura,0.62,0.88,14,2.62,2.12,1.61,1.14,2
A. San Luis,8,5,1,2,12,8,4,16,Mexico - Liga MX - Apertura,0.62,0.75,4,1.5,2.0,1.61,1.33,3
Pumas UNAM,8,4,3,1,8,3,5,15,Mexico - Liga MX - Apertura,0.5,0.88,5,1.0,1.88,2.0,1.14,4
Tijuana,8,4,3,1,10,9,1,15,Mexico - Liga MX - Apertura,0.5,0.88,1,1.25,1.88,2.0,1.14,4
CF America,8,4,2,2,15,10,5,14,Mexico - Liga MX - Apertura,0.5,0.75,5,1.88,1.75,2.0,1.33,5
Tigres,8,4,2,2,13,11,2,14,Mexico - Liga MX - Apertura,0.5,0.75,2,1.62,1.75,2.0,1.33,5
Juarez,8,4,1,3,13,15,-2,13,Mexico - Liga MX - Apertura,0.5,0.62,-2,1.62,1.62,2.0,1.61,6
Monterrey,8,3,3,2,12,7,5,12,Mexico - Liga MX - Apertura,0.38,0.75,5,1.5,1.5,2.63,1.33,7
Club Leon,8,2,5,1,13,9,4,11,Mexico - Liga MX - Apertura,0.25,0.88,4,1.62,1.38,4.0,1.14,8
Guadalajara,8,3,2,3,10,8,2,11,Mexico - Liga MX - Apertura,0.38,0.62,2,1.25,1.38,2.63,1.61,8
Queretaro,8,2,2,4,7,13,-6,8,Mexico - Liga MX - Apertura,0.25,0.5,-6,0.88,1.0,4.0,2.0,9
Atlas,8,1,5,2,6,12,-6,8,Mexico - Liga MX - Apertura,0.12,0.75,-6,0.75,1.0,8.33,1.33,9
Mazatlan,8,1,4,3,4,9,-5,7,Mexico - Liga MX - Apertura,0.12,0.62,-5,0.5,0.88,8.33,1.61,10
Pachuca,8,1,1,6,12,16,-4,4,Mexico - Liga MX - Apertura,0.12,0.25,-4,1.5,0.5,8.33,4.0,11
Necaxa,8,0,3,5,7,18,-11,3,Mexico - Liga MX - Apertura,0.0,0.38,-11,0.88,0.38,0.0,2.63,12
Puebla,8,1,0,7,7,18,-11,3,Mexico - Liga MX - Apertura,0.12,0.12,-11,0.88,0.38,8.33,8.33,12
Santos Laguna,8,0,2,6,4,16,-12,2,Mexico - Liga MX - Apertura,0.0,0.25,-12,0.5,0.25,0.0,4.0,13
Toluca,8,7,0,1,22,10,12,21,Mexico - Liga MX - Clausura,0.88,0.88,12,2.75,2.62,1.14,1.14,1
Cruz Azul,8,5,3,0,12,5,7,18,Mexico - Liga MX - Clausura,0.62,1.0,7,1.5,2.25,1.61,1.0,2
Pachuca,8,4,3,1,17,11,6,15,Mexico - Liga MX - Clausura,0.5,0.88,6,2.12,1.88,2.0,1.14,3
CF America,8,4,2,2,11,3,8,14,Mexico - Liga MX - Clausura,0.5,0.75,8,1.38,1.75,2.0,1.33,4
Tigres,8,4,2,2,8,6,2,14,Mexico - Liga MX - Clausura,0.5,0.75,2,1.0,1.75,2.0,1.33,4
Monterrey,8,4,1,3,14,10,4,13,Mexico - Liga MX - Clausura,0.5,0.62,4,1.75,1.62,2.0,1.61,5
Necaxa,8,4,1,3,17,17,0,13,Mexico - Liga MX - Clausura,0.5,0.62,0,2.12,1.62,2.0,1.61,5
Tijuana,8,4,0,4,16,16,0,12,Mexico - Liga MX - Clausura,0.5,0.5,0,2.0,1.5,2.0,2.0,6
A. San Luis,8,4,0,4,11,13,-2,12,Mexico - Liga MX - Clausura,0.5,0.5,-2,1.38,1.5,2.0,2.0,6
Juarez,8,2,5,1,9,7,2,11,Mexico - Liga MX - Clausura,0.25,0.88,2,1.12,1.38,4.0,1.14,7
Pumas UNAM,8,3,1,4,12,13,-1,10,Mexico - Liga MX - Clausura,0.38,0.5,-1,1.5,1.25,2.63,2.0,8
Club Leon,8,3,1,4,9,10,-1,10,Mexico - Liga MX - Clausura,0.38,0.5,-1,1.12,1.25,2.63,2.0,8
Atlas,8,3,1,4,15,17,-2,10,Mexico - Liga MX - Clausura,0.38,0.5,-2,1.88,1.25,2.63,2.0,8
Queretaro,8,3,1,4,7,12,-5,10,Mexico - Liga MX - Clausura,0.38,0.5,-5,0.88,1.25,2.63,2.0,8
Mazatlan,8,2,3,3,8,10,-2,9,Mexico - Liga MX - Clausura,0.25,0.62,-2,1.0,1.12,4.0,1.61,9
Guadalajara,8,2,3,3,6,9,-3,9,Mexico - Liga MX - Clausura,0.25,0.62,-3,0.75,1.12,4.0,1.61,9
Santos Laguna,8,2,0,6,10,17,-7,6,Mexico - Liga MX - Clausura,0.25,0.25,-7,1.25,0.75,4.0,4.0,10
Puebla,8,0,1,7,2,14,-12,1,Mexico - Liga MX - Clausura,0.0,0.12,-12,0.25,0.12,0.0,8.33,11
Buducnost,8,5,3,0,25,13,12,18,Montenegro - First League,0.62,1.0,12,3.12,2.25,1.61,1.0,1
Sutjeska,8,5,1,2,12,8,4,16,Montenegro - First League,0.62,0.75,4,1.5,2.0,1.61,1.33,2
Petrovac,8,3,4,1,13,8,5,13,Montenegro - First League,0.38,0.88,5,1.62,1.62,2.63,1.14,3
Jezero,8,4,1,3,13,11,2,13,Montenegro - First League,0.5,0.62,2,1.62,1.62,2.0,1.61,3
Arsenal Tivat,8,4,0,4,6,8,-2,12,Montenegro - First League,0.5,0.5,-2,0.75,1.5,2.0,2.0,4
Jedinstvo,8,2,3,3,10,12,-2,9,Montenegro - First League,0.25,0.62,-2,1.25,1.12,4.0,1.61,5
Otrant,8,3,0,5,12,15,-3,9,Montenegro - First League,0.38,0.38,-3,1.5,1.12,2.63,2.63,5
Mornar Bar,8,2,2,4,8,13,-5,8,Montenegro - First League,0.25,0.5,-5,1.0,1.0,4.0,2.0,6
Decic,8,1,3,4,4,8,-4,6,Montenegro - First League,0.12,0.5,-4,0.5,0.75,8.33,2.0,7
Bokelj,8,1,1,6,4,14,-10,4,Montenegro - First League,0.12,0.25,-10,0.5,0.5,8.33,4.0,8
Berkane,8,5,2,1,11,3,8,17,morocco,0.62,0.88,8,1.38,2.12,1.61,1.14,1
Difaa El Jadida,8,4,3,1,9,5,4,15,morocco,0.5,0.88,4,1.12,1.88,2.0,1.14,2
Wydad,8,3,5,0,13,5,8,14,morocco,0.38,1.0,8,1.62,1.75,2.63,1.0,3
FUS Rabat,8,4,2,2,13,8,5,14,morocco,0.5,0.75,5,1.62,1.75,2.0,1.33,3
Raja Casablanca,8,3,5,0,9,5,4,14,morocco,0.38,1.0,4,1.12,1.75,2.63,1.0,3
FAR Rabat,8,4,2,2,11,9,2,14,morocco,0.5,0.75,2,1.38,1.75,2.0,1.33,3
Meknes,8,3,3,2,9,7,2,12,morocco,0.38,0.75,2,1.12,1.5,2.63,1.33,4
Union Touarga,8,3,3,2,9,7,2,12,morocco,0.38,0.75,2,1.12,1.5,2.63,1.33,4
Olympic Safi,8,2,4,2,7,7,0,10,morocco,0.25,0.75,0,0.88,1.25,4.0,1.33,5
Maghreb de Fes,8,2,4,2,8,10,-2,10,morocco,0.25,0.75,-2,1.0,1.25,4.0,1.33,5
Hassania Agadir,8,2,3,3,11,9,2,9,morocco,0.25,0.62,2,1.38,1.12,4.0,1.61,6
Moghreb Tetouan,8,2,3,3,8,10,-2,9,morocco,0.25,0.62,-2,1.0,1.12,4.0,1.61,6
R. Zemamra,8,3,0,5,6,10,-4,9,morocco,0.38,0.38,-4,0.75,1.12,2.63,2.63,6
Ittihad Tanger,8,2,2,4,11,14,-3,8,morocco,0.25,0.5,-3,1.38,1.0,4.0,2.0,7
JS Sousalem,8,0,1,7,4,17,-13,1,morocco,0.0,0.12,-13,0.5,0.12,0.0,8.33,8
C. Mohammedia,8,0,1,7,3,17,-14,1,morocco,0.0,0.12,-14,0.38,0.12,0.0,8.33,8
Shan Utd,8,7,1,0,24,2,22,22,myanmar,0.88,1.0,22,3.0,2.75,1.14,1.0,1
Yangon Utd,8,5,2,1,21,6,15,17,myanmar,0.62,0.88,15,2.62,2.12,1.61,1.14,2
Sagaing Utd,8,4,2,2,16,13,3,14,myanmar,0.5,0.75,3,2.0,1.75,2.0,1.33,3
Thitsar Arman,8,4,1,3,15,12,3,13,myanmar,0.5,0.62,3,1.88,1.62,2.0,1.61,4
Yadanarbon,8,3,3,2,18,15,3,12,myanmar,0.38,0.75,3,2.25,1.5,2.63,1.33,5
Dagon,8,3,2,3,10,11,-1,11,myanmar,0.38,0.62,-1,1.25,1.38,2.63,1.61,6
Hantharwady,8,3,2,3,7,11,-4,11,myanmar,0.38,0.62,-4,0.88,1.38,2.63,1.61,6
Rakhine Utd,8,3,2,3,10,16,-6,11,myanmar,0.38,0.62,-6,1.25,1.38,2.63,1.61,6
Ayeyawady,8,2,0,6,9,16,-7,6,myanmar,0.25,0.25,-7,1.12,0.75,4.0,4.0,7
Ispe FC,8,1,3,4,4,14,-10,6,myanmar,0.12,0.5,-10,0.5,0.75,8.33,2.0,7
Dagon Port,8,1,2,5,12,21,-9,5,myanmar,0.12,0.38,-9,1.5,0.62,8.33,2.63,8
Myawady,8,1,2,5,11,20,-9,5,myanmar,0.12,0.38,-9,1.38,0.62,8.33,2.63,8
Ajax Amsterdam,8,7,1,0,17,4,13,22,netherlands,0.88,1.0,13,2.12,2.75,1.14,1.0,1
Feyenoord,8,6,2,0,18,6,12,20,netherlands,0.75,1.0,12,2.25,2.5,1.33,1.0,2
PSV Eindhoven,8,4,2,2,18,10,8,14,netherlands,0.5,0.75,8,2.25,1.75,2.0,1.33,3
Sparta,8,4,2,2,14,7,7,14,netherlands,0.5,0.75,7,1.75,1.75,2.0,1.33,3
FC Utrecht,8,4,2,2,13,9,4,14,netherlands,0.5,0.75,4,1.62,1.75,2.0,1.33,3
Go Ahead Eagles,8,4,2,2,13,12,1,14,netherlands,0.5,0.75,1,1.62,1.75,2.0,1.33,3
Heracles Almelo,8,4,2,2,12,11,1,14,netherlands,0.5,0.75,1,1.5,1.75,2.0,1.33,3
FC Twente,8,3,3,2,11,11,0,12,netherlands,0.38,0.75,0,1.38,1.5,2.63,1.33,4
FC Groningen,8,3,2,3,11,14,-3,11,netherlands,0.38,0.62,-3,1.38,1.38,2.63,1.61,5
Heerenveen,8,2,3,3,13,14,-1,9,netherlands,0.25,0.62,-1,1.62,1.12,4.0,1.61,6
AZ Alkmaar,8,2,3,3,11,12,-1,9,netherlands,0.25,0.62,-1,1.38,1.12,4.0,1.61,6
NEC Nijmegen,8,2,3,3,10,13,-3,9,netherlands,0.25,0.62,-3,1.25,1.12,4.0,1.61,6
PEC Zwolle,8,1,4,3,9,12,-3,7,netherlands,0.12,0.62,-3,1.12,0.88,8.33,1.61,7
Fortuna Sittard,8,2,1,5,4,11,-7,7,netherlands,0.25,0.38,-7,0.5,0.88,4.0,2.63,7
Almere City,8,1,3,4,8,14,-6,6,netherlands,0.12,0.5,-6,1.0,0.75,8.33,2.0,8
RKC Waalwijk,8,1,2,5,9,13,-4,5,netherlands,0.12,0.38,-4,1.12,0.62,8.33,2.63,9
NAC Breda,8,0,5,3,5,13,-8,5,netherlands,0.0,0.62,-8,0.62,0.62,0.0,1.61,9
Willem II,8,0,1,7,6,19,-13,1,netherlands,0.0,0.12,-13,0.75,0.12,0.0,8.33,10
FC Volendam,8,8,0,0,22,3,19,24,netherlands2,1.0,1.0,19,2.75,3.0,1.0,1.0,1
Excelsior,8,6,1,1,17,7,10,19,netherlands2,0.75,0.88,10,2.12,2.38,1.33,1.14,2
ADO Den Haag,8,5,2,1,12,8,4,17,netherlands2,0.62,0.88,4,1.5,2.12,1.61,1.14,3
De Graafschap,8,5,1,2,15,7,8,16,netherlands2,0.62,0.75,8,1.88,2.0,1.61,1.33,4
Cambuur,8,5,1,2,16,11,5,16,netherlands2,0.62,0.75,5,2.0,2.0,1.61,1.33,4
FC Dordrecht,8,5,0,3,17,9,8,15,netherlands2,0.62,0.62,8,2.12,1.88,1.61,1.61,5
FC Emmen,8,5,0,3,11,7,4,15,netherlands2,0.62,0.62,4,1.38,1.88,1.61,1.61,5
Telstar,8,4,2,2,15,11,4,14,netherlands2,0.5,0.75,4,1.88,1.75,2.0,1.33,6
Jong AZ,8,3,3,2,15,9,6,12,netherlands2,0.38,0.75,6,1.88,1.5,2.63,1.33,7
VVV,8,3,2,3,12,15,-3,11,netherlands2,0.38,0.62,-3,1.5,1.38,2.63,1.61,8
Roda JC,8,3,2,3,9,13,-4,11,netherlands2,0.38,0.62,-4,1.12,1.38,2.63,1.61,8
FC Eindhoven,8,2,4,2,14,13,1,10,netherlands2,0.25,0.75,1,1.75,1.25,4.0,1.33,9
Vitesse Arnhem,8,2,3,3,9,11,-2,9,netherlands2,0.25,0.62,-2,1.12,1.12,4.0,1.61,10
FC Den Bosch,8,2,2,4,11,16,-5,8,netherlands2,0.25,0.5,-5,1.38,1.0,4.0,2.0,11
Helmond Sport,8,1,3,4,14,17,-3,6,netherlands2,0.12,0.5,-3,1.75,0.75,8.33,2.0,12
Jong PSV,8,1,3,4,12,19,-7,6,netherlands2,0.12,0.5,-7,1.5,0.75,8.33,2.0,12
TOP Oss,8,1,3,4,6,15,-9,6,netherlands2,0.12,0.5,-9,0.75,0.75,8.33,2.0,12
Jong Ajax,8,1,1,6,4,15,-11,4,netherlands2,0.12,0.25,-11,0.5,0.5,8.33,4.0,13
Jong Utrecht,8,0,3,5,4,17,-13,3,netherlands2,0.0,0.38,-13,0.5,0.38,0.0,2.63,14
MVV Maastricht,8,0,1,7,5,17,-12,1,netherlands2,0.0,0.12,-12,0.62,0.12,0.0,8.33,15
Diriangen,8,7,1,0,29,1,28,22,nicaragua,0.88,1.0,28,3.62,2.75,1.14,1.0,1
Matagalpa,8,6,1,1,16,6,10,19,nicaragua,0.75,0.88,10,2.0,2.38,1.33,1.14,2
Real Esteli,8,4,3,1,13,9,4,15,nicaragua,0.5,0.88,4,1.62,1.88,2.0,1.14,3
Walter Ferreti,8,3,3,2,7,6,1,12,nicaragua,0.38,0.75,1,0.88,1.5,2.63,1.33,4
Managua FC,8,3,1,4,11,10,1,10,nicaragua,0.38,0.5,1,1.38,1.25,2.63,2.0,5
UNAN Managua,8,3,1,4,9,15,-6,10,nicaragua,0.38,0.5,-6,1.12,1.25,2.63,2.0,5
Jalapa,8,2,3,3,6,13,-7,9,nicaragua,0.25,0.62,-7,0.75,1.12,4.0,1.61,6
Export Sebaco,8,2,2,4,9,10,-1,8,nicaragua,0.25,0.5,-1,1.12,1.0,4.0,2.0,7
Rancho Santana,8,1,1,6,6,20,-14,4,nicaragua,0.12,0.25,-14,0.75,0.5,8.33,4.0,8
D. Ocotal,8,1,1,6,6,21,-15,4,nicaragua,0.12,0.25,-15,0.75,0.5,8.33,4.0,8
Real Esteli,8,8,0,0,23,7,16,24,nicaragua2,1.0,1.0,16,2.88,3.0,1.0,1.0,1
Managua FC,8,6,1,1,20,6,14,19,nicaragua2,0.75,0.88,14,2.5,2.38,1.33,1.14,2
Matagalpa,8,4,2,2,17,12,5,14,nicaragua2,0.5,0.75,5,2.12,1.75,2.0,1.33,3
Diriangen,8,3,2,3,14,15,-1,11,nicaragua2,0.38,0.62,-1,1.75,1.38,2.63,1.61,4
CS Sebaco,8,3,2,3,8,9,-1,11,nicaragua2,0.38,0.62,-1,1.0,1.38,2.63,1.61,4
UNAN Managua,8,3,1,4,10,15,-5,10,nicaragua2,0.38,0.5,-5,1.25,1.25,2.63,2.0,5
D. Ocotal,8,2,2,4,9,18,-9,8,nicaragua2,0.25,0.5,-9,1.12,1.0,4.0,2.0,6
Walter Ferreti,8,1,3,4,6,8,-2,6,nicaragua2,0.12,0.5,-2,0.75,0.75,8.33,2.0,7
Jalapa,8,1,3,4,9,13,-4,6,nicaragua2,0.12,0.5,-4,1.12,0.75,8.33,2.0,7
Rancho Santana,8,0,3,5,4,16,-12,3,nicaragua2,0.0,0.38,-12,0.5,0.38,0.0,2.63,8
Linfield,8,6,1,1,13,5,8,19,northernireland,0.75,0.88,8,1.62,2.38,1.33,1.14,1
Coleraine,8,5,2,1,11,5,6,17,northernireland,0.62,0.88,6,1.38,2.12,1.61,1.14,2
Crusaders,8,5,1,2,11,8,3,16,northernireland,0.62,0.75,3,1.38,2.0,1.61,1.33,3
Larne,8,4,2,2,11,7,4,14,northernireland,0.5,0.75,4,1.38,1.75,2.0,1.33,4
Cliftonville,8,3,2,3,13,10,3,11,northernireland,0.38,0.62,3,1.62,1.38,2.63,1.61,5
Dungannon,8,3,2,3,8,10,-2,11,northernireland,0.38,0.62,-2,1.0,1.38,2.63,1.61,5
Ballymena Utd,8,3,1,4,10,9,1,10,northernireland,0.38,0.5,1,1.25,1.25,2.63,2.0,6
Glentoran,8,2,4,2,9,10,-1,10,northernireland,0.25,0.75,-1,1.12,1.25,4.0,1.33,6
Portadown,8,2,3,3,7,9,-2,9,northernireland,0.25,0.62,-2,0.88,1.12,4.0,1.61,7
Glenavon,8,2,2,4,9,10,-1,8,northernireland,0.25,0.5,-1,1.12,1.0,4.0,2.0,8
Loughgall,8,1,2,5,5,12,-7,5,northernireland,0.12,0.38,-7,0.62,0.62,8.33,2.63,9
Carrick Rangers,8,1,2,5,2,11,-9,5,northernireland,0.12,0.38,-9,0.25,0.62,8.33,2.63,9
Annagh Utd,8,7,0,1,23,8,15,21,northernireland2,0.88,0.88,15,2.88,2.62,1.14,1.14,1
Limavady,8,3,5,0,13,8,5,14,northernireland2,0.38,1.0,5,1.62,1.75,2.63,1.0,2
Newington,8,4,2,2,18,15,3,14,northernireland2,0.5,0.75,3,2.25,1.75,2.0,1.33,2
Ards,8,4,2,2,14,13,1,14,northernireland2,0.5,0.75,1,1.75,1.75,2.0,1.33,2
HW Welders,8,4,1,3,14,11,3,13,northernireland2,0.5,0.62,3,1.75,1.62,2.0,1.61,3
Bangor,8,3,3,2,16,12,4,12,northernireland2,0.38,0.75,4,2.0,1.5,2.63,1.33,4
Institute,8,3,2,3,12,16,-4,11,northernireland2,0.38,0.62,-4,1.5,1.38,2.63,1.61,5
Newry City,8,2,3,3,12,15,-3,9,northernireland2,0.25,0.62,-3,1.5,1.12,4.0,1.61,6
Ballinamallard,8,2,1,5,6,9,-3,7,northernireland2,0.25,0.38,-3,0.75,0.88,4.0,2.63,7
Dundela,8,1,2,5,8,14,-6,5,northernireland2,0.12,0.38,-6,1.0,0.62,8.33,2.63,8
Ballyclare,8,1,2,5,9,16,-7,5,northernireland2,0.12,0.38,-7,1.12,0.62,8.33,2.63,8
Armagh City,8,1,1,6,11,24,-13,4,northernireland2,0.12,0.25,-13,1.38,0.5,8.33,4.0,9
Shkendija,8,6,1,1,14,7,7,19,northmacedonia,0.75,0.88,7,1.75,2.38,1.33,1.14,1
Sileks,8,5,2,1,21,8,13,17,northmacedonia,0.62,0.88,13,2.62,2.12,1.61,1.14,2
Vardar,8,4,4,0,13,5,8,16,northmacedonia,0.5,1.0,8,1.62,2.0,2.0,1.0,3
Struga,8,4,1,3,12,9,3,13,northmacedonia,0.5,0.62,3,1.5,1.62,2.0,1.61,4
Rabotnicki,8,3,3,2,4,4,0,12,northmacedonia,0.38,0.75,0,0.5,1.5,2.63,1.33,5
Besa,8,3,2,3,8,16,-8,11,northmacedonia,0.38,0.62,-8,1.0,1.38,2.63,1.61,6
Gostivar,8,2,3,3,8,9,-1,9,northmacedonia,0.25,0.62,-1,1.0,1.12,4.0,1.61,7
Pelister,8,3,0,5,8,14,-6,9,northmacedonia,0.38,0.38,-6,1.0,1.12,2.63,2.63,7
Shkupi,8,2,2,4,8,10,-2,8,northmacedonia,0.25,0.5,-2,1.0,1.0,4.0,2.0,8
Tikves,8,2,2,4,7,9,-2,8,northmacedonia,0.25,0.5,-2,0.88,1.0,4.0,2.0,8
Voska Sport,8,2,1,5,7,11,-4,7,northmacedonia,0.25,0.38,-4,0.88,0.88,4.0,2.63,9
Brera Strumica,8,1,1,6,7,15,-8,4,northmacedonia,0.12,0.25,-8,0.88,0.5,8.33,4.0,10
Fredrikstad,3,2,0,1,5,1,4,6,norway,0.67,0.67,4,1.67,2.0,1.49,1.49,1
Bodo.Glimt,2,2,0,0,4,0,4,6,norway,1.0,1.0,4,2.0,3.0,1.0,1.0,1
Viking,3,2,0,1,7,5,2,6,norway,0.67,0.67,2,2.33,2.0,1.49,1.49,1
Rosenborg,2,2,0,0,3,1,2,6,norway,1.0,1.0,2,1.5,3.0,1.0,1.0,1
Brann,3,2,0,1,5,5,0,6,norway,0.67,0.67,0,1.67,2.0,1.49,1.49,1
Sarpsborg 08,2,1,1,0,3,1,2,4,norway,0.5,1.0,2,1.5,2.0,2.0,1.0,2
Valerenga,3,1,1,1,4,4,0,4,norway,0.33,0.67,0,1.33,1.33,3.03,1.49,2
Stromsgodset,3,1,0,2,7,4,3,3,norway,0.33,0.33,3,2.33,1.0,3.03,3.03,3
Sandefjord,2,1,0,1,4,3,1,3,norway,0.5,0.5,1,2.0,1.5,2.0,2.0,3
KFUM Oslo,2,1,0,1,4,4,0,3,norway,0.5,0.5,0,2.0,1.5,2.0,2.0,3
Tromso,2,1,0,1,2,3,-1,3,norway,0.5,0.5,-1,1.0,1.5,2.0,2.0,3
Kristiansund,3,1,0,2,4,6,-2,3,norway,0.33,0.33,-2,1.33,1.0,3.03,3.03,3
HamKam,2,1,0,1,2,4,-2,3,norway,0.5,0.5,-2,1.0,1.5,2.0,2.0,3
Bryne,2,0,0,2,1,3,-2,0,norway,0.0,0.0,-2,0.5,0.0,0.0,0.0,4
Molde,2,0,0,2,0,5,-5,0,norway,0.0,0.0,-5,0.0,0.0,0.0,0.0,4
Haugesund,2,0,0,2,0,6,-6,0,norway,0.0,0.0,-6,0.0,0.0,0.0,0.0,4
Egersund,2,2,0,0,5,2,3,6,norway2,1.0,1.0,3,2.5,3.0,1.0,1.0,1
Start,2,2,0,0,5,2,3,6,norway2,1.0,1.0,3,2.5,3.0,1.0,1.0,1
Kongsvinger,2,1,1,0,3,1,2,4,norway2,0.5,1.0,2,1.5,2.0,2.0,1.0,2
Aalesund,2,1,1,0,6,5,1,4,norway2,0.5,1.0,1,3.0,2.0,2.0,1.0,2
Raufoss,2,1,1,0,4,3,1,4,norway2,0.5,1.0,1,2.0,2.0,2.0,1.0,2
Lillestrom,2,1,1,0,3,2,1,4,norway2,0.5,1.0,1,1.5,2.0,2.0,1.0,2
Stabaek,2,1,1,0,2,1,1,4,norway2,0.5,1.0,1,1.0,2.0,2.0,1.0,2
Lyn,2,1,0,1,3,1,2,3,norway2,0.5,0.5,2,1.5,1.5,2.0,2.0,3
Moss,2,1,0,1,4,3,1,3,norway2,0.5,0.5,1,2.0,1.5,2.0,2.0,3
Odd,2,1,0,1,2,2,0,3,norway2,0.5,0.5,0,1.0,1.5,2.0,2.0,3
Mjondalen,2,0,1,1,3,4,-1,1,norway2,0.0,0.5,-1,1.5,0.5,0.0,2.0,4
Asane,2,0,1,1,1,3,-2,1,norway2,0.0,0.5,-2,0.5,0.5,0.0,2.0,4
Hodd,2,0,1,1,1,3,-2,1,norway2,0.0,0.5,-2,0.5,0.5,0.0,2.0,4
Sogndal,2,0,0,2,4,6,-2,0,norway2,0.0,0.0,-2,2.0,0.0,0.0,0.0,5
Skeid,2,0,0,2,2,5,-3,0,norway2,0.0,0.0,-3,1.0,0.0,0.0,0.0,5
Ranheim,2,0,0,2,0,5,-5,0,norway2,0.0,0.0,-5,0.0,0.0,0.0,0.0,5
Brann B,2,2,0,0,8,6,2,6,norway3,1.0,1.0,2,4.0,3.0,1.0,1.0,1
Sotra,2,1,1,0,6,1,5,4,norway3,0.5,1.0,5,3.0,2.0,2.0,1.0,2
Sandnes Ulf,2,1,1,0,6,4,2,4,norway3,0.5,1.0,2,3.0,2.0,2.0,1.0,2
Jerv,2,1,1,0,3,2,1,4,norway3,0.5,1.0,1,1.5,2.0,2.0,1.0,2
Notodden,2,1,1,0,3,2,1,4,norway3,0.5,1.0,1,1.5,2.0,2.0,1.0,2
Brattvag,2,1,0,1,5,5,0,3,norway3,0.5,0.5,0,2.5,1.5,2.0,2.0,3
Sandviken,2,1,0,1,3,3,0,3,norway3,0.5,0.5,0,1.5,1.5,2.0,2.0,3
Arendal,2,0,2,0,4,4,0,2,norway3,0.0,1.0,0,2.0,1.0,0.0,1.0,4
Pors Grenland,2,0,2,0,2,2,0,2,norway3,0.0,1.0,0,1.0,1.0,0.0,1.0,4
Traef,2,0,1,1,4,5,-1,1,norway3,0.0,0.5,-1,2.0,0.5,0.0,2.0,5
Lysekloster,2,0,1,1,1,2,-1,1,norway3,0.0,0.5,-1,0.5,0.5,0.0,2.0,5
Eik Tonsberg,2,0,1,1,2,4,-2,1,norway3,0.0,0.5,-2,1.0,0.5,0.0,2.0,5
Flekkeroy,2,0,1,1,2,7,-5,1,norway3,0.0,0.5,-5,1.0,0.5,0.0,2.0,5
V. Haugesund,2,0,0,2,2,4,-2,0,norway3,0.0,0.0,-2,1.0,0.0,0.0,0.0,6
Strommen,2,2,0,0,6,2,4,6,norway4,1.0,1.0,4,3.0,3.0,1.0,1.0,1
Tromsdalen,2,1,1,0,4,1,3,4,norway4,0.5,1.0,3,2.0,2.0,2.0,1.0,2
Follo,2,1,1,0,4,3,1,4,norway4,0.5,1.0,1,2.0,2.0,2.0,1.0,2
Honefoss,2,1,0,1,3,1,2,3,norway4,0.5,0.5,2,1.5,1.5,2.0,2.0,3
Eidsvold,2,1,0,1,4,4,0,3,norway4,0.5,0.5,0,2.0,1.5,2.0,2.0,3
Kjelsas,2,1,0,1,3,3,0,3,norway4,0.5,0.5,0,1.5,1.5,2.0,2.0,3
Ull/Kisa,2,1,0,1,3,3,0,3,norway4,0.5,0.5,0,1.5,1.5,2.0,2.0,3
Alta,2,1,0,1,4,5,-1,3,norway4,0.5,0.5,-1,2.0,1.5,2.0,2.0,3
Rana,2,1,0,1,3,4,-1,3,norway4,0.5,0.5,-1,1.5,1.5,2.0,2.0,3
Grorud,2,1,0,1,2,4,-2,3,norway4,0.5,0.5,-2,1.0,1.5,2.0,2.0,3
Stjordals-Blink,2,1,0,1,2,4,-2,3,norway4,0.5,0.5,-2,1.0,1.5,2.0,2.0,3
Asker,2,0,2,0,3,3,0,2,norway4,0.0,1.0,0,1.5,1.0,0.0,1.0,4
Levanger,2,0,0,2,4,6,-2,0,norway4,0.0,0.0,-2,2.0,0.0,0.0,0.0,5
Strindheim,2,0,0,2,2,4,-2,0,norway4,0.0,0.0,-2,1.0,0.0,0.0,0.0,5
Floya,2,2,0,0,7,3,4,6,norway5,1.0,1.0,4,3.5,3.0,1.0,1.0,1
Junkeren,2,2,0,0,6,3,3,6,norway5,1.0,1.0,3,3.0,3.0,1.0,1.0,1
Gamle Oslo,2,1,1,0,7,2,5,4,norway5,0.5,1.0,5,3.5,2.0,2.0,1.0,2
Frigg,2,1,1,0,4,3,1,4,norway5,0.5,1.0,1,2.0,2.0,2.0,1.0,2
Sortland,2,1,1,0,4,3,1,4,norway5,0.5,1.0,1,2.0,2.0,2.0,1.0,2
Ullern,2,1,0,1,5,3,2,3,norway5,0.5,0.5,2,2.5,1.5,2.0,2.0,3
Tromso B,2,1,0,1,6,5,1,3,norway5,0.5,0.5,1,3.0,1.5,2.0,2.0,3
Ulfstind,2,1,0,1,1,2,-1,3,norway5,0.5,0.5,-1,0.5,1.5,2.0,2.0,3
Harstad,2,1,0,1,5,7,-2,3,norway5,0.5,0.5,-2,2.5,1.5,2.0,2.0,3
Funnefoss/V,2,0,1,1,5,7,-2,1,norway5,0.0,0.5,-2,2.5,0.5,0.0,2.0,4
Skjervoy,2,0,1,1,4,7,-3,1,norway5,0.0,0.5,-3,2.0,0.5,0.0,2.0,4
Alta B,2,0,1,1,2,6,-4,1,norway5,0.0,0.5,-4,1.0,0.5,0.0,2.0,4
Baerum,2,0,0,2,1,3,-2,0,norway5,0.0,0.0,-2,0.5,0.0,0.0,0.0,5
KFUM B,2,0,0,2,4,7,-3,0,norway5,0.0,0.0,-3,2.0,0.0,0.0,0.0,5
Rosenborg B,3,3,0,0,6,0,6,9,norway6,1.0,1.0,6,2.0,3.0,1.0,1.0,1
Melhus,2,2,0,0,8,0,8,6,norway6,1.0,1.0,8,4.0,3.0,1.0,1.0,2
Byasen,2,1,1,0,3,0,3,4,norway6,0.5,1.0,3,1.5,2.0,2.0,1.0,3
Nardo,2,1,1,0,5,3,2,4,norway6,0.5,1.0,2,2.5,2.0,2.0,1.0,3
Volda,2,1,1,0,3,1,2,4,norway6,0.5,1.0,2,1.5,2.0,2.0,1.0,3
Trygg/Lade,2,1,0,1,4,1,3,3,norway6,0.5,0.5,3,2.0,1.5,2.0,2.0,4
Spjelkavik,2,1,0,1,7,5,2,3,norway6,0.5,0.5,2,3.5,1.5,2.0,2.0,4
Aalesund B,2,1,0,1,5,5,0,3,norway6,0.5,0.5,0,2.5,1.5,2.0,2.0,4
Ranheim B,2,1,0,1,3,3,0,3,norway6,0.5,0.5,0,1.5,1.5,2.0,2.0,4
Tiller,2,0,2,0,1,1,0,2,norway6,0.0,1.0,0,0.5,1.0,0.0,1.0,5
Kristiansund B,2,0,1,1,1,2,-1,1,norway6,0.0,0.5,-1,0.5,0.5,0.0,2.0,6
Kvik Trondheim,2,0,0,2,2,7,-5,0,norway6,0.0,0.0,-5,1.0,0.0,0.0,0.0,7
Molde B,3,0,0,3,3,10,-7,0,norway6,0.0,0.0,-7,1.0,0.0,0.0,0.0,7
Surnadal,2,0,0,2,1,14,-13,0,norway6,0.0,0.0,-13,0.5,0.0,0.0,0.0,7
Kongsvinger B,3,2,1,0,8,4,4,7,norway7,0.67,1.0,4,2.67,2.33,1.49,1.0,1
Elverum,2,2,0,0,8,2,6,6,norway7,1.0,1.0,6,4.0,3.0,1.0,1.0,2
Skjetten,2,2,0,0,6,0,6,6,norway7,1.0,1.0,6,3.0,3.0,1.0,1.0,2
Lillehammer,2,1,1,0,8,3,5,4,norway7,0.5,1.0,5,4.0,2.0,2.0,1.0,3
Gjovik-Lyn,2,1,1,0,3,1,2,4,norway7,0.5,1.0,2,1.5,2.0,2.0,1.0,3
Lorenskog,2,1,0,1,7,4,3,3,norway7,0.5,0.5,3,3.5,1.5,2.0,2.0,4
Stromsgodset B,2,1,0,1,3,2,1,3,norway7,0.5,0.5,1,1.5,1.5,2.0,2.0,4
Skedsmo,2,1,0,1,6,6,0,3,norway7,0.5,0.5,0,3.0,1.5,2.0,2.0,4
Lillestrom B,3,1,0,2,6,10,-4,3,norway7,0.33,0.33,-4,2.0,1.0,3.03,3.03,4
Assiden IF,2,0,1,1,2,4,-2,1,norway7,0.0,0.5,-2,1.0,0.5,0.0,2.0,5
Nordstrand,2,0,1,1,2,5,-3,1,norway7,0.0,0.5,-3,1.0,0.5,0.0,2.0,5
Bjorkelangen,2,0,1,1,2,6,-4,1,norway7,0.0,0.5,-4,1.0,0.5,0.0,2.0,5
HamKam B,2,0,0,2,2,6,-4,0,norway7,0.0,0.0,-4,1.0,0.0,0.0,0.0,6
Ull/Kisa B,2,0,0,2,1,11,-10,0,norway7,0.0,0.0,-10,0.5,0.0,0.0,0.0,6
Fana,3,2,1,0,15,2,13,7,norway8,0.67,1.0,13,5.0,2.33,1.49,1.0,1
Bjarg,2,2,0,0,9,1,8,6,norway8,1.0,1.0,8,4.5,3.0,1.0,1.0,2
Forde,2,2,0,0,4,1,3,6,norway8,1.0,1.0,3,2.0,3.0,1.0,1.0,2
Lyn B,3,2,0,1,10,9,1,6,norway8,0.67,0.67,1,3.33,2.0,1.49,1.49,2
Gneist,3,1,2,0,7,6,1,5,norway8,0.33,1.0,1,2.33,1.67,3.03,1.0,3
Sandefjord B,3,1,1,1,8,10,-2,4,norway8,0.33,0.67,-2,2.67,1.33,3.03,1.49,4
Fyllingsdalen,2,1,0,1,5,4,1,3,norway8,0.5,0.5,1,2.5,1.5,2.0,2.0,5
Asane B,2,1,0,1,6,6,0,3,norway8,0.5,0.5,0,3.0,1.5,2.0,2.0,5
Askoy,2,1,0,1,1,5,-4,3,norway8,0.5,0.5,-4,0.5,1.5,2.0,2.0,5
Loddefjord,2,1,0,1,3,10,-7,3,norway8,0.5,0.5,-7,1.5,1.5,2.0,2.0,5
OS,2,0,0,2,3,5,-2,0,norway8,0.0,0.0,-2,1.5,0.0,0.0,0.0,6
Valerenga B,2,0,0,2,3,5,-2,0,norway8,0.0,0.0,-2,1.5,0.0,0.0,0.0,6
Lyngbo,2,0,0,2,1,4,-3,0,norway8,0.0,0.0,-3,0.5,0.0,0.0,0.0,6
Fjora,2,0,0,2,2,9,-7,0,norway8,0.0,0.0,-7,1.0,0.0,0.0,0.0,6
Vidar,2,2,0,0,4,1,3,6,norway9,1.0,1.0,3,2.0,3.0,1.0,1.0,1
Viking B,2,1,1,0,8,1,7,4,norway9,0.5,1.0,7,4.0,2.0,2.0,1.0,2
Staal Jorpeland,3,1,1,1,12,8,4,4,norway9,0.33,0.67,4,4.0,1.33,3.03,1.49,2
Torvastad,2,1,1,0,6,2,4,4,norway9,0.5,1.0,4,3.0,2.0,2.0,1.0,2
Vindbjart,2,1,1,0,3,2,1,4,norway9,0.5,1.0,1,1.5,2.0,2.0,1.0,2
Vag,2,1,0,1,8,6,2,3,norway9,0.5,0.5,2,4.0,1.5,2.0,2.0,3
Hinna,2,1,0,1,7,7,0,3,norway9,0.5,0.5,0,3.5,1.5,2.0,2.0,3
Brodd,2,1,0,1,3,3,0,3,norway9,0.5,0.5,0,1.5,1.5,2.0,2.0,3
Sandnes Ulf B,2,1,0,1,7,10,-3,3,norway9,0.5,0.5,-3,3.5,1.5,2.0,2.0,3
Sola,3,1,0,2,7,16,-9,3,norway9,0.33,0.33,-9,2.33,1.0,3.03,3.03,3
Madla,2,0,2,0,2,2,0,2,norway9,0.0,1.0,0,1.0,1.0,0.0,1.0,4
Stord,2,0,2,0,2,2,0,2,norway9,0.0,1.0,0,1.0,1.0,0.0,1.0,4
Haugesund B,2,0,0,2,2,6,-4,0,norway9,0.0,0.0,-4,1.0,0.0,0.0,0.0,5
Djerv,2,0,0,2,3,8,-5,0,norway9,0.0,0.0,-5,1.5,0.0,0.0,0.0,5
Sarpsborg 08 B,2,2,0,0,7,2,5,6,norway10,1.0,1.0,5,3.5,3.0,1.0,1.0,1
Stabaek B,2,2,0,0,6,2,4,6,norway10,1.0,1.0,4,3.0,3.0,1.0,1.0,1
Grei,2,1,1,0,3,2,1,4,norway10,0.5,1.0,1,1.5,2.0,2.0,1.0,2
Fram,2,1,0,1,6,3,3,3,norway10,0.5,0.5,3,3.0,1.5,2.0,2.0,3
Flint,2,1,0,1,5,3,2,3,norway10,0.5,0.5,2,2.5,1.5,2.0,2.0,3
Kvik Halden,2,1,0,1,4,4,0,3,norway10,0.5,0.5,0,2.0,1.5,2.0,2.0,3
Fredrikstad B,2,1,0,1,3,3,0,3,norway10,0.5,0.5,0,1.5,1.5,2.0,2.0,3
Oppsal,2,1,0,1,3,3,0,3,norway10,0.5,0.5,0,1.5,1.5,2.0,2.0,3
Pors Grenland B,2,1,0,1,3,3,0,3,norway10,0.5,0.5,0,1.5,1.5,2.0,2.0,3
Odd B,2,1,0,1,2,2,0,3,norway10,0.5,0.5,0,1.0,1.5,2.0,2.0,3
Lokomotiv Oslo,2,1,0,1,2,5,-3,3,norway10,0.5,0.5,-3,1.0,1.5,2.0,2.0,3
Drobak-Frogn,2,0,1,1,2,6,-4,1,norway10,0.0,0.5,-4,1.0,0.5,0.0,2.0,4
Orn Horten,2,0,0,2,1,5,-4,0,norway10,0.0,0.0,-4,0.5,0.0,0.0,0.0,5
IF Ready,2,0,0,2,0,4,-4,0,norway10,0.0,0.0,-4,0.0,0.0,0.0,0.0,5
Universitario,8,6,1,1,11,5,6,19,panama,0.75,0.88,6,1.38,2.38,1.33,1.14,1
Plaza Amador,8,4,3,1,13,8,5,15,panama,0.5,0.88,5,1.62,1.88,2.0,1.14,2
San Francisco,8,4,2,2,12,6,6,14,panama,0.5,0.75,6,1.5,1.75,2.0,1.33,3
Tauro,8,3,3,2,13,9,4,12,panama,0.38,0.75,4,1.62,1.5,2.63,1.33,4
Arabe Unido,8,3,2,3,7,5,2,11,panama,0.38,0.62,2,0.88,1.38,2.63,1.61,5
San Miguelito,8,3,2,3,6,8,-2,11,panama,0.38,0.62,-2,0.75,1.38,2.63,1.61,5
Veraguas,8,3,1,4,11,17,-6,10,panama,0.38,0.5,-6,1.38,1.25,2.63,2.0,6
Independiente,8,2,3,3,10,8,2,9,panama,0.25,0.62,2,1.25,1.12,4.0,1.61,7
Costa del Este,8,3,0,5,6,11,-5,9,panama,0.38,0.38,-5,0.75,1.12,2.63,2.63,7
Alianza,8,1,4,3,8,11,-3,7,panama,0.12,0.62,-3,1.0,0.88,8.33,1.61,8
Herrera,8,1,4,3,5,9,-4,7,panama,0.12,0.62,-4,0.62,0.88,8.33,1.61,8
UMECIT,8,1,3,4,6,11,-5,6,panama,0.12,0.5,-5,0.75,0.75,8.33,2.0,9
San Miguelito,8,5,2,1,8,4,4,17,panama2,0.62,0.88,4,1.0,2.12,1.61,1.14,1
Independiente,8,5,1,2,14,11,3,16,panama2,0.62,0.75,3,1.75,2.0,1.61,1.33,2
Plaza Amador,8,4,3,1,9,6,3,15,panama2,0.5,0.88,3,1.12,1.88,2.0,1.14,3
Tauro,8,4,3,1,9,6,3,15,panama2,0.5,0.88,3,1.12,1.88,2.0,1.14,3
Veraguas,8,3,3,2,11,7,4,12,panama2,0.38,0.75,4,1.38,1.5,2.63,1.33,4
Arabe Unido,8,2,5,1,7,6,1,11,panama2,0.25,0.88,1,0.88,1.38,4.0,1.14,5
Universitario,8,3,2,3,6,5,1,11,panama2,0.38,0.62,1,0.75,1.38,2.63,1.61,5
UMECIT,8,3,1,4,8,8,0,10,panama2,0.38,0.5,0,1.0,1.25,2.63,2.0,6
Costa del Este,8,2,3,3,10,15,-5,9,panama2,0.25,0.62,-5,1.25,1.12,4.0,1.61,7
Alianza,8,2,0,6,8,12,-4,6,panama2,0.25,0.25,-4,1.0,0.75,4.0,4.0,8
San Francisco,8,1,2,5,4,10,-6,5,panama2,0.12,0.38,-6,0.5,0.62,8.33,2.63,9
Herrera,8,1,1,6,4,8,-4,4,panama2,0.12,0.25,-4,0.5,0.5,8.33,4.0,10
Libertad,8,5,3,0,15,4,11,18,paraguay,0.62,1.0,11,1.88,2.25,1.61,1.0,1
Cerro Porteno,8,4,2,2,8,4,4,14,paraguay,0.5,0.75,4,1.0,1.75,2.0,1.33,2
D. Recoleta,8,3,4,1,14,8,6,13,paraguay,0.38,0.88,6,1.75,1.62,2.63,1.14,3
Nacional,8,4,1,3,7,7,0,13,paraguay,0.5,0.62,0,0.88,1.62,2.0,1.61,3
S. Luqueno,8,3,3,2,7,8,-1,12,paraguay,0.38,0.75,-1,0.88,1.5,2.63,1.33,4
S. Trinidense,8,2,5,1,9,7,2,11,paraguay,0.25,0.88,2,1.12,1.38,4.0,1.14,5
Guarani,8,3,2,3,5,7,-2,11,paraguay,0.38,0.62,-2,0.62,1.38,2.63,1.61,5
Olimpia,8,2,3,3,7,8,-1,9,paraguay,0.25,0.62,-1,0.88,1.12,4.0,1.61,6
G. Caballero,8,2,2,4,4,11,-7,8,paraguay,0.25,0.5,-7,0.5,1.0,4.0,2.0,7
A. Tembetary,8,1,3,4,5,8,-3,6,paraguay,0.12,0.5,-3,0.62,0.75,8.33,2.0,8
S. Ameliano,8,1,3,4,5,8,-3,6,paraguay,0.12,0.5,-3,0.62,0.75,8.33,2.0,8
2 de Mayo,8,1,3,4,5,11,-6,6,paraguay,0.12,0.5,-6,0.62,0.75,8.33,2.0,8
Olimpia,8,4,3,1,10,4,6,15,paraguay2,0.5,0.88,6,1.25,1.88,2.0,1.14,1
Guarani,8,3,5,0,10,7,3,14,paraguay2,0.38,1.0,3,1.25,1.75,2.63,1.0,2
S. Ameliano,8,4,1,3,7,6,1,13,paraguay2,0.5,0.62,1,0.88,1.62,2.0,1.61,3
Sol de America,8,3,3,2,12,9,3,12,paraguay2,0.38,0.75,3,1.5,1.5,2.63,1.33,4
S. Luqueno,8,3,3,2,10,8,2,12,paraguay2,0.38,0.75,2,1.25,1.5,2.63,1.33,4
S. Trinidense,8,3,3,2,10,9,1,12,paraguay2,0.38,0.75,1,1.25,1.5,2.63,1.33,4
2 de Mayo,8,2,4,2,7,5,2,10,paraguay2,0.25,0.75,2,0.88,1.25,4.0,1.33,5
G. Caballero,8,2,3,3,7,7,0,9,paraguay2,0.25,0.62,0,0.88,1.12,4.0,1.61,6
Nacional,8,1,5,2,8,9,-1,8,paraguay2,0.12,0.75,-1,1.0,1.0,8.33,1.33,7
Cerro Porteno,8,2,2,4,11,15,-4,8,paraguay2,0.25,0.5,-4,1.38,1.0,4.0,2.0,7
Libertad,8,2,1,5,8,12,-4,7,paraguay2,0.25,0.38,-4,1.0,0.88,4.0,2.63,8
Tacuary,8,1,3,4,5,14,-9,6,paraguay2,0.12,0.5,-9,0.62,0.75,8.33,2.0,9
FBC Melgar,7,6,0,1,15,7,8,18,peru,0.86,0.86,8,2.14,2.57,1.16,1.16,1
Universitario,7,5,2,0,18,6,12,17,peru,0.71,1.0,12,2.57,2.43,1.41,1.0,2
D. Garcilaso,8,5,2,1,16,6,10,17,peru,0.62,0.88,10,2.0,2.12,1.61,1.14,2
Alianza Lima,8,5,1,2,11,8,3,16,peru,0.62,0.75,3,1.38,2.0,1.61,1.33,3
S. Cristal,8,4,1,3,13,10,3,13,peru,0.5,0.62,3,1.62,1.62,2.0,1.61,4
Sport Huancayo,8,4,1,3,10,11,-1,13,peru,0.5,0.62,-1,1.25,1.62,2.0,1.61,4
ADT,8,3,3,2,16,16,0,12,peru,0.38,0.75,0,2.0,1.5,2.63,1.33,5
Sport Boys,8,3,2,3,11,12,-1,11,peru,0.38,0.62,-1,1.38,1.38,2.63,1.61,6
Cusco,7,3,1,3,11,11,0,10,peru,0.43,0.57,0,1.57,1.43,2.33,1.75,7
Atletico Grau,6,2,2,2,9,10,-1,8,peru,0.33,0.67,-1,1.5,1.33,3.03,1.49,8
Binacional,7,2,2,3,10,13,-3,8,peru,0.29,0.57,-3,1.43,1.14,3.45,1.75,8
Cajamarca,7,2,2,3,8,13,-5,8,peru,0.29,0.57,-5,1.14,1.14,3.45,1.75,8
Alianza A.,7,2,1,4,11,11,0,7,peru,0.29,0.43,0,1.57,1.0,3.45,2.33,9
Los Chankas,7,1,4,2,9,10,-1,7,peru,0.14,0.71,-1,1.29,1.0,7.14,1.41,9
Cienciano,7,1,3,3,10,12,-2,6,peru,0.14,0.57,-2,1.43,0.86,7.14,1.75,10
Comerciantes U.,7,1,3,3,9,13,-4,6,peru,0.14,0.57,-4,1.29,0.86,7.14,1.75,10
Juan Pablo II C,7,2,0,5,7,11,-4,6,peru,0.29,0.29,-4,1.0,0.86,3.45,3.45,10
Ayacucho,8,1,2,5,8,13,-5,5,peru,0.12,0.38,-5,1.0,0.62,8.33,2.63,11
A. Huanuco,8,1,2,5,8,17,-9,5,peru,0.12,0.38,-9,1.0,0.62,8.33,2.63,11
Manila Digger,8,6,1,1,20,4,16,19,philippines,0.75,0.88,16,2.5,2.38,1.33,1.14,1
Kaya FC,8,6,1,1,16,6,10,19,philippines,0.75,0.88,10,2.0,2.38,1.33,1.14,1
Davao Aguilas,8,4,3,1,12,3,9,15,philippines,0.5,0.88,9,1.5,1.88,2.0,1.14,2
One Taguig,8,4,2,2,16,6,10,14,philippines,0.5,0.75,10,2.0,1.75,2.0,1.33,3
Stallion,8,3,2,3,15,12,3,11,philippines,0.38,0.62,3,1.88,1.38,2.63,1.61,4
DH Cebu,8,3,2,3,11,9,2,11,philippines,0.38,0.62,2,1.38,1.38,2.63,1.61,4
Maharlika,8,3,0,5,9,14,-5,9,philippines,0.38,0.38,-5,1.12,1.12,2.63,2.63,5
PFF Development,8,1,3,4,9,20,-11,6,philippines,0.12,0.5,-11,1.12,0.75,8.33,2.0,6
Mendiola,8,1,1,6,5,37,-32,4,philippines,0.12,0.25,-32,0.62,0.5,8.33,4.0,7
Loyola,8,0,1,7,5,21,-16,1,philippines,0.0,0.12,-16,0.62,0.12,0.0,8.33,8
Rakow C.,8,7,1,0,16,5,11,22,poland,0.88,1.0,11,2.0,2.75,1.14,1.0,1
Jagiellonia,8,5,2,1,11,5,6,17,poland,0.62,0.88,6,1.38,2.12,1.61,1.14,2
Lech Poznan,8,5,0,3,15,9,6,15,poland,0.62,0.62,6,1.88,1.88,1.61,1.61,3
Pogon Szczecin,8,4,2,2,17,9,8,14,poland,0.5,0.75,8,2.12,1.75,2.0,1.33,4
Slask Wroclaw,8,4,2,2,17,11,6,14,poland,0.5,0.75,6,2.12,1.75,2.0,1.33,4
Korona Kielce,8,4,2,2,10,9,1,14,poland,0.5,0.75,1,1.25,1.75,2.0,1.33,4
Radomiak Radom,8,4,1,3,14,11,3,13,poland,0.5,0.62,3,1.75,1.62,2.0,1.61,5
Legia Warsaw,8,3,2,3,13,12,1,11,poland,0.38,0.62,1,1.62,1.38,2.63,1.61,6
Motor Lublin,8,3,2,3,13,16,-3,11,poland,0.38,0.62,-3,1.62,1.38,2.63,1.61,6
Katowice,8,3,1,4,8,11,-3,10,poland,0.38,0.5,-3,1.0,1.25,2.63,2.0,7
Widzew Lodz,8,3,1,4,7,11,-4,10,poland,0.38,0.5,-4,0.88,1.25,2.63,2.0,7
Gornik Zabrze,8,3,0,5,12,11,1,9,poland,0.38,0.38,1,1.5,1.12,2.63,2.63,8
Cracovia Krakow,8,2,3,3,13,16,-3,9,poland,0.25,0.62,-3,1.62,1.12,4.0,1.61,8
Lechia Gdansk,8,3,0,5,10,14,-4,9,poland,0.38,0.38,-4,1.25,1.12,2.63,2.63,8
Piast Gliwice,8,2,3,3,7,11,-4,9,poland,0.25,0.62,-4,0.88,1.12,4.0,1.61,8
Puszcza Niepolo,8,2,1,5,8,13,-5,7,poland,0.25,0.38,-5,1.0,0.88,4.0,2.63,9
Zaglebie Lubin,8,2,1,5,6,12,-6,7,poland,0.25,0.38,-6,0.75,0.88,4.0,2.63,9
Stal Mielec,8,0,2,6,9,20,-11,2,poland,0.0,0.25,-11,1.12,0.25,0.0,4.0,10
Polonia Warszaw,8,7,1,0,19,9,10,22,poland2,0.88,1.0,10,2.38,2.75,1.14,1.0,1
Tychy,8,7,0,1,16,5,11,21,poland2,0.88,0.88,11,2.0,2.62,1.14,1.14,2
Arka Gdynia,8,6,2,0,13,4,9,20,poland2,0.75,1.0,9,1.62,2.5,1.33,1.0,3
Wisla Plock,8,6,1,1,15,5,10,19,poland2,0.75,0.88,10,1.88,2.38,1.33,1.14,4
Wisla Krakow,8,6,1,1,16,7,9,19,poland2,0.75,0.88,9,2.0,2.38,1.33,1.14,4
T. Nieciecza,8,3,3,2,13,15,-2,12,poland2,0.38,0.75,-2,1.62,1.5,2.63,1.33,5
Znicz Pruszkow,8,3,2,3,9,9,0,11,poland2,0.38,0.62,0,1.12,1.38,2.63,1.61,6
Gornik Leczna,8,3,1,4,8,6,2,10,poland2,0.38,0.5,2,1.0,1.25,2.63,2.0,7
Miedz Legnica,8,3,1,4,8,11,-3,10,poland2,0.38,0.5,-3,1.0,1.25,2.63,2.0,7
Pogon Siedlce,8,2,3,3,10,12,-2,9,poland2,0.25,0.62,-2,1.25,1.12,4.0,1.61,8
Chrobry Glogow,8,2,2,4,12,15,-3,8,poland2,0.25,0.5,-3,1.5,1.0,4.0,2.0,9
LKS Lodz,8,2,2,4,8,11,-3,8,poland2,0.25,0.5,-3,1.0,1.0,4.0,2.0,9
Stal Rzeszow,8,2,2,4,8,12,-4,8,poland2,0.25,0.5,-4,1.0,1.0,4.0,2.0,9
Stalowa Wola,8,1,4,3,7,9,-2,7,poland2,0.12,0.62,-2,0.88,0.88,8.33,1.61,10
K. Kolobrzeg,8,0,5,3,3,6,-3,5,poland2,0.0,0.62,-3,0.38,0.62,0.0,1.61,11
Odra Opole,8,1,2,5,8,15,-7,5,poland2,0.12,0.38,-7,1.0,0.62,8.33,2.63,11
Warta Poznan,8,0,2,6,2,12,-10,2,poland2,0.0,0.25,-10,0.25,0.25,0.0,4.0,12
Ruch Chorzow,8,0,2,6,4,16,-12,2,poland2,0.0,0.25,-12,0.5,0.25,0.0,4.0,12
Polonia Bytom,8,5,3,0,15,8,7,18,poland3,0.62,1.0,7,1.88,2.25,1.61,1.0,1
Pogon Grodzisk,8,6,0,2,15,9,6,18,poland3,0.75,0.75,6,1.88,2.25,1.33,1.33,1
Chojniczanka,8,5,1,2,12,7,5,16,poland3,0.62,0.75,5,1.5,2.0,1.61,1.33,2
Zaglebie L. B,8,4,1,3,12,7,5,13,poland3,0.5,0.62,5,1.5,1.62,2.0,1.61,3
Z. Sosnowiec,8,4,1,3,15,12,3,13,poland3,0.5,0.62,3,1.88,1.62,2.0,1.61,3
Wieczysta K.,8,4,1,3,13,10,3,13,poland3,0.5,0.62,3,1.62,1.62,2.0,1.61,3
O. Grudziadz,8,3,3,2,10,11,-1,12,poland3,0.38,0.75,-1,1.25,1.5,2.63,1.33,4
Rekord Bielsko,8,2,5,1,9,8,1,11,poland3,0.25,0.88,1,1.12,1.38,4.0,1.14,5
Podbeskidzie,8,3,2,3,8,9,-1,11,poland3,0.38,0.62,-1,1.0,1.38,2.63,1.61,5
LKS Lodz B,8,3,2,3,10,12,-2,11,poland3,0.38,0.62,-2,1.25,1.38,2.63,1.61,5
Jastrzebie,8,3,1,4,9,8,1,10,poland3,0.38,0.5,1,1.12,1.25,2.63,2.0,6
Swit Skolwin,8,3,1,4,17,18,-1,10,poland3,0.38,0.5,-1,2.12,1.25,2.63,2.0,6
Wisla Pulawy,8,3,1,4,9,14,-5,10,poland3,0.38,0.5,-5,1.12,1.25,2.63,2.0,6
Resovia Rzeszow,8,2,3,3,11,11,0,9,poland3,0.25,0.62,0,1.38,1.12,4.0,1.61,7
Hutnik Krakow,8,2,2,4,10,16,-6,8,poland3,0.25,0.5,-6,1.25,1.0,4.0,2.0,8
Olimpia Elblag,8,2,1,5,7,10,-3,7,poland3,0.25,0.38,-3,0.88,0.88,4.0,2.63,9
Kalisz,8,2,0,6,7,12,-5,6,poland3,0.25,0.25,-5,0.88,0.75,4.0,4.0,10
SKRA Czestochow,8,2,0,6,7,15,-8,6,poland3,0.25,0.25,-8,0.88,0.75,4.0,4.0,10
Benfica,8,7,1,0,22,7,15,22,portugal,0.88,1.0,15,2.75,2.75,1.14,1.0,1
Sporting CP,8,5,3,0,18,8,10,18,portugal,0.62,1.0,10,2.25,2.25,1.61,1.0,2
Famalicao,8,6,0,2,16,7,9,18,portugal,0.75,0.75,9,2.0,2.25,1.33,1.33,2
Guimaraes,8,5,3,0,11,4,7,18,portugal,0.62,1.0,7,1.38,2.25,1.61,1.0,2
Sporting Braga,8,5,2,1,11,5,6,17,portugal,0.62,0.88,6,1.38,2.12,1.61,1.14,3
FC Porto,8,5,1,2,10,7,3,16,portugal,0.62,0.75,3,1.25,2.0,1.61,1.33,4
Moreirense,8,3,3,2,9,10,-1,12,portugal,0.38,0.75,-1,1.12,1.5,2.63,1.33,5
Nacional,8,3,1,4,8,10,-2,10,portugal,0.38,0.5,-2,1.0,1.25,2.63,2.0,6
Estoril,8,2,3,3,12,14,-2,9,portugal,0.25,0.62,-2,1.5,1.12,4.0,1.61,7
Estrela Amadora,8,2,3,3,4,8,-4,9,portugal,0.25,0.62,-4,0.5,1.12,4.0,1.61,7
Santa Clara,8,2,2,4,3,6,-3,8,portugal,0.25,0.5,-3,0.38,1.0,4.0,2.0,8
Arouca,8,1,4,3,10,13,-3,7,portugal,0.12,0.62,-3,1.25,0.88,8.33,1.61,9
Rio Ave,8,2,1,5,9,12,-3,7,portugal,0.25,0.38,-3,1.12,0.88,4.0,2.63,9
Casa Pia,8,2,1,5,7,12,-5,7,portugal,0.25,0.38,-5,0.88,0.88,4.0,2.63,9
Farense,8,1,3,4,7,10,-3,6,portugal,0.12,0.5,-3,0.88,0.75,8.33,2.0,10
Boavista,8,2,0,6,5,11,-6,6,portugal,0.25,0.25,-6,0.62,0.75,4.0,4.0,10
AVS,8,1,2,5,6,17,-11,5,portugal,0.12,0.38,-11,0.75,0.62,8.33,2.63,11
Gil Vicente,8,1,1,6,4,11,-7,4,portugal,0.12,0.25,-7,0.5,0.5,8.33,4.0,12
Vizela,8,6,2,0,18,6,12,20,portugal2,0.75,1.0,12,2.25,2.5,1.33,1.0,1
Tondela,8,6,2,0,13,6,7,20,portugal2,0.75,1.0,7,1.62,2.5,1.33,1.0,1
Chaves,8,5,0,3,13,7,6,15,portugal2,0.62,0.62,6,1.62,1.88,1.61,1.61,2
Uniao de Leiria,8,4,2,2,12,10,2,14,portugal2,0.5,0.75,2,1.5,1.75,2.0,1.33,3
Alverca,8,3,4,1,14,7,7,13,portugal2,0.38,0.88,7,1.75,1.62,2.63,1.14,4
Torreense,8,3,3,2,16,13,3,12,portugal2,0.38,0.75,3,2.0,1.5,2.63,1.33,5
Feirense,8,4,0,4,10,13,-3,12,portugal2,0.5,0.5,-3,1.25,1.5,2.0,2.0,5
Maritimo,8,3,3,2,7,10,-3,12,portugal2,0.38,0.75,-3,0.88,1.5,2.63,1.33,5
Academico Viseu,8,2,5,1,8,6,2,11,portugal2,0.25,0.88,2,1.0,1.38,4.0,1.14,6
FC Porto B,8,3,2,3,9,8,1,11,portugal2,0.38,0.62,1,1.12,1.38,2.63,1.61,6
Felgueiras,8,2,4,2,5,6,-1,10,portugal2,0.25,0.75,-1,0.62,1.25,4.0,1.33,7
Oliveirense,8,3,1,4,10,16,-6,10,portugal2,0.38,0.5,-6,1.25,1.25,2.63,2.0,7
Benfica B,8,2,3,3,7,8,-1,9,portugal2,0.25,0.62,-1,0.88,1.12,4.0,1.61,8
Leixoes,8,1,4,3,5,7,-2,7,portugal2,0.12,0.62,-2,0.62,0.88,8.33,1.61,9
Mafra,8,2,1,5,8,15,-7,7,portugal2,0.25,0.38,-7,1.0,0.88,4.0,2.63,9
Penafiel,8,2,0,6,10,13,-3,6,portugal2,0.25,0.25,-3,1.25,0.75,4.0,4.0,10
Pacos Ferreira,8,1,1,6,4,10,-6,4,portugal2,0.12,0.25,-6,0.5,0.5,8.33,4.0,11
Portimonense,8,1,1,6,8,16,-8,4,portugal2,0.12,0.25,-8,1.0,0.5,8.33,4.0,11
Al Sadd,8,8,0,0,23,2,21,24,qatar,1.0,1.0,21,2.88,3.0,1.0,1.0,1
Al Duhail,8,6,0,2,13,10,3,18,qatar,0.75,0.75,3,1.62,2.25,1.33,1.33,2
Al Gharafa,8,4,2,2,13,13,0,14,qatar,0.5,0.75,0,1.62,1.75,2.0,1.33,3
Al Rayyan,8,4,1,3,20,12,8,13,qatar,0.5,0.62,8,2.5,1.62,2.0,1.61,4
Al Shamal,8,3,1,4,15,11,4,10,qatar,0.38,0.5,4,1.88,1.25,2.63,2.0,5
Qatar SC,8,2,4,2,11,10,1,10,qatar,0.25,0.75,1,1.38,1.25,4.0,1.33,5
Al Arabi,8,3,1,4,12,14,-2,10,qatar,0.38,0.5,-2,1.5,1.25,2.63,2.0,5
Al Ahli Doha,8,3,1,4,10,15,-5,10,qatar,0.38,0.5,-5,1.25,1.25,2.63,2.0,5
Al Shahaniya,8,3,1,4,10,17,-7,10,qatar,0.38,0.5,-7,1.25,1.25,2.63,2.0,5
Al Wakrah,8,2,2,4,6,13,-7,8,qatar,0.25,0.5,-7,0.75,1.0,4.0,2.0,6
Al Khor,8,2,0,6,9,18,-9,6,qatar,0.25,0.25,-9,1.12,0.75,4.0,4.0,7
Umm Salal,8,1,1,6,6,13,-7,4,qatar,0.12,0.25,-7,0.75,0.5,8.33,4.0,8
CFR Cluj,8,5,3,0,19,5,14,18,romania,0.62,1.0,14,2.38,2.25,1.61,1.0,1
FCSB,8,5,3,0,10,2,8,18,romania,0.62,1.0,8,1.25,2.25,1.61,1.0,1
Univ. Craiova,8,5,1,2,11,6,5,16,romania,0.62,0.75,5,1.38,2.0,1.61,1.33,2
Din. Bucharest,8,4,2,2,10,6,4,14,romania,0.5,0.75,4,1.25,1.75,2.0,1.33,3
Rapid Bucharest,8,4,2,2,9,6,3,14,romania,0.5,0.75,3,1.12,1.75,2.0,1.33,3
Hermannstadt,8,4,2,2,9,7,2,14,romania,0.5,0.75,2,1.12,1.75,2.0,1.33,3
U. Cluj,8,3,3,2,9,8,1,12,romania,0.38,0.75,1,1.12,1.5,2.63,1.33,4
Botosani,8,3,3,2,8,7,1,12,romania,0.38,0.75,1,1.0,1.5,2.63,1.33,4
Sepsi OSK,8,3,2,3,8,9,-1,11,romania,0.38,0.62,-1,1.0,1.38,2.63,1.61,5
Farul Constanta,8,3,1,4,8,10,-2,10,romania,0.38,0.5,-2,1.0,1.25,2.63,2.0,6
P. Iasi,8,2,3,3,8,12,-4,9,romania,0.25,0.62,-4,1.0,1.12,4.0,1.61,7
Petrolul,8,2,2,4,6,8,-2,8,romania,0.25,0.5,-2,0.75,1.0,4.0,2.0,8
UTA Arad,8,2,2,4,5,10,-5,8,romania,0.25,0.5,-5,0.62,1.0,4.0,2.0,8
Otelul,8,2,1,5,7,11,-4,7,romania,0.25,0.38,-4,0.88,0.88,4.0,2.63,9
FC Buzau,8,1,1,6,6,16,-10,4,romania,0.12,0.25,-10,0.75,0.5,8.33,4.0,10
Unirea Slobozia,8,0,1,7,4,14,-10,1,romania,0.0,0.12,-10,0.5,0.12,0.0,8.33,11
CSKA Moscow,8,6,2,0,13,4,9,20,russia,0.75,1.0,9,1.62,2.5,1.33,1.0,1
Spartak Moscow,8,5,1,2,15,5,10,16,russia,0.62,0.75,10,1.88,2.0,1.61,1.33,2
FC Krasnodar,8,4,2,2,12,8,4,14,russia,0.5,0.75,4,1.5,1.75,2.0,1.33,3
Akhmat Grozny,8,3,5,0,8,5,3,14,russia,0.38,1.0,3,1.0,1.75,2.63,1.0,3
Rubin Kazan,8,4,2,2,11,12,-1,14,russia,0.5,0.75,-1,1.38,1.75,2.0,1.33,3
Rostov,8,4,1,3,14,11,3,13,russia,0.5,0.62,3,1.75,1.62,2.0,1.61,4
Dinamo Moscow,8,3,3,2,18,10,8,12,russia,0.38,0.75,8,2.25,1.5,2.63,1.33,5
Akron,8,4,0,4,10,9,1,12,russia,0.5,0.5,1,1.25,1.5,2.0,2.0,5
Zenit,8,3,2,3,15,9,6,11,russia,0.38,0.62,6,1.88,1.38,2.63,1.61,6
Makhachkala,8,3,2,3,13,12,1,11,russia,0.38,0.62,1,1.62,1.38,2.63,1.61,6
Krylya Sovetov,8,3,2,3,14,15,-1,11,russia,0.38,0.62,-1,1.75,1.38,2.63,1.61,6
Khimki,8,3,1,4,10,14,-4,10,russia,0.38,0.5,-4,1.25,1.25,2.63,2.0,7
Lokomotiv M.,8,1,4,3,7,13,-6,7,russia,0.12,0.62,-6,0.88,0.88,8.33,1.61,8
Orenburg,8,2,0,6,5,14,-9,6,russia,0.25,0.25,-9,0.62,0.75,4.0,4.0,9
Nizhny Novgorod,8,1,1,6,4,17,-13,4,russia,0.12,0.25,-13,0.5,0.5,8.33,4.0,10
Fakel Voronezh,8,0,2,6,0,11,-11,2,russia,0.0,0.25,-11,0.0,0.25,0.0,4.0,11
Baltika,8,6,2,0,18,1,17,20,russia2,0.75,1.0,17,2.25,2.5,1.33,1.0,1
SKA Khabarovsk,8,6,0,2,7,3,4,18,russia2,0.75,0.75,4,0.88,2.25,1.33,1.33,2
Chernomorets,8,4,3,1,12,5,7,15,russia2,0.5,0.88,7,1.5,1.88,2.0,1.14,3
Rodina Moskva,8,4,2,2,10,6,4,14,russia2,0.5,0.75,4,1.25,1.75,2.0,1.33,4
Yenisey,8,4,2,2,7,5,2,14,russia2,0.5,0.75,2,0.88,1.75,2.0,1.33,4
Ural,8,3,4,1,8,6,2,13,russia2,0.38,0.88,2,1.0,1.62,2.63,1.14,5
PFC Sochi,8,4,1,3,8,8,0,13,russia2,0.5,0.62,0,1.0,1.62,2.0,1.61,5
Shinnik,8,3,3,2,8,7,1,12,russia2,0.38,0.75,1,1.0,1.5,2.63,1.33,6
Tyumen,8,3,2,3,7,7,0,11,russia2,0.38,0.62,0,0.88,1.38,2.63,1.61,7
Torpedo Moscow,8,3,2,3,4,5,-1,11,russia2,0.38,0.62,-1,0.5,1.38,2.63,1.61,7
Neftekhimik,8,3,1,4,11,10,1,10,russia2,0.38,0.5,1,1.38,1.25,2.63,2.0,8
Kamaz,8,3,1,4,9,10,-1,10,russia2,0.38,0.5,-1,1.12,1.25,2.63,2.0,8
Rotor Volgograd,8,1,5,2,5,6,-1,8,russia2,0.12,0.75,-1,0.62,1.0,8.33,1.33,9
Arsenal Tula,8,1,3,4,2,6,-4,6,russia2,0.12,0.5,-4,0.25,0.75,8.33,2.0,10
Chayka,8,1,3,4,6,14,-8,6,russia2,0.12,0.5,-8,0.75,0.75,8.33,2.0,10
Ufa,8,1,3,4,5,13,-8,6,russia2,0.12,0.5,-8,0.62,0.75,8.33,2.0,10
A. Vladikavkaz,8,1,2,5,5,14,-9,5,russia2,0.12,0.38,-9,0.62,0.62,8.33,2.63,11
Sokol Saratov,8,0,3,5,5,11,-6,3,russia2,0.0,0.38,-6,0.62,0.38,0.0,2.63,12
Al Shabab,8,5,2,1,21,9,12,17,saudiarabia,0.62,0.88,12,2.62,2.12,1.61,1.14,1
Al Ittihad,8,4,4,0,17,8,9,16,saudiarabia,0.5,1.0,9,2.12,2.0,2.0,1.0,2
Al Fateh,8,5,1,2,17,9,8,16,saudiarabia,0.62,0.75,8,2.12,2.0,1.61,1.33,2
Al Nassr,8,5,1,2,18,12,6,16,saudiarabia,0.62,0.75,6,2.25,2.0,1.61,1.33,2
Al Ahli Jeddah,8,4,2,2,18,12,6,14,saudiarabia,0.5,0.75,6,2.25,1.75,2.0,1.33,3
Al Taawon,8,4,2,2,11,7,4,14,saudiarabia,0.5,0.75,4,1.38,1.75,2.0,1.33,3
Al Feiha,8,3,4,1,7,4,3,13,saudiarabia,0.38,0.88,3,0.88,1.62,2.63,1.14,4
Al Ittifaq,8,3,3,2,10,10,0,12,saudiarabia,0.38,0.75,0,1.25,1.5,2.63,1.33,5
Al Hilal,8,3,2,3,15,13,2,11,saudiarabia,0.38,0.62,2,1.88,1.38,2.63,1.61,6
Al Quadisiya,8,3,2,3,10,11,-1,11,saudiarabia,0.38,0.62,-1,1.25,1.38,2.63,1.61,6
Al Wahda,8,3,1,4,8,11,-3,10,saudiarabia,0.38,0.5,-3,1.0,1.25,2.63,2.0,7
Al Akhdoud,8,2,3,3,6,9,-3,9,saudiarabia,0.25,0.62,-3,0.75,1.12,4.0,1.61,8
Al Orubah,8,3,0,5,7,14,-7,9,saudiarabia,0.38,0.38,-7,0.88,1.12,2.63,2.63,8
Al Kholood,8,3,0,5,7,16,-9,9,saudiarabia,0.38,0.38,-9,0.88,1.12,2.63,2.63,8
Al Riyadh,8,1,3,4,5,9,-4,6,saudiarabia,0.12,0.5,-4,0.62,0.75,8.33,2.0,9
Al Khaleej,8,1,3,4,7,14,-7,6,saudiarabia,0.12,0.5,-7,0.88,0.75,8.33,2.0,9
Damak,8,1,2,5,2,10,-8,5,saudiarabia,0.12,0.38,-8,0.25,0.62,8.33,2.63,10
Al Raed,8,1,1,6,8,16,-8,4,saudiarabia,0.12,0.25,-8,1.0,0.5,8.33,4.0,11
Neom SC,8,7,1,0,23,5,18,22,saudiarabia2,0.88,1.0,18,2.88,2.75,1.14,1.0,1
Al Najma,8,6,1,1,14,6,8,19,saudiarabia2,0.75,0.88,8,1.75,2.38,1.33,1.14,2
Al Zulfi,8,4,3,1,10,4,6,15,saudiarabia2,0.5,0.88,6,1.25,1.88,2.0,1.14,3
Al Bukayriyah,8,4,3,1,9,4,5,15,saudiarabia2,0.5,0.88,5,1.12,1.88,2.0,1.14,3
Al Adalha,8,4,2,2,15,11,4,14,saudiarabia2,0.5,0.75,4,1.88,1.75,2.0,1.33,4
Abha,8,2,6,0,15,10,5,12,saudiarabia2,0.25,1.0,5,1.88,1.5,4.0,1.0,5
Al Jabalain,8,3,3,2,11,8,3,12,saudiarabia2,0.38,0.75,3,1.38,1.5,2.63,1.33,5
Al Faisaly,8,3,3,2,9,10,-1,12,saudiarabia2,0.38,0.75,-1,1.12,1.5,2.63,1.33,5
Al Hazm,8,3,2,3,10,12,-2,11,saudiarabia2,0.38,0.62,-2,1.25,1.38,2.63,1.61,6
Al Tai,8,3,1,4,10,11,-1,10,saudiarabia2,0.38,0.5,-1,1.25,1.25,2.63,2.0,7
Jeddah,8,2,3,3,5,7,-2,9,saudiarabia2,0.25,0.62,-2,0.62,1.12,4.0,1.61,8
Al Batin,8,2,3,3,10,16,-6,9,saudiarabia2,0.25,0.62,-6,1.25,1.12,4.0,1.61,8
Ohod,8,2,2,4,9,11,-2,8,saudiarabia2,0.25,0.5,-2,1.12,1.0,4.0,2.0,9
Al Ain,8,1,3,4,8,18,-10,6,saudiarabia2,0.12,0.5,-10,1.0,0.75,8.33,2.0,10
Al Jandal,8,1,2,5,4,10,-6,5,saudiarabia2,0.12,0.38,-6,0.5,0.62,8.33,2.63,11
Al Jubail,8,0,5,3,6,13,-7,5,saudiarabia2,0.0,0.62,-7,0.75,0.62,0.0,1.61,11
Al Arabi,8,1,1,6,10,16,-6,4,saudiarabia2,0.12,0.25,-6,1.25,0.5,8.33,4.0,12
Al Safa,8,0,2,6,6,19,-13,2,saudiarabia2,0.0,0.25,-13,0.75,0.25,0.0,4.0,13
Hibernian,8,6,2,0,17,4,13,20,scotland,0.75,1.0,13,2.12,2.5,1.33,1.0,1
Celtic,8,5,0,3,24,10,14,15,scotland,0.62,0.62,14,3.0,1.88,1.61,1.61,2
Aberdeen,8,4,3,1,13,11,2,15,scotland,0.5,0.88,2,1.62,1.88,2.0,1.14,2
Rangers,8,4,1,3,17,16,1,13,scotland,0.5,0.62,1,2.12,1.62,2.0,1.61,3
Dundee Utd,8,4,1,3,9,12,-3,13,scotland,0.5,0.62,-3,1.12,1.62,2.0,1.61,3
St. Mirren,8,3,2,3,15,15,0,11,scotland,0.38,0.62,0,1.88,1.38,2.63,1.61,4
Hearts,8,3,1,4,9,11,-2,10,scotland,0.38,0.5,-2,1.12,1.25,2.63,2.0,5
Ross County,8,3,0,5,9,9,0,9,scotland,0.38,0.38,0,1.12,1.12,2.63,2.63,6
St. Johnstone,8,2,2,4,5,10,-5,8,scotland,0.25,0.5,-5,0.62,1.0,4.0,2.0,7
Motherwell,8,2,2,4,7,14,-7,8,scotland,0.25,0.5,-7,0.88,1.0,4.0,2.0,7
Dundee FC,8,2,1,5,13,18,-5,7,scotland,0.25,0.38,-5,1.62,0.88,4.0,2.63,8
Kilmarnock,8,2,1,5,10,18,-8,7,scotland,0.25,0.38,-8,1.25,0.88,4.0,2.63,8
Falkirk,8,5,2,1,18,4,14,17,scotland2,0.62,0.88,14,2.25,2.12,1.61,1.14,1
Livingston,8,4,3,1,13,8,5,15,scotland2,0.5,0.88,5,1.62,1.88,2.0,1.14,2
Raith Rovers,8,3,4,1,10,8,2,13,scotland2,0.38,0.88,2,1.25,1.62,2.63,1.14,3
Partick Thistle,8,3,3,2,9,6,3,12,scotland2,0.38,0.75,3,1.12,1.5,2.63,1.33,4
Ayr Utd,8,3,2,3,13,10,3,11,scotland2,0.38,0.62,3,1.62,1.38,2.63,1.61,5
Airdrieonians,8,3,2,3,14,15,-1,11,scotland2,0.38,0.62,-1,1.75,1.38,2.63,1.61,5
Hamilton,8,3,2,3,8,11,-3,11,scotland2,0.38,0.62,-3,1.0,1.38,2.63,1.61,5
Greenock Morton,8,3,1,4,11,15,-4,10,scotland2,0.38,0.5,-4,1.38,1.25,2.63,2.0,6
Dunfermline,8,3,0,5,4,9,-5,9,scotland2,0.38,0.38,-5,0.5,1.12,2.63,2.63,7
Queens Park,8,1,0,7,7,20,-13,3,scotland2,0.12,0.12,-13,0.88,0.38,8.33,8.33,8
Arbroath,8,6,2,0,16,5,11,20,scotland3,0.75,1.0,11,2.0,2.5,1.33,1.0,1
Queen of South,8,5,1,2,15,8,7,16,scotland3,0.62,0.75,7,1.88,2.0,1.61,1.33,2
Alloa Athletic,8,4,1,3,18,15,3,13,scotland3,0.5,0.62,3,2.25,1.62,2.0,1.61,3
Cove Rangers,8,3,2,3,13,10,3,11,scotland3,0.38,0.62,3,1.62,1.38,2.63,1.61,4
Inverness,8,3,2,3,11,10,1,11,scotland3,0.38,0.62,1,1.38,1.38,2.63,1.61,4
Montrose,8,2,3,3,10,12,-2,9,scotland3,0.25,0.62,-2,1.25,1.12,4.0,1.61,5
Kelty Hearts,8,2,3,3,5,13,-8,9,scotland3,0.25,0.62,-8,0.62,1.12,4.0,1.61,5
Dumbarton,8,2,2,4,13,12,1,8,scotland3,0.25,0.5,1,1.62,1.0,4.0,2.0,6
Stenhousemuir,8,2,2,4,9,16,-7,8,scotland3,0.25,0.5,-7,1.12,1.0,4.0,2.0,6
Annan Athletic,8,2,0,6,7,16,-9,6,scotland3,0.25,0.25,-9,0.88,0.75,4.0,4.0,7
Peterhead,8,5,3,0,12,1,11,18,scotland4,0.62,1.0,11,1.5,2.25,1.61,1.0,1
Edinburgh City,8,5,0,3,13,9,4,15,scotland4,0.62,0.62,4,1.62,1.88,1.61,1.61,2
Stirling Albion,8,4,2,2,10,8,2,14,scotland4,0.5,0.75,2,1.25,1.75,2.0,1.33,3
Forfar Athletic,8,4,2,2,6,5,1,14,scotland4,0.5,0.75,1,0.75,1.75,2.0,1.33,3
Spartans,8,4,1,3,12,9,3,13,scotland4,0.5,0.62,3,1.5,1.62,2.0,1.61,4
Clyde,8,3,1,4,9,11,-2,10,scotland4,0.38,0.5,-2,1.12,1.25,2.63,2.0,5
East Fife,8,3,1,4,10,13,-3,10,scotland4,0.38,0.5,-3,1.25,1.25,2.63,2.0,5
Elgin City,8,3,0,5,5,10,-5,9,scotland4,0.38,0.38,-5,0.62,1.12,2.63,2.63,6
Stranraer,8,2,1,5,8,10,-2,7,scotland4,0.25,0.38,-2,1.0,0.88,4.0,2.63,7
Bonnyrigg Rose,8,0,1,7,3,18,-15,1,scotland4,0.0,0.12,-15,0.38,0.12,0.0,8.33,8
Red Star,8,7,1,0,27,9,18,22,serbia,0.88,1.0,18,3.38,2.75,1.14,1.0,1
Partizan,8,6,2,0,19,7,12,20,serbia,0.75,1.0,12,2.38,2.5,1.33,1.0,2
IMT N. Beograd,8,4,2,2,10,8,2,14,serbia,0.5,0.75,2,1.25,1.75,2.0,1.33,3
OFK Beograd,8,4,1,3,13,11,2,13,serbia,0.5,0.62,2,1.62,1.62,2.0,1.61,4
Backa Topola,8,4,1,3,13,12,1,13,serbia,0.5,0.62,1,1.62,1.62,2.0,1.61,4
Novi Pazar,8,3,3,2,13,11,2,12,serbia,0.38,0.75,2,1.62,1.5,2.63,1.33,5
S. Subotica,8,3,2,3,8,8,0,11,serbia,0.38,0.62,0,1.0,1.38,2.63,1.61,6
Radnicki 1923,8,3,2,3,8,9,-1,11,serbia,0.38,0.62,-1,1.0,1.38,2.63,1.61,6
Vojvodina,8,3,1,4,14,15,-1,10,serbia,0.38,0.5,-1,1.75,1.25,2.63,2.0,7
Tekstilac Odzac,8,3,1,4,9,13,-4,10,serbia,0.38,0.5,-4,1.12,1.25,2.63,2.0,7
Jedinstvo U.,8,2,2,4,10,10,0,8,serbia,0.25,0.5,0,1.25,1.0,4.0,2.0,8
Z. Pancevo,8,2,2,4,10,12,-2,8,serbia,0.25,0.5,-2,1.25,1.0,4.0,2.0,8
Cukaricki,8,2,2,4,7,10,-3,8,serbia,0.25,0.5,-3,0.88,1.0,4.0,2.0,8
Napredak,8,2,2,4,6,13,-7,8,serbia,0.25,0.5,-7,0.75,1.0,4.0,2.0,8
Mladost Lucani,8,1,3,4,4,11,-7,6,serbia,0.12,0.5,-7,0.5,0.75,8.33,2.0,9
Radnicki Nis,8,0,3,5,8,20,-12,3,serbia,0.0,0.38,-12,1.0,0.38,0.0,2.63,10
R. Surdulica,8,7,0,1,16,4,12,21,serbia2,0.88,0.88,12,2.0,2.62,1.14,1.14,1
Dubocica,8,5,1,2,16,8,8,16,serbia2,0.62,0.75,8,2.0,2.0,1.61,1.33,2
Zemun,8,4,2,2,10,8,2,14,serbia2,0.5,0.75,2,1.25,1.75,2.0,1.33,3
Sloven Ruma,8,3,4,1,13,10,3,13,serbia2,0.38,0.88,3,1.62,1.62,2.63,1.14,4
Vozdovac,8,3,4,1,8,5,3,13,serbia2,0.38,0.88,3,1.0,1.62,2.63,1.14,4
S. Mitrovica,8,3,4,1,7,4,3,13,serbia2,0.38,0.88,3,0.88,1.62,2.63,1.14,4
Graficar,8,3,4,1,9,7,2,13,serbia2,0.38,0.88,2,1.12,1.62,2.63,1.14,4
Borac Cacak,8,3,2,3,7,8,-1,11,serbia2,0.38,0.62,-1,0.88,1.38,2.63,1.61,5
Macva Sabac,8,2,4,2,6,7,-1,10,serbia2,0.25,0.75,-1,0.75,1.25,4.0,1.33,6
Mladost,8,2,4,2,6,8,-2,10,serbia2,0.25,0.75,-2,0.75,1.25,4.0,1.33,6
Trajal Krusevac,8,2,3,3,9,9,0,9,serbia2,0.25,0.62,0,1.12,1.12,4.0,1.61,7
Smederevo,8,1,4,3,6,8,-2,7,serbia2,0.12,0.62,-2,0.75,0.88,8.33,1.61,8
Javor Ivanjica,8,1,3,4,6,11,-5,6,serbia2,0.12,0.5,-5,0.75,0.75,8.33,2.0,9
Sloboda Uzice,8,1,2,5,5,13,-8,5,serbia2,0.12,0.38,-8,0.62,0.62,8.33,2.63,10
Indija,8,1,1,6,7,14,-7,4,serbia2,0.12,0.25,-7,0.88,0.5,8.33,4.0,11
Vrsac,8,0,4,4,1,8,-7,4,serbia2,0.0,0.5,-7,0.12,0.5,0.0,2.0,11
Lion City,8,6,2,0,27,4,23,20,singapore,0.75,1.0,23,3.38,2.5,1.33,1.0,1
Tampines Rovers,8,6,0,2,22,7,15,18,singapore,0.75,0.75,15,2.75,2.25,1.33,1.33,2
Geylang,8,4,1,3,20,15,5,13,singapore,0.5,0.62,5,2.5,1.62,2.0,1.61,3
Hougang,8,3,2,3,18,16,2,11,singapore,0.38,0.62,2,2.25,1.38,2.63,1.61,4
A. Niigata (S),8,3,2,3,8,13,-5,11,singapore,0.38,0.62,-5,1.0,1.38,2.63,1.61,4
Khalsa,8,2,1,5,15,26,-11,7,singapore,0.25,0.38,-11,1.88,0.88,4.0,2.63,5
Young Lions,8,1,4,3,9,21,-12,7,singapore,0.12,0.62,-12,1.12,0.88,8.33,1.61,5
DPMM FC,8,1,2,5,7,15,-8,5,singapore,0.12,0.38,-8,0.88,0.62,8.33,2.63,6
Tanjong Pagar,8,1,2,5,9,22,-13,5,singapore,0.12,0.38,-13,1.12,0.62,8.33,2.63,6
FC Kosice,8,5,1,2,17,10,7,16,slovakia,0.62,0.75,7,2.12,2.0,1.61,1.33,1
Skalica,8,4,3,1,8,4,4,15,slovakia,0.5,0.88,4,1.0,1.88,2.0,1.14,2
S. Bratislava,8,3,4,1,16,9,7,13,slovakia,0.38,0.88,7,2.0,1.62,2.63,1.14,3
DAC Streda,8,2,6,0,14,9,5,12,slovakia,0.25,1.0,5,1.75,1.5,4.0,1.0,4
Trencin,8,3,3,2,11,10,1,12,slovakia,0.38,0.75,1,1.38,1.5,2.63,1.33,4
Komarno,8,3,3,2,7,6,1,12,slovakia,0.38,0.75,1,0.88,1.5,2.63,1.33,4
Z. Michalovce,8,3,2,3,12,12,0,11,slovakia,0.38,0.62,0,1.5,1.38,2.63,1.61,5
Spartak Trnava,8,2,4,2,10,11,-1,10,slovakia,0.25,0.75,-1,1.25,1.25,4.0,1.33,6
Zilina,8,2,2,4,8,15,-7,8,slovakia,0.25,0.5,-7,1.0,1.0,4.0,2.0,7
Podbrezova,8,1,4,3,8,11,-3,7,slovakia,0.12,0.62,-3,1.0,0.88,8.33,1.61,8
Ruzomberok,8,2,1,5,9,14,-5,7,slovakia,0.25,0.38,-5,1.12,0.88,4.0,2.63,8
Banska Bystrica,8,1,1,6,9,18,-9,4,slovakia,0.12,0.25,-9,1.12,0.5,8.33,4.0,9
Zlate Moravce,8,6,2,0,13,3,10,20,slovakia2,0.75,1.0,10,1.62,2.5,1.33,1.0,1
Presov,8,6,1,1,11,2,9,19,slovakia2,0.75,0.88,9,1.38,2.38,1.33,1.14,2
Petrzalka,8,4,3,1,11,5,6,15,slovakia2,0.5,0.88,6,1.38,1.88,2.0,1.14,3
S. Bratislava B,8,4,2,2,14,10,4,14,slovakia2,0.5,0.75,4,1.75,1.75,2.0,1.33,4
L. Mikulas,8,3,3,2,13,9,4,12,slovakia2,0.38,0.75,4,1.62,1.5,2.63,1.33,5
Zilina B,8,4,0,4,12,12,0,12,slovakia2,0.5,0.5,0,1.5,1.5,2.0,2.0,5
P. Bystrica,8,3,2,3,9,6,3,11,slovakia2,0.38,0.62,3,1.12,1.38,2.63,1.61,6
Puchov,8,3,2,3,14,14,0,11,slovakia2,0.38,0.62,0,1.75,1.38,2.63,1.61,6
Zvolen,8,3,1,4,8,8,0,10,slovakia2,0.38,0.5,0,1.0,1.25,2.63,2.0,7
Samorin,8,3,1,4,7,11,-4,10,slovakia2,0.38,0.5,-4,0.88,1.25,2.63,2.0,7
Pohronie,8,3,0,5,9,15,-6,9,slovakia2,0.38,0.38,-6,1.12,1.12,2.63,2.63,8
S. Lubovna,8,2,1,5,7,9,-2,7,slovakia2,0.25,0.38,-2,0.88,0.88,4.0,2.63,9
Malzenice,8,1,1,6,5,14,-9,4,slovakia2,0.12,0.25,-9,0.62,0.5,8.33,4.0,10
Humenne,8,1,1,6,3,18,-15,4,slovakia2,0.12,0.25,-15,0.38,0.5,8.33,4.0,10
NK Celje,8,5,2,1,19,9,10,17,slovenia,0.62,0.88,10,2.38,2.12,1.61,1.14,1
Maribor,8,4,2,2,14,7,7,14,slovenia,0.5,0.75,7,1.75,1.75,2.0,1.33,2
NK Olimpija,8,4,2,2,13,7,6,14,slovenia,0.5,0.75,6,1.62,1.75,2.0,1.33,2
Koper,8,3,4,1,12,10,2,13,slovenia,0.38,0.88,2,1.5,1.62,2.63,1.14,3
Domzale,8,3,1,4,14,13,1,10,slovenia,0.38,0.5,1,1.75,1.25,2.63,2.0,4
Primorje,8,2,4,2,11,11,0,10,slovenia,0.25,0.75,0,1.38,1.25,4.0,1.33,4
Nafta,8,2,4,2,13,14,-1,10,slovenia,0.25,0.75,-1,1.62,1.25,4.0,1.33,4
Radomlje,8,3,1,4,10,15,-5,10,slovenia,0.38,0.5,-5,1.25,1.25,2.63,2.0,4
Mura,8,2,1,5,10,13,-3,7,slovenia,0.25,0.38,-3,1.25,0.88,4.0,2.63,5
Bravo,8,0,4,4,7,16,-9,4,slovenia,0.0,0.5,-9,0.88,0.5,0.0,2.0,6
Mamelodi S.,8,5,1,2,16,8,8,16,southafrica,0.62,0.75,8,2.0,2.0,1.61,1.33,1
Orlando Pirates,8,5,1,2,9,9,0,16,southafrica,0.62,0.75,0,1.12,2.0,1.61,1.33,1
Stellenbosch,8,4,3,1,8,5,3,15,southafrica,0.5,0.88,3,1.0,1.88,2.0,1.14,2
Magesi,8,5,0,3,6,6,0,15,southafrica,0.62,0.62,0,0.75,1.88,1.61,1.61,2
Sekhukhune,8,4,1,3,14,13,1,13,southafrica,0.5,0.62,1,1.75,1.62,2.0,1.61,3
Chippa Utd,8,3,2,3,6,4,2,11,southafrica,0.38,0.62,2,0.75,1.38,2.63,1.61,4
Richards Bay,8,3,2,3,8,7,1,11,southafrica,0.38,0.62,1,1.0,1.38,2.63,1.61,4
TS Galaxy,8,3,2,3,13,13,0,11,southafrica,0.38,0.62,0,1.62,1.38,2.63,1.61,4
Marumo G.,8,3,2,3,8,8,0,11,southafrica,0.38,0.62,0,1.0,1.38,2.63,1.61,4
AmaZulu,8,3,1,4,8,7,1,10,southafrica,0.38,0.5,1,1.0,1.25,2.63,2.0,5
Golden Arrows,8,2,3,3,5,10,-5,9,southafrica,0.25,0.62,-5,0.62,1.12,4.0,1.61,6
Kaizer Chiefs,8,2,2,4,5,10,-5,8,southafrica,0.25,0.5,-5,0.62,1.0,4.0,2.0,7
SuperSport Utd,8,1,4,3,7,10,-3,7,southafrica,0.12,0.62,-3,0.88,0.88,8.33,1.61,8
Royal AM,8,1,2,5,9,13,-4,5,southafrica,0.12,0.38,-4,1.12,0.62,8.33,2.63,9
Polokwane,8,1,2,5,4,9,-5,5,southafrica,0.12,0.38,-5,0.5,0.62,8.33,2.63,9
Cape Town City,8,0,3,5,3,10,-7,3,southafrica,0.0,0.38,-7,0.38,0.38,0.0,2.63,10
Kruger United,8,5,2,1,12,8,4,17,southafrica2,0.62,0.88,4,1.5,2.12,1.61,1.14,1
Black Leopards,8,4,3,1,15,8,7,15,southafrica2,0.5,0.88,7,1.88,1.88,2.0,1.14,2
Casric Stars,8,3,4,1,12,7,5,13,southafrica2,0.38,0.88,5,1.5,1.62,2.63,1.14,3
Highbury,8,3,3,2,9,5,4,12,southafrica2,0.38,0.75,4,1.12,1.5,2.63,1.33,4
Durban City,8,3,3,2,6,5,1,12,southafrica2,0.38,0.75,1,0.75,1.5,2.63,1.33,4
Orbit College,8,2,5,1,6,5,1,11,southafrica2,0.25,0.88,1,0.75,1.38,4.0,1.14,5
Leruma United,8,2,5,1,7,7,0,11,southafrica2,0.25,0.88,0,0.88,1.38,4.0,1.14,5
Cape Town Spurs,8,2,4,2,7,8,-1,10,southafrica2,0.25,0.75,-1,0.88,1.25,4.0,1.33,6
Baroka,8,2,4,2,9,11,-2,10,southafrica2,0.25,0.75,-2,1.12,1.25,4.0,1.33,6
Venda FC,8,2,3,3,5,4,1,9,southafrica2,0.25,0.62,1,0.62,1.12,4.0,1.61,7
Hungry Lions,8,2,2,4,6,7,-1,8,southafrica2,0.25,0.5,-1,0.75,1.0,4.0,2.0,8
JDR Stars,8,1,5,2,7,10,-3,8,southafrica2,0.12,0.75,-3,0.88,1.0,8.33,1.33,8
Milford,8,2,2,4,10,16,-6,8,southafrica2,0.25,0.5,-6,1.25,1.0,4.0,2.0,8
Pretoria U.,8,1,4,3,7,9,-2,7,southafrica2,0.12,0.62,-2,0.88,0.88,8.33,1.61,9
Upington City,8,2,1,5,3,7,-4,7,southafrica2,0.25,0.38,-4,0.38,0.88,4.0,2.63,9
Pretoria C.,8,2,1,5,5,10,-5,7,southafrica2,0.25,0.38,-5,0.62,0.88,4.0,2.63,9
Gimcheon Sangmu,8,4,2,2,12,8,4,14,southkorea,0.5,0.75,4,1.5,1.75,2.0,1.33,1
Ulsan,8,4,2,2,9,5,4,14,southkorea,0.5,0.75,4,1.12,1.75,2.0,1.33,1
Daejeon Citizen,8,4,2,2,12,11,1,14,southkorea,0.5,0.75,1,1.5,1.75,2.0,1.33,1
Seoul,8,3,4,1,8,7,1,13,southkorea,0.38,0.88,1,1.0,1.62,2.63,1.14,2
Jeonbuk Motors,8,3,3,2,10,8,2,12,southkorea,0.38,0.75,2,1.25,1.5,2.63,1.33,3
Gwangju,8,3,3,2,10,9,1,12,southkorea,0.38,0.75,1,1.25,1.5,2.63,1.33,3
Pohang Steelers,8,3,3,2,10,11,-1,12,southkorea,0.38,0.75,-1,1.25,1.5,2.63,1.33,3
Gangwon,8,3,1,4,5,7,-2,10,southkorea,0.38,0.5,-2,0.62,1.25,2.63,2.0,4
Anyang,8,3,0,5,8,10,-2,9,southkorea,0.38,0.38,-2,1.0,1.12,2.63,2.63,5
Jeju Utd,8,2,2,4,7,10,-3,8,southkorea,0.25,0.5,-3,0.88,1.0,4.0,2.0,6
Suwon City,8,1,4,3,6,9,-3,7,southkorea,0.12,0.62,-3,0.75,0.88,8.33,1.61,7
Daegu,8,1,1,6,7,12,-5,4,southkorea,0.12,0.25,-5,0.88,0.5,8.33,4.0,8
Incheon Utd,7,5,1,1,10,4,6,16,southkorea2,0.71,0.86,6,1.43,2.29,1.41,1.16,1
Seongnam,7,4,3,0,8,3,5,15,southkorea2,0.57,1.0,5,1.14,2.14,1.75,1.0,2
Seoul E-Land,7,4,2,1,15,9,6,14,southkorea2,0.57,0.86,6,2.14,2.0,1.75,1.16,3
Jeonnam,7,4,2,1,10,6,4,14,southkorea2,0.57,0.86,4,1.43,2.0,1.75,1.16,3
Bucheon FC,7,4,1,2,13,10,3,13,southkorea2,0.57,0.71,3,1.86,1.86,1.75,1.41,4
Suwon Bluewings,7,3,2,2,10,8,2,11,southkorea2,0.43,0.71,2,1.43,1.57,2.33,1.41,5
Gimpo,7,2,3,2,8,6,2,9,southkorea2,0.29,0.71,2,1.14,1.29,3.45,1.41,6
Busan IPark,7,2,3,2,7,6,1,9,southkorea2,0.29,0.71,1,1.0,1.29,3.45,1.41,6
Gyeongnam,7,2,2,3,7,10,-3,8,southkorea2,0.29,0.57,-3,1.0,1.14,3.45,1.75,7
Asan,7,1,4,2,7,7,0,7,southkorea2,0.14,0.71,0,1.0,1.0,7.14,1.41,8
Hwaseong,7,1,3,3,8,11,-3,6,southkorea2,0.14,0.57,-3,1.14,0.86,7.14,1.75,9
Ansan Greeners,7,1,1,5,5,11,-6,4,southkorea2,0.14,0.29,-6,0.71,0.57,7.14,3.45,10
Cheongju,7,1,1,5,8,16,-8,4,southkorea2,0.14,0.29,-8,1.14,0.57,7.14,3.45,10
Cheonan City,7,1,0,6,3,12,-9,3,southkorea2,0.14,0.14,-9,0.43,0.43,7.14,7.14,11
FC Barcelona,8,7,1,0,20,4,16,22,spain,0.88,1.0,16,2.5,2.75,1.14,1.0,1
Real Betis,8,6,1,1,15,8,7,19,spain,0.75,0.88,7,1.88,2.38,1.33,1.14,2
Real Madrid,8,5,1,2,13,9,4,16,spain,0.62,0.75,4,1.62,2.0,1.61,1.33,3
Celta Vigo,8,4,3,1,10,8,2,15,spain,0.5,0.88,2,1.25,1.88,2.0,1.14,4
Valencia,8,4,3,1,11,10,1,15,spain,0.5,0.88,1,1.38,1.88,2.0,1.14,4
Atletico Madrid,8,4,2,2,15,11,4,14,spain,0.5,0.75,4,1.88,1.75,2.0,1.33,5
Villarreal,8,4,2,2,9,7,2,14,spain,0.5,0.75,2,1.12,1.75,2.0,1.33,5
Athletic Bilbao,8,3,4,1,13,5,8,13,spain,0.38,0.88,8,1.62,1.62,2.63,1.14,6
Espanyol,8,3,3,2,12,7,5,12,spain,0.38,0.75,5,1.5,1.5,2.63,1.33,7
Mallorca,8,3,3,2,11,8,3,12,spain,0.38,0.75,3,1.38,1.5,2.63,1.33,7
Getafe,8,4,0,4,13,11,2,12,spain,0.5,0.5,2,1.62,1.5,2.0,2.0,7
Real Sociedad,8,3,1,4,10,14,-4,10,spain,0.38,0.5,-4,1.25,1.25,2.63,2.0,8
Alaves,8,2,3,3,8,10,-2,9,spain,0.25,0.62,-2,1.0,1.12,4.0,1.61,9
Sevilla FC,8,2,2,4,9,8,1,8,spain,0.25,0.5,1,1.12,1.0,4.0,2.0,10
Osasuna,8,1,4,3,8,12,-4,7,spain,0.12,0.62,-4,1.0,0.88,8.33,1.61,11
Las Palmas,8,1,3,4,9,14,-5,6,spain,0.12,0.5,-5,1.12,0.75,8.33,2.0,12
Leganes,8,1,2,5,10,16,-6,5,spain,0.12,0.38,-6,1.25,0.62,8.33,2.63,13
Rayo Vallecano,8,1,2,5,7,14,-7,5,spain,0.12,0.38,-7,0.88,0.62,8.33,2.63,13
Girona,8,0,3,5,7,15,-8,3,spain,0.0,0.38,-8,0.88,0.38,0.0,2.63,14
Valladolid,8,0,1,7,6,25,-19,1,spain,0.0,0.12,-19,0.75,0.12,0.0,8.33,15
Levante,8,6,1,1,16,8,8,19,spain2,0.75,0.88,8,2.0,2.38,1.33,1.14,1
Elche,8,6,1,1,12,6,6,19,spain2,0.75,0.88,6,1.5,2.38,1.33,1.14,1
Burgos,8,5,2,1,9,4,5,17,spain2,0.62,0.88,5,1.12,2.12,1.61,1.14,2
Eibar,8,3,5,0,10,6,4,14,spain2,0.38,1.0,4,1.25,1.75,2.63,1.0,3
Deportivo,8,3,5,0,11,8,3,14,spain2,0.38,1.0,3,1.38,1.75,2.63,1.0,3
Cordoba,8,3,4,1,13,7,6,13,spain2,0.38,0.88,6,1.62,1.62,2.63,1.14,4
Albacete,8,4,1,3,12,8,4,13,spain2,0.5,0.62,4,1.5,1.62,2.0,1.61,4
Tenerife,8,4,1,3,10,8,2,13,spain2,0.5,0.62,2,1.25,1.62,2.0,1.61,4
Granada,8,4,1,3,12,11,1,13,spain2,0.5,0.62,1,1.5,1.62,2.0,1.61,4
Racing,8,3,3,2,12,10,2,12,spain2,0.38,0.75,2,1.5,1.5,2.63,1.33,5
Real Oviedo,8,3,2,3,10,8,2,11,spain2,0.38,0.62,2,1.25,1.38,2.63,1.61,6
Mirandes,8,3,2,3,11,10,1,11,spain2,0.38,0.62,1,1.38,1.38,2.63,1.61,6
Almeria,8,3,2,3,12,12,0,11,spain2,0.38,0.62,0,1.5,1.38,2.63,1.61,6
Eldense,8,3,2,3,10,10,0,11,spain2,0.38,0.62,0,1.25,1.38,2.63,1.61,6
Huesca,8,3,1,4,10,11,-1,10,spain2,0.38,0.5,-1,1.25,1.25,2.63,2.0,7
Castellon,8,1,5,2,12,14,-2,8,spain2,0.12,0.75,-2,1.5,1.0,8.33,1.33,8
Cadiz,8,2,2,4,4,7,-3,8,spain2,0.25,0.5,-3,0.5,1.0,4.0,2.0,8
Sporting Gijon,8,1,4,3,9,13,-4,7,spain2,0.12,0.62,-4,1.12,0.88,8.33,1.61,9
Malaga,8,2,1,5,6,10,-4,7,spain2,0.25,0.38,-4,0.75,0.88,4.0,2.63,9
Real Zaragoza,8,1,4,3,10,16,-6,7,spain2,0.12,0.62,-6,1.25,0.88,8.33,1.61,9
Cartagena,8,0,2,6,6,15,-9,2,spain2,0.0,0.25,-9,0.75,0.25,0.0,4.0,10
Racing Ferrol,8,0,1,7,1,14,-13,1,spain2,0.0,0.12,-13,0.12,0.12,0.0,8.33,11
Ourense CF,8,6,1,1,10,4,6,19,spain3,0.75,0.88,6,1.25,2.38,1.33,1.14,1
Ponferradina,8,5,1,2,14,9,5,16,spain3,0.62,0.75,5,1.75,2.0,1.61,1.33,2
Gimnastic T.,8,4,2,2,17,9,8,14,spain3,0.5,0.75,8,2.12,1.75,2.0,1.33,3
Celta Vigo B,8,4,2,2,12,9,3,14,spain3,0.5,0.75,3,1.5,1.75,2.0,1.33,3
Tarazona,8,3,4,1,8,5,3,13,spain3,0.38,0.88,3,1.0,1.62,2.63,1.14,4
Osasuna B,8,3,4,1,12,11,1,13,spain3,0.38,0.88,1,1.5,1.62,2.63,1.14,4
Sestao River,8,3,3,2,12,10,2,12,spain3,0.38,0.75,2,1.5,1.5,2.63,1.33,5
FC Andorra,8,3,3,2,9,8,1,12,spain3,0.38,0.75,1,1.12,1.5,2.63,1.33,5
Athletic B. B,8,2,5,1,11,10,1,11,spain3,0.25,0.88,1,1.38,1.38,4.0,1.14,6
Zamora,8,3,2,3,8,8,0,11,spain3,0.38,0.62,0,1.0,1.38,2.63,1.61,6
Real Sociedad B,8,3,2,3,7,7,0,11,spain3,0.38,0.62,0,0.88,1.38,2.63,1.61,6
Leonesa,8,2,4,2,7,7,0,10,spain3,0.25,0.75,0,0.88,1.25,4.0,1.33,7
Lugo,8,3,0,5,8,13,-5,9,spain3,0.38,0.38,-5,1.0,1.12,2.63,2.63,8
Gimnastica,8,2,3,3,6,12,-6,9,spain3,0.25,0.62,-6,0.75,1.12,4.0,1.61,8
Barakaldo,8,2,2,4,10,11,-1,8,spain3,0.25,0.5,-1,1.25,1.0,4.0,2.0,9
Real Union,8,2,2,4,6,7,-1,8,spain3,0.25,0.5,-1,0.75,1.0,4.0,2.0,9
FC Barcelona B,8,2,2,4,12,14,-2,8,spain3,0.25,0.5,-2,1.5,1.0,4.0,2.0,9
Unionistas,8,2,1,5,7,14,-7,7,spain3,0.25,0.38,-7,0.88,0.88,4.0,2.63,10
Arenteiro,8,1,3,4,8,11,-3,6,spain3,0.12,0.5,-3,1.0,0.75,8.33,2.0,11
Amorebieta,8,1,3,4,5,8,-3,6,spain3,0.12,0.5,-3,0.62,0.75,8.33,2.0,11
Ceuta,8,4,4,0,13,6,7,16,spain4,0.5,1.0,7,1.62,2.0,2.0,1.0,1
Real Murcia,8,4,2,2,13,7,6,14,spain4,0.5,0.75,6,1.62,1.75,2.0,1.33,2
Algeciras,8,4,2,2,11,8,3,14,spain4,0.5,0.75,3,1.38,1.75,2.0,1.33,2
Merida,8,4,2,2,11,13,-2,14,spain4,0.5,0.75,-2,1.38,1.75,2.0,1.33,2
Atletico M. B,8,3,4,1,11,7,4,13,spain4,0.38,0.88,4,1.38,1.62,2.63,1.14,3
Alcorcon,8,4,1,3,11,8,3,13,spain4,0.5,0.62,3,1.38,1.62,2.0,1.61,3
Sevilla FC B,8,4,1,3,8,5,3,13,spain4,0.5,0.62,3,1.0,1.62,2.0,1.61,3
Antequera,8,3,3,2,13,14,-1,12,spain4,0.38,0.75,-1,1.62,1.5,2.63,1.33,4
UD Ibiza,8,3,2,3,11,10,1,11,spain4,0.38,0.62,1,1.38,1.38,2.63,1.61,5
Marbella,8,3,2,3,9,10,-1,11,spain4,0.38,0.62,-1,1.12,1.38,2.63,1.61,5
Real Madrid B,8,1,7,0,7,6,1,10,spain4,0.12,1.0,1,0.88,1.25,8.33,1.0,6
Fuenlabrada,8,2,3,3,11,10,1,9,spain4,0.25,0.62,1,1.38,1.12,4.0,1.61,7
Hercules,8,2,3,3,11,12,-1,9,spain4,0.25,0.62,-1,1.38,1.12,4.0,1.61,7
Real Betis B,8,2,3,3,9,12,-3,9,spain4,0.25,0.62,-3,1.12,1.12,4.0,1.61,7
Recreativo H.,8,2,3,3,4,9,-5,9,spain4,0.25,0.62,-5,0.5,1.12,4.0,1.61,7
Villarreal B,8,2,2,4,8,9,-1,8,spain4,0.25,0.5,-1,1.0,1.0,4.0,2.0,8
Intercity,8,2,2,4,9,14,-5,8,spain4,0.25,0.5,-5,1.12,1.0,4.0,2.0,8
Yeclano,8,1,4,3,6,7,-1,7,spain4,0.12,0.62,-1,0.75,0.88,8.33,1.61,9
Sanluqueno,8,1,4,3,11,14,-3,7,spain4,0.12,0.62,-3,1.38,0.88,8.33,1.61,9
Alcoyano,8,1,2,5,7,13,-6,5,spain4,0.12,0.38,-6,0.88,0.62,8.33,2.63,10
Rayo Cantabria,8,6,1,1,13,6,7,19,spain5,0.75,0.88,7,1.62,2.38,1.33,1.14,1
Real Aviles,8,4,4,0,10,4,6,16,spain5,0.5,1.0,6,1.25,2.0,2.0,1.0,2
Bergantinos,8,5,1,2,12,7,5,16,spain5,0.62,0.75,5,1.5,2.0,1.61,1.33,2
Pontevedra,8,5,1,2,10,5,5,16,spain5,0.62,0.75,5,1.25,2.0,1.61,1.33,2
Langreo,8,4,3,1,9,4,5,15,spain5,0.5,0.88,5,1.12,1.88,2.0,1.14,3
D. Fabril,8,4,2,2,10,7,3,14,spain5,0.5,0.75,3,1.25,1.75,2.0,1.33,4
Llanera,8,3,4,1,10,7,3,13,spain5,0.38,0.88,3,1.25,1.62,2.63,1.14,5
Numancia,8,3,1,4,9,6,3,10,spain5,0.38,0.5,3,1.12,1.25,2.63,2.0,6
Real Avila,8,2,4,2,6,7,-1,10,spain5,0.25,0.75,-1,0.75,1.25,4.0,1.33,6
Torrelavega,8,2,3,3,10,9,1,9,spain5,0.25,0.62,1,1.25,1.12,4.0,1.61,7
Coruxo,8,2,3,3,8,8,0,9,spain5,0.25,0.62,0,1.0,1.12,4.0,1.61,7
Valladolid B,8,3,0,5,12,14,-2,9,spain5,0.38,0.38,-2,1.5,1.12,2.63,2.63,7
Marino de L.,8,2,3,3,5,7,-2,9,spain5,0.25,0.62,-2,0.62,1.12,4.0,1.61,7
Escobedo,8,2,2,4,7,9,-2,8,spain5,0.25,0.5,-2,0.88,1.0,4.0,2.0,8
Compostela,8,2,2,4,6,10,-4,8,spain5,0.25,0.5,-4,0.75,1.0,4.0,2.0,8
Guijuelo,8,2,0,6,5,17,-12,6,spain5,0.25,0.25,-12,0.62,0.75,4.0,4.0,9
Laredo,8,1,2,5,3,13,-10,5,spain5,0.12,0.38,-10,0.38,0.62,8.33,2.63,10
Salamanca CF,8,1,1,6,7,14,-7,4,spain5,0.12,0.25,-7,0.88,0.5,8.33,4.0,11
Teruel,8,6,2,0,13,3,10,20,spain6,0.75,1.0,10,1.62,2.5,1.33,1.0,1
SD Logrones,8,6,2,0,15,6,9,20,spain6,0.75,1.0,9,1.88,2.5,1.33,1.0,1
Arenas Club,8,5,2,1,13,4,9,17,spain6,0.62,0.88,9,1.62,2.12,1.61,1.14,2
Alaves B,8,5,2,1,10,5,5,17,spain6,0.62,0.88,5,1.25,2.12,1.61,1.14,2
Utebo,8,4,3,1,11,6,5,15,spain6,0.5,0.88,5,1.38,1.88,2.0,1.14,3
Barbastro,8,4,1,3,7,5,2,13,spain6,0.5,0.62,2,0.88,1.62,2.0,1.61,4
Eibar B,8,3,3,2,12,6,6,12,spain6,0.38,0.75,6,1.5,1.5,2.63,1.33,5
Tudelano,8,3,3,2,10,7,3,12,spain6,0.38,0.75,3,1.25,1.5,2.63,1.33,5
Real Zaragoza B,8,3,1,4,9,9,0,10,spain6,0.38,0.5,0,1.12,1.25,2.63,2.0,6
Subiza,8,3,0,5,9,10,-1,9,spain6,0.38,0.38,-1,1.12,1.12,2.63,2.63,7
Real Sociedad C,8,3,0,5,9,14,-5,9,spain6,0.38,0.38,-5,1.12,1.12,2.63,2.63,7
Ejea,8,1,5,2,10,11,-1,8,spain6,0.12,0.75,-1,1.25,1.0,8.33,1.33,8
Calahorra,8,2,2,4,5,12,-7,8,spain6,0.25,0.5,-7,0.62,1.0,4.0,2.0,8
Alfaro,8,2,2,4,4,12,-8,8,spain6,0.25,0.5,-8,0.5,1.0,4.0,2.0,8
Gernika,8,2,2,4,6,15,-9,8,spain6,0.25,0.5,-9,0.75,1.0,4.0,2.0,8
UD Logrones,8,1,3,4,5,6,-1,6,spain6,0.12,0.5,-1,0.62,0.75,8.33,2.0,9
Anguiano,8,1,1,6,6,15,-9,4,spain6,0.12,0.25,-9,0.75,0.5,8.33,4.0,10
Izarra,8,1,0,7,6,14,-8,3,spain6,0.12,0.12,-8,0.75,0.38,8.33,8.33,11
Andratx,8,7,0,1,12,5,7,21,spain7,0.88,0.88,7,1.5,2.62,1.14,1.14,1
A. Baleares,8,6,2,0,12,3,9,20,spain7,0.75,1.0,9,1.5,2.5,1.33,1.0,2
Europa,8,6,1,1,11,6,5,19,spain7,0.75,0.88,5,1.38,2.38,1.33,1.14,3
SD Ibiza,8,6,0,2,14,8,6,18,spain7,0.75,0.75,6,1.75,2.25,1.33,1.33,4
Sant Andreu,8,5,2,1,18,7,11,17,spain7,0.62,0.88,11,2.25,2.12,1.61,1.14,5
Sabadell,8,5,0,3,14,9,5,15,spain7,0.62,0.62,5,1.75,1.88,1.61,1.61,6
Olot,8,4,1,3,7,8,-1,13,spain7,0.5,0.62,-1,0.88,1.62,2.0,1.61,7
Torrent,8,3,3,2,11,8,3,12,spain7,0.38,0.75,3,1.38,1.5,2.63,1.33,8
Valencia B,8,3,2,3,9,8,1,11,spain7,0.38,0.62,1,1.12,1.38,2.63,1.61,9
Elche B,8,3,2,3,10,10,0,11,spain7,0.38,0.62,0,1.25,1.38,2.63,1.61,9
Cornella,8,3,1,4,13,13,0,10,spain7,0.38,0.5,0,1.62,1.25,2.63,2.0,10
Lleida,8,2,4,2,8,8,0,10,spain7,0.25,0.75,0,1.0,1.25,4.0,1.33,10
Espanyol B,8,2,2,4,9,10,-1,8,spain7,0.25,0.5,-1,1.12,1.0,4.0,2.0,11
Terrassa,8,2,1,5,6,9,-3,7,spain7,0.25,0.38,-3,0.75,0.88,4.0,2.63,12
Pena Deportiva,8,0,4,4,8,14,-6,4,spain7,0.0,0.5,-6,1.0,0.5,0.0,2.0,13
Mallorca B,8,1,1,6,8,15,-7,4,spain7,0.12,0.25,-7,1.0,0.5,8.33,4.0,13
Badalona,8,0,1,7,3,16,-13,1,spain7,0.0,0.12,-13,0.38,0.12,0.0,8.33,14
Alzira,8,0,1,7,3,19,-16,1,spain7,0.0,0.12,-16,0.38,0.12,0.0,8.33,14
La Union,8,6,2,0,11,2,9,20,spain8,0.75,1.0,9,1.38,2.5,1.33,1.0,1
Torremolinos,8,6,0,2,13,7,6,18,spain8,0.75,0.75,6,1.62,2.25,1.33,1.33,2
CD Estepona,8,5,2,1,12,8,4,17,spain8,0.62,0.88,4,1.5,2.12,1.61,1.14,3
Antoniano,8,5,1,2,11,9,2,16,spain8,0.62,0.75,2,1.38,2.0,1.61,1.33,4
Xerez CD,8,4,2,2,11,6,5,14,spain8,0.5,0.75,5,1.38,1.75,2.0,1.33,5
Orihuela,8,4,1,3,7,6,1,13,spain8,0.5,0.62,1,0.88,1.62,2.0,1.61,6
Xerez D. FC,8,4,1,3,7,10,-3,13,spain8,0.5,0.62,-3,0.88,1.62,2.0,1.61,6
UCAM Murcia,8,3,3,2,8,4,4,12,spain8,0.38,0.75,4,1.0,1.5,2.63,1.33,7
Linares,8,3,2,3,11,8,3,11,spain8,0.38,0.62,3,1.38,1.38,2.63,1.61,8
Almeria B,8,3,2,3,8,9,-1,11,spain8,0.38,0.62,-1,1.0,1.38,2.63,1.61,8
Villanovense,8,3,1,4,4,6,-2,10,spain8,0.38,0.5,-2,0.5,1.25,2.63,2.0,9
D. Minera,8,3,0,5,13,13,0,9,spain8,0.38,0.38,0,1.62,1.12,2.63,2.63,10
Cadiz B,8,2,2,4,7,9,-2,8,spain8,0.25,0.5,-2,0.88,1.0,4.0,2.0,11
Aguilas CF,8,2,2,4,5,10,-5,8,spain8,0.25,0.5,-5,0.62,1.0,4.0,2.0,11
San Fernando,8,1,4,3,5,7,-2,7,spain8,0.12,0.62,-2,0.62,0.88,8.33,1.61,12
Granada B,8,2,1,5,7,12,-5,7,spain8,0.25,0.38,-5,0.88,0.88,4.0,2.63,12
Don Benito,8,1,3,4,7,10,-3,6,spain8,0.12,0.5,-3,0.88,0.75,8.33,2.0,13
Linense,8,0,1,7,1,12,-11,1,spain8,0.0,0.12,-11,0.12,0.12,0.0,8.33,14
Cacereno,8,6,2,0,17,7,10,20,spain9,0.75,1.0,10,2.12,2.5,1.33,1.0,1
Navalcarnero,8,6,0,2,13,7,6,18,spain9,0.75,0.75,6,1.62,2.25,1.33,1.33,2
S. Sebastian R.,8,6,0,2,11,7,4,18,spain9,0.75,0.75,4,1.38,2.25,1.33,1.33,2
CD Coria,8,4,3,1,12,6,6,15,spain9,0.5,0.88,6,1.5,1.88,2.0,1.14,3
Guadalajara,8,4,3,1,9,4,5,15,spain9,0.5,0.88,5,1.12,1.88,2.0,1.14,3
Real Madrid C,8,4,2,2,9,6,3,14,spain9,0.5,0.75,3,1.12,1.75,2.0,1.33,4
Talavera CF,8,3,3,2,12,5,7,12,spain9,0.38,0.75,7,1.5,1.5,2.63,1.33,5
CD Mostoles,8,4,0,4,15,11,4,12,spain9,0.5,0.5,4,1.88,1.5,2.0,2.0,5
Conquense,8,4,0,4,6,9,-3,12,spain9,0.5,0.5,-3,0.75,1.5,2.0,2.0,5
Getafe B,8,3,2,3,10,10,0,11,spain9,0.38,0.62,0,1.25,1.38,2.63,1.61,6
R. Majadahonda,8,2,4,2,6,6,0,10,spain9,0.25,0.75,0,0.75,1.25,4.0,1.33,7
Melilla,8,2,2,4,5,8,-3,8,spain9,0.25,0.5,-3,0.62,1.0,4.0,2.0,8
Atletico Paso,8,1,4,3,7,11,-4,7,spain9,0.12,0.62,-4,0.88,0.88,8.33,1.61,9
Union Adarve,8,1,3,4,2,5,-3,6,spain9,0.12,0.5,-3,0.25,0.75,8.33,2.0,10
Illescas,8,1,2,5,6,12,-6,5,spain9,0.12,0.38,-6,0.75,0.62,8.33,2.63,11
Tenerife B,8,1,2,5,7,14,-7,5,spain9,0.12,0.38,-7,0.88,0.62,8.33,2.63,11
Yaiza,8,1,2,5,4,13,-9,5,spain9,0.12,0.38,-9,0.5,0.62,8.33,2.63,11
Colonia M.,8,1,2,5,5,15,-10,5,spain9,0.12,0.38,-10,0.62,0.62,8.33,2.63,11
Hammarby,3,3,0,0,8,0,8,9,sweden,1.0,1.0,8,2.67,3.0,1.0,1.0,1
AIK,3,2,1,0,5,3,2,7,sweden,0.67,1.0,2,1.67,2.33,1.49,1.0,2
Malmo FF,3,2,1,0,3,1,2,7,sweden,0.67,1.0,2,1.0,2.33,1.49,1.0,2
Degerfors,3,2,0,1,6,2,4,6,sweden,0.67,0.67,4,2.0,2.0,1.49,1.49,3
IFK Goteborg,3,2,0,1,2,4,-2,6,sweden,0.67,0.67,-2,0.67,2.0,1.49,1.49,3
Mjallby,3,1,2,0,6,3,3,5,sweden,0.33,1.0,3,2.0,1.67,3.03,1.0,4
Elfsborg,3,1,1,1,5,4,1,4,sweden,0.33,0.67,1,1.67,1.33,3.03,1.49,5
GAIS,3,1,1,1,3,2,1,4,sweden,0.33,0.67,1,1.0,1.33,3.03,1.49,5
Oster,3,1,0,2,5,5,0,3,sweden,0.33,0.33,0,1.67,1.0,3.03,3.03,6
Brommapojkarna,3,1,0,2,3,4,-1,3,sweden,0.33,0.33,-1,1.0,1.0,3.03,3.03,6
Norrkoping,3,1,0,2,7,9,-2,3,sweden,0.33,0.33,-2,2.33,1.0,3.03,3.03,6
Djurgarden,3,1,0,2,1,3,-2,3,sweden,0.33,0.33,-2,0.33,1.0,3.03,3.03,6
Hacken,3,1,0,2,2,5,-3,3,sweden,0.33,0.33,-3,0.67,1.0,3.03,3.03,6
Sirius,3,1,0,2,2,5,-3,3,sweden,0.33,0.33,-3,0.67,1.0,3.03,3.03,6
Halmstad,3,1,0,2,1,6,-5,3,sweden,0.33,0.33,-5,0.33,1.0,3.03,3.03,6
Varnamo,3,0,0,3,1,4,-3,0,sweden,0.0,0.0,-3,0.33,0.0,0.0,0.0,7
Kalmar,3,2,1,0,4,1,3,7,sweden2,0.67,1.0,3,1.33,2.33,1.49,1.0,1
Sandviken,3,2,1,0,4,1,3,7,sweden2,0.67,1.0,3,1.33,2.33,1.49,1.0,1
Vasteras,3,2,1,0,4,1,3,7,sweden2,0.67,1.0,3,1.33,2.33,1.49,1.0,1
Oddevold,3,2,0,1,4,3,1,6,sweden2,0.67,0.67,1,1.33,2.0,1.49,1.49,2
Landskrona,3,1,2,0,7,6,1,5,sweden2,0.33,1.0,1,2.33,1.67,3.03,1.0,3
Ostersunds,3,1,2,0,6,5,1,5,sweden2,0.33,1.0,1,2.0,1.67,3.03,1.0,3
Varberg BoIS,3,1,2,0,5,4,1,5,sweden2,0.33,1.0,1,1.67,1.67,3.03,1.0,3
Orgryte,3,1,2,0,3,2,1,5,sweden2,0.33,1.0,1,1.0,1.67,3.03,1.0,3
Falkenberg,3,1,1,1,4,3,1,4,sweden2,0.33,0.67,1,1.33,1.33,3.03,1.49,4
GIF Sundsvall,3,1,1,1,2,1,1,4,sweden2,0.33,0.67,1,0.67,1.33,3.03,1.49,4
Helsingborg,3,1,0,2,3,4,-1,3,sweden2,0.33,0.33,-1,1.0,1.0,3.03,3.03,5
Trelleborg,3,1,0,2,1,3,-2,3,sweden2,0.33,0.33,-2,0.33,1.0,3.03,3.03,5
Brage,3,0,2,1,3,5,-2,2,sweden2,0.0,0.67,-2,1.0,0.67,0.0,1.49,6
Umea,3,0,1,2,2,4,-2,1,sweden2,0.0,0.33,-2,0.67,0.33,0.0,3.03,7
Utsikten,3,0,0,3,2,6,-4,0,sweden2,0.0,0.0,-4,0.67,0.0,0.0,0.0,8
Orebro,3,0,0,3,1,6,-5,0,sweden2,0.0,0.0,-5,0.33,0.0,0.0,0.0,8
FC Basel,8,5,2,1,16,6,10,17,switzerland,0.62,0.88,10,2.0,2.12,1.61,1.14,1
BSC Young Boys,8,5,1,2,9,8,1,16,switzerland,0.62,0.75,1,1.12,2.0,1.61,1.33,2
FC Zurich,8,4,2,2,13,13,0,14,switzerland,0.5,0.75,0,1.62,1.75,2.0,1.33,3
Servette,8,4,1,3,12,8,4,13,switzerland,0.5,0.62,4,1.5,1.62,2.0,1.61,4
Luzern,8,3,3,2,18,12,6,12,switzerland,0.38,0.75,6,2.25,1.5,2.63,1.33,5
Grasshopper,8,3,2,3,12,12,0,11,switzerland,0.38,0.62,0,1.5,1.38,2.63,1.61,6
Winterthur,8,3,1,4,10,10,0,10,switzerland,0.38,0.5,0,1.25,1.25,2.63,2.0,7
Yverdon,8,2,3,3,11,13,-2,9,switzerland,0.25,0.62,-2,1.38,1.12,4.0,1.61,8
St. Gallen,8,2,3,3,8,12,-4,9,switzerland,0.25,0.62,-4,1.0,1.12,4.0,1.61,8
Lausanne Sport,8,2,2,4,9,13,-4,8,switzerland,0.25,0.5,-4,1.12,1.0,4.0,2.0,9
Lugano,8,2,1,5,6,12,-6,7,switzerland,0.25,0.38,-6,0.75,0.88,4.0,2.63,10
Sion,8,1,3,4,7,12,-5,6,switzerland,0.12,0.5,-5,0.88,0.75,8.33,2.0,11
Thun,8,5,2,1,14,9,5,17,switzerland2,0.62,0.88,5,1.75,2.12,1.61,1.14,1
Etoile Carouge,8,4,4,0,19,7,12,16,switzerland2,0.5,1.0,12,2.38,2.0,2.0,1.0,2
Aarau,8,3,5,0,14,8,6,14,switzerland2,0.38,1.0,6,1.75,1.75,2.63,1.0,3
Lausanne Ouchy,8,4,1,3,12,11,1,13,switzerland2,0.5,0.62,1,1.5,1.62,2.0,1.61,4
Neuchatel Xamax,8,3,2,3,18,12,6,11,switzerland2,0.38,0.62,6,2.25,1.38,2.63,1.61,5
Wil,8,3,2,3,15,13,2,11,switzerland2,0.38,0.62,2,1.88,1.38,2.63,1.61,5
Vaduz,8,3,1,4,12,11,1,10,switzerland2,0.38,0.5,1,1.5,1.25,2.63,2.0,6
Stade Nyonnais,8,2,1,5,9,15,-6,7,switzerland2,0.25,0.38,-6,1.12,0.88,4.0,2.63,7
Bellinzona,8,1,3,4,6,19,-13,6,switzerland2,0.12,0.5,-13,0.75,0.75,8.33,2.0,8
Schaffhausen,8,1,1,6,9,23,-14,4,switzerland2,0.12,0.25,-14,1.12,0.5,8.33,4.0,9
Pathum Utd,8,7,1,0,13,3,10,22,thailand,0.88,1.0,10,1.62,2.75,1.14,1.0,1
Bangkok Utd,8,6,2,0,18,7,11,20,thailand,0.75,1.0,11,2.25,2.5,1.33,1.0,2
Ratchaburi,8,5,1,2,22,12,10,16,thailand,0.62,0.75,10,2.75,2.0,1.61,1.33,3
Buriram Utd,8,5,1,2,15,7,8,16,thailand,0.62,0.75,8,1.88,2.0,1.61,1.33,3
Prachuap,8,5,0,3,17,9,8,15,thailand,0.62,0.62,8,2.12,1.88,1.61,1.61,4
Lamphun Warrior,8,4,1,3,10,9,1,13,thailand,0.5,0.62,1,1.25,1.62,2.0,1.61,5
Chiangrai Utd,8,4,0,4,11,9,2,12,thailand,0.5,0.5,2,1.38,1.5,2.0,2.0,6
Port FC,8,2,3,3,11,12,-1,9,thailand,0.25,0.62,-1,1.38,1.12,4.0,1.61,7
Rayong,8,2,2,4,11,15,-4,8,thailand,0.25,0.5,-4,1.38,1.0,4.0,2.0,8
Nakhon Pathom,8,2,2,4,9,14,-5,8,thailand,0.25,0.5,-5,1.12,1.0,4.0,2.0,8
Uthai Thani,8,1,4,3,5,7,-2,7,thailand,0.12,0.62,-2,0.62,0.88,8.33,1.61,9
Sukhothai,8,1,3,4,8,12,-4,6,thailand,0.12,0.5,-4,1.0,0.75,8.33,2.0,10
Muang Thong Utd,8,2,0,6,10,18,-8,6,thailand,0.25,0.25,-8,1.25,0.75,4.0,4.0,10
N. Bua Pitchaya,8,1,3,4,5,13,-8,6,thailand,0.12,0.5,-8,0.62,0.75,8.33,2.0,10
N. Ratchasima,8,1,3,4,10,19,-9,6,thailand,0.12,0.5,-9,1.25,0.75,8.33,2.0,10
Khon Kaen Utd,8,1,2,5,8,19,-11,5,thailand,0.12,0.38,-11,1.0,0.62,8.33,2.63,11
Chonburi,8,6,0,2,18,9,9,18,thailand2,0.75,0.75,9,2.25,2.25,1.33,1.33,1
Kanchanaburi,8,5,2,1,19,10,9,17,thailand2,0.62,0.88,9,2.38,2.12,1.61,1.14,2
Chanthaburi,8,4,2,2,11,9,2,14,thailand2,0.5,0.75,2,1.38,1.75,2.0,1.33,3
Ayutthaya Utd,8,4,1,3,16,9,7,13,thailand2,0.5,0.62,7,2.0,1.62,2.0,1.61,4
Mahasarakham,8,3,4,1,9,5,4,13,thailand2,0.38,0.88,4,1.12,1.62,2.63,1.14,4
Police Tero,8,4,1,3,12,12,0,13,thailand2,0.5,0.62,0,1.5,1.62,2.0,1.61,4
Phrae Utd,8,3,2,3,17,15,2,11,thailand2,0.38,0.62,2,2.12,1.38,2.63,1.61,5
Kasetsart,8,3,2,3,9,8,1,11,thailand2,0.38,0.62,1,1.12,1.38,2.63,1.61,5
Chainat,8,3,2,3,7,7,0,11,thailand2,0.38,0.62,0,0.88,1.38,2.63,1.61,5
Nakhon Si,8,3,2,3,13,15,-2,11,thailand2,0.38,0.62,-2,1.62,1.38,2.63,1.61,5
Lampang,8,3,1,4,11,12,-1,10,thailand2,0.38,0.5,-1,1.38,1.25,2.63,2.0,6
Chiangmai Utd,8,3,1,4,13,16,-3,10,thailand2,0.38,0.5,-3,1.62,1.25,2.63,2.0,6
Suphanburi,8,1,4,3,13,18,-5,7,thailand2,0.12,0.62,-5,1.62,0.88,8.33,1.61,7
Sisaket Utd,8,2,1,5,7,15,-8,7,thailand2,0.25,0.38,-8,0.88,0.88,4.0,2.63,7
Bangkok FC,8,1,3,4,9,13,-4,6,thailand2,0.12,0.5,-4,1.12,0.75,8.33,2.0,8
Pattaya United,8,1,2,5,5,18,-13,5,thailand2,0.12,0.38,-13,0.62,0.62,8.33,2.63,9
Trat FC,8,1,1,6,8,16,-8,4,thailand2,0.12,0.25,-8,1.0,0.5,8.33,4.0,10
Samut Prakan,0,0,0,0,0,0,0,0,thailand2,0.0,0.0,0,0.0,0.0,0.0,0.0,11
Fenerbahce,8,6,2,0,19,5,14,20,turkey,0.75,1.0,14,2.38,2.5,1.33,1.0,1
Galatasaray,8,5,2,1,17,7,10,17,turkey,0.62,0.88,10,2.12,2.12,1.61,1.14,2
Bodrumspor,8,5,2,1,8,4,4,17,turkey,0.62,0.88,4,1.0,2.12,1.61,1.14,2
Kayserispor,8,5,1,2,13,5,8,16,turkey,0.62,0.75,8,1.62,2.0,1.61,1.33,3
Gaziantep,8,5,1,2,13,9,4,16,turkey,0.62,0.75,4,1.62,2.0,1.61,1.33,3
Antalyaspor,8,4,2,2,9,12,-3,14,turkey,0.5,0.75,-3,1.12,1.75,2.0,1.33,4
Besiktas,8,4,1,3,11,9,2,13,turkey,0.5,0.62,2,1.38,1.62,2.0,1.61,5
Konyaspor,8,4,1,3,6,5,1,13,turkey,0.5,0.62,1,0.75,1.62,2.0,1.61,5
Basaksehir,8,4,1,3,8,8,0,13,turkey,0.5,0.62,0,1.0,1.62,2.0,1.61,5
Eyupspor,8,3,2,3,14,12,2,11,turkey,0.38,0.62,2,1.75,1.38,2.63,1.61,6
Trabzonspor,8,3,1,4,12,12,0,10,turkey,0.38,0.5,0,1.5,1.25,2.63,2.0,7
Hatayspor,8,3,0,5,7,14,-7,9,turkey,0.38,0.38,-7,0.88,1.12,2.63,2.63,8
Sivasspor,8,2,2,4,14,13,1,8,turkey,0.25,0.5,1,1.75,1.0,4.0,2.0,9
Kasimpasa,8,2,2,4,10,12,-2,8,turkey,0.25,0.5,-2,1.25,1.0,4.0,2.0,9
Samsunspor,8,2,2,4,9,13,-4,8,turkey,0.25,0.5,-4,1.12,1.0,4.0,2.0,9
Rizespor,8,2,1,5,11,15,-4,7,turkey,0.25,0.38,-4,1.38,0.88,4.0,2.63,10
Goztepe,8,0,5,3,6,10,-4,5,turkey,0.0,0.62,-4,0.75,0.62,0.0,1.61,11
Alanyaspor,8,1,0,7,7,15,-8,3,turkey,0.12,0.12,-8,0.88,0.38,8.33,8.33,12
Adana Demirspor,8,0,2,6,6,23,-17,2,turkey,0.0,0.25,-17,0.75,0.25,0.0,4.0,13
Igdir,8,4,4,0,12,3,9,16,turkey2,0.5,1.0,9,1.5,2.0,2.0,1.0,1
Bandirmaspor,8,4,4,0,13,7,6,16,turkey2,0.5,1.0,6,1.62,2.0,2.0,1.0,1
Kocaelispor,8,3,5,0,20,9,11,14,turkey2,0.38,1.0,11,2.5,1.75,2.63,1.0,2
Erokspor,8,3,5,0,15,10,5,14,turkey2,0.38,1.0,5,1.88,1.75,2.63,1.0,2
Erzurum BB,8,4,2,2,12,8,4,14,turkey2,0.5,0.75,4,1.5,1.75,2.0,1.33,2
F. Karagumruk,8,4,2,2,11,7,4,14,turkey2,0.5,0.75,4,1.38,1.75,2.0,1.33,2
Genclerbirligi,8,4,2,2,11,9,2,14,turkey2,0.5,0.75,2,1.38,1.75,2.0,1.33,2
Istanbulspor,8,4,1,3,16,7,9,13,turkey2,0.5,0.62,9,2.0,1.62,2.0,1.61,3
Keciorengucu,8,4,1,3,16,12,4,13,turkey2,0.5,0.62,4,2.0,1.62,2.0,1.61,3
Amed SK,8,3,4,1,9,7,2,13,turkey2,0.38,0.88,2,1.12,1.62,2.63,1.14,3
Boluspor,8,3,3,2,10,7,3,12,turkey2,0.38,0.75,3,1.25,1.5,2.63,1.33,4
Corum,8,3,3,2,14,14,0,12,turkey2,0.38,0.75,0,1.75,1.5,2.63,1.33,4
Umraniyespor,8,2,4,2,9,6,3,10,turkey2,0.25,0.75,3,1.12,1.25,4.0,1.33,5
Sakaryaspor,8,3,1,4,13,15,-2,10,turkey2,0.38,0.5,-2,1.62,1.25,2.63,2.0,5
Pendikspor,8,2,2,4,8,11,-3,8,turkey2,0.25,0.5,-3,1.0,1.0,4.0,2.0,6
Sanliurfaspor,8,2,1,5,11,15,-4,7,turkey2,0.25,0.38,-4,1.38,0.88,4.0,2.63,7
Adanaspor,8,2,0,6,7,15,-8,6,turkey2,0.25,0.25,-8,0.88,0.75,4.0,4.0,8
Manisa BB,8,1,2,5,8,13,-5,5,turkey2,0.12,0.38,-5,1.0,0.62,8.33,2.63,9
Ankaragucu,8,1,2,5,8,17,-9,5,turkey2,0.12,0.38,-9,1.0,0.62,8.33,2.63,9
Y. Malatyaspor,8,0,0,8,3,34,-31,0,turkey2,0.0,0.0,-31,0.38,0.0,0.0,0.0,10
Sariyer,8,6,1,1,20,7,13,19,turkey3,0.75,0.88,13,2.5,2.38,1.33,1.14,1
B. Petrolspor,8,6,1,1,12,4,8,19,turkey3,0.75,0.88,8,1.5,2.38,1.33,1.14,1
Ankaraspor,8,5,1,2,19,5,14,16,turkey3,0.62,0.75,14,2.38,2.0,1.61,1.33,2
Kastamonuspor,8,4,4,0,14,6,8,16,turkey3,0.5,1.0,8,1.75,2.0,2.0,1.0,2
Trabzon FK,8,5,1,2,12,5,7,16,turkey3,0.62,0.75,7,1.5,2.0,1.61,1.33,2
Adana,8,5,1,2,12,6,6,16,turkey3,0.62,0.75,6,1.5,2.0,1.61,1.33,2
B. Anadolu,8,4,2,2,14,16,-2,14,turkey3,0.5,0.75,-2,1.75,1.75,2.0,1.33,3
Iskenderun,8,3,2,3,12,11,1,11,turkey3,0.38,0.62,1,1.5,1.38,2.63,1.61,4
Kirklarelispor,8,3,2,3,12,12,0,11,turkey3,0.38,0.62,0,1.5,1.38,2.63,1.61,4
Inegolspor,8,3,2,3,12,16,-4,11,turkey3,0.38,0.62,-4,1.5,1.38,2.63,1.61,4
Fethiyespor,8,3,1,4,6,11,-5,10,turkey3,0.38,0.5,-5,0.75,1.25,2.63,2.0,5
Altay,8,3,0,5,9,15,-6,9,turkey3,0.38,0.38,-6,1.12,1.12,2.63,2.63,6
Kepez Belediyes,8,2,2,4,9,11,-2,8,turkey3,0.25,0.5,-2,1.12,1.0,4.0,2.0,7
Altinordu,8,2,2,4,6,10,-4,8,turkey3,0.25,0.5,-4,0.75,1.0,4.0,2.0,7
Isparta Davrazs,8,2,1,5,10,14,-4,7,turkey3,0.25,0.38,-4,1.25,0.88,4.0,2.63,8
24 Erzincanspor,8,1,3,4,12,16,-4,6,turkey3,0.12,0.5,-4,1.5,0.75,8.33,2.0,9
Karakopru,8,1,1,6,6,11,-5,4,turkey3,0.12,0.25,-5,0.75,0.5,8.33,4.0,10
Afyonspor,8,0,0,8,0,24,-24,0,turkey3,0.0,0.0,-24,0.0,0.0,0.0,0.0,11
Karacabey,8,6,1,1,14,6,8,19,turkey4,0.75,0.88,8,1.75,2.38,1.33,1.14,1
Elazigspor,8,6,0,2,18,6,12,18,turkey4,0.75,0.75,12,2.25,2.25,1.33,1.33,2
Beyoglu Yeni C.,8,5,1,2,19,9,10,16,turkey4,0.62,0.75,10,2.38,2.0,1.61,1.33,3
Yeni Mersin,8,4,3,1,14,4,10,15,turkey4,0.5,0.88,10,1.75,1.88,2.0,1.14,4
Serik Belediyes,8,4,2,2,22,11,11,14,turkey4,0.5,0.75,11,2.75,1.75,2.0,1.33,5
Van Spor,8,4,2,2,15,11,4,14,turkey4,0.5,0.75,4,1.88,1.75,2.0,1.33,5
Menemen B.,8,4,2,2,13,9,4,14,turkey4,0.5,0.75,4,1.62,1.75,2.0,1.33,5
Aksaray B.,8,4,2,2,15,12,3,14,turkey4,0.5,0.75,3,1.88,1.75,2.0,1.33,5
A. Demirspor,8,3,3,2,14,11,3,12,turkey4,0.38,0.75,3,1.75,1.5,2.63,1.33,6
Erbaaspor,8,4,0,4,16,16,0,12,turkey4,0.5,0.5,0,2.0,1.5,2.0,2.0,6
Karaman,8,2,5,1,9,7,2,11,turkey4,0.25,0.88,2,1.12,1.38,4.0,1.14,7
Somaspor,8,3,1,4,9,8,1,10,turkey4,0.38,0.5,1,1.12,1.25,2.63,2.0,8
Diyarbekirspor,8,3,1,4,7,11,-4,10,turkey4,0.38,0.5,-4,0.88,1.25,2.63,2.0,8
Bucaspor,8,3,1,4,10,15,-5,10,turkey4,0.38,0.5,-5,1.25,1.25,2.63,2.0,8
Arnavutkoy B.,8,2,1,5,12,18,-6,7,turkey4,0.25,0.38,-6,1.5,0.88,4.0,2.63,9
Derince,8,2,1,5,7,18,-11,7,turkey4,0.25,0.38,-11,0.88,0.88,4.0,2.63,9
Giresunspor,8,0,0,8,5,24,-19,0,turkey4,0.0,0.0,-19,0.62,0.0,0.0,0.0,10
Nazillispor,8,0,0,8,4,27,-23,0,turkey4,0.0,0.0,-23,0.5,0.0,0.0,0.0,10
Musspor,8,7,1,0,21,6,15,22,turkey5,0.88,1.0,15,2.62,2.75,1.14,1.0,1
Bursaspor,8,5,2,1,17,7,10,17,turkey5,0.62,0.88,10,2.12,2.12,1.61,1.14,2
Karsiyaka,8,5,1,2,18,8,10,16,turkey5,0.62,0.75,10,2.25,2.0,1.61,1.33,3
Kutahyaspor,8,5,1,2,17,12,5,16,turkey5,0.62,0.75,5,2.12,2.0,1.61,1.33,3
Silifke,8,5,1,2,13,8,5,16,turkey5,0.62,0.75,5,1.62,2.0,1.61,1.33,3
Duzcespor,8,5,0,3,8,8,0,15,turkey5,0.62,0.62,0,1.0,1.88,1.61,1.61,4
Anadolu U.,8,4,2,2,10,10,0,14,turkey5,0.5,0.75,0,1.25,1.75,2.0,1.33,5
Artvin Hopaspor,8,4,1,3,6,6,0,13,turkey5,0.5,0.62,0,0.75,1.62,2.0,1.61,6
K. Bulvarspor,8,4,1,3,16,17,-1,13,turkey5,0.5,0.62,-1,2.0,1.62,2.0,1.61,6
Ergene Velimese,8,3,1,4,7,14,-7,10,turkey5,0.38,0.5,-7,0.88,1.25,2.63,2.0,7
Tokat,8,2,2,4,10,10,0,8,turkey5,0.25,0.5,0,1.25,1.0,4.0,2.0,8
Kahramanmar.,8,2,1,5,9,10,-1,7,turkey5,0.25,0.38,-1,1.12,0.88,4.0,2.63,9
Kusadasispor,8,2,1,5,6,16,-10,7,turkey5,0.25,0.38,-10,0.75,0.88,4.0,2.63,9
Kirsehir B.,8,0,3,5,4,15,-11,3,turkey5,0.0,0.38,-11,0.5,0.38,0.0,2.63,10
Elaziz K.,8,0,2,6,4,11,-7,2,turkey5,0.0,0.25,-7,0.5,0.25,0.0,4.0,11
Viven Bornova,8,0,2,6,7,15,-8,2,turkey5,0.0,0.25,-8,0.88,0.25,0.0,4.0,11
Tire 2021 FK,8,6,2,0,18,4,14,20,turkey6,0.75,1.0,14,2.25,2.5,1.33,1.0,1
Muglaspor,8,6,1,1,14,3,11,19,turkey6,0.75,0.88,11,1.75,2.38,1.33,1.14,2
Balikesirspor,8,5,1,2,16,6,10,16,turkey6,0.62,0.75,10,2.0,2.0,1.61,1.33,3
Silivrispor,8,4,2,2,15,7,8,14,turkey6,0.5,0.75,8,1.88,1.75,2.0,1.33,4
Beykoz Ishaklis,8,4,1,3,17,11,6,13,turkey6,0.5,0.62,6,2.12,1.62,2.0,1.61,5
Cayelispor,8,3,4,1,7,2,5,13,turkey6,0.38,0.88,5,0.88,1.62,2.63,1.14,5
Mazidagi,8,3,3,2,9,8,1,12,turkey6,0.38,0.75,1,1.12,1.5,2.63,1.33,6
Amasyaspor,8,3,2,3,13,10,3,11,turkey6,0.38,0.62,3,1.62,1.38,2.63,1.61,7
Usakspor,8,2,5,1,8,6,2,11,turkey6,0.25,0.88,2,1.0,1.38,4.0,1.14,7
Turk Metal 1963,8,3,2,3,14,16,-2,11,turkey6,0.38,0.62,-2,1.75,1.38,2.63,1.61,7
Inegol Kafkas,8,2,3,3,11,10,1,9,turkey6,0.25,0.62,1,1.38,1.12,4.0,1.61,8
Kelkit,8,2,2,4,7,9,-2,8,turkey6,0.25,0.5,-2,0.88,1.0,4.0,2.0,9
Fatsa B.,8,2,2,4,5,12,-7,8,turkey6,0.25,0.5,-7,0.62,1.0,4.0,2.0,9
Etimesgut,8,1,4,3,9,14,-5,7,turkey6,0.12,0.62,-5,1.12,0.88,8.33,1.61,10
Nevsehirspor,8,0,2,6,3,24,-21,2,turkey6,0.0,0.25,-21,0.38,0.25,0.0,4.0,11
Adiyaman,8,0,0,8,0,24,-24,0,turkey6,0.0,0.0,-24,0.0,0.0,0.0,0.0,12
Aliaga FAS,8,7,1,0,16,4,12,22,turkey7,0.88,1.0,12,2.0,2.75,1.14,1.0,1
Ayvalikgucu,8,6,2,0,15,7,8,20,turkey7,0.75,1.0,8,1.88,2.5,1.33,1.0,2
Orduspor,8,5,1,2,22,8,14,16,turkey7,0.62,0.75,14,2.75,2.0,1.61,1.33,3
Corluspor,8,4,2,2,14,7,7,14,turkey7,0.5,0.75,7,1.75,1.75,2.0,1.33,4
Kucukcekmece,8,3,4,1,12,9,3,13,turkey7,0.38,0.88,3,1.5,1.62,2.63,1.14,5
Yozgat Bld Bozo,8,4,1,3,16,14,2,13,turkey7,0.5,0.62,2,2.0,1.62,2.0,1.61,5
1923 M.,8,3,3,2,13,10,3,12,turkey7,0.38,0.75,3,1.62,1.5,2.63,1.33,6
Alanya 1221,8,3,2,3,9,9,0,11,turkey7,0.38,0.62,0,1.12,1.38,2.63,1.61,7
Osmaniyespor,8,3,1,4,10,14,-4,10,turkey7,0.38,0.5,-4,1.25,1.25,2.63,2.0,8
Cankaya FK,8,3,1,4,12,23,-11,10,turkey7,0.38,0.5,-11,1.5,1.25,2.63,2.0,8
Viransehir,8,3,0,5,6,10,-4,9,turkey7,0.38,0.38,-4,0.75,1.12,2.63,2.63,9
Pazarspor,8,2,1,5,13,14,-1,7,turkey7,0.25,0.38,-1,1.62,0.88,4.0,2.63,10
Efeler 09,8,1,4,3,6,11,-5,7,turkey7,0.12,0.62,-5,0.75,0.88,8.33,1.61,10
Bayburt,8,1,3,4,4,13,-9,6,turkey7,0.12,0.5,-9,0.5,0.75,8.33,2.0,11
K. Idmanyurdu,8,1,2,5,7,12,-5,5,turkey7,0.12,0.38,-5,0.88,0.62,8.33,2.63,12
1922 Konyaspor,8,0,2,6,7,17,-10,2,turkey7,0.0,0.25,-10,0.88,0.25,0.0,4.0,13
Sebat G.,8,6,1,1,25,9,16,19,turkey8,0.75,0.88,16,3.12,2.38,1.33,1.14,1
Agri 1970,8,4,4,0,10,6,4,16,turkey8,0.5,1.0,4,1.25,2.0,2.0,1.0,2
Kirikkale B.,8,5,1,2,14,13,1,16,turkey8,0.62,0.75,1,1.75,2.0,1.61,1.33,2
Mardin BB,8,4,3,1,15,8,7,15,turkey8,0.5,0.88,7,1.88,1.88,2.0,1.14,3
Erciyes,8,4,2,2,16,13,3,14,turkey8,0.5,0.75,3,2.0,1.75,2.0,1.33,4
Z. Komurspor,8,4,2,2,11,11,0,14,turkey8,0.5,0.75,0,1.38,1.75,2.0,1.33,4
K. Istiklalspor,8,3,2,3,16,14,2,11,turkey8,0.38,0.62,2,2.0,1.38,2.63,1.61,5
Nilufer B.,8,3,2,3,9,7,2,11,turkey8,0.38,0.62,2,1.12,1.38,2.63,1.61,5
Denizlispor,8,1,6,1,12,10,2,9,turkey8,0.12,0.88,2,1.5,1.12,8.33,1.14,6
Tepecik,8,2,3,3,10,15,-5,9,turkey8,0.25,0.62,-5,1.25,1.12,4.0,1.61,6
Orduspor 1967,8,2,2,4,10,12,-2,8,turkey8,0.25,0.5,-2,1.25,1.0,4.0,2.0,7
Polatli B.,8,2,2,4,9,12,-3,8,turkey8,0.25,0.5,-3,1.12,1.0,4.0,2.0,7
Nigde Belediyes,8,2,2,4,7,10,-3,8,turkey8,0.25,0.5,-3,0.88,1.0,4.0,2.0,7
Edirnespor,8,2,2,4,10,16,-6,8,turkey8,0.25,0.5,-6,1.25,1.0,4.0,2.0,7
Turgutluspor,8,1,2,5,9,16,-7,5,turkey8,0.12,0.38,-7,1.12,0.62,8.33,2.63,8
Coruhlu,8,0,2,6,7,18,-11,2,turkey8,0.0,0.25,-11,0.88,0.25,0.0,4.0,9
Shabab Al Ahli,8,6,2,0,15,3,12,20,uae,0.75,1.0,12,1.88,2.5,1.33,1.0,1
Al Wasl,8,5,2,1,16,7,9,17,uae,0.62,0.88,9,2.0,2.12,1.61,1.14,2
Khorfakkan,8,5,2,1,12,7,5,17,uae,0.62,0.88,5,1.5,2.12,1.61,1.14,2
Al Wahda,8,4,2,2,16,12,4,14,uae,0.5,0.75,4,2.0,1.75,2.0,1.33,3
Al Sharjah,8,4,2,2,5,3,2,14,uae,0.5,0.75,2,0.62,1.75,2.0,1.33,3
Bani Yas,8,4,1,3,9,12,-3,13,uae,0.5,0.62,-3,1.12,1.62,2.0,1.61,4
Al Ain,8,3,2,3,13,10,3,11,uae,0.38,0.62,3,1.62,1.38,2.63,1.61,5
Ajman,8,3,2,3,12,14,-2,11,uae,0.38,0.62,-2,1.5,1.38,2.63,1.61,5
Al Bataeh,8,2,4,2,8,9,-1,10,uae,0.25,0.75,-1,1.0,1.25,4.0,1.33,6
Al Jazira,8,3,1,4,11,16,-5,10,uae,0.38,0.5,-5,1.38,1.25,2.63,2.0,6
Dibba Al Hisn,8,2,1,5,11,15,-4,7,uae,0.25,0.38,-4,1.38,0.88,4.0,2.63,7
Ittihad Kalba,8,1,2,5,6,11,-5,5,uae,0.12,0.38,-5,0.75,0.62,8.33,2.63,8
Al Nasr,8,1,2,5,8,14,-6,5,uae,0.12,0.38,-6,1.0,0.62,8.33,2.63,8
Al Urooba,8,1,0,7,8,19,-11,3,uae,0.12,0.12,-11,1.0,0.38,8.33,8.33,9
Dynamo Kyiv,8,6,2,0,14,4,10,20,ukraine,0.75,1.0,10,1.75,2.5,1.33,1.0,1
Shakhtar,8,5,2,1,14,3,11,17,ukraine,0.62,0.88,11,1.75,2.12,1.61,1.14,2
Oleksandria,8,5,2,1,11,6,5,17,ukraine,0.62,0.88,5,1.38,2.12,1.61,1.14,2
Polessya,8,5,2,1,10,7,3,17,ukraine,0.62,0.88,3,1.25,2.12,1.61,1.14,2
Veres,8,4,1,3,12,9,3,13,ukraine,0.5,0.62,3,1.5,1.62,2.0,1.61,3
Zorya Luhansk,8,4,1,3,12,12,0,13,ukraine,0.5,0.62,0,1.5,1.62,2.0,1.61,3
Obolon,8,4,1,3,7,9,-2,13,ukraine,0.5,0.62,-2,0.88,1.62,2.0,1.61,3
Karpaty Lviv,8,3,3,2,8,6,2,12,ukraine,0.38,0.75,2,1.0,1.5,2.63,1.33,4
Livyi Bereh,8,4,0,4,7,7,0,12,ukraine,0.5,0.5,0,0.88,1.5,2.0,2.0,4
Kryvbas KR,8,3,1,4,7,10,-3,10,ukraine,0.38,0.5,-3,0.88,1.25,2.63,2.0,5
Kolos Kovalivka,8,3,0,5,9,8,1,9,ukraine,0.38,0.38,1,1.12,1.12,2.63,2.63,6
Inhulets,8,2,1,5,4,7,-3,7,ukraine,0.25,0.38,-3,0.5,0.88,4.0,2.63,7
LNZ Cherkasy,8,2,1,5,6,10,-4,7,ukraine,0.25,0.38,-4,0.75,0.88,4.0,2.63,7
Rukh Lviv,8,2,1,5,4,10,-6,7,ukraine,0.25,0.38,-6,0.5,0.88,4.0,2.63,7
Chornomorets,8,2,0,6,5,13,-8,6,ukraine,0.25,0.25,-8,0.62,0.75,4.0,4.0,8
Vorskla Poltava,8,1,2,5,3,8,-5,5,ukraine,0.12,0.38,-5,0.38,0.62,8.33,2.63,9
Dnipro-1,0,0,0,0,0,0,0,0,ukraine,0.0,0.0,0,0.0,0.0,0.0,0.0,10
Racing CM,8,6,1,1,12,4,8,19,uruguay,0.75,0.88,8,1.5,2.38,1.33,1.14,1
Liverpool M.,8,5,3,0,14,5,9,18,uruguay,0.62,1.0,9,1.75,2.25,1.61,1.0,2
Nacional,8,4,3,1,17,10,7,15,uruguay,0.5,0.88,7,2.12,1.88,2.0,1.14,3
Juventud,8,5,0,3,14,10,4,15,uruguay,0.62,0.62,4,1.75,1.88,1.61,1.61,3
Defensor S.,8,3,3,2,9,7,2,12,uruguay,0.38,0.75,2,1.12,1.5,2.63,1.33,4
Cerro,8,2,4,2,9,9,0,10,uruguay,0.25,0.75,0,1.12,1.25,4.0,1.33,5
Boston River,8,3,1,4,10,13,-3,10,uruguay,0.38,0.5,-3,1.25,1.25,2.63,2.0,5
Penarol,8,3,1,4,8,11,-3,10,uruguay,0.38,0.5,-3,1.0,1.25,2.63,2.0,5
Progreso,8,1,6,1,8,8,0,9,uruguay,0.12,0.88,0,1.0,1.12,8.33,1.14,6
Plaza Colonia,8,2,3,3,7,8,-1,9,uruguay,0.25,0.62,-1,0.88,1.12,4.0,1.61,6
Cerro Largo,8,2,3,3,6,11,-5,9,uruguay,0.25,0.62,-5,0.75,1.12,4.0,1.61,6
Miramar Misione,8,2,2,4,9,13,-4,8,uruguay,0.25,0.5,-4,1.12,1.0,4.0,2.0,7
Wanderers,8,1,4,3,8,8,0,7,uruguay,0.12,0.62,0,1.0,0.88,8.33,1.61,8
Montevideo City,8,1,4,3,8,14,-6,7,uruguay,0.12,0.62,-6,1.0,0.88,8.33,1.61,8
River Plate,8,1,3,4,7,11,-4,6,uruguay,0.12,0.5,-4,0.88,0.75,8.33,2.0,9
Danubio,8,0,5,3,6,10,-4,5,uruguay,0.0,0.62,-4,0.75,0.62,0.0,1.61,10
Nacional,7,5,1,1,18,5,13,16,uruguay2,0.71,0.86,13,2.57,2.29,1.41,1.16,1
Penarol,7,4,2,1,10,5,5,14,uruguay2,0.57,0.86,5,1.43,2.0,1.75,1.16,2
Danubio,7,4,2,1,11,11,0,14,uruguay2,0.57,0.86,0,1.57,2.0,1.75,1.16,2
Wanderers,7,4,1,2,11,9,2,13,uruguay2,0.57,0.71,2,1.57,1.86,1.75,1.41,3
Defensor S.,7,3,2,2,7,5,2,11,uruguay2,0.43,0.71,2,1.0,1.57,2.33,1.41,4
Cerro Largo,7,3,2,2,6,7,-1,11,uruguay2,0.43,0.71,-1,0.86,1.57,2.33,1.41,4
Cerro,7,3,1,3,8,5,3,10,uruguay2,0.43,0.57,3,1.14,1.43,2.33,1.75,5
Fenix,7,3,1,3,10,9,1,10,uruguay2,0.43,0.57,1,1.43,1.43,2.33,1.75,5
Miramar Misione,7,3,1,3,7,10,-3,10,uruguay2,0.43,0.57,-3,1.0,1.43,2.33,1.75,5
River Plate,7,2,2,3,8,9,-1,8,uruguay2,0.29,0.57,-1,1.14,1.14,3.45,1.75,6
Progreso,7,2,2,3,8,11,-3,8,uruguay2,0.29,0.57,-3,1.14,1.14,3.45,1.75,6
Rampla Juniors,7,2,2,3,8,12,-4,8,uruguay2,0.29,0.57,-4,1.14,1.14,3.45,1.75,6
Boston River,7,2,1,4,6,8,-2,7,uruguay2,0.29,0.43,-2,0.86,1.0,3.45,2.33,7
Racing CM,7,1,3,3,8,10,-2,6,uruguay2,0.14,0.57,-2,1.14,0.86,7.14,1.75,8
D. Maldonado,7,1,3,3,5,9,-4,6,uruguay2,0.14,0.57,-4,0.71,0.86,7.14,1.75,8
Liverpool M.,7,1,0,6,4,10,-6,3,uruguay2,0.14,0.14,-6,0.57,0.43,7.14,7.14,9
Vancouver,8,6,1,1,17,6,11,19,usa,0.75,0.88,11,2.12,2.38,1.33,1.14,1
Columbus Crew,8,5,3,0,12,6,6,18,usa,0.62,1.0,6,1.5,2.25,1.61,1.0,2
Charlotte,8,5,1,2,13,7,6,16,usa,0.62,0.75,6,1.62,2.0,1.61,1.33,3
Cincinnati,8,5,1,2,10,9,1,16,usa,0.62,0.75,1,1.25,2.0,1.61,1.33,3
Inter Miami,7,4,3,0,12,6,6,15,usa,0.57,1.0,6,1.71,2.14,1.75,1.0,4
Minnesota Utd,8,4,3,1,11,7,4,15,usa,0.5,0.88,4,1.38,1.88,2.0,1.14,4
San Diego,8,4,2,2,15,9,6,14,usa,0.5,0.75,6,1.88,1.75,2.0,1.33,5
Portland,8,4,2,2,13,10,3,14,usa,0.5,0.75,3,1.62,1.75,2.0,1.33,5
Colorado Rapids,8,4,2,2,11,11,0,14,usa,0.5,0.75,0,1.38,1.75,2.0,1.33,5
Philadelphia,8,4,1,3,13,9,4,13,usa,0.5,0.62,4,1.62,1.62,2.0,1.61,6
Nashville SC,8,4,1,3,12,8,4,13,usa,0.5,0.62,4,1.5,1.62,2.0,1.61,6
Austin,8,4,1,3,6,8,-2,13,usa,0.5,0.62,-2,0.75,1.62,2.0,1.61,6
Orlando City,8,3,3,2,15,12,3,12,usa,0.38,0.75,3,1.88,1.5,2.63,1.33,7
Chicago Fire,8,3,3,2,14,12,2,12,usa,0.38,0.75,2,1.75,1.5,2.63,1.33,7
New York RB,8,3,3,2,9,7,2,12,usa,0.38,0.75,2,1.12,1.5,2.63,1.33,7
Los Angeles FC,8,4,0,4,10,11,-1,12,usa,0.5,0.5,-1,1.25,1.5,2.0,2.0,7
New York City,8,3,2,3,11,11,0,11,usa,0.38,0.62,0,1.38,1.38,2.63,1.61,8
Dallas,8,3,2,3,10,11,-1,11,usa,0.38,0.62,-1,1.25,1.38,2.63,1.61,8
SJ Earthquakes,8,3,1,4,16,12,4,10,usa,0.38,0.5,4,2.0,1.25,2.63,2.0,9
Atlanta Utd,8,2,3,3,11,13,-2,9,usa,0.25,0.62,-2,1.38,1.12,4.0,1.61,10
Seattle,8,2,3,3,9,11,-2,9,usa,0.25,0.62,-2,1.12,1.12,4.0,1.61,10
Real Salt Lake,8,3,0,5,8,13,-5,9,usa,0.38,0.38,-5,1.0,1.12,2.63,2.63,10
St. Louis City,8,2,2,4,5,6,-1,8,usa,0.25,0.5,-1,0.62,1.0,4.0,2.0,11
New England,7,2,1,4,4,7,-3,7,usa,0.29,0.43,-3,0.57,1.0,3.45,2.33,12
Houston Dynamo,8,1,3,4,6,12,-6,6,usa,0.12,0.5,-6,0.75,0.75,8.33,2.0,13
DC United,8,1,3,4,9,18,-9,6,usa,0.12,0.5,-9,1.12,0.75,8.33,2.0,13
Sporting KC,8,1,1,6,10,16,-6,4,usa,0.12,0.25,-6,1.25,0.5,8.33,4.0,14
Toronto,8,0,4,4,7,13,-6,4,usa,0.0,0.5,-6,0.88,0.5,0.0,2.0,14
LA Galaxy,8,0,3,5,6,15,-9,3,usa,0.0,0.38,-9,0.75,0.38,0.0,2.63,15
Loudoun Utd,6,5,0,1,11,5,6,15,usa2,0.83,0.83,6,1.83,2.5,1.2,1.2,1
Monterey Bay,6,4,1,1,11,5,6,13,usa2,0.67,0.83,6,1.83,2.17,1.49,1.2,2
San Antonio,6,4,0,2,10,7,3,12,usa2,0.67,0.67,3,1.67,2.0,1.49,1.49,3
New Mexico,5,4,0,1,7,4,3,12,usa2,0.8,0.8,3,1.4,2.4,1.25,1.25,3
Louisville City,5,3,2,0,8,3,5,11,usa2,0.6,1.0,5,1.6,2.2,1.67,1.0,4
Detroit City,6,3,2,1,9,7,2,11,usa2,0.5,0.83,2,1.5,1.83,2.0,1.2,4
Charleston,5,3,0,2,8,6,2,9,usa2,0.6,0.6,2,1.6,1.8,1.67,1.67,5
FC Tulsa,5,3,0,2,4,3,1,9,usa2,0.6,0.6,1,0.8,1.8,1.67,1.67,5
Las Vegas L.,5,2,2,1,4,3,1,8,usa2,0.4,0.8,1,0.8,1.6,2.5,1.25,6
North Carolina,6,2,2,2,7,7,0,8,usa2,0.33,0.67,0,1.17,1.33,3.03,1.49,6
El Paso,6,2,2,2,11,12,-1,8,usa2,0.33,0.67,-1,1.83,1.33,3.03,1.49,6
Pittsburgh,5,2,1,2,5,5,0,7,usa2,0.4,0.6,0,1.0,1.4,2.5,1.67,7
Orange County,5,2,1,2,8,9,-1,7,usa2,0.4,0.6,-1,1.6,1.4,2.5,1.67,7
Lexington,6,1,3,2,8,8,0,6,usa2,0.17,0.67,0,1.33,1.0,5.88,1.49,8
Indy Eleven,4,1,2,1,8,7,1,5,usa2,0.25,0.75,1,2.0,1.25,4.0,1.33,9
Colorado S.,5,1,2,2,9,10,-1,5,usa2,0.2,0.6,-1,1.8,1.0,5.0,1.67,9
Sacramento R.,5,1,2,2,6,7,-1,5,usa2,0.2,0.6,-1,1.2,1.0,5.0,1.67,9
Birmingham L.,5,1,2,2,7,9,-2,5,usa2,0.2,0.6,-2,1.4,1.0,5.0,1.67,9
Phoenix Rising,6,1,2,3,11,14,-3,5,usa2,0.17,0.5,-3,1.83,0.83,5.88,2.0,9
Rhode Island,4,1,1,2,5,6,-1,4,usa2,0.25,0.5,-1,1.25,1.0,4.0,2.0,10
Oakland Roots,6,1,1,4,7,13,-6,4,usa2,0.17,0.33,-6,1.17,0.67,5.88,3.03,10
Tampa Bay,5,1,0,4,4,7,-3,3,usa2,0.2,0.2,-3,0.8,0.6,5.0,5.0,11
Miami FC,5,1,0,4,4,9,-5,3,usa2,0.2,0.2,-5,0.8,0.6,5.0,5.0,11
Hartford A.,4,0,0,4,1,7,-6,0,usa2,0.0,0.0,-6,0.25,0.0,0.0,0.0,12
Naples,6,4,2,0,9,2,7,14,usa3,0.67,1.0,7,1.5,2.33,1.49,1.0,1
Richmond K.,6,3,0,3,10,8,2,9,usa3,0.5,0.5,2,1.67,1.5,2.0,2.0,2
Spokane V.,5,2,2,1,10,4,6,8,usa3,0.4,0.8,6,2.0,1.6,2.5,1.25,3
One Knoxville,3,2,1,0,5,2,3,7,usa3,0.67,1.0,3,1.67,2.33,1.49,1.0,4
Tormenta,5,2,1,2,9,10,-1,7,usa3,0.4,0.6,-1,1.8,1.4,2.5,1.67,4
Greenville,5,2,1,2,5,6,-1,7,usa3,0.4,0.6,-1,1.0,1.4,2.5,1.67,4
Alta,4,2,0,2,6,7,-1,6,usa3,0.5,0.5,-1,1.5,1.5,2.0,2.0,5
Charlotte I.,4,1,2,1,2,2,0,5,usa3,0.25,0.75,0,0.5,1.25,4.0,1.33,6
Westchester SC,3,1,1,1,4,4,0,4,usa3,0.33,0.67,0,1.33,1.33,3.03,1.49,7
Forward Madison,3,1,1,1,3,4,-1,4,usa3,0.33,0.67,-1,1.0,1.33,3.03,1.49,7
Chattanooga RW,4,0,3,1,5,6,-1,3,usa3,0.0,0.75,-1,1.25,0.75,0.0,1.33,8
Union Omaha,3,1,0,2,3,5,-2,3,usa3,0.33,0.33,-2,1.0,1.0,3.03,3.03,8
Portland Hearts,3,0,2,1,1,2,-1,2,usa3,0.0,0.67,-1,0.33,0.67,0.0,1.49,9
Texoma,4,0,0,4,2,12,-10,0,usa3,0.0,0.0,-10,0.5,0.0,0.0,0.0,10
UCV,8,6,2,0,9,2,7,20,venezuela,0.75,1.0,7,1.12,2.5,1.33,1.0,1
D. La Guaira,8,6,1,1,14,6,8,19,venezuela,0.75,0.88,8,1.75,2.38,1.33,1.14,2
Carabobo,8,5,2,1,8,6,2,17,venezuela,0.62,0.88,2,1.0,2.12,1.61,1.14,3
Puerto Cabello,8,4,3,1,7,3,4,15,venezuela,0.5,0.88,4,0.88,1.88,2.0,1.14,4
Rayo Zuliano,8,4,0,4,8,6,2,12,venezuela,0.5,0.5,2,1.0,1.5,2.0,2.0,5
D. Tachira,8,3,3,2,10,9,1,12,venezuela,0.38,0.75,1,1.25,1.5,2.63,1.33,5
Monagas,8,3,2,3,9,10,-1,11,venezuela,0.38,0.62,-1,1.12,1.38,2.63,1.61,6
A. Anzoategui,8,2,4,2,8,7,1,10,venezuela,0.25,0.75,1,1.0,1.25,4.0,1.33,7
Metropolitanos,8,2,3,3,10,12,-2,9,venezuela,0.25,0.62,-2,1.25,1.12,4.0,1.61,8
Portuguesa,8,2,2,4,8,10,-2,8,venezuela,0.25,0.5,-2,1.0,1.0,4.0,2.0,9
Caracas,8,1,3,4,5,9,-4,6,venezuela,0.12,0.5,-4,0.62,0.75,8.33,2.0,10
Zamora,8,1,2,5,6,10,-4,5,venezuela,0.12,0.38,-4,0.75,0.62,8.33,2.63,11
E. Merida,8,1,1,6,11,17,-6,4,venezuela,0.12,0.25,-6,1.38,0.5,8.33,4.0,12
Yaracuyanos,8,0,4,4,10,16,-6,4,venezuela,0.0,0.5,-6,1.25,0.5,0.0,2.0,12
AGMK,5,4,1,0,8,2,6,13,uzbekistan,0.8,1.0,6,1.6,2.6,1.25,1.0,1
Bunyodkor,5,3,2,0,9,3,6,11,uzbekistan,0.6,1.0,6,1.8,2.2,1.67,1.0,2
Nasaf Qarshi,5,3,2,0,7,2,5,11,uzbekistan,0.6,1.0,5,1.4,2.2,1.67,1.0,2
Neftchi,5,2,3,0,9,5,4,9,uzbekistan,0.4,1.0,4,1.8,1.8,2.5,1.0,3
Andijan,5,2,3,0,8,6,2,9,uzbekistan,0.4,1.0,2,1.6,1.8,2.5,1.0,3
D. Samarqand,5,2,3,0,3,1,2,9,uzbekistan,0.4,1.0,2,0.6,1.8,2.5,1.0,3
Navbahor,5,2,2,1,9,7,2,8,uzbekistan,0.4,0.8,2,1.8,1.6,2.5,1.25,4
Buxoro,5,2,0,3,7,6,1,6,uzbekistan,0.4,0.4,1,1.4,1.2,2.5,2.5,5
Xorazm,4,2,0,2,5,5,0,6,uzbekistan,0.5,0.5,0,1.25,1.5,2.0,2.0,5
Kokand-1912,5,1,3,1,3,4,-1,6,uzbekistan,0.2,0.8,-1,0.6,1.2,5.0,1.25,5
Sogdiana,5,1,1,3,5,6,-1,4,uzbekistan,0.2,0.4,-1,1.0,0.8,5.0,2.5,6
Qizilqum,4,1,1,2,3,5,-2,4,uzbekistan,0.25,0.5,-2,0.75,1.0,4.0,2.0,6
Pakhtakor,5,1,0,4,7,8,-1,3,uzbekistan,0.2,0.2,-1,1.4,0.6,5.0,5.0,7
Termez Surkhon,5,1,0,4,4,9,-5,3,uzbekistan,0.2,0.2,-5,0.8,0.6,5.0,5.0,7
Mashal,5,1,0,4,2,11,-9,3,uzbekistan,0.2,0.2,-9,0.4,0.6,5.0,5.0,7
Shurtan,5,0,1,4,1,10,-9,1,uzbekistan,0.0,0.2,-9,0.2,0.2,0.0,5.0,8
Nam Dinh,8,4,3,1,11,5,6,15,vietnam,0.5,0.88,6,1.38,1.88,2.0,1.14,1
Ha Noi,8,4,2,2,14,7,7,14,vietnam,0.5,0.75,7,1.75,1.75,2.0,1.33,2
Hai Phong,8,4,2,2,7,5,2,14,vietnam,0.5,0.75,2,0.88,1.75,2.0,1.33,2
Cong An Nhan,8,3,4,1,14,11,3,13,vietnam,0.38,0.88,3,1.75,1.62,2.63,1.14,3
Viettel,8,3,3,2,12,12,0,12,vietnam,0.38,0.75,0,1.5,1.5,2.63,1.33,4
Song Lam Nghe,8,3,3,2,7,8,-1,12,vietnam,0.38,0.75,-1,0.88,1.5,2.63,1.33,4
Binh Duong,8,3,2,3,9,12,-3,11,vietnam,0.38,0.62,-3,1.12,1.38,2.63,1.61,5
Ho Chi Minh,8,2,4,2,8,10,-2,10,vietnam,0.25,0.75,-2,1.0,1.25,4.0,1.33,6
Quang Nam,8,2,3,3,14,14,0,9,vietnam,0.25,0.62,0,1.75,1.12,4.0,1.61,7
Hong Linh Ha T.,8,1,6,1,7,7,0,9,vietnam,0.12,0.88,0,0.88,1.12,8.33,1.14,7
Gia Lai,8,2,2,4,10,12,-2,8,vietnam,0.25,0.5,-2,1.25,1.0,4.0,2.0,8
Da Nang,8,1,3,4,8,11,-3,6,vietnam,0.12,0.5,-3,1.0,0.75,8.33,2.0,9
Thanh Hoa,8,0,6,2,8,11,-3,6,vietnam,0.0,0.75,-3,1.0,0.75,0.0,1.33,9
Binh Dinh,8,1,2,5,5,10,-5,5,vietnam,0.12,0.38,-5,0.62,0.62,8.33,2.63,10
Phu Dong,8,8,0,0,17,0,17,24,vietnam2,1.0,1.0,17,2.12,3.0,1.0,1.0,1
PVF-CAND,8,6,1,1,15,7,8,19,vietnam2,0.75,0.88,8,1.88,2.38,1.33,1.14,2
Binh Phuoc,8,5,2,1,13,5,8,17,vietnam2,0.62,0.88,8,1.62,2.12,1.61,1.14,3
Ba Ria Vung Tau,8,3,1,4,6,13,-7,10,vietnam2,0.38,0.5,-7,0.75,1.25,2.63,2.0,4
S. Khanh Hoa,8,2,3,3,7,9,-2,9,vietnam2,0.25,0.62,-2,0.88,1.12,4.0,1.61,5
Ho Chi Minh B,8,2,3,3,7,10,-3,9,vietnam2,0.25,0.62,-3,0.88,1.12,4.0,1.61,5
Long An,8,2,2,4,4,8,-4,8,vietnam2,0.25,0.5,-4,0.5,1.0,4.0,2.0,6
Dong Nai,8,1,4,3,2,4,-2,7,vietnam2,0.12,0.62,-2,0.25,0.88,8.33,1.61,7
Hoa Binh,8,1,4,3,4,8,-4,7,vietnam2,0.12,0.62,-4,0.5,0.88,8.33,1.61,7
Dong Thap,8,1,3,4,4,6,-2,6,vietnam2,0.12,0.5,-2,0.5,0.75,8.33,2.0,8
Hue,8,1,1,6,6,15,-9,4,vietnam2,0.12,0.25,-9,0.75,0.5,8.33,4.0,9
The New Saints,8,7,0,1,22,3,19,21,wales,0.88,0.88,19,2.75,2.62,1.14,1.14,1
Barry,8,5,1,2,16,12,4,16,wales,0.62,0.75,4,2.0,2.0,1.61,1.33,2
Flint,8,5,1,2,15,14,1,16,wales,0.62,0.75,1,1.88,2.0,1.61,1.33,2
Connahs Quay,8,5,0,3,13,6,7,15,wales,0.62,0.62,7,1.62,1.88,1.61,1.61,3
Penybont,8,4,2,2,11,11,0,14,wales,0.5,0.75,0,1.38,1.75,2.0,1.33,4
Briton Ferry,8,3,1,4,11,13,-2,10,wales,0.38,0.5,-2,1.38,1.25,2.63,2.0,5
Cardiff MU,8,2,3,3,8,14,-6,9,wales,0.25,0.62,-6,1.0,1.12,4.0,1.61,6
Caernarfon,8,2,2,4,13,14,-1,8,wales,0.25,0.5,-1,1.62,1.0,4.0,2.0,7
Haverfordwest,8,1,5,2,6,10,-4,8,wales,0.12,0.75,-4,0.75,1.0,8.33,1.33,7
Newtown,8,1,3,4,10,13,-3,6,wales,0.12,0.5,-3,1.25,0.75,8.33,2.0,8
Aberystwyth,8,2,0,6,8,15,-7,6,wales,0.25,0.25,-7,1.0,0.75,4.0,4.0,8
Bala Town,8,0,2,6,5,17,-12,2,wales,0.0,0.25,-12,0.62,0.25,0.0,4.0,9
