Team_Home_Overall,GP,W,D,L,GF,GA,GD,Pts_Overall,Liga,PIO,PIO_HA,GD_Overall,GF_AVG_Overall,GA_AVG_Overall,PPG_Overall,Odd_Justa_MO,Odd_Justa_HA,Rank_Overall
AF Elbasani,8,4,3,1,8,6,2,15,Albania - Abissnet Superiore,0.5,0.88,2,1.0,0.75,1.88,2.0,1.14,1
Partizani T.,8,4,1,3,6,6,0,13,Albania - Abissnet Superiore,0.5,0.62,0,0.75,0.75,1.62,2.0,1.61,2
Skenderbeu K.,8,3,2,3,11,9,2,11,Albania - Abissnet Superiore,0.38,0.62,2,1.38,1.12,1.38,2.63,1.61,3
Bylis,8,3,2,3,7,9,-2,11,Albania - Abissnet Superiore,0.38,0.62,-2,0.88,1.12,1.38,2.63,1.61,3
KF Tirana,8,2,4,2,10,7,3,10,Albania - Abissnet Superiore,0.25,0.75,3,1.25,0.88,1.25,4.0,1.33,4
Vllaznia S.,8,1,5,2,8,7,1,8,Albania - Abissnet Superiore,0.12,0.75,1,1.0,0.88,1.0,8.33,1.33,5
Dinamo Tirana,8,2,2,4,7,13,-6,8,Albania - Abissnet Superiore,0.25,0.5,-6,0.88,1.62,1.0,4.0,2.0,5
Egnatia R.,8,1,4,3,8,9,-1,7,Albania - Abissnet Superiore,0.12,0.62,-1,1.0,1.12,0.88,8.33,1.61,6
Laci,8,1,3,4,4,7,-3,6,Albania - Abissnet Superiore,0.12,0.5,-3,0.5,0.88,0.75,8.33,2.0,7
Racing Club,8,6,1,1,13,5,8,19,Argentina - Liga Profesional,0.75,0.88,8,1.62,0.62,2.38,1.33,1.14,1
Rosario Central,8,5,3,0,11,4,7,18,Argentina - Liga Profesional,0.62,1.0,7,1.38,0.5,2.25,1.61,1.0,2
I. Rivadavia,8,5,2,1,12,8,4,17,Argentina - Liga Profesional,0.62,0.88,4,1.5,1.0,2.12,1.61,1.14,3
Boca Juniors,8,5,1,2,15,6,9,16,Argentina - Liga Profesional,0.62,0.75,9,1.88,0.75,2.0,1.61,1.33,4
River Plate,8,4,4,0,14,6,8,16,Argentina - Liga Profesional,0.5,1.0,8,1.75,0.75,2.0,2.0,1.0,4
Argentinos Jrs,8,4,3,1,15,6,9,15,Argentina - Liga Profesional,0.5,0.88,9,1.88,0.75,1.88,2.0,1.14,5
Platense,8,4,2,2,7,4,3,14,Argentina - Liga Profesional,0.5,0.75,3,0.88,0.5,1.75,2.0,1.33,6
Barracas C.,8,4,2,2,8,8,0,14,Argentina - Liga Profesional,0.5,0.75,0,1.0,1.0,1.75,2.0,1.33,6
Newells,8,3,4,1,8,3,5,13,Argentina - Liga Profesional,0.38,0.88,5,1.0,0.38,1.62,2.63,1.14,7
Aldosivi,8,4,1,3,12,10,2,13,Argentina - Liga Profesional,0.5,0.62,2,1.5,1.25,1.62,2.0,1.61,7
D. Riestra,8,3,4,1,6,4,2,13,Argentina - Liga Profesional,0.38,0.88,2,0.75,0.5,1.62,2.63,1.14,7
Independiente,8,3,3,2,10,6,4,12,Argentina - Liga Profesional,0.38,0.75,4,1.25,0.75,1.5,2.63,1.33,8
Huracan,8,3,3,2,9,8,1,12,Argentina - Liga Profesional,0.38,0.75,1,1.12,1.0,1.5,2.63,1.33,8
Velez Sarsfield,8,4,0,4,7,9,-2,12,Argentina - Liga Profesional,0.5,0.5,-2,0.88,1.12,1.5,2.0,2.0,8
Lanus,8,2,5,1,8,5,3,11,Argentina - Liga Profesional,0.25,0.88,3,1.0,0.62,1.38,4.0,1.14,9
Instituto,8,3,2,3,11,13,-2,11,Argentina - Liga Profesional,0.38,0.62,-2,1.38,1.62,1.38,2.63,1.61,9
San Lorenzo,8,2,4,2,5,5,0,10,Argentina - Liga Profesional,0.25,0.75,0,0.62,0.62,1.25,4.0,1.33,10
Union Santa Fe,8,2,3,3,8,8,0,9,Argentina - Liga Profesional,0.25,0.62,0,1.0,1.0,1.12,4.0,1.61,11
Sarmiento,8,1,6,1,5,5,0,9,Argentina - Liga Profesional,0.12,0.88,0,0.62,0.62,1.12,8.33,1.14,11
A. Tucuman,8,3,0,5,8,9,-1,9,Argentina - Liga Profesional,0.38,0.38,-1,1.0,1.12,1.12,2.63,2.63,11
Belgrano,8,1,6,1,6,7,-1,9,Argentina - Liga Profesional,0.12,0.88,-1,0.75,0.88,1.12,8.33,1.14,11
Tigre,8,2,3,3,6,7,-1,9,Argentina - Liga Profesional,0.25,0.62,-1,0.75,0.88,1.12,4.0,1.61,11
T. de Cordoba,8,1,4,3,6,7,-1,7,Argentina - Liga Profesional,0.12,0.62,-1,0.75,0.88,0.88,8.33,1.61,12
Godoy Cruz,8,1,4,3,2,9,-7,7,Argentina - Liga Profesional,0.12,0.62,-7,0.25,1.12,0.88,8.33,1.61,12
Banfield,8,1,3,4,9,14,-5,6,Argentina - Liga Profesional,0.12,0.5,-5,1.12,1.75,0.75,8.33,2.0,13
Gimnasia,8,1,3,4,4,10,-6,6,Argentina - Liga Profesional,0.12,0.5,-6,0.5,1.25,0.75,8.33,2.0,13
Defensa y J.,8,1,2,5,7,16,-9,5,Argentina - Liga Profesional,0.12,0.38,-9,0.88,2.0,0.62,8.33,2.63,14
Central Cordoba,8,1,1,6,6,14,-8,4,Argentina - Liga Profesional,0.12,0.25,-8,0.75,1.75,0.5,8.33,4.0,15
Estudiantes,8,0,3,5,3,12,-9,3,Argentina - Liga Profesional,0.0,0.38,-9,0.38,1.5,0.38,0.0,2.63,16
Deportivo Moron,8,6,2,0,14,3,11,20,Argentina - Primera Nacional,0.75,1.0,11,1.75,0.38,2.5,1.33,1.0,1
Gimnasia Jujuy,8,5,2,1,11,6,5,17,Argentina - Primera Nacional,0.62,0.88,5,1.38,0.75,2.12,1.61,1.14,2
Atlanta,8,5,2,1,8,4,4,17,Argentina - Primera Nacional,0.62,0.88,4,1.0,0.5,2.12,1.61,1.14,2
Almagro,8,4,3,1,8,5,3,15,Argentina - Primera Nacional,0.5,0.88,3,1.0,0.62,1.88,2.0,1.14,3
Chacarita J.,8,4,2,2,13,7,6,14,Argentina - Primera Nacional,0.5,0.75,6,1.62,0.88,1.75,2.0,1.33,4
Patronato,8,4,2,2,12,8,4,14,Argentina - Primera Nacional,0.5,0.75,4,1.5,1.0,1.75,2.0,1.33,4
SM Tucuman,8,4,2,2,10,7,3,14,Argentina - Primera Nacional,0.5,0.75,3,1.25,0.88,1.75,2.0,1.33,4
D. Madryn,8,3,4,1,11,7,4,13,Argentina - Primera Nacional,0.38,0.88,4,1.38,0.88,1.62,2.63,1.14,5
Tristan Suarez,8,3,4,1,8,4,4,13,Argentina - Primera Nacional,0.38,0.88,4,1.0,0.5,1.62,2.63,1.14,5
Chaco For Ever,8,4,1,3,9,7,2,13,Argentina - Primera Nacional,0.5,0.62,2,1.12,0.88,1.62,2.0,1.61,5
San Telmo,8,3,4,1,9,7,2,13,Argentina - Primera Nacional,0.38,0.88,2,1.12,0.88,1.62,2.63,1.14,5
G. Mendoza,8,3,4,1,7,5,2,13,Argentina - Primera Nacional,0.38,0.88,2,0.88,0.62,1.62,2.63,1.14,5
Temperley,8,3,4,1,6,4,2,13,Argentina - Primera Nacional,0.38,0.88,2,0.75,0.5,1.62,2.63,1.14,5
San Miguel,8,3,3,2,9,7,2,12,Argentina - Primera Nacional,0.38,0.75,2,1.12,0.88,1.5,2.63,1.33,6
CA Estudiantes,8,3,3,2,6,4,2,12,Argentina - Primera Nacional,0.38,0.75,2,0.75,0.5,1.5,2.63,1.33,6
E. Rio Cuarto,8,3,3,2,5,3,2,12,Argentina - Primera Nacional,0.38,0.75,2,0.62,0.38,1.5,2.63,1.33,6
Agropecuario,8,3,3,2,10,9,1,12,Argentina - Primera Nacional,0.38,0.75,1,1.25,1.12,1.5,2.63,1.33,6
Deportivo Maipu,8,3,3,2,7,6,1,12,Argentina - Primera Nacional,0.38,0.75,1,0.88,0.75,1.5,2.63,1.33,6
Colegiales,8,4,0,4,5,10,-5,12,Argentina - Primera Nacional,0.5,0.5,-5,0.62,1.25,1.5,2.0,2.0,6
D. de Belgrano,8,3,2,3,6,7,-1,11,Argentina - Primera Nacional,0.38,0.62,-1,0.75,0.88,1.38,2.63,1.61,7
Atletico Mitre,8,2,4,2,6,4,2,10,Argentina - Primera Nacional,0.25,0.75,2,0.75,0.5,1.25,4.0,1.33,8
CA Guemes,8,2,4,2,8,8,0,10,Argentina - Primera Nacional,0.25,0.75,0,1.0,1.0,1.25,4.0,1.33,8
Los Andes,8,3,1,4,7,8,-1,10,Argentina - Primera Nacional,0.38,0.5,-1,0.88,1.0,1.25,2.63,2.0,8
Gimnasia y Tiro,8,2,3,3,8,5,3,9,Argentina - Primera Nacional,0.25,0.62,3,1.0,0.62,1.12,4.0,1.61,9
Almirante Brown,8,2,3,3,5,8,-3,9,Argentina - Primera Nacional,0.25,0.62,-3,0.62,1.0,1.12,4.0,1.61,9
Racing Cordoba,8,1,5,2,12,11,1,8,Argentina - Primera Nacional,0.12,0.75,1,1.5,1.38,1.0,8.33,1.33,10
All Boys,8,1,5,2,7,8,-1,8,Argentina - Primera Nacional,0.12,0.75,-1,0.88,1.0,1.0,8.33,1.33,10
Nueva Chicago,8,2,2,4,6,8,-2,8,Argentina - Primera Nacional,0.25,0.5,-2,0.75,1.0,1.0,4.0,2.0,10
Quilmes,8,1,4,3,6,7,-1,7,Argentina - Primera Nacional,0.12,0.62,-1,0.75,0.88,0.88,8.33,1.61,11
Argentino Merlo,8,6,1,1,15,6,9,19,Argentina - Primera B,0.75,0.88,9,1.88,0.75,2.38,1.33,1.14,1
A. Quilmes,8,5,2,1,12,4,8,17,Argentina - Primera B,0.62,0.88,8,1.5,0.5,2.12,1.61,1.14,2
Comunicaciones,8,5,2,1,12,6,6,17,Argentina - Primera B,0.62,0.88,6,1.5,0.75,2.12,1.61,1.14,2
Villa Dalmine,8,5,2,1,7,2,5,17,Argentina - Primera B,0.62,0.88,5,0.88,0.25,2.12,1.61,1.14,2
Deportivo Merlo,8,4,3,1,8,4,4,15,Argentina - Primera B,0.5,0.88,4,1.0,0.5,1.88,2.0,1.14,3
Excursionistas,8,4,2,2,16,9,7,14,Argentina - Primera B,0.5,0.75,7,2.0,1.12,1.75,2.0,1.33,4
D. Armenio,8,4,1,3,13,8,5,13,Argentina - Primera B,0.5,0.62,5,1.62,1.0,1.62,2.0,1.61,5
Colegiales,8,4,1,3,9,7,2,13,Argentina - Primera B,0.5,0.62,2,1.12,0.88,1.62,2.0,1.61,5
Midland,8,3,3,2,10,7,3,12,Argentina - Primera B,0.38,0.75,3,1.25,0.88,1.5,2.63,1.33,6
Sacachispas,8,3,2,3,4,6,-2,11,Argentina - Primera B,0.38,0.62,-2,0.5,0.75,1.38,2.63,1.61,7
Liniers,8,2,4,2,5,5,0,10,Argentina - Primera B,0.25,0.75,0,0.62,0.62,1.25,4.0,1.33,8
S. Italiano,8,2,3,3,9,9,0,9,Argentina - Primera B,0.25,0.62,0,1.12,1.12,1.12,4.0,1.61,9
Flandria,8,2,3,3,7,9,-2,9,Argentina - Primera B,0.25,0.62,-2,0.88,1.12,1.12,4.0,1.61,9
SM Burzaco,8,3,0,5,5,9,-4,9,Argentina - Primera B,0.38,0.38,-4,0.62,1.12,1.12,2.63,2.63,9
Dock Sud,8,2,2,4,5,8,-3,8,Argentina - Primera B,0.25,0.5,-3,0.62,1.0,1.0,4.0,2.0,10
Los Andes,8,2,2,4,5,9,-4,8,Argentina - Primera B,0.25,0.5,-4,0.62,1.12,1.0,4.0,2.0,10
Acassuso,8,2,2,4,5,12,-7,8,Argentina - Primera B,0.25,0.5,-7,0.62,1.5,1.0,4.0,2.0,10
UAI Urquiza,8,2,2,4,10,18,-8,8,Argentina - Primera B,0.25,0.5,-8,1.25,2.25,1.0,4.0,2.0,10
V. San Carlos,8,2,1,5,5,9,-4,7,Argentina - Primera B,0.25,0.38,-4,0.62,1.12,0.88,4.0,2.63,11
D. Laferrere,8,1,4,3,4,9,-5,7,Argentina - Primera B,0.12,0.62,-5,0.5,1.12,0.88,8.33,1.61,11
Canuelas,8,2,0,6,6,11,-5,6,Argentina - Primera B,0.25,0.25,-5,0.75,1.38,0.75,4.0,4.0,12
Fenix,8,1,1,6,5,12,-7,4,Argentina - Primera B,0.12,0.25,-7,0.62,1.5,0.5,8.33,4.0,13
Cipolletti,8,6,1,1,12,3,9,19,Argentina - Torneo Federal,0.75,0.88,9,1.5,0.38,2.38,1.33,1.14,1
Villa Mitre,8,5,2,1,11,4,7,17,Argentina - Torneo Federal,0.62,0.88,7,1.38,0.5,2.12,1.61,1.14,2
A. Rafaela,8,5,2,1,10,4,6,17,Argentina - Torneo Federal,0.62,0.88,6,1.25,0.5,2.12,1.61,1.14,2
Costa Brava,8,5,2,1,8,4,4,17,Argentina - Torneo Federal,0.62,0.88,4,1.0,0.5,2.12,1.61,1.14,2
SM Formosa,8,4,4,0,13,3,10,16,Argentina - Torneo Federal,0.5,1.0,10,1.62,0.38,2.0,2.0,1.0,3
Ciudad Bolivar,8,5,1,2,13,5,8,16,Argentina - Torneo Federal,0.62,0.75,8,1.62,0.62,2.0,1.61,1.33,3
S. Belgrano,8,5,1,2,13,7,6,16,Argentina - Torneo Federal,0.62,0.75,6,1.62,0.88,2.0,1.61,1.33,3
Kimberley,8,4,3,1,10,7,3,15,Argentina - Torneo Federal,0.5,0.88,3,1.25,0.88,1.88,2.0,1.14,4
Douglas Haig,8,4,2,2,10,7,3,14,Argentina - Torneo Federal,0.5,0.75,3,1.25,0.88,1.75,2.0,1.33,5
Atenas,8,4,1,3,10,5,5,13,Argentina - Torneo Federal,0.5,0.62,5,1.25,0.62,1.62,2.0,1.61,6
Sarmiento DLB,8,4,1,3,9,7,2,13,Argentina - Torneo Federal,0.5,0.62,2,1.12,0.88,1.62,2.0,1.61,6
Bartolom√© Mitre,8,3,3,2,9,7,2,12,Argentina - Torneo Federal,0.38,0.75,2,1.12,0.88,1.5,2.63,1.33,7
S. Estudiantes,8,3,3,2,9,7,2,12,Argentina - Torneo Federal,0.38,0.75,2,1.12,0.88,1.5,2.63,1.33,7
Circulo D.,8,4,0,4,5,6,-1,12,Argentina - Torneo Federal,0.5,0.5,-1,0.62,0.75,1.5,2.0,2.0,7
9 Julio Rafaela,8,3,2,3,12,10,2,11,Argentina - Torneo Federal,0.38,0.62,2,1.5,1.25,1.38,2.63,1.61,8
J. Antoniana,8,3,2,3,9,7,2,11,Argentina - Torneo Federal,0.38,0.62,2,1.12,0.88,1.38,2.63,1.61,8
Juventud U. U.,8,2,5,1,8,6,2,11,Argentina - Torneo Federal,0.25,0.88,2,1.0,0.75,1.38,4.0,1.14,8
El Linqueno,8,3,2,3,8,7,1,11,Argentina - Torneo Federal,0.38,0.62,1,1.0,0.88,1.38,2.63,1.61,8
D. Rincon,8,3,2,3,11,11,0,11,Argentina - Torneo Federal,0.38,0.62,0,1.38,1.38,1.38,2.63,1.61,8
G. Chivilcoy,8,2,5,1,9,9,0,11,Argentina - Torneo Federal,0.25,0.88,0,1.12,1.12,1.38,4.0,1.14,8
Gimnasia E.,8,3,2,3,10,11,-1,11,Argentina - Torneo Federal,0.38,0.62,-1,1.25,1.38,1.38,2.63,1.61,8
Germinal,8,3,2,3,8,10,-2,11,Argentina - Torneo Federal,0.38,0.62,-2,1.0,1.25,1.38,2.63,1.61,8
Huracan Las H.,8,3,2,3,7,11,-4,11,Argentina - Torneo Federal,0.38,0.62,-4,0.88,1.38,1.38,2.63,1.61,8
D. Belgrano VR,8,2,4,2,6,6,0,10,Argentina - Torneo Federal,0.25,0.75,0,0.75,0.75,1.25,4.0,1.33,9
SM Mendoza,8,3,0,5,10,10,0,9,Argentina - Torneo Federal,0.38,0.38,0,1.25,1.25,1.12,2.63,2.63,10
Ben Hur,8,2,3,3,7,8,-1,9,Argentina - Torneo Federal,0.25,0.62,-1,0.88,1.0,1.12,4.0,1.61,10
Argentino MM,8,2,3,3,6,7,-1,9,Argentina - Torneo Federal,0.25,0.62,-1,0.75,0.88,1.12,4.0,1.61,10
Sol de Mayo,8,2,3,3,6,7,-1,9,Argentina - Torneo Federal,0.25,0.62,-1,0.75,0.88,1.12,4.0,1.61,10
I. Chivilcoy,8,2,3,3,6,10,-4,9,Argentina - Torneo Federal,0.25,0.62,-4,0.75,1.25,1.12,4.0,1.61,10
Ararat-Armenia,8,7,0,1,28,5,23,21,Armenia - Premier League,0.88,0.88,23,3.5,0.62,2.62,1.14,1.14,1
Noah,8,5,2,1,18,8,10,17,Armenia - Premier League,0.62,0.88,10,2.25,1.0,2.12,1.61,1.14,2
Urartu,8,4,3,1,22,10,12,15,Armenia - Premier League,0.5,0.88,12,2.75,1.25,1.88,2.0,1.14,3
Van,8,4,2,2,14,11,3,14,Armenia - Premier League,0.5,0.75,3,1.75,1.38,1.75,2.0,1.33,4
Alashkert,8,3,2,3,9,11,-2,11,Armenia - Premier League,0.38,0.62,-2,1.12,1.38,1.38,2.63,1.61,5
BKMA,8,3,2,3,11,16,-5,11,Armenia - Premier League,0.38,0.62,-5,1.38,2.0,1.38,2.63,1.61,5
Pyunik,8,3,1,4,15,15,0,10,Armenia - Premier League,0.38,0.5,0,1.88,1.88,1.25,2.63,2.0,6
Ararat Yerevan,8,3,0,5,13,23,-10,9,Armenia - Premier League,0.38,0.38,-10,1.62,2.88,1.12,2.63,2.63,7
Shirak,8,2,1,5,12,14,-2,7,Armenia - Premier League,0.25,0.38,-2,1.5,1.75,0.88,4.0,2.63,8
Gandzasar,8,2,1,5,7,13,-6,7,Armenia - Premier League,0.25,0.38,-6,0.88,1.62,0.88,4.0,2.63,8
West Armenia,8,1,0,7,3,27,-24,3,Armenia - Premier League,0.12,0.12,-24,0.38,3.38,0.38,8.33,8.33,9
Western United,8,6,0,2,22,11,11,18,Australia - A-League,0.75,0.75,11,2.75,1.38,2.25,1.33,1.33,1
WS Wanderers,8,5,3,0,19,9,10,18,Australia - A-League,0.62,1.0,10,2.38,1.12,2.25,1.61,1.0,1
Melbourne City,8,5,2,1,16,8,8,17,Australia - A-League,0.62,0.88,8,2.0,1.0,2.12,1.61,1.14,2
Melbourne V.,8,4,2,2,17,14,3,14,Australia - A-League,0.5,0.75,3,2.12,1.75,1.75,2.0,1.33,3
Auckland,8,3,4,1,13,10,3,13,Australia - A-League,0.38,0.88,3,1.62,1.25,1.62,2.63,1.14,4
Brisbane Roar,8,4,1,3,12,14,-2,13,Australia - A-League,0.5,0.62,-2,1.5,1.75,1.62,2.0,1.61,4
Sydney FC,8,3,2,3,14,16,-2,11,Australia - A-League,0.38,0.62,-2,1.75,2.0,1.38,2.63,1.61,5
Newcastle Jets,8,2,2,4,16,16,0,8,Australia - A-League,0.25,0.5,0,2.0,2.0,1.0,4.0,2.0,6
Macarthur FC,8,2,2,4,17,19,-2,8,Australia - A-League,0.25,0.5,-2,2.12,2.38,1.0,4.0,2.0,6
Perth Glory,8,2,1,5,10,15,-5,7,Australia - A-League,0.25,0.38,-5,1.25,1.88,0.88,4.0,2.63,7
Adelaide Utd,8,1,3,4,15,21,-6,6,Australia - A-League,0.12,0.5,-6,1.88,2.62,0.75,8.33,2.0,8
Wellington,8,1,2,5,10,17,-7,5,Australia - A-League,0.12,0.38,-7,1.25,2.12,0.62,8.33,2.63,9
Central Coast,8,1,2,5,9,20,-11,5,Australia - A-League,0.12,0.38,-11,1.12,2.5,0.62,8.33,2.63,9
Heidelberg Utd,8,7,1,0,18,6,12,22,Australia - NPL Victoria,0.88,1.0,12,2.25,0.75,2.75,1.14,1.0,1
Hume City,8,6,1,1,18,10,8,19,Australia - NPL Victoria,0.75,0.88,8,2.25,1.25,2.38,1.33,1.14,2
Avondale,8,6,0,2,23,11,12,18,Australia - NPL Victoria,0.75,0.75,12,2.88,1.38,2.25,1.33,1.33,3
Oakleigh C.,8,6,0,2,18,9,9,18,Australia - NPL Victoria,0.75,0.75,9,2.25,1.12,2.25,1.33,1.33,3
Dandenong T.,8,5,2,1,22,10,12,17,Australia - NPL Victoria,0.62,0.88,12,2.75,1.25,2.12,1.61,1.14,4
Preston Lions,8,4,2,2,9,8,1,14,Australia - NPL Victoria,0.5,0.75,1,1.12,1.0,1.75,2.0,1.33,5
Green Gully,8,4,1,3,16,13,3,13,Australia - NPL Victoria,0.5,0.62,3,2.0,1.62,1.62,2.0,1.61,6
Dandenong City,8,4,1,3,15,13,2,13,Australia - NPL Victoria,0.5,0.62,2,1.88,1.62,1.62,2.0,1.61,6
Altona Magic,8,3,1,4,10,17,-7,10,Australia - NPL Victoria,0.38,0.5,-7,1.25,2.12,1.25,2.63,2.0,7
South Melbourne,8,2,1,5,9,16,-7,7,Australia - NPL Victoria,0.25,0.38,-7,1.12,2.0,0.88,4.0,2.63,8
Port Melbourne,8,1,2,5,10,18,-8,5,Australia - NPL Victoria,0.12,0.38,-8,1.25,2.25,0.62,8.33,2.63,9
St. Albans,8,0,3,5,11,17,-6,3,Australia - NPL Victoria,0.0,0.38,-6,1.38,2.12,0.38,0.0,2.63,10
M. Victory B,8,0,1,7,10,21,-11,1,Australia - NPL Victoria,0.0,0.12,-11,1.25,2.62,0.12,0.0,8.33,11
Melbourne K.,8,0,0,8,3,21,-18,0,Australia - NPL Victoria,0.0,0.0,-18,0.38,2.62,0.0,0.0,0.0,12
Q. Lions,8,6,1,1,19,11,8,19,Australia - NPL Queensland,0.75,0.88,8,2.38,1.38,2.38,1.33,1.14,1
Eastern Suburbs,8,5,2,1,18,12,6,17,Australia - NPL Queensland,0.62,0.88,6,2.25,1.5,2.12,1.61,1.14,2
Moreton City E.,8,4,2,2,16,13,3,14,Australia - NPL Queensland,0.5,0.75,3,2.0,1.62,1.75,2.0,1.33,3
Gold C. Knights,8,4,1,3,9,8,1,13,Australia - NPL Queensland,0.5,0.62,1,1.12,1.0,1.62,2.0,1.61,4
Peninsula,8,3,3,2,18,10,8,12,Australia - NPL Queensland,0.38,0.75,8,2.25,1.25,1.5,2.63,1.33,5
Brisbane City,8,3,3,2,16,13,3,12,Australia - NPL Queensland,0.38,0.75,3,2.0,1.62,1.5,2.63,1.33,5
Gold C. Utd,8,3,3,2,12,15,-3,12,Australia - NPL Queensland,0.38,0.75,-3,1.5,1.88,1.5,2.63,1.33,5
Brisbane Roar B,8,3,0,5,13,12,1,9,Australia - NPL Queensland,0.38,0.38,1,1.62,1.5,1.12,2.63,2.63,6
Olympic FC,8,3,0,5,11,11,0,9,Australia - NPL Queensland,0.38,0.38,0,1.38,1.38,1.12,2.63,2.63,6
St George W.,8,2,2,4,9,15,-6,8,Australia - NPL Queensland,0.25,0.5,-6,1.12,1.88,1.0,4.0,2.0,7
Wynnum Wolves,8,1,3,4,14,17,-3,6,Australia - NPL Queensland,0.12,0.5,-3,1.75,2.12,0.75,8.33,2.0,8
SC Wanderers,8,1,2,5,9,21,-12,5,Australia - NPL Queensland,0.12,0.38,-12,1.12,2.62,0.62,8.33,2.63,9
Austria Wien,8,6,1,1,16,6,10,19,Austria - Bundesliga,0.75,0.88,10,2.0,0.75,2.38,1.33,1.14,1
Wolfsberger AC,8,5,1,2,19,11,8,16,Austria - Bundesliga,0.62,0.75,8,2.38,1.38,2.0,1.61,1.33,2
Salzburg,8,4,4,0,12,5,7,16,Austria - Bundesliga,0.5,1.0,7,1.5,0.62,2.0,2.0,1.0,2
BW Linz,8,5,1,2,13,9,4,16,Austria - Bundesliga,0.62,0.75,4,1.62,1.12,2.0,1.61,1.33,2
Sturm Graz,8,4,2,2,15,13,2,14,Austria - Bundesliga,0.5,0.75,2,1.88,1.62,1.75,2.0,1.33,3
LASK Linz,8,3,2,3,10,12,-2,11,Austria - Bundesliga,0.38,0.62,-2,1.25,1.5,1.38,2.63,1.61,4
Hartberg,8,2,3,3,7,13,-6,9,Austria - Bundesliga,0.25,0.62,-6,0.88,1.62,1.12,4.0,1.61,5
Rapid Wien,8,2,1,5,14,12,2,7,Austria - Bundesliga,0.25,0.38,2,1.75,1.5,0.88,4.0,2.63,6
Altach,8,1,4,3,8,15,-7,7,Austria - Bundesliga,0.12,0.62,-7,1.0,1.88,0.88,8.33,1.61,6
Tirol,8,1,3,4,9,13,-4,6,Austria - Bundesliga,0.12,0.5,-4,1.12,1.62,0.75,8.33,2.0,7
A. Klagenfurt,8,1,3,4,9,14,-5,6,Austria - Bundesliga,0.12,0.5,-5,1.12,1.75,0.75,8.33,2.0,7
Grazer AK,8,1,1,6,9,19,-10,4,Austria - Bundesliga,0.12,0.25,-10,1.12,2.38,0.5,8.33,4.0,8
Kapfenberger,8,6,0,2,18,13,5,18,Austria - 2. Liga,0.75,0.75,5,2.25,1.62,2.25,1.33,1.33,1
Ried,8,5,2,1,18,7,11,17,Austria - 2. Liga,0.62,0.88,11,2.25,0.88,2.12,1.61,1.14,2
SV Horn,8,5,2,1,18,11,7,17,Austria - 2. Liga,0.62,0.88,7,2.25,1.38,2.12,1.61,1.14,2
St. Polten,8,5,1,2,22,13,9,16,Austria - 2. Liga,0.62,0.75,9,2.75,1.62,2.0,1.61,1.33,3
Floridsdorfer,8,4,4,0,10,5,5,16,Austria - 2. Liga,0.5,1.0,5,1.25,0.62,2.0,2.0,1.0,3
Stripfing,8,4,2,2,15,12,3,14,Austria - 2. Liga,0.5,0.75,3,1.88,1.5,1.75,2.0,1.33,4
Amstetten,8,4,1,3,16,10,6,13,Austria - 2. Liga,0.5,0.62,6,2.0,1.25,1.62,2.0,1.61,5
Liefering,8,4,0,4,14,13,1,12,Austria - 2. Liga,0.5,0.5,1,1.75,1.62,1.5,2.0,2.0,6
A. Lustenau,8,3,2,3,8,7,1,11,Austria - 2. Liga,0.38,0.62,1,1.0,0.88,1.38,2.63,1.61,7
Sturm Graz B,8,3,2,3,15,15,0,11,Austria - 2. Liga,0.38,0.62,0,1.88,1.88,1.38,2.63,1.61,7
First Vienna,8,3,2,3,9,12,-3,11,Austria - 2. Liga,0.38,0.62,-3,1.12,1.5,1.38,2.63,1.61,7
Voitsberg,8,2,3,3,7,10,-3,9,Austria - 2. Liga,0.25,0.62,-3,0.88,1.25,1.12,4.0,1.61,8
Admira Wacker,8,2,1,5,9,14,-5,7,Austria - 2. Liga,0.25,0.38,-5,1.12,1.75,0.88,4.0,2.63,9
Lafnitz,8,1,2,5,12,21,-9,5,Austria - 2. Liga,0.12,0.38,-9,1.5,2.62,0.62,8.33,2.63,10
Rapid Wien B,8,1,0,7,10,23,-13,3,Austria - 2. Liga,0.12,0.12,-13,1.25,2.88,0.38,8.33,8.33,11
Bregenz,8,0,0,8,10,25,-15,0,Austria - 2. Liga,0.0,0.0,-15,1.25,3.12,0.0,0.0,0.0,12
Qarabag,8,7,1,0,17,2,15,22,Azerbaijan - Premier League,0.88,1.0,15,2.12,0.25,2.75,1.14,1.0,1
Zira,8,6,1,1,12,5,7,19,Azerbaijan - Premier League,0.75,0.88,7,1.5,0.62,2.38,1.33,1.14,2
Turan,8,3,3,2,10,6,4,12,Azerbaijan - Premier League,0.38,0.75,4,1.25,0.75,1.5,2.63,1.33,3
Sabah,8,3,3,2,11,9,2,12,Azerbaijan - Premier League,0.38,0.75,2,1.38,1.12,1.5,2.63,1.33,3
Neftci,8,3,2,3,13,13,0,11,Azerbaijan - Premier League,0.38,0.62,0,1.62,1.62,1.38,2.63,1.61,4
Araz,8,2,4,2,6,6,0,10,Azerbaijan - Premier League,0.25,0.75,0,0.75,0.75,1.25,4.0,1.33,5
Shamakhi,8,2,2,4,7,11,-4,8,Azerbaijan - Premier League,0.25,0.5,-4,0.88,1.38,1.0,4.0,2.0,6
Kapaz,8,2,2,4,5,12,-7,8,Azerbaijan - Premier League,0.25,0.5,-7,0.62,1.5,1.0,4.0,2.0,6
Sumqayit,8,1,1,6,8,14,-6,4,Azerbaijan - Premier League,0.12,0.25,-6,1.0,1.75,0.5,8.33,4.0,7
Sebail,8,0,3,5,6,17,-11,3,Azerbaijan - Premier League,0.0,0.38,-11,0.75,2.12,0.38,0.0,2.63,8
Al-Muharraq,8,5,1,2,18,8,10,16,Bahrain - Premier League,0.62,0.75,10,2.25,1.0,2.0,1.61,1.33,1
Al Riffa,8,4,2,2,17,12,5,14,Bahrain - Premier League,0.5,0.75,5,2.12,1.5,1.75,2.0,1.33,2
Sitra,8,3,4,1,10,8,2,13,Bahrain - Premier League,0.38,0.88,2,1.25,1.0,1.62,2.63,1.14,3
East Riffa,8,3,4,1,9,7,2,13,Bahrain - Premier League,0.38,0.88,2,1.12,0.88,1.62,2.63,1.14,3
Khalidiya,8,4,1,3,12,11,1,13,Bahrain - Premier League,0.5,0.62,1,1.5,1.38,1.62,2.0,1.61,3
AAli FC,8,3,3,2,11,10,1,12,Bahrain - Premier League,0.38,0.75,1,1.38,1.25,1.5,2.63,1.33,4
Malkiya,8,2,4,2,9,9,0,10,Bahrain - Premier League,0.25,0.75,0,1.12,1.12,1.25,4.0,1.33,5
Al Shabbab,8,1,6,1,6,5,1,9,Bahrain - Premier League,0.12,0.88,1,0.75,0.62,1.12,8.33,1.14,6
Al-Najma,8,2,3,3,7,8,-1,9,Bahrain - Premier League,0.25,0.62,-1,0.88,1.0,1.12,4.0,1.61,6
Bahrain SC,8,2,2,4,9,13,-4,8,Bahrain - Premier League,0.25,0.5,-4,1.12,1.62,1.0,4.0,2.0,7
Al Ahli M.,8,2,1,5,7,11,-4,7,Bahrain - Premier League,0.25,0.38,-4,0.88,1.38,0.88,4.0,2.63,8
Manama,8,0,3,5,6,19,-13,3,Bahrain - Premier League,0.0,0.38,-13,0.75,2.38,0.38,0.0,2.63,9
Mohammedan,8,4,3,1,22,12,10,15,Bangladesh - Premier League,0.5,0.88,10,2.75,1.5,1.88,2.0,1.14,1
Rahmatgonj,8,4,3,1,15,8,7,15,Bangladesh - Premier League,0.5,0.88,7,1.88,1.0,1.88,2.0,1.14,1
B. Police,8,4,2,2,10,9,1,14,Bangladesh - Premier League,0.5,0.75,1,1.25,1.12,1.75,2.0,1.33,2
Fortis,8,3,4,1,12,6,6,13,Bangladesh - Premier League,0.38,0.88,6,1.5,0.75,1.62,2.63,1.14,3
Abahani,8,3,3,2,14,6,8,12,Bangladesh - Premier League,0.38,0.75,8,1.75,0.75,1.5,2.63,1.33,4
Bashundhara K.,8,3,3,2,16,9,7,12,Bangladesh - Premier League,0.38,0.75,7,2.0,1.12,1.5,2.63,1.33,4
Brothers Union,8,3,3,2,14,9,5,12,Bangladesh - Premier League,0.38,0.75,5,1.75,1.12,1.5,2.63,1.33,4
Fakirerpool,8,3,1,4,12,25,-13,10,Bangladesh - Premier League,0.38,0.5,-13,1.5,3.12,1.25,2.63,2.0,5
Dhaka Wanderers,8,2,0,6,9,21,-12,6,Bangladesh - Premier League,0.25,0.25,-12,1.12,2.62,0.75,4.0,4.0,6
Chittagong,8,0,0,8,5,24,-19,0,Bangladesh - Premier League,0.0,0.0,-19,0.62,3.0,0.0,0.0,0.0,7
Maxline,8,7,1,0,16,4,12,22,Belarus - Vysshaya Liga,0.88,1.0,12,2.0,0.5,2.75,1.14,1.0,1
Dinamo Brest,8,6,1,1,19,6,13,19,Belarus - Vysshaya Liga,0.75,0.88,13,2.38,0.75,2.38,1.33,1.14,2
Dinamo Minsk,8,6,1,1,15,10,5,19,Belarus - Vysshaya Liga,0.75,0.88,5,1.88,1.25,2.38,1.33,1.14,2
Isloch,8,4,4,0,19,7,12,16,Belarus - Vysshaya Liga,0.5,1.0,12,2.38,0.88,2.0,2.0,1.0,3
Slavia Mozyr,8,5,1,2,12,8,4,16,Belarus - Vysshaya Liga,0.62,0.75,4,1.5,1.0,2.0,1.61,1.33,3
T. Zhodino,8,4,2,2,10,6,4,14,Belarus - Vysshaya Liga,0.5,0.75,4,1.25,0.75,1.75,2.0,1.33,4
FC Minsk,8,4,1,3,12,16,-4,13,Belarus - Vysshaya Liga,0.5,0.62,-4,1.5,2.0,1.62,2.0,1.61,5
Neman Grodno,8,4,0,4,10,7,3,12,Belarus - Vysshaya Liga,0.5,0.5,3,1.25,0.88,1.5,2.0,2.0,6
Vitebsk,8,3,2,3,16,12,4,11,Belarus - Vysshaya Liga,0.38,0.62,4,2.0,1.5,1.38,2.63,1.61,7
Gomel,8,3,2,3,6,4,2,11,Belarus - Vysshaya Liga,0.38,0.62,2,0.75,0.5,1.38,2.63,1.61,7
BATE Borisov,8,2,2,4,11,13,-2,8,Belarus - Vysshaya Liga,0.25,0.5,-2,1.38,1.62,1.0,4.0,2.0,8
Arsenal D.,8,1,3,4,8,14,-6,6,Belarus - Vysshaya Liga,0.12,0.5,-6,1.0,1.75,0.75,8.33,2.0,9
Naftan,8,2,0,6,6,16,-10,6,Belarus - Vysshaya Liga,0.25,0.25,-10,0.75,2.0,0.75,4.0,4.0,9
Slutsk,8,1,1,6,6,16,-10,4,Belarus - Vysshaya Liga,0.12,0.25,-10,0.75,2.0,0.5,8.33,4.0,10
Smorgon,8,1,1,6,5,15,-10,4,Belarus - Vysshaya Liga,0.12,0.25,-10,0.62,1.88,0.5,8.33,4.0,10
Molodechno,8,0,0,8,4,21,-17,0,Belarus - Vysshaya Liga,0.0,0.0,-17,0.5,2.62,0.0,0.0,0.0,11
Dnepr Mogilev,8,6,1,1,17,6,11,19,Belarus - First League,0.75,0.88,11,2.12,0.75,2.38,1.33,1.14,1
Belshina,8,6,1,1,16,7,9,19,Belarus - First League,0.75,0.88,9,2.0,0.88,2.38,1.33,1.14,1
Baranovichi,8,5,2,1,20,7,13,17,Belarus - First League,0.62,0.88,13,2.5,0.88,2.12,1.61,1.14,2
Niva,8,5,2,1,20,10,10,17,Belarus - First League,0.62,0.88,10,2.5,1.25,2.12,1.61,1.14,2
Lokomotiv Gomel,8,5,2,1,13,8,5,17,Belarus - First League,0.62,0.88,5,1.62,1.0,2.12,1.61,1.14,2
Dinamo Minsk B,8,3,3,2,9,4,5,12,Belarus - First League,0.38,0.75,5,1.12,0.5,1.5,2.63,1.33,3
Ostrovets,8,4,0,4,9,11,-2,12,Belarus - First League,0.5,0.5,-2,1.12,1.38,1.5,2.0,2.0,3
BATE B,8,3,2,3,16,12,4,11,Belarus - First League,0.38,0.62,4,2.0,1.5,1.38,2.63,1.61,4
Lida,8,3,2,3,11,10,1,11,Belarus - First League,0.38,0.62,1,1.38,1.25,1.38,2.63,1.61,4
Bumprom,8,3,2,3,8,8,0,11,Belarus - First League,0.38,0.62,0,1.0,1.0,1.38,2.63,1.61,4
ABFF U19,8,3,2,3,11,12,-1,11,Belarus - First League,0.38,0.62,-1,1.38,1.5,1.38,2.63,1.61,4
Volna Pinsk,8,2,3,3,10,13,-3,9,Belarus - First League,0.25,0.62,-3,1.25,1.62,1.12,4.0,1.61,5
Orsha,8,2,2,4,14,19,-5,8,Belarus - First League,0.25,0.5,-5,1.75,2.38,1.0,4.0,2.0,6
Gomel B,8,2,2,4,9,15,-6,8,Belarus - First League,0.25,0.5,-6,1.12,1.88,1.0,4.0,2.0,6
Uni X L. Minsk,8,2,0,6,8,19,-11,6,Belarus - First League,0.25,0.25,-11,1.0,2.38,0.75,4.0,4.0,7
Osipovichy,8,1,1,6,11,20,-9,4,Belarus - First League,0.12,0.25,-9,1.38,2.5,0.5,8.33,4.0,8
Slonim,8,1,1,6,4,18,-14,4,Belarus - First League,0.12,0.25,-14,0.5,2.25,0.5,8.33,4.0,8
Minsk B,8,1,0,7,7,17,-10,3,Belarus - First League,0.12,0.12,-10,0.88,2.12,0.38,8.33,8.33,9
KRC Genk,8,6,2,0,11,5,6,20,Belgium - Pro League,0.75,1.0,6,1.38,0.62,2.5,1.33,1.0,1
Royale Union SG,8,6,0,2,18,6,12,18,Belgium - Pro League,0.75,0.75,12,2.25,0.75,2.25,1.33,1.33,2
Anderlecht,8,5,0,3,12,6,6,15,Belgium - Pro League,0.62,0.62,6,1.5,0.75,1.88,1.61,1.61,3
Westerlo,8,4,2,2,13,10,3,14,Belgium - Pro League,0.5,0.75,3,1.62,1.25,1.75,2.0,1.33,4
Gent,8,3,4,1,10,8,2,13,Belgium - Pro League,0.38,0.88,2,1.25,1.0,1.62,2.63,1.14,5
Club Brugge,8,3,3,2,14,11,3,12,Belgium - Pro League,0.38,0.75,3,1.75,1.38,1.5,2.63,1.33,6
OH Leuven,8,3,3,2,9,9,0,12,Belgium - Pro League,0.38,0.75,0,1.12,1.12,1.5,2.63,1.33,6
KV Mechelen,8,3,2,3,9,11,-2,11,Belgium - Pro League,0.38,0.62,-2,1.12,1.38,1.38,2.63,1.61,7
Antwerp,8,2,4,2,7,8,-1,10,Belgium - Pro League,0.25,0.75,-1,0.88,1.0,1.25,4.0,1.33,8
Charleroi,8,2,3,3,13,10,3,9,Belgium - Pro League,0.25,0.62,3,1.62,1.25,1.12,4.0,1.61,9
Sint-Truiden,8,2,3,3,14,13,1,9,Belgium - Pro League,0.25,0.62,1,1.75,1.62,1.12,4.0,1.61,9
Kortrijk,8,2,2,4,11,13,-2,8,Belgium - Pro League,0.25,0.5,-2,1.38,1.62,1.0,4.0,2.0,10
Standard Liege,8,2,2,4,7,13,-6,8,Belgium - Pro League,0.25,0.5,-6,0.88,1.62,1.0,4.0,2.0,10
Cercle Brugge,8,0,5,3,6,12,-6,5,Belgium - Pro League,0.0,0.62,-6,0.75,1.5,0.62,0.0,1.61,11
Beerschot,8,1,2,5,5,13,-8,5,Belgium - Pro League,0.12,0.38,-8,0.62,1.62,0.62,8.33,2.63,11
Dender,8,1,1,6,6,17,-11,4,Belgium - Pro League,0.12,0.25,-11,0.75,2.12,0.5,8.33,4.0,12
Lokeren-Temse,8,7,0,1,15,4,11,21,Belgium - Challenger Pro League,0.88,0.88,11,1.88,0.5,2.62,1.14,1.14,1
La Louviere,8,6,2,0,15,6,9,20,Belgium - Challenger Pro League,0.75,1.0,9,1.88,0.75,2.5,1.33,1.0,2
Beveren,8,6,1,1,17,8,9,19,Belgium - Challenger Pro League,0.75,0.88,9,2.12,1.0,2.38,1.33,1.14,3
RWDM,8,5,1,2,10,4,6,16,Belgium - Challenger Pro League,0.62,0.75,6,1.25,0.5,2.0,1.61,1.33,4
Club Brugge B,8,4,1,3,13,9,4,13,Belgium - Challenger Pro League,0.5,0.62,4,1.62,1.12,1.62,2.0,1.61,5
Zulte-Waregem,8,4,1,3,13,10,3,13,Belgium - Challenger Pro League,0.5,0.62,3,1.62,1.25,1.62,2.0,1.61,5
Patro Eisden,8,3,3,2,8,7,1,12,Belgium - Challenger Pro League,0.38,0.75,1,1.0,0.88,1.5,2.63,1.33,6
RFC Liege,8,3,2,3,15,14,1,11,Belgium - Challenger Pro League,0.38,0.62,1,1.88,1.75,1.38,2.63,1.61,7
Eupen,8,3,2,3,8,10,-2,11,Belgium - Challenger Pro League,0.38,0.62,-2,1.0,1.25,1.38,2.63,1.61,7
Lierse K.,8,3,1,4,9,8,1,10,Belgium - Challenger Pro League,0.38,0.5,1,1.12,1.0,1.25,2.63,2.0,8
Lommel SK,8,3,1,4,8,8,0,10,Belgium - Challenger Pro League,0.38,0.5,0,1.0,1.0,1.25,2.63,2.0,8
Francs Borains,8,2,0,6,8,15,-7,6,Belgium - Challenger Pro League,0.25,0.25,-7,1.0,1.88,0.75,4.0,4.0,9
Seraing,8,0,3,5,7,19,-12,3,Belgium - Challenger Pro League,0.0,0.38,-12,0.88,2.38,0.38,0.0,2.63,10
Anderlecht B,8,0,2,6,9,22,-13,2,Belgium - Challenger Pro League,0.0,0.25,-13,1.12,2.75,0.25,0.0,4.0,11
KRC Genk B,8,0,1,7,4,17,-13,1,Belgium - Challenger Pro League,0.0,0.12,-13,0.5,2.12,0.12,0.0,8.33,12
Deinze,0,0,0,0,0,0,0,0,Belgium - Challenger Pro League,0.0,0.0,0,0.0,0.0,0.0,0.0,0.0,13
Always Ready,8,6,2,0,28,9,19,20,Bolivia - Primera Div. - Apertura,0.75,1.0,19,3.5,1.12,2.5,1.33,1.0,1
The Strongest,8,6,1,1,26,12,14,19,Bolivia - Primera Div. - Apertura,0.75,0.88,14,3.25,1.5,2.38,1.33,1.14,2
Bolivar,8,5,1,2,22,10,12,16,Bolivia - Primera Div. - Apertura,0.62,0.75,12,2.75,1.25,2.0,1.61,1.33,3
Blooming,8,4,2,2,17,13,4,14,Bolivia - Primera Div. - Apertura,0.5,0.75,4,2.12,1.62,1.75,2.0,1.33,4
GV San Jose,8,3,2,3,8,13,-5,11,Bolivia - Primera Div. - Apertura,0.38,0.62,-5,1.0,1.62,1.38,2.63,1.61,5
Guabira,8,3,1,4,14,19,-5,10,Bolivia - Primera Div. - Apertura,0.38,0.5,-5,1.75,2.38,1.25,2.63,2.0,6
Real Tomayapo,8,1,6,1,7,7,0,9,Bolivia - Primera Div. - Apertura,0.12,0.88,0,0.88,0.88,1.12,8.33,1.14,7
SA Bulo Bulo,8,2,3,3,16,20,-4,9,Bolivia - Primera Div. - Apertura,0.25,0.62,-4,2.0,2.5,1.12,4.0,1.61,7
ABB,8,2,3,3,6,10,-4,9,Bolivia - Primera Div. - Apertura,0.25,0.62,-4,0.75,1.25,1.12,4.0,1.61,7
Oriente P.,8,2,3,3,12,17,-5,9,Bolivia - Primera Div. - Apertura,0.25,0.62,-5,1.5,2.12,1.12,4.0,1.61,7
U. de Vinto,8,2,3,3,7,13,-6,9,Bolivia - Primera Div. - Apertura,0.25,0.62,-6,0.88,1.62,1.12,4.0,1.61,7
Nacional Potosi,8,2,2,4,9,9,0,8,Bolivia - Primera Div. - Apertura,0.25,0.5,0,1.12,1.12,1.0,4.0,2.0,8
Real Oruro,8,1,5,2,8,9,-1,8,Bolivia - Primera Div. - Apertura,0.12,0.75,-1,1.0,1.12,1.0,8.33,1.33,8
Aurora,8,2,2,4,13,17,-4,8,Bolivia - Primera Div. - Apertura,0.25,0.5,-4,1.62,2.12,1.0,4.0,2.0,8
I. Petrolero,8,1,3,4,14,19,-5,6,Bolivia - Primera Div. - Apertura,0.12,0.5,-5,1.75,2.38,0.75,8.33,2.0,9
Wilstermann,8,1,1,6,6,21,-15,4,Bolivia - Primera Div. - Apertura,0.12,0.25,-15,0.75,2.62,0.5,8.33,4.0,10
Cruzeiro,8,6,1,1,14,3,11,19,Brazil - Serie A,0.75,0.88,11,1.75,0.38,2.38,1.33,1.14,1
Bragantino,8,6,1,1,10,4,6,19,Brazil - Serie A,0.75,0.88,6,1.25,0.5,2.38,1.33,1.14,1
Flamengo,8,5,2,1,19,2,17,17,Brazil - Serie A,0.62,0.88,17,2.38,0.25,2.12,1.61,1.14,2
Mirassol,8,4,3,1,14,8,6,15,Brazil - Serie A,0.5,0.88,6,1.75,1.0,1.88,2.0,1.14,3
Atletico MG,8,4,3,1,8,6,2,15,Brazil - Serie A,0.5,0.88,2,1.0,0.75,1.88,2.0,1.14,3
Palmeiras,8,5,0,3,8,7,1,15,Brazil - Serie A,0.62,0.62,1,1.0,0.88,1.88,1.61,1.61,3
Bahia,8,5,0,3,7,7,0,15,Brazil - Serie A,0.62,0.62,0,0.88,0.88,1.88,1.61,1.61,3
Botafogo,8,4,2,2,12,6,6,14,Brazil - Serie A,0.5,0.75,6,1.5,0.75,1.75,2.0,1.33,4
Fluminense,8,4,2,2,12,9,3,14,Brazil - Serie A,0.5,0.75,3,1.5,1.12,1.75,2.0,1.33,4
Gremio,8,3,3,2,9,9,0,12,Brazil - Serie A,0.38,0.75,0,1.12,1.12,1.5,2.63,1.33,5
Ceara,8,3,2,3,8,7,1,11,Brazil - Serie A,0.38,0.62,1,1.0,0.88,1.38,2.63,1.61,6
Corinthians,8,3,2,3,8,11,-3,11,Brazil - Serie A,0.38,0.62,-3,1.0,1.38,1.38,2.63,1.61,6
Vitoria,8,2,3,3,7,8,-1,9,Brazil - Serie A,0.25,0.62,-1,0.88,1.0,1.12,4.0,1.61,7
Sao Paulo,8,2,3,3,8,10,-2,9,Brazil - Serie A,0.25,0.62,-2,1.0,1.25,1.12,4.0,1.61,7
Santos,8,2,1,5,5,7,-2,7,Brazil - Serie A,0.25,0.38,-2,0.62,0.88,0.88,4.0,2.63,8
Internacional,8,1,3,4,8,15,-7,6,Brazil - Serie A,0.12,0.5,-7,1.0,1.88,0.75,8.33,2.0,9
Fortaleza,8,1,2,5,7,14,-7,5,Brazil - Serie A,0.12,0.38,-7,0.88,1.75,0.62,8.33,2.63,10
Vasco da Gama,8,1,1,6,6,10,-4,4,Brazil - Serie A,0.12,0.25,-4,0.75,1.25,0.5,8.33,4.0,11
Sport Recife,8,0,2,6,3,13,-10,2,Brazil - Serie A,0.0,0.25,-10,0.38,1.62,0.25,0.0,4.0,12
Juventude,8,0,2,6,4,21,-17,2,Brazil - Serie A,0.0,0.25,-17,0.5,2.62,0.25,0.0,4.0,12
Goias,8,6,1,1,10,3,7,19,Brazil - Serie B,0.75,0.88,7,1.25,0.38,2.38,1.33,1.14,1
Novorizontino,8,5,2,1,12,6,6,17,Brazil - Serie B,0.62,0.88,6,1.5,0.75,2.12,1.61,1.14,2
Remo,8,4,3,1,9,6,3,15,Brazil - Serie B,0.5,0.88,3,1.12,0.75,1.88,2.0,1.14,3
Avai,8,4,2,2,11,6,5,14,Brazil - Serie B,0.5,0.75,5,1.38,0.75,1.75,2.0,1.33,4
Cuiaba,8,4,2,2,10,7,3,14,Brazil - Serie B,0.5,0.75,3,1.25,0.88,1.75,2.0,1.33,4
Chapecoense,8,4,1,3,11,7,4,13,Brazil - Serie B,0.5,0.62,4,1.38,0.88,1.62,2.0,1.61,5
Coritiba,8,4,1,3,7,5,2,13,Brazil - Serie B,0.5,0.62,2,0.88,0.62,1.62,2.0,1.61,5
Vila Nova,8,4,1,3,8,7,1,13,Brazil - Serie B,0.5,0.62,1,1.0,0.88,1.62,2.0,1.61,5
Operario PR,8,3,2,3,10,10,0,11,Brazil - Serie B,0.38,0.62,0,1.25,1.25,1.38,2.63,1.61,6
Atletico GO,8,2,4,2,7,7,0,10,Brazil - Serie B,0.25,0.75,0,0.88,0.88,1.25,4.0,1.33,7
Ferroviaria,8,2,4,2,8,9,-1,10,Brazil - Serie B,0.25,0.75,-1,1.0,1.12,1.25,4.0,1.33,7
Volta Redonda,8,2,4,2,5,6,-1,10,Brazil - Serie B,0.25,0.75,-1,0.62,0.75,1.25,4.0,1.33,7
Criciuma,8,2,3,3,8,6,2,9,Brazil - Serie B,0.25,0.62,2,1.0,0.75,1.12,4.0,1.61,8
CRB,8,2,3,3,7,8,-1,9,Brazil - Serie B,0.25,0.62,-1,0.88,1.0,1.12,4.0,1.61,8
Athletico PR,8,2,2,4,9,12,-3,8,Brazil - Serie B,0.25,0.5,-3,1.12,1.5,1.0,4.0,2.0,9
Botafogo SP,8,2,2,4,7,12,-5,8,Brazil - Serie B,0.25,0.5,-5,0.88,1.5,1.0,4.0,2.0,9
America MG,8,2,1,5,6,11,-5,7,Brazil - Serie B,0.25,0.38,-5,0.75,1.38,0.88,4.0,2.63,10
Amazonas,8,1,3,4,6,13,-7,6,Brazil - Serie B,0.12,0.5,-7,0.75,1.62,0.75,8.33,2.0,11
Athletic Club,8,2,0,6,5,12,-7,6,Brazil - Serie B,0.25,0.25,-7,0.62,1.5,0.75,4.0,4.0,11
Paysandu,8,0,4,4,4,9,-5,4,Brazil - Serie B,0.0,0.5,-5,0.5,1.12,0.5,0.0,2.0,12
Ponte Preta,8,5,1,2,9,7,2,16,Brazil - Serie C,0.62,0.75,2,1.12,0.88,2.0,1.61,1.33,1
Caxias,8,5,0,3,14,10,4,15,Brazil - Serie C,0.62,0.62,4,1.75,1.25,1.88,1.61,1.61,2
Brusque,8,4,2,2,8,6,2,14,Brazil - Serie C,0.5,0.75,2,1.0,0.75,1.75,2.0,1.33,3
Londrina,8,3,4,1,12,8,4,13,Brazil - Serie C,0.38,0.88,4,1.5,1.0,1.62,2.63,1.14,4
CSA,8,3,4,1,10,7,3,13,Brazil - Serie C,0.38,0.88,3,1.25,0.88,1.62,2.63,1.14,4
Maringa,8,3,4,1,13,11,2,13,Brazil - Serie C,0.38,0.88,2,1.62,1.38,1.62,2.63,1.14,4
Ypiranga,8,4,1,3,7,10,-3,13,Brazil - Serie C,0.5,0.62,-3,0.88,1.25,1.62,2.0,1.61,4
Ituano,8,3,3,2,8,7,1,12,Brazil - Serie C,0.38,0.75,1,1.0,0.88,1.5,2.63,1.33,5
Floresta,8,3,3,2,5,5,0,12,Brazil - Serie C,0.38,0.75,0,0.62,0.62,1.5,2.63,1.33,5
Sao Bernardo,8,3,2,3,5,6,-1,11,Brazil - Serie C,0.38,0.62,-1,0.62,0.75,1.38,2.63,1.61,6
Tombense,8,2,4,2,8,8,0,10,Brazil - Serie C,0.25,0.75,0,1.0,1.0,1.25,4.0,1.33,7
Nautico,8,2,3,3,8,5,3,9,Brazil - Serie C,0.25,0.62,3,1.0,0.62,1.12,4.0,1.61,8
Botafogo PB,8,2,3,3,8,7,1,9,Brazil - Serie C,0.25,0.62,1,1.0,0.88,1.12,4.0,1.61,8
Figueirense,8,2,3,3,10,10,0,9,Brazil - Serie C,0.25,0.62,0,1.25,1.25,1.12,4.0,1.61,8
ABC,8,1,6,1,9,9,0,9,Brazil - Serie C,0.12,0.88,0,1.12,1.12,1.12,8.33,1.14,8
Guarani,8,2,2,4,6,8,-2,8,Brazil - Serie C,0.25,0.5,-2,0.75,1.0,1.0,4.0,2.0,9
Itabaiana,8,2,1,5,7,11,-4,7,Brazil - Serie C,0.25,0.38,-4,0.88,1.38,0.88,4.0,2.63,10
Retro,8,2,1,5,4,8,-4,7,Brazil - Serie C,0.25,0.38,-4,0.5,1.0,0.88,4.0,2.63,10
Confianca,8,2,1,5,9,14,-5,7,Brazil - Serie C,0.25,0.38,-5,1.12,1.75,0.88,4.0,2.63,10
Anapolis,8,0,6,2,6,9,-3,6,Brazil - Serie C,0.0,0.75,-3,0.75,1.12,0.75,0.0,1.33,11
ASA,8,6,2,0,20,5,15,20,Brazil - Serie D,0.75,1.0,15,2.5,0.62,2.5,1.33,1.0,1
Santa Cruz,8,6,1,1,14,6,8,19,Brazil - Serie D,0.75,0.88,8,1.75,0.75,2.38,1.33,1.14,2
Manauara,8,5,3,0,17,3,14,18,Brazil - Serie D,0.62,1.0,14,2.12,0.38,2.25,1.61,1.0,3
Inter Limeira,8,5,2,1,14,6,8,17,Brazil - Serie D,0.62,0.88,8,1.75,0.75,2.12,1.61,1.14,4
Ceilandia,8,5,2,1,14,7,7,17,Brazil - Serie D,0.62,0.88,7,1.75,0.88,2.12,1.61,1.14,4
Portuguesa,8,5,2,1,14,9,5,17,Brazil - Serie D,0.62,0.88,5,1.75,1.12,2.12,1.61,1.14,4
Aparecidense,8,5,1,2,16,10,6,16,Brazil - Serie D,0.62,0.75,6,2.0,1.25,2.0,1.61,1.33,5
Central,8,5,1,2,11,5,6,16,Brazil - Serie D,0.62,0.75,6,1.38,0.62,2.0,1.61,1.33,5
Joinville,8,5,1,2,7,4,3,16,Brazil - Serie D,0.62,0.75,3,0.88,0.5,2.0,1.61,1.33,5
Luverdense,8,5,1,2,10,9,1,16,Brazil - Serie D,0.62,0.75,1,1.25,1.12,2.0,1.61,1.33,5
Aguia de Maraba,8,4,3,1,13,4,9,15,Brazil - Serie D,0.5,0.88,9,1.62,0.5,1.88,2.0,1.14,6
Tuna Luso,8,4,3,1,13,5,8,15,Brazil - Serie D,0.5,0.88,8,1.62,0.62,1.88,2.0,1.14,6
EC Sao Jose,8,4,3,1,12,5,7,15,Brazil - Serie D,0.5,0.88,7,1.5,0.62,1.88,2.0,1.14,6
Imperatriz,8,4,3,1,9,8,1,15,Brazil - Serie D,0.5,0.88,1,1.12,1.0,1.88,2.0,1.14,6
Sergipe,8,4,2,2,10,4,6,14,Brazil - Serie D,0.5,0.75,6,1.25,0.5,1.75,2.0,1.33,7
Goiatuba EC,8,4,2,2,15,10,5,14,Brazil - Serie D,0.5,0.75,5,1.88,1.25,1.75,2.0,1.33,7
Independencia,8,4,2,2,11,7,4,14,Brazil - Serie D,0.5,0.75,4,1.38,0.88,1.75,2.0,1.33,7
Jequie,8,4,2,2,13,10,3,14,Brazil - Serie D,0.5,0.75,3,1.62,1.25,1.75,2.0,1.33,7
Marcilio Dias,8,4,2,2,11,9,2,14,Brazil - Serie D,0.5,0.75,2,1.38,1.12,1.75,2.0,1.33,7
America RN,7,4,1,2,12,4,8,13,Brazil - Serie D,0.57,0.71,8,1.71,0.57,1.86,1.75,1.41,8
Barra FC,7,4,1,2,10,5,5,13,Brazil - Serie D,0.57,0.71,5,1.43,0.71,1.86,1.75,1.41,8
Altos,7,3,4,0,11,7,4,13,Brazil - Serie D,0.43,1.0,4,1.57,1.0,1.86,2.33,1.0,8
Mixto,8,3,4,1,14,11,3,13,Brazil - Serie D,0.38,0.88,3,1.75,1.38,1.62,2.63,1.14,8
Rio Branco ES,8,4,0,4,10,7,3,12,Brazil - Serie D,0.5,0.5,3,1.25,0.88,1.5,2.0,2.0,9
Manaus,8,3,3,2,10,8,2,12,Brazil - Serie D,0.38,0.75,2,1.25,1.0,1.5,2.63,1.33,9
Capital,8,3,3,2,6,4,2,12,Brazil - Serie D,0.38,0.75,2,0.75,0.5,1.5,2.63,1.33,9
Cascavel,8,3,3,2,10,11,-1,12,Brazil - Serie D,0.38,0.75,-1,1.25,1.38,1.5,2.63,1.33,9
Ferroviario,8,4,0,4,10,12,-2,12,Brazil - Serie D,0.5,0.5,-2,1.25,1.5,1.5,2.0,2.0,9
Uberlandia,8,3,2,3,12,10,2,11,Brazil - Serie D,0.38,0.62,2,1.5,1.25,1.38,2.63,1.61,10
Flamengo,8,7,1,0,22,0,22,22,Brazil - Carioca,0.88,1.0,22,2.75,0.0,2.75,1.14,1.0,1
Fluminense,8,4,3,1,12,7,5,15,Brazil - Carioca,0.5,0.88,5,1.5,0.88,1.88,2.0,1.14,2
Vasco da Gama,8,4,2,2,11,7,4,14,Brazil - Carioca,0.5,0.75,4,1.38,0.88,1.75,2.0,1.33,3
Volta Redonda,8,4,2,2,11,10,1,14,Brazil - Carioca,0.5,0.75,1,1.38,1.25,1.75,2.0,1.33,3
Sampaio Correa,8,3,3,2,11,9,2,12,Brazil - Carioca,0.38,0.75,2,1.38,1.12,1.5,2.63,1.33,4
Madureira,8,3,2,3,7,5,2,11,Brazil - Carioca,0.38,0.62,2,0.88,0.62,1.38,2.63,1.61,5
Boavista,8,1,7,0,7,5,2,10,Brazil - Carioca,0.12,1.0,2,0.88,0.62,1.25,8.33,1.0,6
Botafogo,8,3,1,4,7,8,-1,10,Brazil - Carioca,0.38,0.5,-1,0.88,1.0,1.25,2.63,2.0,6
Nova Iguacu,8,2,3,3,4,7,-3,9,Brazil - Carioca,0.25,0.62,-3,0.5,0.88,1.12,4.0,1.61,7
CFRJ . Marica,8,1,2,5,7,15,-8,5,Brazil - Carioca,0.12,0.38,-8,0.88,1.88,0.62,8.33,2.63,8
Portuguesa RJ,8,1,1,6,9,21,-12,4,Brazil - Carioca,0.12,0.25,-12,1.12,2.62,0.5,8.33,4.0,9
Bangu,8,0,3,5,4,18,-14,3,Brazil - Carioca,0.0,0.38,-14,0.5,2.25,0.38,0.0,2.63,10
Atletico MG,8,4,4,0,9,2,7,16,Brazil - Mineiro,0.5,1.0,7,1.12,0.25,2.0,2.0,1.0,1
Tombense,8,5,1,2,8,5,3,16,Brazil - Mineiro,0.62,0.75,3,1.0,0.62,2.0,1.61,1.33,1
Betim,8,4,3,1,12,5,7,15,Brazil - Mineiro,0.5,0.88,7,1.5,0.62,1.88,2.0,1.14,2
America MG,8,3,4,1,14,5,9,13,Brazil - Mineiro,0.38,0.88,9,1.75,0.62,1.62,2.63,1.14,3
Athletic Club,8,4,0,4,12,12,0,12,Brazil - Mineiro,0.5,0.5,0,1.5,1.5,1.5,2.0,2.0,4
Cruzeiro,8,3,2,3,11,9,2,11,Brazil - Mineiro,0.38,0.62,2,1.38,1.12,1.38,2.63,1.61,5
Democrata GV,8,3,2,3,8,9,-1,11,Brazil - Mineiro,0.38,0.62,-1,1.0,1.12,1.38,2.63,1.61,5
Uberlandia,8,2,3,3,10,10,0,9,Brazil - Mineiro,0.25,0.62,0,1.25,1.25,1.12,4.0,1.61,6
Itabirito,8,2,2,4,7,11,-4,8,Brazil - Mineiro,0.25,0.5,-4,0.88,1.38,1.0,4.0,2.0,7
Pouso Alegre,8,2,2,4,7,15,-8,8,Brazil - Mineiro,0.25,0.5,-8,0.88,1.88,1.0,4.0,2.0,7
Aymores,8,1,4,3,3,5,-2,7,Brazil - Mineiro,0.12,0.62,-2,0.38,0.62,0.88,8.33,1.61,8
Villa Nova,8,1,1,6,4,17,-13,4,Brazil - Mineiro,0.12,0.25,-13,0.5,2.12,0.5,8.33,4.0,9
Anapolis,8,6,0,2,13,6,7,18,Brazil - Goiano,0.75,0.75,7,1.62,0.75,2.25,1.33,1.33,1
Vila Nova,8,4,3,1,8,5,3,15,Brazil - Goiano,0.5,0.88,3,1.0,0.62,1.88,2.0,1.14,2
Atletico GO,8,4,2,2,10,6,4,14,Brazil - Goiano,0.5,0.75,4,1.25,0.75,1.75,2.0,1.33,3
CRAC,8,4,2,2,7,4,3,14,Brazil - Goiano,0.5,0.75,3,0.88,0.5,1.75,2.0,1.33,3
Goias,8,4,2,2,7,5,2,14,Brazil - Goiano,0.5,0.75,2,0.88,0.62,1.75,2.0,1.33,3
Goianesia,8,2,4,2,11,9,2,10,Brazil - Goiano,0.25,0.75,2,1.38,1.12,1.25,4.0,1.33,4
ABECAT Ouvidore,8,3,1,4,8,10,-2,10,Brazil - Goiano,0.38,0.5,-2,1.0,1.25,1.25,2.63,2.0,4
Goiatuba EC,8,2,4,2,4,6,-2,10,Brazil - Goiano,0.25,0.75,-2,0.5,0.75,1.25,4.0,1.33,4
Jataiense,8,3,0,5,10,10,0,9,Brazil - Goiano,0.38,0.38,0,1.25,1.25,1.12,2.63,2.63,5
Goiania,8,2,1,5,8,14,-6,7,Brazil - Goiano,0.25,0.38,-6,1.0,1.75,0.88,4.0,2.63,6
Aparecidense,8,1,3,4,4,7,-3,6,Brazil - Goiano,0.12,0.5,-3,0.5,0.88,0.75,8.33,2.0,7
Inhumas,8,1,2,5,5,13,-8,5,Brazil - Goiano,0.12,0.38,-8,0.62,1.62,0.62,8.33,2.63,8
Santa Cruz,8,6,1,1,13,3,10,19,Brazil - Pernambucano,0.75,0.88,10,1.62,0.38,2.38,1.33,1.14,1
Nautico,8,5,0,3,14,8,6,15,Brazil - Pernambucano,0.62,0.62,6,1.75,1.0,1.88,1.61,1.61,2
Sport Recife,8,4,2,2,16,7,9,14,Brazil - Pernambucano,0.5,0.75,9,2.0,0.88,1.75,2.0,1.33,3
Maguary PE,8,4,2,2,10,9,1,14,Brazil - Pernambucano,0.5,0.75,1,1.25,1.12,1.75,2.0,1.33,3
Retro,8,3,3,2,7,7,0,12,Brazil - Pernambucano,0.38,0.75,0,0.88,0.88,1.5,2.63,1.33,4
Decisao,8,3,3,2,10,11,-1,12,Brazil - Pernambucano,0.38,0.75,-1,1.25,1.38,1.5,2.63,1.33,4
Jaguar,8,3,1,4,10,16,-6,10,Brazil - Pernambucano,0.38,0.5,-6,1.25,2.0,1.25,2.63,2.0,5
Central,8,2,2,4,8,9,-1,8,Brazil - Pernambucano,0.25,0.5,-1,1.0,1.12,1.0,4.0,2.0,6
Afogados,8,0,4,4,4,12,-8,4,Brazil - Pernambucano,0.0,0.5,-8,0.5,1.5,0.5,0.0,2.0,7
Petrolina,8,0,2,6,3,13,-10,2,Brazil - Pernambucano,0.0,0.25,-10,0.38,1.62,0.25,0.0,4.0,8
Corinthians,8,5,3,0,13,7,6,18,Brazil - Paulista,0.62,1.0,6,1.62,0.88,2.25,1.61,1.0,1
Palmeiras,8,4,4,0,15,6,9,16,Brazil - Paulista,0.5,1.0,9,1.88,0.75,2.0,2.0,1.0,2
Ponte Preta,8,5,1,2,9,6,3,16,Brazil - Paulista,0.62,0.75,3,1.12,0.75,2.0,1.61,1.33,2
Santos,8,4,2,2,15,8,7,14,Brazil - Paulista,0.5,0.75,7,1.88,1.0,1.75,2.0,1.33,3
Bragantino,8,4,2,2,10,5,5,14,Brazil - Paulista,0.5,0.75,5,1.25,0.62,1.75,2.0,1.33,3
Sao Bernardo,8,4,2,2,12,11,1,14,Brazil - Paulista,0.5,0.75,1,1.5,1.38,1.75,2.0,1.33,3
Novorizontino,8,3,4,1,8,6,2,13,Brazil - Paulista,0.38,0.88,2,1.0,0.75,1.62,2.63,1.14,4
Portuguesa,8,2,5,1,12,10,2,11,Brazil - Paulista,0.25,0.88,2,1.5,1.25,1.38,4.0,1.14,5
Velo Clube,8,2,4,2,10,10,0,10,Brazil - Paulista,0.25,0.75,0,1.25,1.25,1.25,4.0,1.33,6
Sao Paulo,8,2,3,3,12,11,1,9,Brazil - Paulista,0.25,0.62,1,1.5,1.38,1.12,4.0,1.61,7
Botafogo SP,8,2,3,3,8,10,-2,9,Brazil - Paulista,0.25,0.62,-2,1.0,1.25,1.12,4.0,1.61,7
Mirassol,8,2,1,5,10,17,-7,7,Brazil - Paulista,0.25,0.38,-7,1.25,2.12,0.88,4.0,2.63,8
Guarani,8,1,3,4,10,13,-3,6,Brazil - Paulista,0.12,0.5,-3,1.25,1.62,0.75,8.33,2.0,9
Agua Santa,8,0,4,4,5,13,-8,4,Brazil - Paulista,0.0,0.5,-8,0.62,1.62,0.5,0.0,2.0,10
Noroeste,8,0,3,5,9,16,-7,3,Brazil - Paulista,0.0,0.38,-7,1.12,2.0,0.38,0.0,2.63,11
Inter Limeira,8,0,3,5,5,15,-10,3,Brazil - Paulista,0.0,0.38,-10,0.62,1.88,0.38,0.0,2.63,11
Treze,8,5,2,1,17,7,10,17,Brazil - Paraibano,0.62,0.88,10,2.12,0.88,2.12,1.61,1.14,1
Sousa,8,5,2,1,12,3,9,17,Brazil - Paraibano,0.62,0.88,9,1.5,0.38,2.12,1.61,1.14,1
Botafogo PB,8,5,1,2,15,6,9,16,Brazil - Paraibano,0.62,0.75,9,1.88,0.75,2.0,1.61,1.33,2
Serra Branca,8,4,2,2,20,8,12,14,Brazil - Paraibano,0.5,0.75,12,2.5,1.0,1.75,2.0,1.33,3
Campinense,8,4,2,2,14,9,5,14,Brazil - Paraibano,0.5,0.75,5,1.75,1.12,1.75,2.0,1.33,3
Pombal,8,2,3,3,7,8,-1,9,Brazil - Paraibano,0.25,0.62,-1,0.88,1.0,1.12,4.0,1.61,4
Nacional Patos,8,2,3,3,13,17,-4,9,Brazil - Paraibano,0.25,0.62,-4,1.62,2.12,1.12,4.0,1.61,4
EC de Patos,8,2,1,5,11,16,-5,7,Brazil - Paraibano,0.25,0.38,-5,1.38,2.0,0.88,4.0,2.63,5
Auto Esporte,8,1,3,4,8,15,-7,6,Brazil - Paraibano,0.12,0.5,-7,1.0,1.88,0.75,8.33,2.0,6
Picuiense,8,0,1,7,5,33,-28,1,Brazil - Paraibano,0.0,0.12,-28,0.62,4.12,0.12,0.0,8.33,7
Santa Catarina,8,4,3,1,14,9,5,15,Brazil - Catarinense,0.5,0.88,5,1.75,1.12,1.88,2.0,1.14,1
Brusque,8,4,2,2,12,6,6,14,Brazil - Catarinense,0.5,0.75,6,1.5,0.75,1.75,2.0,1.33,2
Avai,8,4,1,3,12,6,6,13,Brazil - Catarinense,0.5,0.62,6,1.5,0.75,1.62,2.0,1.61,3
Criciuma,8,3,4,1,10,4,6,13,Brazil - Catarinense,0.38,0.88,6,1.25,0.5,1.62,2.63,1.14,3
Figueirense,8,4,1,3,16,11,5,13,Brazil - Catarinense,0.5,0.62,5,2.0,1.38,1.62,2.0,1.61,3
Barra FC,8,3,3,2,6,7,-1,12,Brazil - Catarinense,0.38,0.75,-1,0.75,0.88,1.5,2.63,1.33,4
Marcilio Dias,8,2,4,2,7,8,-1,10,Brazil - Catarinense,0.25,0.75,-1,0.88,1.0,1.25,4.0,1.33,5
Concordia,8,3,1,4,8,15,-7,10,Brazil - Catarinense,0.38,0.5,-7,1.0,1.88,1.25,2.63,2.0,5
Chapecoense,8,1,6,1,10,9,1,9,Brazil - Catarinense,0.12,0.88,1,1.25,1.12,1.12,8.33,1.14,6
Joinville,8,2,3,3,9,14,-5,9,Brazil - Catarinense,0.25,0.62,-5,1.12,1.75,1.12,4.0,1.61,6
Caravaggio,8,2,1,5,5,12,-7,7,Brazil - Catarinense,0.25,0.38,-7,0.62,1.5,0.88,4.0,2.63,7
Hercilio Luz,8,1,2,5,6,13,-7,5,Brazil - Catarinense,0.12,0.38,-7,0.75,1.62,0.62,8.33,2.63,8
Internacional,8,6,2,0,16,4,12,20,Brazil - Gaucho,0.75,1.0,12,2.0,0.5,2.5,1.33,1.0,1
Juventude,8,6,1,1,14,6,8,19,Brazil - Gaucho,0.75,0.88,8,1.75,0.75,2.38,1.33,1.14,2
Gremio,8,5,2,1,19,3,16,17,Brazil - Gaucho,0.62,0.88,16,2.38,0.38,2.12,1.61,1.14,3
Caxias,8,4,2,2,8,9,-1,14,Brazil - Gaucho,0.5,0.75,-1,1.0,1.12,1.75,2.0,1.33,4
Ypiranga,8,3,3,2,6,6,0,12,Brazil - Gaucho,0.38,0.75,0,0.75,0.75,1.5,2.63,1.33,5
Guarany de Bage,8,2,3,3,6,6,0,9,Brazil - Gaucho,0.25,0.62,0,0.75,0.75,1.12,4.0,1.61,6
Sao Luiz,8,2,3,3,7,13,-6,9,Brazil - Gaucho,0.25,0.62,-6,0.88,1.62,1.12,4.0,1.61,6
Brasil de P.,8,1,4,3,5,10,-5,7,Brazil - Gaucho,0.12,0.62,-5,0.62,1.25,0.88,8.33,1.61,7
Monsoon,8,2,1,5,7,14,-7,7,Brazil - Gaucho,0.25,0.38,-7,0.88,1.75,0.88,4.0,2.63,7
Pelotas,8,1,3,4,6,13,-7,6,Brazil - Gaucho,0.12,0.5,-7,0.75,1.62,0.75,8.33,2.0,8
EC Sao Jose,8,0,5,3,5,10,-5,5,Brazil - Gaucho,0.0,0.62,-5,0.62,1.25,0.62,0.0,1.61,9
Avenida,8,0,3,5,4,9,-5,3,Brazil - Gaucho,0.0,0.38,-5,0.5,1.12,0.38,0.0,2.63,10
CSKA Sofia,8,7,0,1,20,2,18,21,Bulgaria - Parva Liga,0.88,0.88,18,2.5,0.25,2.62,1.14,1.14,1
Lokomotiv Sofia,8,5,3,0,15,3,12,18,Bulgaria - Parva Liga,0.62,1.0,12,1.88,0.38,2.25,1.61,1.0,2
Botev Vratsa,8,6,0,2,13,9,4,18,Bulgaria - Parva Liga,0.75,0.75,4,1.62,1.12,2.25,1.33,1.33,2
Levski Sofia,8,3,4,1,11,6,5,13,Bulgaria - Parva Liga,0.38,0.88,5,1.38,0.75,1.62,2.63,1.14,3
Ludogorets,8,3,4,1,12,9,3,13,Bulgaria - Parva Liga,0.38,0.88,3,1.5,1.12,1.62,2.63,1.14,3
CSKA 1948 Sofia,8,4,1,3,8,6,2,13,Bulgaria - Parva Liga,0.5,0.62,2,1.0,0.75,1.62,2.0,1.61,3
Septemvri Sofia,8,4,0,4,10,10,0,12,Bulgaria - Parva Liga,0.5,0.5,0,1.25,1.25,1.5,2.0,2.0,4
Botev Plovdiv,8,3,2,3,15,13,2,11,Bulgaria - Parva Liga,0.38,0.62,2,1.88,1.62,1.38,2.63,1.61,5
Beroe,8,3,2,3,10,15,-5,11,Bulgaria - Parva Liga,0.38,0.62,-5,1.25,1.88,1.38,2.63,1.61,5
Lok. Plovdiv,8,3,1,4,10,10,0,10,Bulgaria - Parva Liga,0.38,0.5,0,1.25,1.25,1.25,2.63,2.0,6
Cherno More,8,2,4,2,6,7,-1,10,Bulgaria - Parva Liga,0.25,0.75,-1,0.75,0.88,1.25,4.0,1.33,6
Slavia Sofia,8,3,1,4,8,10,-2,10,Bulgaria - Parva Liga,0.38,0.5,-2,1.0,1.25,1.25,2.63,2.0,6
Arda,8,1,5,2,11,11,0,8,Bulgaria - Parva Liga,0.12,0.75,0,1.38,1.38,1.0,8.33,1.33,7
Hebar,8,2,1,5,8,13,-5,7,Bulgaria - Parva Liga,0.25,0.38,-5,1.0,1.62,0.88,4.0,2.63,8
Spartak Varna,8,2,0,6,8,17,-9,6,Bulgaria - Parva Liga,0.25,0.25,-9,1.0,2.12,0.75,4.0,4.0,9
L. Krumovgrad,8,2,0,6,5,14,-9,6,Bulgaria - Parva Liga,0.25,0.25,-9,0.62,1.75,0.75,4.0,4.0,9
Cavalry,8,5,2,1,18,7,11,17,Canada - Premier League,0.62,0.88,11,2.25,0.88,2.12,1.61,1.14,1
A. Ottawa,8,5,2,1,19,12,7,17,Canada - Premier League,0.62,0.88,7,2.38,1.5,2.12,1.61,1.14,1
Forge,8,3,5,0,11,7,4,14,Canada - Premier League,0.38,1.0,4,1.38,0.88,1.75,2.63,1.0,2
HFX Wanderers,8,4,1,3,9,8,1,13,Canada - Premier League,0.5,0.62,1,1.12,1.0,1.62,2.0,1.61,3
Valour,8,2,2,4,9,16,-7,8,Canada - Premier League,0.25,0.5,-7,1.12,2.0,1.0,4.0,2.0,4
York Utd,8,2,1,5,11,13,-2,7,Canada - Premier League,0.25,0.38,-2,1.38,1.62,0.88,4.0,2.63,5
Vancouver FC,8,1,3,4,9,15,-6,6,Canada - Premier League,0.12,0.5,-6,1.12,1.88,0.75,8.33,2.0,6
Pacific,8,1,2,5,5,14,-9,5,Canada - Premier League,0.12,0.38,-9,0.62,1.75,0.62,8.33,2.63,7
U. de Chile,8,5,1,2,19,9,10,16,Chile - Primera Division,0.62,0.75,10,2.38,1.12,2.0,1.61,1.33,1
Audax Italiano,8,5,1,2,12,8,4,16,Chile - Primera Division,0.62,0.75,4,1.5,1.0,2.0,1.61,1.33,1
Coquimbo Unido,8,4,3,1,9,5,4,15,Chile - Primera Division,0.5,0.88,4,1.12,0.62,1.88,2.0,1.14,2
Colo-Colo,8,4,2,2,13,7,6,14,Chile - Primera Division,0.5,0.75,6,1.62,0.88,1.75,2.0,1.33,3
Cobresal,8,4,2,2,11,8,3,14,Chile - Primera Division,0.5,0.75,3,1.38,1.0,1.75,2.0,1.33,3
OHiggins,8,4,1,3,9,12,-3,13,Chile - Primera Division,0.5,0.62,-3,1.12,1.5,1.62,2.0,1.61,4
Palestino,8,3,3,2,8,7,1,12,Chile - Primera Division,0.38,0.75,1,1.0,0.88,1.5,2.63,1.33,5
U. Catolica,8,3,2,3,13,10,3,11,Chile - Primera Division,0.38,0.62,3,1.62,1.25,1.38,2.63,1.61,6
Union La Calera,8,3,2,3,6,6,0,11,Chile - Primera Division,0.38,0.62,0,0.75,0.75,1.38,2.63,1.61,6
D. Limache,8,3,1,4,10,11,-1,10,Chile - Primera Division,0.38,0.5,-1,1.25,1.38,1.25,2.63,2.0,7
Nublense,8,2,4,2,7,8,-1,10,Chile - Primera Division,0.25,0.75,-1,0.88,1.0,1.25,4.0,1.33,7
Everton,8,2,3,3,11,14,-3,9,Chile - Primera Division,0.25,0.62,-3,1.38,1.75,1.12,4.0,1.61,8
La Serena,8,3,0,5,12,17,-5,9,Chile - Primera Division,0.38,0.38,-5,1.5,2.12,1.12,2.63,2.63,8
Huachipato,8,2,1,5,9,16,-7,7,Chile - Primera Division,0.25,0.38,-7,1.12,2.0,0.88,4.0,2.63,9
D. Iquique,8,1,2,5,8,14,-6,5,Chile - Primera Division,0.12,0.38,-6,1.0,1.75,0.62,8.33,2.63,10
Union Espanola,8,1,1,6,8,16,-8,4,Chile - Primera Division,0.12,0.25,-8,1.0,2.0,0.5,8.33,4.0,11
San Marcos,8,6,0,2,11,7,4,18,Chile - Primera B,0.75,0.75,4,1.38,0.88,2.25,1.33,1.33,1
Concepcion,8,5,2,1,12,5,7,17,Chile - Primera B,0.62,0.88,7,1.5,0.62,2.12,1.61,1.14,2
Copiapo,8,5,1,2,12,4,8,16,Chile - Primera B,0.62,0.75,8,1.5,0.5,2.0,1.61,1.33,3
Cobreloa,8,4,3,1,12,8,4,15,Chile - Primera B,0.5,0.88,4,1.5,1.0,1.88,2.0,1.14,4
U. Concepcion,8,4,1,3,11,7,4,13,Chile - Primera B,0.5,0.62,4,1.38,0.88,1.62,2.0,1.61,5
San Luis,8,4,1,3,8,8,0,13,Chile - Primera B,0.5,0.62,0,1.0,1.0,1.62,2.0,1.61,5
Curico Unido,8,3,1,4,10,9,1,10,Chile - Primera B,0.38,0.5,1,1.25,1.12,1.25,2.63,2.0,6
Deportes Temuco,8,3,1,4,10,11,-1,10,Chile - Primera B,0.38,0.5,-1,1.25,1.38,1.25,2.63,2.0,6
Antofagasta,8,2,3,3,11,13,-2,9,Chile - Primera B,0.25,0.62,-2,1.38,1.62,1.12,4.0,1.61,7
Magallanes,8,2,3,3,5,7,-2,9,Chile - Primera B,0.25,0.62,-2,0.62,0.88,1.12,4.0,1.61,7
Rangers,8,1,5,2,10,10,0,8,Chile - Primera B,0.12,0.75,0,1.25,1.25,1.0,8.33,1.33,8
Recoleta,8,2,2,4,8,11,-3,8,Chile - Primera B,0.25,0.5,-3,1.0,1.38,1.0,4.0,2.0,8
S. Morning,8,2,2,4,7,13,-6,8,Chile - Primera B,0.25,0.5,-6,0.88,1.62,1.0,4.0,2.0,8
S. Wanderers,8,1,4,3,10,14,-4,7,Chile - Primera B,0.12,0.62,-4,1.25,1.75,0.88,8.33,1.61,9
CD Santa Cruz,8,1,3,4,7,13,-6,6,Chile - Primera B,0.12,0.5,-6,0.88,1.62,0.75,8.33,2.0,10
U. San Felipe,8,1,2,5,7,14,-7,5,Chile - Primera B,0.12,0.38,-7,0.88,1.75,0.62,8.33,2.63,11
S. Shenhua,8,7,0,1,19,6,13,21,China - Super League,0.88,0.88,13,2.38,0.75,2.62,1.14,1.14,1
Beijing Guoan,8,6,2,0,21,8,13,20,China - Super League,0.75,1.0,13,2.62,1.0,2.5,1.33,1.0,2
Chengdu,8,6,2,0,15,5,10,20,China - Super League,0.75,1.0,10,1.88,0.62,2.5,1.33,1.0,2
Shanghai Port,8,4,2,2,16,11,5,14,China - Super League,0.5,0.75,5,2.0,1.38,1.75,2.0,1.33,3
Shandong T.,8,3,2,3,18,15,3,11,China - Super League,0.38,0.62,3,2.25,1.88,1.38,2.63,1.61,4
Yunnan Yukun,8,3,2,3,12,12,0,11,China - Super League,0.38,0.62,0,1.5,1.5,1.38,2.63,1.61,4
Wuhan Three T.,8,3,2,3,14,16,-2,11,China - Super League,0.38,0.62,-2,1.75,2.0,1.38,2.63,1.61,4
Henan SL,8,3,1,4,13,12,1,10,China - Super League,0.38,0.5,1,1.62,1.5,1.25,2.63,2.0,5
Tianjin T.,8,3,1,4,11,13,-2,10,China - Super League,0.38,0.5,-2,1.38,1.62,1.25,2.63,2.0,5
Qingdao West C.,8,2,3,3,10,15,-5,9,China - Super League,0.25,0.62,-5,1.25,1.88,1.12,4.0,1.61,6
Dalian Yingbo,8,2,3,3,8,13,-5,9,China - Super League,0.25,0.62,-5,1.0,1.62,1.12,4.0,1.61,6
Zhejiang,8,2,2,4,15,18,-3,8,China - Super League,0.25,0.5,-3,1.88,2.25,1.0,4.0,2.0,7
Sichuan Jiuniu,8,2,2,4,7,15,-8,8,China - Super League,0.25,0.5,-8,0.88,1.88,1.0,4.0,2.0,7
Qingdao Hainiu,8,1,3,4,10,13,-3,6,China - Super League,0.12,0.5,-3,1.25,1.62,0.75,8.33,2.0,8
Meizhou Hakka,8,1,2,5,9,18,-9,5,China - Super League,0.12,0.38,-9,1.12,2.25,0.62,8.33,2.63,9
Changchun Yatai,8,1,1,6,8,16,-8,4,China - Super League,0.12,0.25,-8,1.0,2.0,0.5,8.33,4.0,10
Liaoning Tieren,8,6,2,0,21,8,13,20,China - League One,0.75,1.0,13,2.62,1.0,2.5,1.33,1.0,1
Chongqing T.,8,6,2,0,16,6,10,20,China - League One,0.75,1.0,10,2.0,0.75,2.5,1.33,1.0,1
Yanbian Longdin,8,5,1,2,11,6,5,16,China - League One,0.62,0.75,5,1.38,0.75,2.0,1.61,1.33,2
Guangdong GZP,8,5,0,3,15,13,2,15,China - League One,0.62,0.62,2,1.88,1.62,1.88,1.61,1.61,3
S. Gongfu,8,4,1,3,11,7,4,13,China - League One,0.5,0.62,4,1.38,0.88,1.62,2.0,1.61,4
Suzhou Dongwu,8,3,3,2,9,6,3,12,China - League One,0.38,0.75,3,1.12,0.75,1.5,2.63,1.33,5
Nantong Zhiyun,8,3,2,3,14,11,3,11,China - League One,0.38,0.62,3,1.75,1.38,1.38,2.63,1.61,6
Shanghai Jiadin,8,3,2,3,9,9,0,11,China - League One,0.38,0.62,0,1.12,1.12,1.38,2.63,1.61,6
Dalian Kuncheng,8,3,2,3,9,11,-2,11,China - League One,0.38,0.62,-2,1.12,1.38,1.38,2.63,1.61,6
Shaanxi Union,8,3,1,4,13,14,-1,10,China - League One,0.38,0.5,-1,1.62,1.75,1.25,2.63,2.0,7
Shenzhen J.,8,3,0,5,12,22,-10,9,China - League One,0.38,0.38,-10,1.5,2.75,1.12,2.63,2.63,8
Nanjing City,8,2,2,4,12,15,-3,8,China - League One,0.25,0.5,-3,1.5,1.88,1.0,4.0,2.0,9
Heilongjiang IC,8,1,4,3,8,12,-4,7,China - League One,0.12,0.62,-4,1.0,1.5,0.88,8.33,1.61,10
Foshan Nanshi,8,1,3,4,4,10,-6,6,China - League One,0.12,0.5,-6,0.5,1.25,0.75,8.33,2.0,11
Guangxi Baoyun,8,1,2,5,6,14,-8,5,China - League One,0.12,0.38,-8,0.75,1.75,0.62,8.33,2.63,12
Qingdao RL,8,1,1,6,4,10,-6,4,China - League One,0.12,0.25,-6,0.5,1.25,0.5,8.33,4.0,13
Guangxi H.,8,8,0,0,23,3,20,24,China - League Two,1.0,1.0,20,2.88,0.38,3.0,1.0,1.0,1
Wuxi Wugou,8,7,0,1,12,4,8,21,China - League Two,0.88,0.88,8,1.5,0.5,2.62,1.14,1.14,2
Shenzhen 2028,8,6,2,0,12,4,8,20,China - League Two,0.75,1.0,8,1.5,0.5,2.5,1.33,1.0,3
Nantong Haimen,8,5,2,1,23,10,13,17,China - League Two,0.62,0.88,13,2.88,1.25,2.12,1.61,1.14,4
Chengdu Rongche,8,5,0,3,17,7,10,15,China - League Two,0.62,0.62,10,2.12,0.88,1.88,1.61,1.61,5
Changchun Xidu,8,4,2,2,6,2,4,14,China - League Two,0.5,0.75,4,0.75,0.25,1.75,2.0,1.33,6
Shandong T. B,8,4,2,2,12,10,2,14,China - League Two,0.5,0.75,2,1.5,1.25,1.75,2.0,1.33,6
Wuhan Three Tow,8,4,1,3,9,5,4,13,China - League Two,0.5,0.62,4,1.12,0.62,1.62,2.0,1.61,7
Shanghai Port B,8,3,4,1,8,5,3,13,China - League Two,0.38,0.88,3,1.0,0.62,1.62,2.63,1.14,7
Guizhou Zhuchen,8,4,0,4,9,12,-3,12,China - League Two,0.5,0.5,-3,1.12,1.5,1.5,2.0,2.0,8
Taian Tiankuang,8,3,2,3,10,9,1,11,China - League Two,0.38,0.62,1,1.25,1.12,1.38,2.63,1.61,9
Hubei Istar,8,3,1,4,11,10,1,10,China - League Two,0.38,0.5,1,1.38,1.25,1.25,2.63,2.0,10
Jiangxi Lushan,8,3,0,5,11,13,-2,9,China - League Two,0.38,0.38,-2,1.38,1.62,1.12,2.63,2.63,11
Guangzhou Dande,8,2,3,3,7,9,-2,9,China - League Two,0.25,0.62,-2,0.88,1.12,1.12,4.0,1.61,11
Wenzhou Pro.,8,2,3,3,8,11,-3,9,China - League Two,0.25,0.62,-3,1.0,1.38,1.12,4.0,1.61,11
Guangdong Mingt,8,1,5,2,5,7,-2,8,China - League Two,0.12,0.75,-2,0.62,0.88,1.0,8.33,1.33,12
Xian Ronghai,8,2,2,4,5,15,-10,8,China - League Two,0.25,0.5,-10,0.62,1.88,1.0,4.0,2.0,12
Langfang Glory,8,2,1,5,7,14,-7,7,China - League Two,0.25,0.38,-7,0.88,1.75,0.88,4.0,2.63,13
Haikou M.,8,2,1,5,5,15,-10,7,China - League Two,0.25,0.38,-10,0.62,1.88,0.88,4.0,2.63,13
Ganzhou Ruishi,8,1,3,4,6,11,-5,6,China - League Two,0.12,0.5,-5,0.75,1.38,0.75,8.33,2.0,14
Rizhao Yuqi,8,1,2,5,5,13,-8,5,China - League Two,0.12,0.38,-8,0.62,1.62,0.62,8.33,2.63,15
Quanzhou Yassin,8,1,1,6,3,10,-7,4,China - League Two,0.12,0.25,-7,0.38,1.25,0.5,8.33,4.0,16
Beijing IT,8,1,0,7,5,13,-8,3,China - League Two,0.12,0.12,-8,0.62,1.62,0.38,8.33,8.33,17
Guangxi Lanhang,8,0,3,5,6,18,-12,3,China - League Two,0.0,0.38,-12,0.75,2.25,0.38,0.0,2.63,17
A. Bucaramanga,8,5,1,2,15,7,8,16,Colombia - Primera A - Apertura,0.62,0.75,8,1.88,0.88,2.0,1.61,1.33,1
A. Petrolera,8,5,1,2,13,5,8,16,Colombia - Primera A - Apertura,0.62,0.75,8,1.62,0.62,2.0,1.61,1.33,1
Millonarios,8,4,4,0,11,4,7,16,Colombia - Primera A - Apertura,0.5,1.0,7,1.38,0.5,2.0,2.0,1.0,1
D. Pereira,8,4,3,1,12,7,5,15,Colombia - Primera A - Apertura,0.5,0.88,5,1.5,0.88,1.88,2.0,1.14,2
America de Cali,8,4,3,1,8,3,5,15,Colombia - Primera A - Apertura,0.5,0.88,5,1.0,0.38,1.88,2.0,1.14,2
Once Caldas,8,4,2,2,12,7,5,14,Colombia - Primera A - Apertura,0.5,0.75,5,1.5,0.88,1.75,2.0,1.33,3
Deportes Tolima,8,4,2,2,12,9,3,14,Colombia - Primera A - Apertura,0.5,0.75,3,1.5,1.12,1.75,2.0,1.33,3
Junior,8,3,3,2,11,9,2,12,Colombia - Primera A - Apertura,0.38,0.75,2,1.38,1.12,1.5,2.63,1.33,4
R. Aguilas,8,3,3,2,10,8,2,12,Colombia - Primera A - Apertura,0.38,0.75,2,1.25,1.0,1.5,2.63,1.33,4
A. Nacional,8,3,2,3,13,9,4,11,Colombia - Primera A - Apertura,0.38,0.62,4,1.62,1.12,1.38,2.63,1.61,5
I. Medelin,8,3,2,3,7,7,0,11,Colombia - Primera A - Apertura,0.38,0.62,0,0.88,0.88,1.38,2.63,1.61,5
Santa Fe,8,3,2,3,9,12,-3,11,Colombia - Primera A - Apertura,0.38,0.62,-3,1.12,1.5,1.38,2.63,1.61,5
Fortaleza CEIF,8,3,1,4,8,8,0,10,Colombia - Primera A - Apertura,0.38,0.5,0,1.0,1.0,1.25,2.63,2.0,6
Deportivo Pasto,8,3,1,4,8,11,-3,10,Colombia - Primera A - Apertura,0.38,0.5,-3,1.0,1.38,1.25,2.63,2.0,6
Llaneros,8,3,0,5,8,11,-3,9,Colombia - Primera A - Apertura,0.38,0.38,-3,1.0,1.38,1.12,2.63,2.63,7
Boyaca Chico,8,2,3,3,7,12,-5,9,Colombia - Primera A - Apertura,0.25,0.62,-5,0.88,1.5,1.12,4.0,1.61,7
Envigado,8,2,0,6,7,11,-4,6,Colombia - Primera A - Apertura,0.25,0.25,-4,0.88,1.38,0.75,4.0,4.0,8
Union Magdalena,8,1,3,4,7,14,-7,6,Colombia - Primera A - Apertura,0.12,0.5,-7,0.88,1.75,0.75,8.33,2.0,8
La Equidad,8,2,0,6,6,19,-13,6,Colombia - Primera A - Apertura,0.25,0.25,-13,0.75,2.38,0.75,4.0,4.0,8
Deportivo Cali,8,1,2,5,2,10,-8,5,Colombia - Primera A - Apertura,0.12,0.38,-8,0.25,1.25,0.62,8.33,2.63,9
I. Medelin,8,5,2,1,15,6,9,17,Colombia - Primera A - Clausura,0.62,0.88,9,1.88,0.75,2.12,1.61,1.14,1
Millonarios,8,5,2,1,11,4,7,17,Colombia - Primera A - Clausura,0.62,0.88,7,1.38,0.5,2.12,1.61,1.14,1
Junior,8,4,3,1,11,4,7,15,Colombia - Primera A - Clausura,0.5,0.88,7,1.38,0.5,1.88,2.0,1.14,2
Santa Fe,8,4,3,1,12,6,6,15,Colombia - Primera A - Clausura,0.5,0.88,6,1.5,0.75,1.88,2.0,1.14,2
D. Pereira,8,4,3,1,12,9,3,15,Colombia - Primera A - Clausura,0.5,0.88,3,1.5,1.12,1.88,2.0,1.14,2
Deportes Tolima,8,4,2,2,9,4,5,14,Colombia - Primera A - Clausura,0.5,0.75,5,1.12,0.5,1.75,2.0,1.33,3
Deportivo Pasto,8,4,1,3,14,11,3,13,Colombia - Primera A - Clausura,0.5,0.62,3,1.75,1.38,1.62,2.0,1.61,4
A. Nacional,8,3,4,1,9,7,2,13,Colombia - Primera A - Clausura,0.38,0.88,2,1.12,0.88,1.62,2.63,1.14,4
A. Bucaramanga,8,3,3,2,12,7,5,12,Colombia - Primera A - Clausura,0.38,0.75,5,1.5,0.88,1.5,2.63,1.33,5
America de Cali,8,3,2,3,10,10,0,11,Colombia - Primera A - Clausura,0.38,0.62,0,1.25,1.25,1.38,2.63,1.61,6
Fortaleza CEIF,8,3,1,4,9,8,1,10,Colombia - Primera A - Clausura,0.38,0.5,1,1.12,1.0,1.25,2.63,2.0,7
La Equidad,8,2,3,3,12,13,-1,9,Colombia - Primera A - Clausura,0.25,0.62,-1,1.5,1.62,1.12,4.0,1.61,8
Patriotas,8,2,2,4,12,14,-2,8,Colombia - Primera A - Clausura,0.25,0.5,-2,1.5,1.75,1.0,4.0,2.0,9
Deportivo Cali,8,2,2,4,5,9,-4,8,Colombia - Primera A - Clausura,0.25,0.5,-4,0.62,1.12,1.0,4.0,2.0,9
A. Petrolera,8,2,2,4,7,12,-5,8,Colombia - Primera A - Clausura,0.25,0.5,-5,0.88,1.5,1.0,4.0,2.0,9
Jaguares de C.,8,2,2,4,7,14,-7,8,Colombia - Primera A - Clausura,0.25,0.5,-7,0.88,1.75,1.0,4.0,2.0,9
Envigado,8,2,1,5,5,9,-4,7,Colombia - Primera A - Clausura,0.25,0.38,-4,0.62,1.12,0.88,4.0,2.63,10
Boyaca Chico,8,2,1,5,5,15,-10,7,Colombia - Primera A - Clausura,0.25,0.38,-10,0.62,1.88,0.88,4.0,2.63,10
Once Caldas,8,1,2,5,4,12,-8,5,Colombia - Primera A - Clausura,0.12,0.38,-8,0.5,1.5,0.62,8.33,2.63,11
R. Aguilas,8,1,1,6,4,15,-11,4,Colombia - Primera A - Clausura,0.12,0.25,-11,0.5,1.88,0.5,8.33,4.0,12
Saprissa,8,5,2,1,13,7,6,17,Costa Rica - Primera Div. - Apertura,0.62,0.88,6,1.62,0.88,2.12,1.61,1.14,1
Alajuelense,8,5,1,2,13,6,7,16,Costa Rica - Primera Div. - Apertura,0.62,0.75,7,1.62,0.75,2.0,1.61,1.33,2
Santos Guapiles,8,5,1,2,14,8,6,16,Costa Rica - Primera Div. - Apertura,0.62,0.75,6,1.75,1.0,2.0,1.61,1.33,2
Guanacasteca,8,4,1,3,11,11,0,13,Costa Rica - Primera Div. - Apertura,0.5,0.62,0,1.38,1.38,1.62,2.0,1.61,3
Herediano,8,3,3,2,11,9,2,12,Costa Rica - Primera Div. - Apertura,0.38,0.75,2,1.38,1.12,1.5,2.63,1.33,4
San Carlos,8,2,5,1,11,11,0,11,Costa Rica - Primera Div. - Apertura,0.25,0.88,0,1.38,1.38,1.38,4.0,1.14,5
Cartagines,8,3,1,4,15,18,-3,10,Costa Rica - Primera Div. - Apertura,0.38,0.5,-3,1.88,2.25,1.25,2.63,2.0,6
Zeledon,8,3,1,4,9,12,-3,10,Costa Rica - Primera Div. - Apertura,0.38,0.5,-3,1.12,1.5,1.25,2.63,2.0,6
M. Liberia,8,2,2,4,9,11,-2,8,Costa Rica - Primera Div. - Apertura,0.25,0.5,-2,1.12,1.38,1.0,4.0,2.0,7
Sporting SJ,8,2,1,5,10,11,-1,7,Costa Rica - Primera Div. - Apertura,0.25,0.38,-1,1.25,1.38,0.88,4.0,2.63,8
Santa Ana,8,2,1,5,7,11,-4,7,Costa Rica - Primera Div. - Apertura,0.25,0.38,-4,0.88,1.38,0.88,4.0,2.63,8
Puntarenas,8,2,1,5,8,16,-8,7,Costa Rica - Primera Div. - Apertura,0.25,0.38,-8,1.0,2.0,0.88,4.0,2.63,8
Slavia Prague,8,7,0,1,24,8,16,21,CzechRepublic - 1. Liga,0.88,0.88,16,3.0,1.0,2.62,1.14,1.14,1
Jablonec,8,7,0,1,16,8,8,21,CzechRepublic - 1. Liga,0.88,0.88,8,2.0,1.0,2.62,1.14,1.14,1
Viktoria Plzen,8,6,0,2,20,11,9,18,CzechRepublic - 1. Liga,0.75,0.75,9,2.5,1.38,2.25,1.33,1.33,2
Slovan Liberec,8,5,1,2,13,7,6,16,CzechRepublic - 1. Liga,0.62,0.75,6,1.62,0.88,2.0,1.61,1.33,3
Teplice,8,4,2,2,11,5,6,14,CzechRepublic - 1. Liga,0.5,0.75,6,1.38,0.62,1.75,2.0,1.33,4
Banik Ostrava,8,4,2,2,10,10,0,14,CzechRepublic - 1. Liga,0.5,0.75,0,1.25,1.25,1.75,2.0,1.33,4
Dukla Praha,8,4,1,3,15,14,1,13,CzechRepublic - 1. Liga,0.5,0.62,1,1.88,1.75,1.62,2.0,1.61,5
Karvina,8,4,1,3,11,15,-4,13,CzechRepublic - 1. Liga,0.5,0.62,-4,1.38,1.88,1.62,2.0,1.61,5
Hradec Kralove,8,4,0,4,13,7,6,12,CzechRepublic - 1. Liga,0.5,0.5,6,1.62,0.88,1.5,2.0,2.0,6
Pardubice,8,3,0,5,6,10,-4,9,CzechRepublic - 1. Liga,0.38,0.38,-4,0.75,1.25,1.12,2.63,2.63,7
Slovacko,8,2,3,3,9,14,-5,9,CzechRepublic - 1. Liga,0.25,0.62,-5,1.12,1.75,1.12,4.0,1.61,7
Sparta Prague,8,2,2,4,10,13,-3,8,CzechRepublic - 1. Liga,0.25,0.5,-3,1.25,1.62,1.0,4.0,2.0,8
Bohemians,8,2,1,5,7,10,-3,7,CzechRepublic - 1. Liga,0.25,0.38,-3,0.88,1.25,0.88,4.0,2.63,9
Mlada Boleslav,8,2,1,5,8,12,-4,7,CzechRepublic - 1. Liga,0.25,0.38,-4,1.0,1.5,0.88,4.0,2.63,9
Sigma Olomouc,8,1,3,4,8,16,-8,6,CzechRepublic - 1. Liga,0.12,0.5,-8,1.0,2.0,0.75,8.33,2.0,10
C. Budejovice,8,0,2,6,3,14,-11,2,CzechRepublic - 1. Liga,0.0,0.25,-11,0.38,1.75,0.25,0.0,4.0,11
FC Midtjylland,8,5,2,1,21,11,10,17,Denmark - Superligaen,0.62,0.88,10,2.62,1.38,2.12,1.61,1.14,1
SonderjyskE,8,5,2,1,18,10,8,17,Denmark - Superligaen,0.62,0.88,8,2.25,1.25,2.12,1.61,1.14,1
FC Kobenhavn,8,5,1,2,20,9,11,16,Denmark - Superligaen,0.62,0.75,11,2.5,1.12,2.0,1.61,1.33,2
Silkeborg,8,4,1,3,15,9,6,13,Denmark - Superligaen,0.5,0.62,6,1.88,1.12,1.62,2.0,1.61,3
Viborg,8,3,4,1,13,10,3,13,Denmark - Superligaen,0.38,0.88,3,1.62,1.25,1.62,2.63,1.14,3
Brondby IF,8,3,3,2,12,13,-1,12,Denmark - Superligaen,0.38,0.75,-1,1.5,1.62,1.5,2.63,1.33,4
Vejle BK,8,3,2,3,10,12,-2,11,Denmark - Superligaen,0.38,0.62,-2,1.25,1.5,1.38,2.63,1.61,5
Nordsjaelland,8,3,2,3,14,17,-3,11,Denmark - Superligaen,0.38,0.62,-3,1.75,2.12,1.38,2.63,1.61,5
Randers FC,8,3,1,4,16,20,-4,10,Denmark - Superligaen,0.38,0.5,-4,2.0,2.5,1.25,2.63,2.0,6
Lyngby,8,2,3,3,9,13,-4,9,Denmark - Superligaen,0.25,0.62,-4,1.12,1.62,1.12,4.0,1.61,7
Aalborg BK,8,0,2,6,10,21,-11,2,Denmark - Superligaen,0.0,0.25,-11,1.25,2.62,0.25,0.0,4.0,8
AGF Aarhus,8,0,1,7,8,21,-13,1,Denmark - Superligaen,0.0,0.12,-13,1.0,2.62,0.12,0.0,8.33,9
Fredericia,8,5,3,0,19,4,15,18,Denmark - 1st Division,0.62,1.0,15,2.38,0.5,2.25,1.61,1.0,1
Hillerod,8,5,1,2,20,10,10,16,Denmark - 1st Division,0.62,0.75,10,2.5,1.25,2.0,1.61,1.33,2
Odense BK,8,3,4,1,20,12,8,13,Denmark - 1st Division,0.38,0.88,8,2.5,1.5,1.62,2.63,1.14,3
Kolding IF,8,4,1,3,13,13,0,13,Denmark - 1st Division,0.5,0.62,0,1.62,1.62,1.62,2.0,1.61,3
Roskilde,8,3,3,2,15,14,1,12,Denmark - 1st Division,0.38,0.75,1,1.88,1.75,1.5,2.63,1.33,4
Hobro,8,3,3,2,8,10,-2,12,Denmark - 1st Division,0.38,0.75,-2,1.0,1.25,1.5,2.63,1.33,4
HB Koge,8,3,1,4,9,14,-5,10,Denmark - 1st Division,0.38,0.5,-5,1.12,1.75,1.25,2.63,2.0,5
Hvidovre,8,2,3,3,8,12,-4,9,Denmark - 1st Division,0.25,0.62,-4,1.0,1.5,1.12,4.0,1.61,6
B 93,8,2,2,4,12,14,-2,8,Denmark - 1st Division,0.25,0.5,-2,1.5,1.75,1.0,4.0,2.0,7
Vendsyssel,8,2,2,4,10,12,-2,8,Denmark - 1st Division,0.25,0.5,-2,1.25,1.5,1.0,4.0,2.0,7
AC Horsens,8,2,2,4,10,18,-8,8,Denmark - 1st Division,0.25,0.5,-8,1.25,2.25,1.0,4.0,2.0,7
Esbjerg,8,1,1,6,8,19,-11,4,Denmark - 1st Division,0.12,0.25,-11,1.0,2.38,0.5,8.33,4.0,8
AB Copenhagen,8,5,1,2,20,11,9,16,Denmark - 2nd Division,0.62,0.75,9,2.5,1.38,2.0,1.61,1.33,1
Aarhus Fremad,8,5,1,2,12,3,9,16,Denmark - 2nd Division,0.62,0.75,9,1.5,0.38,2.0,1.61,1.33,1
Middelfart,8,5,1,2,12,9,3,16,Denmark - 2nd Division,0.62,0.75,3,1.5,1.12,2.0,1.61,1.33,1
Skive,8,4,2,2,9,6,3,14,Denmark - 2nd Division,0.5,0.75,3,1.12,0.75,1.75,2.0,1.33,2
Naestved,8,4,1,3,10,9,1,13,Denmark - 2nd Division,0.5,0.62,1,1.25,1.12,1.62,2.0,1.61,3
BK Frem,8,3,2,3,9,7,2,11,Denmark - 2nd Division,0.38,0.62,2,1.12,0.88,1.38,2.63,1.61,4
Ishoj,8,3,2,3,8,9,-1,11,Denmark - 2nd Division,0.38,0.62,-1,1.0,1.12,1.38,2.63,1.61,4
Fremad Amager,8,3,1,4,10,11,-1,10,Denmark - 2nd Division,0.38,0.5,-1,1.25,1.38,1.25,2.63,2.0,5
Hellerup IK,8,3,0,5,6,16,-10,9,Denmark - 2nd Division,0.38,0.38,-10,0.75,2.0,1.12,2.63,2.63,6
Helsingor,8,1,5,2,9,11,-2,8,Denmark - 2nd Division,0.12,0.75,-2,1.12,1.38,1.0,8.33,1.33,7
Nykobing,8,1,2,5,8,13,-5,5,Denmark - 2nd Division,0.12,0.38,-5,1.0,1.62,0.62,8.33,2.63,8
Thisted,8,1,2,5,8,16,-8,5,Denmark - 2nd Division,0.12,0.38,-8,1.0,2.0,0.62,8.33,2.63,8
I. del Valle,8,6,1,1,16,8,8,19,Ecuador - Liga Pro 1st Stage,0.75,0.88,8,2.0,1.0,2.38,1.33,1.14,1
D. Cuenca,8,5,1,2,9,3,6,16,Ecuador - Liga Pro 1st Stage,0.62,0.75,6,1.12,0.38,2.0,1.61,1.33,2
Aucas,8,5,1,2,12,7,5,16,Ecuador - Liga Pro 1st Stage,0.62,0.75,5,1.5,0.88,2.0,1.61,1.33,2
El Nacional,8,4,2,2,14,12,2,14,Ecuador - Liga Pro 1st Stage,0.5,0.75,2,1.75,1.5,1.75,2.0,1.33,3
Barcelona SC,8,4,2,2,9,8,1,14,Ecuador - Liga Pro 1st Stage,0.5,0.75,1,1.12,1.0,1.75,2.0,1.33,3
Orense,8,4,1,3,12,9,3,13,Ecuador - Liga Pro 1st Stage,0.5,0.62,3,1.5,1.12,1.62,2.0,1.61,4
LDU Quito,8,3,3,2,12,11,1,12,Ecuador - Liga Pro 1st Stage,0.38,0.75,1,1.5,1.38,1.5,2.63,1.33,5
Delfin,8,3,3,2,7,10,-3,12,Ecuador - Liga Pro 1st Stage,0.38,0.75,-3,0.88,1.25,1.5,2.63,1.33,5
Cuniburo,8,3,1,4,14,11,3,10,Ecuador - Liga Pro 1st Stage,0.38,0.5,3,1.75,1.38,1.25,2.63,2.0,6
Manta,8,2,4,2,10,12,-2,10,Ecuador - Liga Pro 1st Stage,0.25,0.75,-2,1.25,1.5,1.25,4.0,1.33,6
Emelec,8,3,1,4,5,8,-3,10,Ecuador - Liga Pro 1st Stage,0.38,0.5,-3,0.62,1.0,1.25,2.63,2.0,6
U. Catolica,8,2,2,4,11,13,-2,8,Ecuador - Liga Pro 1st Stage,0.25,0.5,-2,1.38,1.62,1.0,4.0,2.0,7
Libertad,8,2,2,4,7,9,-2,8,Ecuador - Liga Pro 1st Stage,0.25,0.5,-2,0.88,1.12,1.0,4.0,2.0,7
Macara,8,1,3,4,7,10,-3,6,Ecuador - Liga Pro 1st Stage,0.12,0.5,-3,0.88,1.25,0.75,8.33,2.0,8
Mushuc Runa,8,2,0,6,12,19,-7,6,Ecuador - Liga Pro 1st Stage,0.25,0.25,-7,1.5,2.38,0.75,4.0,4.0,8
Tecnico U.,8,1,1,6,8,15,-7,4,Ecuador - Liga Pro 1st Stage,0.12,0.25,-7,1.0,1.88,0.5,8.33,4.0,9
Al Ahly,8,6,1,1,22,9,13,19,Egypt - Premier League,0.75,0.88,13,2.75,1.12,2.38,1.33,1.14,1
Modern Sport,8,5,2,1,12,7,5,17,Egypt - Premier League,0.62,0.88,5,1.5,0.88,2.12,1.61,1.14,2
Zamalek,8,4,3,1,14,6,8,15,Egypt - Premier League,0.5,0.88,8,1.75,0.75,1.88,2.0,1.14,3
ENPPI,8,4,3,1,8,5,3,15,Egypt - Premier League,0.5,0.88,3,1.0,0.62,1.88,2.0,1.14,3
Pyramids FC,8,4,2,2,15,10,5,14,Egypt - Premier League,0.5,0.75,5,1.88,1.25,1.75,2.0,1.33,4
Ceramica C.,8,4,1,3,15,12,3,13,Egypt - Premier League,0.5,0.62,3,1.88,1.5,1.62,2.0,1.61,5
El Gouna,8,4,1,3,10,7,3,13,Egypt - Premier League,0.5,0.62,3,1.25,0.88,1.62,2.0,1.61,5
Al Masry,8,3,3,2,10,9,1,12,Egypt - Premier League,0.38,0.75,1,1.25,1.12,1.5,2.63,1.33,6
ZED FC,8,2,5,1,9,5,4,11,Egypt - Premier League,0.25,0.88,4,1.12,0.62,1.38,4.0,1.14,7
National Bank,8,2,3,3,13,12,1,9,Egypt - Premier League,0.25,0.62,1,1.62,1.5,1.12,4.0,1.61,8
Ismaily,8,2,3,3,7,7,0,9,Egypt - Premier League,0.25,0.62,0,0.88,0.88,1.12,4.0,1.61,8
Pharco,8,2,3,3,8,16,-8,9,Egypt - Premier League,0.25,0.62,-8,1.0,2.0,1.12,4.0,1.61,8
El Geish,8,1,5,2,5,6,-1,8,Egypt - Premier League,0.12,0.75,-1,0.62,0.75,1.0,8.33,1.33,9
Al Ittihad,8,1,5,2,3,5,-2,8,Egypt - Premier League,0.12,0.75,-2,0.38,0.62,1.0,8.33,1.33,9
Ghazl El M.,8,1,3,4,4,12,-8,6,Egypt - Premier League,0.12,0.5,-8,0.5,1.5,0.75,8.33,2.0,10
Smouha,8,0,5,3,2,6,-4,5,Egypt - Premier League,0.0,0.62,-4,0.25,0.75,0.62,0.0,1.61,11
Petrojet,8,1,2,5,7,17,-10,5,Egypt - Premier League,0.12,0.38,-10,0.88,2.12,0.62,8.33,2.63,11
Haras El Hodood,8,0,2,6,3,16,-13,2,Egypt - Premier League,0.0,0.25,-13,0.38,2.0,0.25,0.0,4.0,12
Manchester City,8,6,2,0,15,4,11,20,Premier League,0.75,1.0,11,1.88,0.5,2.5,1.33,1.0,2
Aston Villa,8,6,0,2,14,6,8,18,Premier League,0.75,0.75,8,1.75,0.75,2.25,1.33,1.33,3
Chelsea,8,5,2,1,10,6,4,17,Premier League,0.62,0.88,4,1.25,0.75,2.12,1.61,1.14,4
Brentford,8,4,3,1,15,10,5,15,Premier League,0.5,0.88,5,1.88,1.25,1.88,2.0,1.14,5
Brighton,8,4,2,2,18,14,4,14,Premier League,0.5,0.75,4,2.25,1.75,1.75,2.0,1.33,6
Everton,8,4,2,2,10,7,3,14,Premier League,0.5,0.75,3,1.25,0.88,1.75,2.0,1.33,6
Newcastle Utd,8,4,1,3,16,8,8,13,Premier League,0.5,0.62,8,2.0,1.0,1.62,2.0,1.61,7
Arsenal,8,3,4,1,14,9,5,13,Premier League,0.38,0.88,5,1.75,1.12,1.62,2.63,1.14,7
Wolverhampton,8,4,1,3,13,11,2,13,Premier League,0.5,0.62,2,1.62,1.38,1.62,2.0,1.61,7
Bournemouth,8,3,3,2,9,8,1,12,Premier League,0.38,0.75,1,1.12,1.0,1.5,2.63,1.33,8
Liverpool,8,3,2,3,16,14,2,11,Premier League,0.38,0.62,2,2.0,1.75,1.38,2.63,1.61,9
Crystal Palace,8,2,4,2,12,16,-4,10,Premier League,0.25,0.75,-4,1.5,2.0,1.25,4.0,1.33,10
West Ham Utd,8,2,3,3,13,12,1,9,Premier League,0.25,0.62,1,1.62,1.5,1.12,4.0,1.61,11
Fulham,8,3,0,5,10,14,-4,9,Premier League,0.38,0.38,-4,1.25,1.75,1.12,2.63,2.63,11
Nottm Forest,8,2,2,4,8,11,-3,8,Premier League,0.25,0.5,-3,1.0,1.38,1.0,4.0,2.0,12
Leicester City,8,2,2,4,8,13,-5,8,Premier League,0.25,0.5,-5,1.0,1.62,1.0,4.0,2.0,12
Manchester Utd,8,1,2,5,7,13,-6,5,Premier League,0.12,0.38,-6,0.88,1.62,0.62,8.33,2.63,14
Tottenham,8,1,1,6,9,21,-12,4,Premier League,0.12,0.25,-12,1.12,2.62,0.5,8.33,4.0,15
Southampton,8,0,2,6,4,15,-11,2,Premier League,0.0,0.25,-11,0.5,1.88,0.25,0.0,4.0,17
Ipswich Town,8,0,2,6,6,19,-13,2,Premier League,0.0,0.25,-13,0.75,2.38,0.25,0.0,4.0,17
Burnley,8,7,1,0,17,5,12,22,Premier League,0.88,1.0,12,2.12,0.62,2.75,1.14,1.0,1
Leeds Utd,8,6,2,0,19,5,14,20,Premier League,0.75,1.0,14,2.38,0.62,2.5,1.33,1.0,2
Swansea City,8,5,2,1,13,7,6,17,Premier League,0.62,0.88,6,1.62,0.88,2.12,1.61,1.14,4
Millwall,8,5,0,3,10,10,0,15,Premier League,0.62,0.62,0,1.25,1.25,1.88,1.61,1.61,5
Blackburn,8,4,2,2,11,8,3,14,Premier League,0.5,0.75,3,1.38,1.0,1.75,2.0,1.33,6
Luton Town,8,4,2,2,11,9,2,14,Premier League,0.5,0.75,2,1.38,1.12,1.75,2.0,1.33,6
Plymouth,8,4,1,3,11,11,0,13,Premier League,0.5,0.62,0,1.38,1.38,1.62,2.0,1.61,7
Derby County,8,3,3,2,8,5,3,12,Premier League,0.38,0.75,3,1.0,0.62,1.5,2.63,1.33,8
Portsmouth,8,3,3,2,12,10,2,12,Premier League,0.38,0.75,2,1.5,1.25,1.5,2.63,1.33,8
Stoke City,8,3,3,2,8,11,-3,12,Premier League,0.38,0.75,-3,1.0,1.38,1.5,2.63,1.33,8
Oxford Utd,8,3,2,3,10,10,0,11,Premier League,0.38,0.62,0,1.25,1.25,1.38,2.63,1.61,9
Bristol City,8,3,2,3,10,14,-4,11,Premier League,0.38,0.62,-4,1.25,1.75,1.38,2.63,1.61,9
QP Rangers,8,3,2,3,9,13,-4,11,Premier League,0.38,0.62,-4,1.12,1.62,1.38,2.63,1.61,9
Sheffield Utd,8,3,1,4,10,8,2,10,Premier League,0.38,0.5,2,1.25,1.0,1.25,2.63,2.0,10
Coventry City,8,3,1,4,9,10,-1,10,Premier League,0.38,0.5,-1,1.12,1.25,1.25,2.63,2.0,10
Middlesbrough,8,3,1,4,7,8,-1,10,Premier League,0.38,0.5,-1,0.88,1.0,1.25,2.63,2.0,10
Hull City,8,2,2,4,5,7,-2,8,Premier League,0.25,0.5,-2,0.62,0.88,1.0,4.0,2.0,12
Norwich City,8,2,2,4,11,14,-3,8,Premier League,0.25,0.5,-3,1.38,1.75,1.0,4.0,2.0,12
Sheffield Wed,8,1,4,3,7,10,-3,7,Premier League,0.12,0.62,-3,0.88,1.25,0.88,8.33,1.61,13
West Brom,8,2,1,5,9,13,-4,7,Premier League,0.25,0.38,-4,1.12,1.62,0.88,4.0,2.63,13
Sunderland,8,2,1,5,3,7,-4,7,Premier League,0.25,0.38,-4,0.38,0.88,0.88,4.0,2.63,13
Watford,8,1,2,5,6,10,-4,5,Premier League,0.12,0.38,-4,0.75,1.25,0.62,8.33,2.63,14
Cardiff City,8,0,5,3,6,11,-5,5,Premier League,0.0,0.62,-5,0.75,1.38,0.62,0.0,1.61,14
Preston,8,0,3,5,9,15,-6,3,Premier League,0.0,0.38,-6,1.12,1.88,0.38,0.0,2.63,16
Birmingham City,8,7,1,0,19,5,14,22,League One,0.88,1.0,14,2.38,0.62,2.75,1.14,1.0,1
Stockport,8,7,1,0,19,7,12,22,League One,0.88,1.0,12,2.38,0.88,2.75,1.14,1.0,1
Charlton,8,6,1,1,18,8,10,19,League One,0.75,0.88,10,2.25,1.0,2.38,1.33,1.14,2
Leyton Orient,8,6,1,1,18,10,8,19,League One,0.75,0.88,8,2.25,1.25,2.38,1.33,1.14,2
Wrexham,8,5,3,0,15,4,11,18,League One,0.62,1.0,11,1.88,0.5,2.25,1.61,1.0,3
Rotherham,8,4,2,2,12,10,2,14,League One,0.5,0.75,2,1.5,1.25,1.75,2.0,1.33,4
Crawley Town,8,4,1,3,17,12,5,13,League One,0.5,0.62,5,2.12,1.5,1.62,2.0,1.61,5
Blackpool,8,4,1,3,15,10,5,13,League One,0.5,0.62,5,1.88,1.25,1.62,2.0,1.61,5
Reading,8,4,1,3,13,10,3,13,League One,0.5,0.62,3,1.62,1.25,1.62,2.0,1.61,5
Wigan Athletic,8,2,6,0,6,4,2,12,League One,0.25,1.0,2,0.75,0.5,1.5,4.0,1.0,6
Lincoln City,8,3,2,3,11,11,0,11,League One,0.38,0.62,0,1.38,1.38,1.38,2.63,1.61,7
Burton Albion,8,3,2,3,10,11,-1,11,League One,0.38,0.62,-1,1.25,1.38,1.38,2.63,1.61,7
Exeter City,8,3,2,3,9,12,-3,11,League One,0.38,0.62,-3,1.12,1.5,1.38,2.63,1.61,7
Wycombe,8,3,1,4,5,9,-4,10,League One,0.38,0.5,-4,0.62,1.12,1.25,2.63,2.0,8
Northampton,8,2,3,3,11,10,1,9,League One,0.25,0.62,1,1.38,1.25,1.12,4.0,1.61,9
Barnsley,8,2,2,4,17,19,-2,8,League One,0.25,0.5,-2,2.12,2.38,1.0,4.0,2.0,10
Cambridge Utd,8,2,2,4,9,11,-2,8,League One,0.25,0.5,-2,1.12,1.38,1.0,4.0,2.0,10
Stevenage,8,2,2,4,7,11,-4,8,League One,0.25,0.5,-4,0.88,1.38,1.0,4.0,2.0,10
Bolton,8,2,2,4,7,13,-6,8,League One,0.25,0.5,-6,0.88,1.62,1.0,4.0,2.0,10
Mansfield,8,2,1,5,15,21,-6,7,League One,0.25,0.38,-6,1.88,2.62,0.88,4.0,2.63,11
Peterborough,8,1,3,4,11,18,-7,6,League One,0.12,0.5,-7,1.38,2.25,0.75,8.33,2.0,12
Shrewsbury,8,1,2,5,6,13,-7,5,League One,0.12,0.38,-7,0.75,1.62,0.62,8.33,2.63,13
Huddersfield,8,1,0,7,6,17,-11,3,League One,0.12,0.12,-11,0.75,2.12,0.38,8.33,8.33,14
Bristol Rovers,8,0,1,7,5,15,-10,1,League One,0.0,0.12,-10,0.62,1.88,0.12,0.0,8.33,15
Doncaster,8,5,3,0,16,6,10,18,League Two,0.62,1.0,10,2.0,0.75,2.25,1.61,1.0,1
Port Vale,8,5,1,2,17,8,9,16,League Two,0.62,0.75,9,2.12,1.0,2.0,1.61,1.33,2
Chesterfield,8,4,3,1,14,10,4,15,League Two,0.5,0.88,4,1.75,1.25,1.88,2.0,1.14,3
Swindon Town,8,4,2,2,16,8,8,14,League Two,0.5,0.75,8,2.0,1.0,1.75,2.0,1.33,4
Tranmere,8,4,2,2,17,10,7,14,League Two,0.5,0.75,7,2.12,1.25,1.75,2.0,1.33,4
Bromley,8,4,2,2,15,12,3,14,League Two,0.5,0.75,3,1.88,1.5,1.75,2.0,1.33,4
Gillingham,8,3,5,0,9,6,3,14,League Two,0.38,1.0,3,1.12,0.75,1.75,2.63,1.0,4
Salford City,8,3,4,1,17,11,6,13,League Two,0.38,0.88,6,2.12,1.38,1.62,2.63,1.14,5
Harrogate,8,3,3,2,14,13,1,12,League Two,0.38,0.75,1,1.75,1.62,1.5,2.63,1.33,6
Barrow,8,2,5,1,9,5,4,11,League Two,0.25,0.88,4,1.12,0.62,1.38,4.0,1.14,7
Carlisle Utd,8,3,2,3,14,15,-1,11,League Two,0.38,0.62,-1,1.75,1.88,1.38,2.63,1.61,7
Notts County,8,3,1,4,12,10,2,10,League Two,0.38,0.5,2,1.5,1.25,1.25,2.63,2.0,8
Fleetwood,8,3,1,4,11,14,-3,10,League Two,0.38,0.5,-3,1.38,1.75,1.25,2.63,2.0,8
Cheltenham,8,3,1,4,9,15,-6,10,League Two,0.38,0.5,-6,1.12,1.88,1.25,2.63,2.0,8
Bradford,8,2,3,3,12,13,-1,9,League Two,0.25,0.62,-1,1.5,1.62,1.12,4.0,1.61,9
AFC Wimbledon,8,2,3,3,5,7,-2,9,League Two,0.25,0.62,-2,0.62,0.88,1.12,4.0,1.61,9
Grimsby,8,2,3,3,9,13,-4,9,League Two,0.25,0.62,-4,1.12,1.62,1.12,4.0,1.61,9
Colchester Utd,8,2,3,3,6,10,-4,9,League Two,0.25,0.62,-4,0.75,1.25,1.12,4.0,1.61,9
Accrington,8,2,3,3,8,14,-6,9,League Two,0.25,0.62,-6,1.0,1.75,1.12,4.0,1.61,9
Walsall,8,1,4,3,8,11,-3,7,League Two,0.12,0.62,-3,1.0,1.38,0.88,8.33,1.61,10
Morecambe,8,2,0,6,7,15,-8,6,League Two,0.25,0.25,-8,0.88,1.88,0.75,4.0,4.0,11
Milton Keynes,8,1,3,4,3,11,-8,6,League Two,0.12,0.5,-8,0.38,1.38,0.75,8.33,2.0,11
Crewe Alexandra,8,1,1,6,4,10,-6,4,League Two,0.12,0.25,-6,0.5,1.25,0.5,8.33,4.0,12
Newport,8,0,3,5,4,14,-10,3,League Two,0.0,0.38,-10,0.5,1.75,0.38,0.0,2.63,13
York City,8,7,1,0,25,5,20,22,England - National League,0.88,1.0,20,3.12,0.62,2.75,1.14,1.0,1
Barnet,8,5,2,1,17,6,11,17,England - National League,0.62,0.88,11,2.12,0.75,2.12,1.61,1.14,2
Woking,8,4,4,0,14,8,6,16,England - National League,0.5,1.0,6,1.75,1.0,2.0,2.0,1.0,3
Maidenhead Utd,8,4,3,1,14,6,8,15,England - National League,0.5,0.88,8,1.75,0.75,1.88,2.0,1.14,4
Boston Utd,8,5,0,3,11,10,1,15,England - National League,0.62,0.62,1,1.38,1.25,1.88,1.61,1.61,4
Rochdale,8,4,2,2,13,6,7,14,England - National League,0.5,0.75,7,1.62,0.75,1.75,2.0,1.33,5
Hartlepool,8,4,2,2,15,14,1,14,England - National League,0.5,0.75,1,1.88,1.75,1.75,2.0,1.33,5
Dagenham & R.,8,3,4,1,12,6,6,13,England - National League,0.38,0.88,6,1.5,0.75,1.62,2.63,1.14,6
Tamworth,8,4,1,3,15,14,1,13,England - National League,0.5,0.62,1,1.88,1.75,1.62,2.0,1.61,6
Southend Utd,8,3,3,2,9,5,4,12,England - National League,0.38,0.75,4,1.12,0.62,1.5,2.63,1.33,7
Forest Green,8,3,2,3,10,10,0,11,England - National League,0.38,0.62,0,1.25,1.25,1.38,2.63,1.61,8
Braintree Town,8,3,2,3,9,9,0,11,England - National League,0.38,0.62,0,1.12,1.12,1.38,2.63,1.61,8
Solihull Moors,8,3,2,3,8,9,-1,11,England - National League,0.38,0.62,-1,1.0,1.12,1.38,2.63,1.61,8
Wealdstone,8,3,2,3,8,12,-4,11,England - National League,0.38,0.62,-4,1.0,1.5,1.38,2.63,1.61,8
Yeovil Town,8,3,1,4,10,9,1,10,England - National League,0.38,0.5,1,1.25,1.12,1.25,2.63,2.0,9
Oldham,8,3,1,4,9,8,1,10,England - National League,0.38,0.5,1,1.12,1.0,1.25,2.63,2.0,9
Altrincham,8,2,3,3,11,14,-3,9,England - National League,0.25,0.62,-3,1.38,1.75,1.12,4.0,1.61,10
Sutton Utd,8,2,3,3,9,13,-4,9,England - National League,0.25,0.62,-4,1.12,1.62,1.12,4.0,1.61,10
Halifax Town,8,2,2,4,4,10,-6,8,England - National League,0.25,0.5,-6,0.5,1.25,1.0,4.0,2.0,11
Gateshead FC,8,2,1,5,10,16,-6,7,England - National League,0.25,0.38,-6,1.25,2.0,0.88,4.0,2.63,12
Aldershot Town,8,2,1,5,8,22,-14,7,England - National League,0.25,0.38,-14,1.0,2.75,0.88,4.0,2.63,12
Eastleigh,8,1,3,4,6,14,-8,6,England - National League,0.12,0.5,-8,0.75,1.75,0.75,8.33,2.0,13
Ebbsfleet Utd,8,1,2,5,11,18,-7,5,England - National League,0.12,0.38,-7,1.38,2.25,0.62,8.33,2.63,14
AFC Fylde,8,0,1,7,4,15,-11,1,England - National League,0.0,0.12,-11,0.5,1.88,0.12,0.0,8.33,15
Brackley Town,8,7,0,1,15,3,12,21,England - National L. North,0.88,0.88,12,1.88,0.38,2.62,1.14,1.14,1
Kidderminster,8,6,1,1,20,6,14,19,England - National L. North,0.75,0.88,14,2.5,0.75,2.38,1.33,1.14,2
Chester,8,5,2,1,13,8,5,17,England - National L. North,0.62,0.88,5,1.62,1.0,2.12,1.61,1.14,3
Buxton,8,5,1,2,12,6,6,16,England - National L. North,0.62,0.75,6,1.5,0.75,2.0,1.61,1.33,4
Spennymoor,8,5,1,2,12,9,3,16,England - National L. North,0.62,0.75,3,1.5,1.12,2.0,1.61,1.33,4
Kings Lynn,8,5,1,2,7,7,0,16,England - National L. North,0.62,0.75,0,0.88,0.88,2.0,1.61,1.33,4
Chorley,8,4,3,1,17,3,14,15,England - National L. North,0.5,0.88,14,2.12,0.38,1.88,2.0,1.14,5
Scunthorpe,8,5,0,3,13,4,9,15,England - National L. North,0.62,0.62,9,1.62,0.5,1.88,1.61,1.61,5
Marine,8,4,2,2,10,8,2,14,England - National L. North,0.5,0.75,2,1.25,1.0,1.75,2.0,1.33,6
Hereford Utd,8,4,1,3,15,11,4,13,England - National L. North,0.5,0.62,4,1.88,1.38,1.62,2.0,1.61,7
Alfreton Town,8,3,4,1,8,6,2,13,England - National L. North,0.38,0.88,2,1.0,0.75,1.62,2.63,1.14,7
Darlington,8,3,3,2,15,12,3,12,England - National L. North,0.38,0.75,3,1.88,1.5,1.5,2.63,1.33,8
Scarborough,8,3,3,2,8,8,0,12,England - National L. North,0.38,0.75,0,1.0,1.0,1.5,2.63,1.33,8
Curzon,8,3,3,2,9,10,-1,12,England - National L. North,0.38,0.75,-1,1.12,1.25,1.5,2.63,1.33,8
Oxford City,8,3,2,3,10,8,2,11,England - National L. North,0.38,0.62,2,1.25,1.0,1.38,2.63,1.61,9
Peterborough S.,8,3,1,4,10,14,-4,10,England - National L. North,0.38,0.5,-4,1.25,1.75,1.25,2.63,2.0,10
Southport,8,2,3,3,6,7,-1,9,England - National L. North,0.25,0.62,-1,0.75,0.88,1.12,4.0,1.61,11
Radcliffe,8,2,2,4,7,13,-6,8,England - National L. North,0.25,0.5,-6,0.88,1.62,1.0,4.0,2.0,12
Leamington,8,1,2,5,3,10,-7,5,England - National L. North,0.12,0.38,-7,0.38,1.25,0.62,8.33,2.63,13
Rushall,8,1,2,5,8,17,-9,5,England - National L. North,0.12,0.38,-9,1.0,2.12,0.62,8.33,2.63,13
Needham Market,8,1,0,7,6,16,-10,3,England - National L. North,0.12,0.12,-10,0.75,2.0,0.38,8.33,8.33,14
South Shields,8,0,2,6,4,14,-10,2,England - National L. North,0.0,0.25,-10,0.5,1.75,0.25,0.0,4.0,15
Warrington,8,0,1,7,3,15,-12,1,England - National L. North,0.0,0.12,-12,0.38,1.88,0.12,0.0,8.33,16
Farsley Celtic,8,0,0,8,5,28,-23,0,England - National L. North,0.0,0.0,-23,0.62,3.5,0.0,0.0,0.0,17
Torquay Utd,8,7,0,1,14,3,11,21,England - National L. South,0.88,0.88,11,1.75,0.38,2.62,1.14,1.14,1
Eastbourne,8,6,1,1,17,5,12,19,England - National L. South,0.75,0.88,12,2.12,0.62,2.38,1.33,1.14,2
Truro City,8,5,1,2,15,8,7,16,England - National L. South,0.62,0.75,7,1.88,1.0,2.0,1.61,1.33,3
Maidstone Utd,8,4,3,1,17,6,11,15,England - National L. South,0.5,0.88,11,2.12,0.75,1.88,2.0,1.14,4
Boreham Wood,8,5,0,3,18,11,7,15,England - National L. South,0.62,0.62,7,2.25,1.38,1.88,1.61,1.61,4
Dorking,8,4,3,1,14,8,6,15,England - National L. South,0.5,0.88,6,1.75,1.0,1.88,2.0,1.14,4
Hornchurch,8,4,2,2,12,8,4,14,England - National L. South,0.5,0.75,4,1.5,1.0,1.75,2.0,1.33,5
Weston-s.-Mare,8,4,1,3,12,10,2,13,England - National L. South,0.5,0.62,2,1.5,1.25,1.62,2.0,1.61,6
Chesham Utd,8,4,1,3,12,11,1,13,England - National L. South,0.5,0.62,1,1.5,1.38,1.62,2.0,1.61,6
Slough Town,8,4,1,3,13,15,-2,13,England - National L. South,0.5,0.62,-2,1.62,1.88,1.62,2.0,1.61,6
Bath City,8,3,3,2,13,6,7,12,England - National L. South,0.38,0.75,7,1.62,0.75,1.5,2.63,1.33,7
St Albans,8,3,3,2,9,10,-1,12,England - National L. South,0.38,0.75,-1,1.12,1.25,1.5,2.63,1.33,7
Worthing,8,3,2,3,14,9,5,11,England - National L. South,0.38,0.62,5,1.75,1.12,1.38,2.63,1.61,8
Chelmsford City,8,3,1,4,14,8,6,10,England - National L. South,0.38,0.5,6,1.75,1.0,1.25,2.63,2.0,9
Farnborough,8,3,1,4,17,15,2,10,England - National L. South,0.38,0.5,2,2.12,1.88,1.25,2.63,2.0,9
Enfield Town,8,2,4,2,10,15,-5,10,England - National L. South,0.25,0.75,-5,1.25,1.88,1.25,4.0,1.33,9
Chippenham,8,3,1,4,5,12,-7,10,England - National L. South,0.38,0.5,-7,0.62,1.5,1.25,2.63,2.0,9
Hemel Hempstead,8,2,3,3,7,11,-4,9,England - National L. South,0.25,0.62,-4,0.88,1.38,1.12,4.0,1.61,10
Salisbury,8,2,2,4,7,11,-4,8,England - National L. South,0.25,0.5,-4,0.88,1.38,1.0,4.0,2.0,11
Aveley,8,2,2,4,6,11,-5,8,England - National L. South,0.25,0.5,-5,0.75,1.38,1.0,4.0,2.0,11
Weymouth,8,2,2,4,10,17,-7,8,England - National L. South,0.25,0.5,-7,1.25,2.12,1.0,4.0,2.0,11
Welling Utd,8,1,2,5,6,21,-15,5,England - National L. South,0.12,0.38,-15,0.75,2.62,0.62,8.33,2.63,12
Tonbridge,8,1,1,6,5,17,-12,4,England - National L. South,0.12,0.25,-12,0.62,2.12,0.5,8.33,4.0,13
Hampton & R.,8,1,0,7,10,25,-15,3,England - National L. South,0.12,0.12,-15,1.25,3.12,0.38,8.33,8.33,14
Horsham,8,8,0,0,19,3,16,24,England - Isthmian league,1.0,1.0,16,2.38,0.38,3.0,1.0,1.0,1
Billericay Town,8,6,0,2,21,9,12,18,England - Isthmian league,0.75,0.75,12,2.62,1.12,2.25,1.33,1.33,2
Cray Valley PM,8,6,0,2,16,9,7,18,England - Isthmian league,0.75,0.75,7,2.0,1.12,2.25,1.33,1.33,2
Dartford,8,5,2,1,16,9,7,17,England - Isthmian league,0.62,0.88,7,2.0,1.12,2.12,1.61,1.14,3
Dover Athletic,8,5,1,2,14,10,4,16,England - Isthmian league,0.62,0.75,4,1.75,1.25,2.0,1.61,1.33,4
Carshalton,8,5,0,3,20,13,7,15,England - Isthmian league,0.62,0.62,7,2.5,1.62,1.88,1.61,1.61,5
Chichester City,8,5,0,3,14,7,7,15,England - Isthmian league,0.62,0.62,7,1.75,0.88,1.88,1.61,1.61,5
Chatham Town,8,4,2,2,13,8,5,14,England - Isthmian league,0.5,0.75,5,1.62,1.0,1.75,2.0,1.33,6
Potters Bar,8,4,0,4,12,14,-2,12,England - Isthmian league,0.5,0.5,-2,1.5,1.75,1.5,2.0,2.0,7
Cray Wanderers,8,3,1,4,17,14,3,10,England - Isthmian league,0.38,0.5,3,2.12,1.75,1.25,2.63,2.0,8
Folkestone,8,3,1,4,8,12,-4,10,England - Isthmian league,0.38,0.5,-4,1.0,1.5,1.25,2.63,2.0,8
Lewes,8,3,1,4,12,17,-5,10,England - Isthmian league,0.38,0.5,-5,1.5,2.12,1.25,2.63,2.0,8
Whitehawk,8,3,0,5,7,8,-1,9,England - Isthmian league,0.38,0.38,-1,0.88,1.0,1.12,2.63,2.63,9
Hashtag United,8,2,3,3,11,13,-2,9,England - Isthmian league,0.25,0.62,-2,1.38,1.62,1.12,4.0,1.61,9
Wingate & F.,8,2,3,3,10,12,-2,9,England - Isthmian league,0.25,0.62,-2,1.25,1.5,1.12,4.0,1.61,9
Cheshunt,8,3,0,5,10,15,-5,9,England - Isthmian league,0.38,0.38,-5,1.25,1.88,1.12,2.63,2.63,9
Hendon,8,2,2,4,15,20,-5,8,England - Isthmian league,0.25,0.5,-5,1.88,2.5,1.0,4.0,2.0,10
Bowers & Pitsea,8,2,1,5,6,15,-9,7,England - Isthmian league,0.25,0.38,-9,0.75,1.88,0.88,4.0,2.63,11
Bognor Regis,8,2,1,5,6,18,-12,7,England - Isthmian league,0.25,0.38,-12,0.75,2.25,0.88,4.0,2.63,11
Canvey Island,8,1,3,4,4,9,-5,6,England - Isthmian league,0.12,0.5,-5,0.5,1.12,0.75,8.33,2.0,12
Hastings Utd,8,1,3,4,7,13,-6,6,England - Isthmian league,0.12,0.5,-6,0.88,1.62,0.75,8.33,2.0,12
Dulwich Hamlet,8,1,1,6,6,17,-11,4,England - Isthmian league,0.12,0.25,-11,0.75,2.12,0.5,8.33,4.0,13
Macclesfield,8,8,0,0,27,4,23,24,England - Northern league,1.0,1.0,23,3.38,0.5,3.0,1.0,1.0,1
Stockton Town,8,6,1,1,9,3,6,19,England - Northern league,0.75,0.88,6,1.12,0.38,2.38,1.33,1.14,2
Worksop Town,8,6,0,2,19,9,10,18,England - Northern league,0.75,0.75,10,2.38,1.12,2.25,1.33,1.33,3
Bamber Bridge,8,5,0,3,13,7,6,15,England - Northern league,0.62,0.62,6,1.62,0.88,1.88,1.61,1.61,4
Gainsborough,8,5,0,3,13,8,5,15,England - Northern league,0.62,0.62,5,1.62,1.0,1.88,1.61,1.61,4
Prescot Cables,8,5,0,3,10,8,2,15,England - Northern league,0.62,0.62,2,1.25,1.0,1.88,1.61,1.61,4
Ilkeston Town,8,4,2,2,12,10,2,14,England - Northern league,0.5,0.75,2,1.5,1.25,1.75,2.0,1.33,5
Leek Town,8,4,1,3,13,9,4,13,England - Northern league,0.5,0.62,4,1.62,1.12,1.62,2.0,1.61,6
Guiseley,8,3,3,2,9,8,1,12,England - Northern league,0.38,0.75,1,1.12,1.0,1.5,2.63,1.33,7
Whitby Town,8,4,0,4,11,14,-3,12,England - Northern league,0.5,0.5,-3,1.38,1.75,1.5,2.0,2.0,7
Morpeth Town,8,2,5,1,8,10,-2,11,England - Northern league,0.25,0.88,-2,1.0,1.25,1.38,4.0,1.14,8
Mickleover,8,3,2,3,9,13,-4,11,England - Northern league,0.38,0.62,-4,1.12,1.62,1.38,2.63,1.61,8
Workington,8,3,1,4,14,9,5,10,England - Northern league,0.38,0.5,5,1.75,1.12,1.25,2.63,2.0,9
Matlock,8,2,3,3,11,10,1,9,England - Northern league,0.25,0.62,1,1.38,1.25,1.12,4.0,1.61,10
Ashton Utd,8,3,0,5,12,15,-3,9,England - Northern league,0.38,0.38,-3,1.5,1.88,1.12,2.63,2.63,10
Hyde Utd,8,3,0,5,9,16,-7,9,England - Northern league,0.38,0.38,-7,1.12,2.0,1.12,2.63,2.63,10
Rylands,8,2,2,4,8,11,-3,8,England - Northern league,0.25,0.5,-3,1.0,1.38,1.0,4.0,2.0,11
Lancaster City,8,2,2,4,8,16,-8,8,England - Northern league,0.25,0.5,-8,1.0,2.0,1.0,4.0,2.0,11
FC United,8,1,3,4,8,15,-7,6,England - Northern league,0.12,0.5,-7,1.0,1.88,0.75,8.33,2.0,12
Basford Utd,8,1,2,5,8,15,-7,5,England - Northern league,0.12,0.38,-7,1.0,1.88,0.62,8.33,2.63,13
Hebburn Town,8,1,2,5,8,15,-7,5,England - Northern league,0.12,0.38,-7,1.0,1.88,0.62,8.33,2.63,13
Blyth Spartans,8,0,0,8,7,22,-15,0,England - Northern league,0.0,0.0,-15,0.88,2.75,0.0,0.0,0.0,14
Bedford Town,8,6,2,0,17,6,11,20,England - Southern Central,0.75,1.0,11,2.12,0.75,2.5,1.33,1.0,1
Spalding United,8,5,3,0,25,7,18,18,England - Southern Central,0.62,1.0,18,3.12,0.88,2.25,1.61,1.0,2
AFC Sudbury,8,5,2,1,11,7,4,17,England - Southern Central,0.62,0.88,4,1.38,0.88,2.12,1.61,1.14,3
Kettering Town,8,4,4,0,11,6,5,16,England - Southern Central,0.5,1.0,5,1.38,0.75,2.0,2.0,1.0,4
Harborough Town,8,4,3,1,15,6,9,15,England - Southern Central,0.5,0.88,9,1.88,0.75,1.88,2.0,1.14,5
Telford Utd,8,3,5,0,16,5,11,14,England - Southern Central,0.38,1.0,11,2.0,0.62,1.75,2.63,1.0,6
Halesowen Town,8,3,5,0,12,6,6,14,England - Southern Central,0.38,1.0,6,1.5,0.75,1.75,2.63,1.0,6
Stourbridge,8,4,2,2,12,10,2,14,England - Southern Central,0.5,0.75,2,1.5,1.25,1.75,2.0,1.33,6
Banbury Utd,8,3,3,2,13,10,3,12,England - Southern Central,0.38,0.75,3,1.62,1.25,1.5,2.63,1.33,7
Stamford,8,3,3,2,8,13,-5,12,England - Southern Central,0.38,0.75,-5,1.0,1.62,1.5,2.63,1.33,7
Stratford Town,8,2,4,2,10,9,1,10,England - Southern Central,0.25,0.75,1,1.25,1.12,1.25,4.0,1.33,8
Royston,8,2,4,2,9,8,1,10,England - Southern Central,0.25,0.75,1,1.12,1.0,1.25,4.0,1.33,8
Barwell,8,3,1,4,11,19,-8,10,England - Southern Central,0.38,0.5,-8,1.38,2.38,1.25,2.63,2.0,8
Redditch Utd,8,2,3,3,8,9,-1,9,England - Southern Central,0.25,0.62,-1,1.0,1.12,1.12,4.0,1.61,9
Alvechurch,8,2,3,3,9,11,-2,9,England - Southern Central,0.25,0.62,-2,1.12,1.38,1.12,4.0,1.61,9
B. Stortford,8,2,2,4,8,14,-6,8,England - Southern Central,0.25,0.5,-6,1.0,1.75,1.0,4.0,2.0,10
Bromsgrove,8,2,1,5,13,14,-1,7,England - Southern Central,0.25,0.38,-1,1.62,1.75,0.88,4.0,2.63,11
St. Ives Town,8,1,4,3,10,13,-3,7,England - Southern Central,0.12,0.62,-3,1.25,1.62,0.88,8.33,1.61,11
Biggleswade,8,2,1,5,8,14,-6,7,England - Southern Central,0.25,0.38,-6,1.0,1.75,0.88,4.0,2.63,11
Leiston,8,1,3,4,6,11,-5,6,England - Southern Central,0.12,0.5,-5,0.75,1.38,0.75,8.33,2.0,12
Hitchin Town,8,0,2,6,9,20,-11,2,England - Southern Central,0.0,0.25,-11,1.12,2.5,0.25,0.0,4.0,13
Lowestoft,8,0,1,7,8,27,-19,1,England - Southern Central,0.0,0.12,-19,1.0,3.38,0.12,0.0,8.33,14
Flora,8,7,0,1,20,6,14,21,Estonia - Meistriliiga,0.88,0.88,14,2.5,0.75,2.62,1.14,1.14,1
Nomme Kalju,8,7,0,1,19,6,13,21,Estonia - Meistriliiga,0.88,0.88,13,2.38,0.75,2.62,1.14,1.14,1
Narva Trans,8,6,0,2,22,11,11,18,Estonia - Meistriliiga,0.75,0.75,11,2.75,1.38,2.25,1.33,1.33,2
Levadia,8,4,1,3,19,8,11,13,Estonia - Meistriliiga,0.5,0.62,11,2.38,1.0,1.62,2.0,1.61,3
Vaprus,8,3,1,4,10,14,-4,10,Estonia - Meistriliiga,0.38,0.5,-4,1.25,1.75,1.25,2.63,2.0,4
Kuressaare,8,3,1,4,8,12,-4,10,Estonia - Meistriliiga,0.38,0.5,-4,1.0,1.5,1.25,2.63,2.0,4
Paide,8,2,2,4,8,9,-1,8,Estonia - Meistriliiga,0.25,0.5,-1,1.0,1.12,1.0,4.0,2.0,5
Harju JK,8,2,1,5,12,17,-5,7,Estonia - Meistriliiga,0.25,0.38,-5,1.5,2.12,0.88,4.0,2.63,6
Tammeka,8,2,0,6,9,18,-9,6,Estonia - Meistriliiga,0.25,0.25,-9,1.12,2.25,0.75,4.0,4.0,7
Tallinna Kalev,8,1,0,7,5,31,-26,3,Estonia - Meistriliiga,0.12,0.12,-26,0.62,3.88,0.38,8.33,8.33,8
Tartu Welco,8,6,2,0,19,8,11,20,Estonia - Esiliiga,0.75,1.0,11,2.38,1.0,2.5,1.33,1.0,1
Nomme Utd,8,6,1,1,22,7,15,19,Estonia - Esiliiga,0.75,0.88,15,2.75,0.88,2.38,1.33,1.14,2
Viimsi,8,6,1,1,19,6,13,19,Estonia - Esiliiga,0.75,0.88,13,2.38,0.75,2.38,1.33,1.14,2
Elva,8,3,4,1,14,11,3,13,Estonia - Esiliiga,0.38,0.88,3,1.75,1.38,1.62,2.63,1.14,3
Flora B,8,3,3,2,22,11,11,12,Estonia - Esiliiga,0.38,0.75,11,2.75,1.38,1.5,2.63,1.33,4
FC Tallinn,8,3,3,2,17,13,4,12,Estonia - Esiliiga,0.38,0.75,4,2.12,1.62,1.5,2.63,1.33,4
Tallinna K. B,8,1,3,4,15,21,-6,6,Estonia - Esiliiga,0.12,0.5,-6,1.88,2.62,0.75,8.33,2.0,5
Levadia B,8,1,3,4,8,15,-7,6,Estonia - Esiliiga,0.12,0.5,-7,1.0,1.88,0.75,8.33,2.0,5
Tammeka B,8,1,0,7,12,35,-23,3,Estonia - Esiliiga,0.12,0.12,-23,1.5,4.38,0.38,8.33,8.33,6
Nomme Kalju B,8,0,1,7,8,28,-20,1,Estonia - Esiliiga,0.0,0.12,-20,1.0,3.5,0.12,0.0,8.33,7
Klaksvik,8,7,1,0,31,4,27,22,FaroeIslands - Premier League,0.88,1.0,27,3.88,0.5,2.75,1.14,1.0,1
NSI Runavik,8,5,0,3,29,12,17,15,FaroeIslands - Premier League,0.62,0.62,17,3.62,1.5,1.88,1.61,1.61,2
Vikingur,8,5,0,3,13,8,5,15,FaroeIslands - Premier League,0.62,0.62,5,1.62,1.0,1.88,1.61,1.61,2
B36 Torshavn,8,4,2,2,13,10,3,14,FaroeIslands - Premier League,0.5,0.75,3,1.62,1.25,1.75,2.0,1.33,3
HB Torshavn,8,4,1,3,14,19,-5,13,FaroeIslands - Premier League,0.5,0.62,-5,1.75,2.38,1.62,2.0,1.61,4
Streymur,8,4,1,3,7,12,-5,13,FaroeIslands - Premier League,0.5,0.62,-5,0.88,1.5,1.62,2.0,1.61,4
B68 Toftir,8,3,2,3,11,10,1,11,FaroeIslands - Premier League,0.38,0.62,1,1.38,1.25,1.38,2.63,1.61,5
07 Vestur,8,2,0,6,12,12,0,6,FaroeIslands - Premier League,0.25,0.25,0,1.5,1.5,0.75,4.0,4.0,6
TB Tvoroyri,8,1,1,6,7,34,-27,4,FaroeIslands - Premier League,0.12,0.25,-27,0.88,4.25,0.5,8.33,4.0,7
Suduroy,8,1,0,7,6,22,-16,3,FaroeIslands - Premier League,0.12,0.12,-16,0.75,2.75,0.38,8.33,8.33,8
Skala,8,8,0,0,29,3,26,24,FaroeIslands - 1. Deild,1.0,1.0,26,3.62,0.38,3.0,1.0,1.0,1
AB Argir,8,7,0,1,19,7,12,21,FaroeIslands - 1. Deild,0.88,0.88,12,2.38,0.88,2.62,1.14,1.14,2
B71 Sandur,8,6,0,2,15,12,3,18,FaroeIslands - 1. Deild,0.75,0.75,3,1.88,1.5,2.25,1.33,1.33,3
IF Fuglafjordur,8,4,0,4,18,17,1,12,FaroeIslands - 1. Deild,0.5,0.5,1,2.25,2.12,1.5,2.0,2.0,4
NSI Runavik B,8,3,0,5,12,13,-1,9,FaroeIslands - 1. Deild,0.38,0.38,-1,1.5,1.62,1.12,2.63,2.63,5
Klaksvik B,8,3,0,5,13,19,-6,9,FaroeIslands - 1. Deild,0.38,0.38,-6,1.62,2.38,1.12,2.63,2.63,5
Vikingur B,8,2,1,5,14,17,-3,7,FaroeIslands - 1. Deild,0.25,0.38,-3,1.75,2.12,0.88,4.0,2.63,6
Streymur B,8,2,1,5,9,23,-14,7,FaroeIslands - 1. Deild,0.25,0.38,-14,1.12,2.88,0.88,4.0,2.63,6
07 Vestur B,8,1,1,6,10,17,-7,4,FaroeIslands - 1. Deild,0.12,0.25,-7,1.25,2.12,0.5,8.33,4.0,7
B36 Torshavn B,8,0,3,5,8,22,-14,3,FaroeIslands - 1. Deild,0.0,0.38,-14,1.0,2.75,0.38,0.0,2.63,8
Inter Turku,8,6,2,0,17,5,12,20,Finland - Veikkausliiga,0.75,1.0,12,2.12,0.62,2.5,1.33,1.0,1
HJK Helsinki,8,5,2,1,19,6,13,17,Finland - Veikkausliiga,0.62,0.88,13,2.38,0.75,2.12,1.61,1.14,2
KuPS,8,5,1,2,13,8,5,16,Finland - Veikkausliiga,0.62,0.75,5,1.62,1.0,2.0,1.61,1.33,3
Ilves,8,4,1,3,16,9,7,13,Finland - Veikkausliiga,0.5,0.62,7,2.0,1.12,1.62,2.0,1.61,4
VPS,8,3,2,3,10,11,-1,11,Finland - Veikkausliiga,0.38,0.62,-1,1.25,1.38,1.38,2.63,1.61,5
Gnistan,8,3,2,3,10,12,-2,11,Finland - Veikkausliiga,0.38,0.62,-2,1.25,1.5,1.38,2.63,1.61,5
Haka,8,2,2,4,9,12,-3,8,Finland - Veikkausliiga,0.25,0.5,-3,1.12,1.5,1.0,4.0,2.0,6
Mariehamn,8,2,2,4,10,18,-8,8,Finland - Veikkausliiga,0.25,0.5,-8,1.25,2.25,1.0,4.0,2.0,6
SJK,8,1,3,4,13,16,-3,6,Finland - Veikkausliiga,0.12,0.5,-3,1.62,2.0,0.75,8.33,2.0,7
KTP,8,1,3,4,9,21,-12,6,Finland - Veikkausliiga,0.12,0.5,-12,1.12,2.62,0.75,8.33,2.0,7
Oulu,8,1,2,5,10,16,-6,5,Finland - Veikkausliiga,0.12,0.38,-6,1.25,2.0,0.62,8.33,2.63,8
Jaro,8,1,2,5,5,11,-6,5,Finland - Veikkausliiga,0.12,0.38,-6,0.62,1.38,0.62,8.33,2.63,8
TPS,8,6,1,1,22,11,11,19,Finland - Ykkosliga,0.75,0.88,11,2.75,1.38,2.38,1.33,1.14,1
Lahti,8,6,1,1,15,8,7,19,Finland - Ykkosliga,0.75,0.88,7,1.88,1.0,2.38,1.33,1.14,1
Klubi-04,8,5,1,2,22,14,8,16,Finland - Ykkosliga,0.62,0.75,8,2.75,1.75,2.0,1.61,1.33,2
Ekenas IF,8,4,1,3,12,11,1,13,Finland - Ykkosliga,0.5,0.62,1,1.5,1.38,1.62,2.0,1.61,3
PK-35,8,3,3,2,13,9,4,12,Finland - Ykkosliga,0.38,0.75,4,1.62,1.12,1.5,2.63,1.33,4
SJK Akatemia,8,2,3,3,10,8,2,9,Finland - Ykkosliga,0.25,0.62,2,1.25,1.0,1.12,4.0,1.61,5
JIPPO,8,1,4,3,9,13,-4,7,Finland - Ykkosliga,0.12,0.62,-4,1.12,1.62,0.88,8.33,1.61,6
KaPa,8,1,2,5,11,25,-14,5,Finland - Ykkosliga,0.12,0.38,-14,1.38,3.12,0.62,8.33,2.63,7
JaPS,8,0,4,4,8,19,-11,4,Finland - Ykkosliga,0.0,0.5,-11,1.0,2.38,0.5,0.0,2.0,8
SalPa,8,0,2,6,4,12,-8,2,Finland - Ykkosliga,0.0,0.25,-8,0.5,1.5,0.25,0.0,4.0,9
Tampere Utd,8,5,1,2,13,12,1,16,Finland - Ykkonen,0.62,0.75,1,1.62,1.5,2.0,1.61,1.33,1
OLS Oulu,8,4,2,2,19,11,8,14,Finland - Ykkonen,0.5,0.75,8,2.38,1.38,1.75,2.0,1.33,2
Jazz Pori,8,4,1,3,12,12,0,13,Finland - Ykkonen,0.5,0.62,0,1.5,1.5,1.62,2.0,1.61,3
Inter Turku B,8,4,0,4,22,17,5,12,Finland - Ykkonen,0.5,0.5,5,2.75,2.12,1.5,2.0,2.0,4
EPS,8,4,0,4,11,14,-3,12,Finland - Ykkonen,0.5,0.5,-3,1.38,1.75,1.5,2.0,2.0,4
JJK,8,3,2,3,16,10,6,11,Finland - Ykkonen,0.38,0.62,6,2.0,1.25,1.38,2.63,1.61,5
Mikkelin,8,3,2,3,12,8,4,11,Finland - Ykkonen,0.38,0.62,4,1.5,1.0,1.38,2.63,1.61,5
PKKU,8,3,2,3,16,17,-1,11,Finland - Ykkonen,0.38,0.62,-1,2.0,2.12,1.38,2.63,1.61,5
KPV Kokkola,8,3,2,3,9,10,-1,11,Finland - Ykkonen,0.38,0.62,-1,1.12,1.25,1.38,2.63,1.61,5
KuPS Ak.,8,3,1,4,16,18,-2,10,Finland - Ykkonen,0.38,0.5,-2,2.0,2.25,1.25,2.63,2.0,6
Rovaniemi,8,3,1,4,10,15,-5,10,Finland - Ykkonen,0.38,0.5,-5,1.25,1.88,1.25,2.63,2.0,6
Atlantis,8,2,0,6,9,21,-12,6,Finland - Ykkonen,0.25,0.25,-12,1.12,2.62,0.75,4.0,4.0,7
Honka,8,7,0,1,38,7,31,21,Finland - Kakkonen Group A,0.88,0.88,31,4.75,0.88,2.62,1.14,1.14,1
VJS,8,7,0,1,29,9,20,21,Finland - Kakkonen Group A,0.88,0.88,20,3.62,1.12,2.62,1.14,1.14,1
GrIFK,8,4,1,3,19,13,6,13,Finland - Kakkonen Group A,0.5,0.62,6,2.38,1.62,1.62,2.0,1.61,2
PEPO,8,4,1,3,13,16,-3,13,Finland - Kakkonen Group A,0.5,0.62,-3,1.62,2.0,1.62,2.0,1.61,2
Reipas,8,3,1,4,17,18,-1,10,Finland - Kakkonen Group A,0.38,0.5,-1,2.12,2.25,1.25,2.63,2.0,3
MYPA,8,3,1,4,19,21,-2,10,Finland - Kakkonen Group A,0.38,0.5,-2,2.38,2.62,1.25,2.63,2.0,3
PuiU Helsinki,8,3,1,4,11,16,-5,10,Finland - Kakkonen Group A,0.38,0.5,-5,1.38,2.0,1.25,2.63,2.0,3
Vaajakoski,7,2,1,4,12,17,-5,7,Finland - Kakkonen Group A,0.29,0.43,-5,1.71,2.43,1.0,3.45,2.33,4
HaPK,8,1,2,5,6,29,-23,5,Finland - Kakkonen Group A,0.12,0.38,-23,0.75,3.62,0.62,8.33,2.63,5
JPS,7,1,0,6,9,27,-18,3,Finland - Kakkonen Group A,0.14,0.14,-18,1.29,3.86,0.43,7.14,7.14,6
TPV,8,6,1,1,21,10,11,19,Finland - Kakkonen Group B,0.75,0.88,11,2.62,1.25,2.38,1.33,1.14,1
Ilves B,8,5,2,1,26,12,14,17,Finland - Kakkonen Group B,0.62,0.88,14,3.25,1.5,2.12,1.61,1.14,2
MuSa,7,4,1,2,16,8,8,13,Finland - Kakkonen Group B,0.57,0.71,8,2.29,1.14,1.86,1.75,1.41,3
P-Iirot,7,4,0,3,14,9,5,12,Finland - Kakkonen Group B,0.57,0.57,5,2.0,1.29,1.71,1.75,1.75,4
Kiffen,8,4,0,4,16,14,2,12,Finland - Kakkonen Group B,0.5,0.5,2,2.0,1.75,1.5,2.0,2.0,4
HJS,8,2,4,2,15,12,3,10,Finland - Kakkonen Group B,0.25,0.75,3,1.88,1.5,1.25,4.0,1.33,5
PPJ,8,3,1,4,18,20,-2,10,Finland - Kakkonen Group B,0.38,0.5,-2,2.25,2.5,1.25,2.63,2.0,5
HPS,8,3,0,5,10,15,-5,9,Finland - Kakkonen Group B,0.38,0.38,-5,1.25,1.88,1.12,2.63,2.63,6
NJS,8,1,2,5,9,25,-16,5,Finland - Kakkonen Group B,0.12,0.38,-16,1.12,3.12,0.62,8.33,2.63,7
Atlantis B,8,1,1,6,10,30,-20,4,Finland - Kakkonen Group B,0.12,0.25,-20,1.25,3.75,0.5,8.33,4.0,8
VPS B,8,6,1,1,26,7,19,19,Finland - Kakkonen Group C,0.75,0.88,19,3.25,0.88,2.38,1.33,1.14,1
TP-47,8,5,2,1,19,17,2,17,Finland - Kakkonen Group C,0.62,0.88,2,2.38,2.12,2.12,1.61,1.14,2
OsPa,8,5,1,2,22,14,8,16,Finland - Kakkonen Group C,0.62,0.75,8,2.75,1.75,2.0,1.61,1.33,3
GBK Kokkola,8,4,1,3,12,17,-5,13,Finland - Kakkonen Group C,0.5,0.62,-5,1.5,2.12,1.62,2.0,1.61,4
SJK Akatemia B,8,4,0,4,23,22,1,12,Finland - Kakkonen Group C,0.5,0.5,1,2.88,2.75,1.5,2.0,2.0,5
JS Hercules,8,4,0,4,17,18,-1,12,Finland - Kakkonen Group C,0.5,0.5,-1,2.12,2.25,1.5,2.0,2.0,5
JBK,7,3,1,3,12,10,2,10,Finland - Kakkonen Group C,0.43,0.57,2,1.71,1.43,1.43,2.33,1.75,6
VIFK,8,1,2,5,15,19,-4,5,Finland - Kakkonen Group C,0.12,0.38,-4,1.88,2.38,0.62,8.33,2.63,7
Narpes Kraft,7,1,1,5,11,16,-5,4,Finland - Kakkonen Group C,0.14,0.29,-5,1.57,2.29,0.57,7.14,3.45,8
Kuopion Elo,6,0,1,5,10,27,-17,1,Finland - Kakkonen Group C,0.0,0.17,-17,1.67,4.5,0.17,0.0,5.88,9
Paris SG,8,5,1,2,19,10,9,16,France - Ligue 1,0.62,0.75,9,2.38,1.25,2.0,1.61,1.33,1
Marseille,8,5,1,2,21,14,7,16,France - Ligue 1,0.62,0.75,7,2.62,1.75,2.0,1.61,1.33,1
Lille,8,5,1,2,12,8,4,16,France - Ligue 1,0.62,0.75,4,1.5,1.0,2.0,1.61,1.33,1
Strasbourg,8,4,2,2,15,11,4,14,France - Ligue 1,0.5,0.75,4,1.88,1.38,1.75,2.0,1.33,2
Monaco,8,4,2,2,12,9,3,14,France - Ligue 1,0.5,0.75,3,1.5,1.12,1.75,2.0,1.33,2
Nice,8,4,1,3,16,10,6,13,France - Ligue 1,0.5,0.62,6,2.0,1.25,1.62,2.0,1.61,3
Lens,8,4,1,3,11,10,1,13,France - Ligue 1,0.5,0.62,1,1.38,1.25,1.62,2.0,1.61,3
Le Havre,8,4,1,3,14,16,-2,13,France - Ligue 1,0.5,0.62,-2,1.75,2.0,1.62,2.0,1.61,3
Brest,8,4,1,3,14,19,-5,13,France - Ligue 1,0.5,0.62,-5,1.75,2.38,1.62,2.0,1.61,3
Rennes,8,4,0,4,16,13,3,12,France - Ligue 1,0.5,0.5,3,2.0,1.62,1.5,2.0,2.0,4
Lyon,8,4,0,4,15,13,2,12,France - Ligue 1,0.5,0.5,2,1.88,1.62,1.5,2.0,2.0,4
Reims,8,3,1,4,7,7,0,10,France - Ligue 1,0.38,0.5,0,0.88,0.88,1.25,2.63,2.0,5
Auxerre,8,3,1,4,11,12,-1,10,France - Ligue 1,0.38,0.5,-1,1.38,1.5,1.25,2.63,2.0,5
Nantes,8,2,3,3,10,9,1,9,France - Ligue 1,0.25,0.62,1,1.25,1.12,1.12,4.0,1.61,6
Angers,8,3,0,5,6,11,-5,9,France - Ligue 1,0.38,0.38,-5,0.75,1.38,1.12,2.63,2.63,6
Toulouse,8,2,2,4,11,14,-3,8,France - Ligue 1,0.25,0.5,-3,1.38,1.75,1.0,4.0,2.0,7
Saint-Etienne,8,2,1,5,12,20,-8,7,France - Ligue 1,0.25,0.38,-8,1.5,2.5,0.88,4.0,2.63,8
Montpellier,8,0,1,7,2,18,-16,1,France - Ligue 1,0.0,0.12,-16,0.25,2.25,0.12,0.0,8.33,9
Lorient,8,6,1,1,23,5,18,19,France - Ligue 2,0.75,0.88,18,2.88,0.62,2.38,1.33,1.14,1
Paris FC,8,5,2,1,13,8,5,17,France - Ligue 2,0.62,0.88,5,1.62,1.0,2.12,1.61,1.14,2
Metz,8,4,3,1,20,15,5,15,France - Ligue 2,0.5,0.88,5,2.5,1.88,1.88,2.0,1.14,3
Guingamp,8,4,1,3,14,12,2,13,France - Ligue 2,0.5,0.62,2,1.75,1.5,1.62,2.0,1.61,4
Amiens,8,4,1,3,12,10,2,13,France - Ligue 2,0.5,0.62,2,1.5,1.25,1.62,2.0,1.61,4
Annecy,8,3,3,2,10,7,3,12,France - Ligue 2,0.38,0.75,3,1.25,0.88,1.5,2.63,1.33,5
SC Bastia,8,3,2,3,14,14,0,11,France - Ligue 2,0.38,0.62,0,1.75,1.75,1.38,2.63,1.61,6
Troyes,8,3,2,3,8,8,0,11,France - Ligue 2,0.38,0.62,0,1.0,1.0,1.38,2.63,1.61,6
AC Ajaccio,8,3,2,3,7,10,-3,11,France - Ligue 2,0.38,0.62,-3,0.88,1.25,1.38,2.63,1.61,6
Grenoble,8,3,1,4,11,13,-2,10,France - Ligue 2,0.38,0.5,-2,1.38,1.62,1.25,2.63,2.0,7
Laval,8,3,1,4,11,13,-2,10,France - Ligue 2,0.38,0.5,-2,1.38,1.62,1.25,2.63,2.0,7
Rodez Aveyron,8,1,6,1,11,11,0,9,France - Ligue 2,0.12,0.88,0,1.38,1.38,1.12,8.33,1.14,8
Pau FC,8,2,3,3,11,18,-7,9,France - Ligue 2,0.25,0.62,-7,1.38,2.25,1.12,4.0,1.61,8
USL Dunkerque,8,2,2,4,8,9,-1,8,France - Ligue 2,0.25,0.5,-1,1.0,1.12,1.0,4.0,2.0,9
Clermont,8,1,5,2,8,11,-3,8,France - Ligue 2,0.12,0.75,-3,1.0,1.38,1.0,8.33,1.33,9
Martigues,8,2,2,4,11,15,-4,8,France - Ligue 2,0.25,0.5,-4,1.38,1.88,1.0,4.0,2.0,9
Red Star,8,0,6,2,9,11,-2,6,France - Ligue 2,0.0,0.75,-2,1.12,1.38,0.75,0.0,1.33,10
Caen,8,0,3,5,9,20,-11,3,France - Ligue 2,0.0,0.38,-11,1.12,2.5,0.38,0.0,2.63,11
Nancy,8,6,2,0,18,7,11,20,France - National,0.75,1.0,11,2.25,0.88,2.5,1.33,1.0,1
Le Mans,8,4,2,2,14,11,3,14,France - National,0.5,0.75,3,1.75,1.38,1.75,2.0,1.33,2
Bourg-en-Bresse,8,4,2,2,8,7,1,14,France - National,0.5,0.75,1,1.0,0.88,1.75,2.0,1.33,2
Concarneau,8,3,4,1,15,8,7,13,France - National,0.38,0.88,7,1.88,1.0,1.62,2.63,1.14,3
Boulogne,8,3,3,2,13,10,3,12,France - National,0.38,0.75,3,1.62,1.25,1.5,2.63,1.33,4
Aubagne,8,3,2,3,13,12,1,11,France - National,0.38,0.62,1,1.62,1.5,1.38,2.63,1.61,5
Paris 13 A.,8,2,5,1,11,10,1,11,France - National,0.25,0.88,1,1.38,1.25,1.38,4.0,1.14,5
Dijon,8,3,2,3,11,12,-1,11,France - National,0.38,0.62,-1,1.38,1.5,1.38,2.63,1.61,5
Quevilly Rouen,8,3,2,3,6,10,-4,11,France - National,0.38,0.62,-4,0.75,1.25,1.38,2.63,1.61,5
Rouen,8,2,4,2,11,11,0,10,France - National,0.25,0.75,0,1.38,1.38,1.25,4.0,1.33,6
Versailles,8,2,3,3,11,10,1,9,France - National,0.25,0.62,1,1.38,1.25,1.12,4.0,1.61,7
Chateauroux,8,2,3,3,13,16,-3,9,France - National,0.25,0.62,-3,1.62,2.0,1.12,4.0,1.61,7
Sochaux,8,2,2,4,6,8,-2,8,France - National,0.25,0.5,-2,0.75,1.0,1.0,4.0,2.0,8
Orleans,8,2,2,4,6,10,-4,8,France - National,0.25,0.5,-4,0.75,1.25,1.0,4.0,2.0,8
Valenciennes,8,1,2,5,10,12,-2,5,France - National,0.12,0.38,-2,1.25,1.5,0.62,8.33,2.63,9
Villefranche,8,0,5,3,5,9,-4,5,France - National,0.0,0.62,-4,0.62,1.12,0.62,0.0,1.61,9
Nimes,8,1,1,6,5,17,-12,4,France - National,0.12,0.25,-12,0.62,2.12,0.5,8.33,4.0,10
Iberia,8,6,2,0,14,7,7,20,Georgia - Erovnuli Liga,0.75,1.0,7,1.75,0.88,2.5,1.33,1.0,1
Dila Gori,8,6,0,2,16,9,7,18,Georgia - Erovnuli Liga,0.75,0.75,7,2.0,1.12,2.25,1.33,1.33,2
Torpedo Kutaisi,8,5,0,3,8,7,1,15,Georgia - Erovnuli Liga,0.62,0.62,1,1.0,0.88,1.88,1.61,1.61,3
Dinamo Tbilisi,8,4,2,2,11,6,5,14,Georgia - Erovnuli Liga,0.5,0.75,5,1.38,0.75,1.75,2.0,1.33,4
Gareji Sagarejo,8,3,4,1,12,7,5,13,Georgia - Erovnuli Liga,0.38,0.88,5,1.5,0.88,1.62,2.63,1.14,5
Gagra,8,2,4,2,10,9,1,10,Georgia - Erovnuli Liga,0.25,0.75,1,1.25,1.12,1.25,4.0,1.33,6
Dinamo Batumi,8,2,2,4,8,13,-5,8,Georgia - Erovnuli Liga,0.25,0.5,-5,1.0,1.62,1.0,4.0,2.0,7
Samgurali,8,2,1,5,11,12,-1,7,Georgia - Erovnuli Liga,0.25,0.38,-1,1.38,1.5,0.88,4.0,2.63,8
Kolkheti Poti,8,1,2,5,7,16,-9,5,Georgia - Erovnuli Liga,0.12,0.38,-9,0.88,2.0,0.62,8.33,2.63,9
Telavi,8,0,1,7,6,17,-11,1,Georgia - Erovnuli Liga,0.0,0.12,-11,0.75,2.12,0.12,0.0,8.33,10
Spaeri,8,5,2,1,10,1,9,17,Georgia - Erovnuli Liga 2,0.62,0.88,9,1.25,0.12,2.12,1.61,1.14,1
Meshakhte,8,4,3,1,8,2,6,15,Georgia - Erovnuli Liga 2,0.5,0.88,6,1.0,0.25,1.88,2.0,1.14,2
Iberia B,8,4,2,2,11,7,4,14,Georgia - Erovnuli Liga 2,0.5,0.75,4,1.38,0.88,1.75,2.0,1.33,3
Merani Martvili,8,4,1,3,8,12,-4,13,Georgia - Erovnuli Liga 2,0.5,0.62,-4,1.0,1.5,1.62,2.0,1.61,4
Rustavi,8,3,3,2,7,6,1,12,Georgia - Erovnuli Liga 2,0.38,0.75,1,0.88,0.75,1.5,2.63,1.33,5
L. Tbilisi,8,3,2,3,8,7,1,11,Georgia - Erovnuli Liga 2,0.38,0.62,1,1.0,0.88,1.38,2.63,1.61,6
Gonio,8,3,1,4,9,12,-3,10,Georgia - Erovnuli Liga 2,0.38,0.5,-3,1.12,1.5,1.25,2.63,2.0,7
Bolnisi,8,1,6,1,6,5,1,9,Georgia - Erovnuli Liga 2,0.12,0.88,1,0.75,0.62,1.12,8.33,1.14,8
Samtredia,8,1,3,4,6,9,-3,6,Georgia - Erovnuli Liga 2,0.12,0.5,-3,0.75,1.12,0.75,8.33,2.0,9
D. Tbilisi B,8,0,1,7,5,17,-12,1,Georgia - Erovnuli Liga 2,0.0,0.12,-12,0.62,2.12,0.12,0.0,8.33,10
Dortmund,8,7,1,0,26,10,16,22,Germany - Bundesliga,0.88,1.0,16,3.25,1.25,2.75,1.14,1.0,1
Bayern Munich,8,6,2,0,24,8,16,20,Germany - Bundesliga,0.75,1.0,16,3.0,1.0,2.5,1.33,1.0,2
Werder Bremen,8,5,3,0,14,4,10,18,Germany - Bundesliga,0.62,1.0,10,1.75,0.5,2.25,1.61,1.0,3
E. Frankfurt,8,4,3,1,14,6,8,15,Germany - Bundesliga,0.5,0.88,8,1.75,0.75,1.88,2.0,1.14,4
Stuttgart,8,4,1,3,17,10,7,13,Germany - Bundesliga,0.5,0.62,7,2.12,1.25,1.62,2.0,1.61,5
Leverkusen,8,3,4,1,13,10,3,13,Germany - Bundesliga,0.38,0.88,3,1.62,1.25,1.62,2.63,1.14,5
Union Berlin,8,3,4,1,12,12,0,13,Germany - Bundesliga,0.38,0.88,0,1.5,1.5,1.62,2.63,1.14,5
Freiburg,8,4,1,3,13,15,-2,13,Germany - Bundesliga,0.5,0.62,-2,1.62,1.88,1.62,2.0,1.61,5
Heidenheim,8,3,1,4,6,12,-6,10,Germany - Bundesliga,0.38,0.5,-6,0.75,1.5,1.25,2.63,2.0,6
RB Leipzig,8,2,3,3,12,15,-3,9,Germany - Bundesliga,0.25,0.62,-3,1.5,1.88,1.12,4.0,1.61,7
Holstein Kiel,8,2,2,4,11,16,-5,8,Germany - Bundesliga,0.25,0.5,-5,1.38,2.0,1.0,4.0,2.0,8
Sankt Pauli,8,1,4,3,8,11,-3,7,Germany - Bundesliga,0.12,0.62,-3,1.0,1.38,0.88,8.33,1.61,9
FSV Mainz,8,1,4,3,11,15,-4,7,Germany - Bundesliga,0.12,0.62,-4,1.38,1.88,0.88,8.33,1.61,9
Hoffenheim,8,1,3,4,14,20,-6,6,Germany - Bundesliga,0.12,0.5,-6,1.75,2.5,0.75,8.33,2.0,10
Monchengladbach,8,1,2,5,12,17,-5,5,Germany - Bundesliga,0.12,0.38,-5,1.5,2.12,0.62,8.33,2.63,11
Wolfsburg,8,1,2,5,7,14,-7,5,Germany - Bundesliga,0.12,0.38,-7,0.88,1.75,0.62,8.33,2.63,11
Bochum,8,1,2,5,6,15,-9,5,Germany - Bundesliga,0.12,0.38,-9,0.75,1.88,0.62,8.33,2.63,11
FC Augsburg,8,1,2,5,6,16,-10,5,Germany - Bundesliga,0.12,0.38,-10,0.75,2.0,0.62,8.33,2.63,11
Elversberg,8,5,3,0,19,5,14,18,Germany - 2. Bundesliga,0.62,1.0,14,2.38,0.62,2.25,1.61,1.0,1
Karlsruher SC,8,4,3,1,13,9,4,15,Germany - 2. Bundesliga,0.5,0.88,4,1.62,1.12,1.88,2.0,1.14,2
Hertha Berlin,8,4,3,1,11,8,3,15,Germany - 2. Bundesliga,0.5,0.88,3,1.38,1.0,1.88,2.0,1.14,2
FC Koln,8,4,2,2,13,7,6,14,Germany - 2. Bundesliga,0.5,0.75,6,1.62,0.88,1.75,2.0,1.33,3
Hamburger SV,8,3,3,2,21,12,9,12,Germany - 2. Bundesliga,0.38,0.75,9,2.62,1.5,1.5,2.63,1.33,4
Dusseldorf,8,3,3,2,14,14,0,12,Germany - 2. Bundesliga,0.38,0.75,0,1.75,1.75,1.5,2.63,1.33,4
Braunschweig,8,3,3,2,14,15,-1,12,Germany - 2. Bundesliga,0.38,0.75,-1,1.75,1.88,1.5,2.63,1.33,4
Magdeburg,8,3,2,3,11,11,0,11,Germany - 2. Bundesliga,0.38,0.62,0,1.38,1.38,1.38,2.63,1.61,5
Darmstadt,8,3,2,3,11,12,-1,11,Germany - 2. Bundesliga,0.38,0.62,-1,1.38,1.5,1.38,2.63,1.61,5
Preuss. Munster,8,2,4,2,13,9,4,10,Germany - 2. Bundesliga,0.25,0.75,4,1.62,1.12,1.25,4.0,1.33,6
Paderborn,8,3,1,4,12,14,-2,10,Germany - 2. Bundesliga,0.38,0.5,-2,1.5,1.75,1.25,2.63,2.0,6
Ulm,8,3,1,4,11,16,-5,10,Germany - 2. Bundesliga,0.38,0.5,-5,1.38,2.0,1.25,2.63,2.0,6
Kaiserslautern,8,3,1,4,10,15,-5,10,Germany - 2. Bundesliga,0.38,0.5,-5,1.25,1.88,1.25,2.63,2.0,6
Hannover 96,8,2,3,3,7,10,-3,9,Germany - 2. Bundesliga,0.25,0.62,-3,0.88,1.25,1.12,4.0,1.61,7
Regensburg,8,2,3,3,9,17,-8,9,Germany - 2. Bundesliga,0.25,0.62,-8,1.12,2.12,1.12,4.0,1.61,7
FC Nurnberg,8,2,1,5,14,18,-4,7,Germany - 2. Bundesliga,0.25,0.38,-4,1.75,2.25,0.88,4.0,2.63,8
Schalke 04,8,1,2,5,9,16,-7,5,Germany - 2. Bundesliga,0.12,0.38,-7,1.12,2.0,0.62,8.33,2.63,9
Greuther Furth,8,0,4,4,8,12,-4,4,Germany - 2. Bundesliga,0.0,0.5,-4,1.0,1.5,0.5,0.0,2.0,10
Bielefeld,8,7,1,0,18,4,14,22,Germany - 3. Liga,0.88,1.0,14,2.25,0.5,2.75,1.14,1.0,1
RW Essen,8,6,1,1,16,9,7,19,Germany - 3. Liga,0.75,0.88,7,2.0,1.12,2.38,1.33,1.14,2
Viktoria Koln,8,5,0,3,13,7,6,15,Germany - 3. Liga,0.62,0.62,6,1.62,0.88,1.88,1.61,1.61,3
Hansa Rostock,8,5,0,3,13,9,4,15,Germany - 3. Liga,0.62,0.62,4,1.62,1.12,1.88,1.61,1.61,3
1860 Munchen,8,4,2,2,16,9,7,14,Germany - 3. Liga,0.5,0.75,7,2.0,1.12,1.75,2.0,1.33,4
Dynamo Dresden,8,4,2,2,15,9,6,14,Germany - 3. Liga,0.5,0.75,6,1.88,1.12,1.75,2.0,1.33,4
Wehen Wiesbaden,8,4,2,2,17,14,3,14,Germany - 3. Liga,0.5,0.75,3,2.12,1.75,1.75,2.0,1.33,4
Saarbrucken,8,4,2,2,16,14,2,14,Germany - 3. Liga,0.5,0.75,2,2.0,1.75,1.75,2.0,1.33,4
Verl,8,3,2,3,17,14,3,11,Germany - 3. Liga,0.38,0.62,3,2.12,1.75,1.38,2.63,1.61,5
Hannover 96 B,8,2,4,2,13,11,2,10,Germany - 3. Liga,0.25,0.75,2,1.62,1.38,1.25,4.0,1.33,6
Alemannia A.,8,3,1,4,11,11,0,10,Germany - 3. Liga,0.38,0.5,0,1.38,1.38,1.25,2.63,2.0,6
VfB Stuttgart B,8,2,4,2,9,9,0,10,Germany - 3. Liga,0.25,0.75,0,1.12,1.12,1.25,4.0,1.33,6
Osnabruck,8,3,1,4,6,9,-3,10,Germany - 3. Liga,0.38,0.5,-3,0.75,1.12,1.25,2.63,2.0,6
Erzgebirge Aue,8,3,1,4,11,17,-6,10,Germany - 3. Liga,0.38,0.5,-6,1.38,2.12,1.25,2.63,2.0,6
Mannheim,8,2,3,3,8,11,-3,9,Germany - 3. Liga,0.25,0.62,-3,1.0,1.38,1.12,4.0,1.61,7
Dortmund B,8,2,1,5,12,17,-5,7,Germany - 3. Liga,0.25,0.38,-5,1.5,2.12,0.88,4.0,2.63,8
Energie Cottbus,8,2,1,5,10,20,-10,7,Germany - 3. Liga,0.25,0.38,-10,1.25,2.5,0.88,4.0,2.63,8
FC Ingolstadt,8,1,3,4,14,17,-3,6,Germany - 3. Liga,0.12,0.5,-3,1.75,2.12,0.75,8.33,2.0,9
Unterhaching,8,1,3,4,6,13,-7,6,Germany - 3. Liga,0.12,0.5,-7,0.75,1.62,0.75,8.33,2.0,9
Sandhausen,8,1,0,7,6,20,-14,3,Germany - 3. Liga,0.12,0.12,-14,0.75,2.5,0.38,8.33,8.33,10
Heart of Lions,8,6,1,1,12,6,6,19,Ghana - Premier League,0.75,0.88,6,1.5,0.75,2.38,1.33,1.14,1
Nations,8,6,0,2,14,4,10,18,Ghana - Premier League,0.75,0.75,10,1.75,0.5,2.25,1.33,1.33,2
Hearts of Oak,8,5,2,1,10,3,7,17,Ghana - Premier League,0.62,0.88,7,1.25,0.38,2.12,1.61,1.14,3
Bibiani GS,8,5,1,2,13,5,8,16,Ghana - Premier League,0.62,0.75,8,1.62,0.62,2.0,1.61,1.33,4
Vision,8,5,1,2,13,6,7,16,Ghana - Premier League,0.62,0.75,7,1.62,0.75,2.0,1.61,1.33,4
Dreams,8,5,1,2,14,8,6,16,Ghana - Premier League,0.62,0.75,6,1.75,1.0,2.0,1.61,1.33,4
Aduana Stars,8,5,0,3,19,11,8,15,Ghana - Premier League,0.62,0.62,8,2.38,1.38,1.88,1.61,1.61,5
Karela,8,4,1,3,11,6,5,13,Ghana - Premier League,0.5,0.62,5,1.38,0.75,1.62,2.0,1.61,6
Samartex,8,4,1,3,11,9,2,13,Ghana - Premier League,0.5,0.62,2,1.38,1.12,1.62,2.0,1.61,6
Asante Kotoko,8,3,2,3,9,11,-2,11,Ghana - Premier League,0.38,0.62,-2,1.12,1.38,1.38,2.63,1.61,7
Young Apostles,8,3,1,4,8,12,-4,10,Ghana - Premier League,0.38,0.5,-4,1.0,1.5,1.25,2.63,2.0,8
Medeama,8,3,0,5,13,11,2,9,Ghana - Premier League,0.38,0.38,2,1.62,1.38,1.12,2.63,2.63,9
Berekum Chelsea,8,3,0,5,10,12,-2,9,Ghana - Premier League,0.38,0.38,-2,1.25,1.5,1.12,2.63,2.63,9
Accra Lions,8,3,0,5,12,16,-4,9,Ghana - Premier League,0.38,0.38,-4,1.5,2.0,1.12,2.63,2.63,9
Holy Stars,8,2,2,4,4,10,-6,8,Ghana - Premier League,0.25,0.5,-6,0.5,1.25,1.0,4.0,2.0,10
Bechem Utd,8,2,1,5,5,10,-5,7,Ghana - Premier League,0.25,0.38,-5,0.62,1.25,0.88,4.0,2.63,11
Legon Cities,8,1,0,7,5,17,-12,3,Ghana - Premier League,0.12,0.12,-12,0.62,2.12,0.38,8.33,8.33,12
Nsoatreman,8,0,0,8,0,24,-24,0,Ghana - Premier League,0.0,0.0,-24,0.0,3.0,0.0,0.0,0.0,13
St Josephs,8,7,0,1,24,4,20,21,Gibraltar - Premier Division,0.88,0.88,20,3.0,0.5,2.62,1.14,1.14,1
Lincoln RI,8,7,0,1,18,3,15,21,Gibraltar - Premier Division,0.88,0.88,15,2.25,0.38,2.62,1.14,1.14,1
Europa FC,8,5,0,3,18,12,6,15,Gibraltar - Premier Division,0.62,0.62,6,2.25,1.5,1.88,1.61,1.61,2
Manchester 62,8,4,1,3,16,7,9,13,Gibraltar - Premier Division,0.5,0.62,9,2.0,0.88,1.62,2.0,1.61,3
Magpies,8,4,0,4,16,13,3,12,Gibraltar - Premier Division,0.5,0.5,3,2.0,1.62,1.5,2.0,2.0,4
College 1975,8,3,1,4,13,13,0,10,Gibraltar - Premier Division,0.38,0.5,0,1.62,1.62,1.25,2.63,2.0,5
Lynx,8,3,1,4,10,22,-12,10,Gibraltar - Premier Division,0.38,0.5,-12,1.25,2.75,1.25,2.63,2.0,5
Glacis Utd,8,2,0,6,13,24,-11,6,Gibraltar - Premier Division,0.25,0.25,-11,1.62,3.0,0.75,4.0,4.0,6
Europa Point,8,0,2,6,7,28,-21,2,Gibraltar - Premier Division,0.0,0.25,-21,0.88,3.5,0.25,0.0,4.0,7
Mons Calpe,8,0,1,7,7,25,-18,1,Gibraltar - Premier Division,0.0,0.12,-18,0.88,3.12,0.12,0.0,8.33,8
Lions FC,8,0,1,7,3,22,-19,1,Gibraltar - Premier Division,0.0,0.12,-19,0.38,2.75,0.12,0.0,8.33,8
Olympiakos,8,7,0,1,15,6,9,21,Greece - Super League,0.88,0.88,9,1.88,0.75,2.62,1.14,1.14,1
Levadiakos,8,5,1,2,15,8,7,16,Greece - Super League,0.62,0.75,7,1.88,1.0,2.0,1.61,1.33,2
Volos,8,5,0,3,15,9,6,15,Greece - Super League,0.62,0.62,6,1.88,1.12,1.88,1.61,1.61,3
Aris,8,4,3,1,9,6,3,15,Greece - Super League,0.5,0.88,3,1.12,0.75,1.88,2.0,1.14,3
PAOK,8,5,0,3,14,13,1,15,Greece - Super League,0.62,0.62,1,1.75,1.62,1.88,1.61,1.61,3
Panaitolikos,8,4,2,2,8,7,1,14,Greece - Super League,0.5,0.75,1,1.0,0.88,1.75,2.0,1.33,4
Panathinaikos,8,4,1,3,14,11,3,13,Greece - Super League,0.5,0.62,3,1.75,1.38,1.62,2.0,1.61,5
Atromitos,8,4,1,3,9,8,1,13,Greece - Super League,0.5,0.62,1,1.12,1.0,1.62,2.0,1.61,5
OFI Crete,8,4,0,4,13,14,-1,12,Greece - Super League,0.5,0.5,-1,1.62,1.75,1.5,2.0,2.0,6
A. Kallithea,8,3,2,3,9,11,-2,11,Greece - Super League,0.38,0.62,-2,1.12,1.38,1.38,2.63,1.61,7
Asteras T.,8,3,1,4,7,11,-4,10,Greece - Super League,0.38,0.5,-4,0.88,1.38,1.25,2.63,2.0,8
Panserraikos,8,2,2,4,9,10,-1,8,Greece - Super League,0.25,0.5,-1,1.12,1.25,1.0,4.0,2.0,9
Lamia,8,1,1,6,6,17,-11,4,Greece - Super League,0.12,0.25,-11,0.75,2.12,0.5,8.33,4.0,10
AEK Athens,8,0,1,7,4,13,-9,1,Greece - Super League,0.0,0.12,-9,0.5,1.62,0.12,0.0,8.33,11
Malacateco,8,6,0,2,15,5,10,18,Guatemala - Liga Nacional - Apertura,0.75,0.75,10,1.88,0.62,2.25,1.33,1.33,1
Xelaju,8,5,2,1,16,5,11,17,Guatemala - Liga Nacional - Apertura,0.62,0.88,11,2.0,0.62,2.12,1.61,1.14,2
Municipal,8,4,2,2,13,13,0,14,Guatemala - Liga Nacional - Apertura,0.5,0.75,0,1.62,1.62,1.75,2.0,1.33,3
Coban Imperial,8,4,1,3,13,9,4,13,Guatemala - Liga Nacional - Apertura,0.5,0.62,4,1.62,1.12,1.62,2.0,1.61,4
Antigua GFC,8,3,3,2,14,11,3,12,Guatemala - Liga Nacional - Apertura,0.38,0.75,3,1.75,1.38,1.5,2.63,1.33,5
Xinabajul,8,3,2,3,15,14,1,11,Guatemala - Liga Nacional - Apertura,0.38,0.62,1,1.88,1.75,1.38,2.63,1.61,6
Comunicaciones,8,3,2,3,12,13,-1,11,Guatemala - Liga Nacional - Apertura,0.38,0.62,-1,1.5,1.62,1.38,2.63,1.61,6
Guastatoya,8,2,4,2,12,10,2,10,Guatemala - Liga Nacional - Apertura,0.25,0.75,2,1.5,1.25,1.25,4.0,1.33,7
Mixco,8,3,1,4,7,11,-4,10,Guatemala - Liga Nacional - Apertura,0.38,0.5,-4,0.88,1.38,1.25,2.63,2.0,7
Achuapa,8,2,3,3,6,10,-4,9,Guatemala - Liga Nacional - Apertura,0.25,0.62,-4,0.75,1.25,1.12,4.0,1.61,8
Marquense,8,0,3,5,4,16,-12,3,Guatemala - Liga Nacional - Apertura,0.0,0.38,-12,0.5,2.0,0.38,0.0,2.63,9
Zacapa Tellioz,8,0,2,6,3,14,-11,2,Guatemala - Liga Nacional - Apertura,0.0,0.25,-11,0.38,1.75,0.25,0.0,4.0,10
Municipal,8,3,2,3,8,6,2,11,guatemala2,0.38,0.62,2,1.0,0.75,1.38,2.63,1.61,1
Guastatoya,8,3,2,3,9,10,-1,11,guatemala2,0.38,0.62,-1,1.12,1.25,1.38,2.63,1.61,1
Comunicaciones,8,2,3,3,10,11,-1,9,guatemala2,0.25,0.62,-1,1.25,1.38,1.12,4.0,1.61,2
Antigua GFC,8,2,3,3,5,7,-2,9,guatemala2,0.25,0.62,-2,0.62,0.88,1.12,4.0,1.61,2
Mixco,8,1,5,2,7,8,-1,8,guatemala2,0.12,0.75,-1,0.88,1.0,1.0,8.33,1.33,3
Coban Imperial,8,2,0,6,10,16,-6,6,guatemala2,0.25,0.25,-6,1.25,2.0,0.75,4.0,4.0,4
Malacateco,8,1,2,5,10,16,-6,5,guatemala2,0.12,0.38,-6,1.25,2.0,0.62,8.33,2.63,5
Marquense,8,1,2,5,3,9,-6,5,guatemala2,0.12,0.38,-6,0.38,1.12,0.62,8.33,2.63,5
Xinabajul,8,1,1,6,6,18,-12,4,guatemala2,0.12,0.25,-12,0.75,2.25,0.5,8.33,4.0,6
Xelaju,8,0,3,5,5,10,-5,3,guatemala2,0.0,0.38,-5,0.62,1.25,0.38,0.0,2.63,7
Achuapa,8,1,0,7,6,12,-6,3,guatemala2,0.12,0.12,-6,0.75,1.5,0.38,8.33,8.33,7
Olimpia,8,6,2,0,16,4,12,20,Honduras - Liga Nacional - Apertura,0.75,1.0,12,2.0,0.5,2.5,1.33,1.0,1
Genesis,8,4,3,1,16,8,8,15,Honduras - Liga Nacional - Apertura,0.5,0.88,8,2.0,1.0,1.88,2.0,1.14,2
Motagua,8,4,2,2,18,14,4,14,Honduras - Liga Nacional - Apertura,0.5,0.75,4,2.25,1.75,1.75,2.0,1.33,3
Olancho,8,3,4,1,15,10,5,13,Honduras - Liga Nacional - Apertura,0.38,0.88,5,1.88,1.25,1.62,2.63,1.14,4
Marathon,8,2,4,2,9,8,1,10,Honduras - Liga Nacional - Apertura,0.25,0.75,1,1.12,1.0,1.25,4.0,1.33,5
Juticalpa,8,2,2,4,7,14,-7,8,Honduras - Liga Nacional - Apertura,0.25,0.5,-7,0.88,1.75,1.0,4.0,2.0,6
UPNFM,8,2,2,4,6,16,-10,8,Honduras - Liga Nacional - Apertura,0.25,0.5,-10,0.75,2.0,1.0,4.0,2.0,6
Real Espana,8,1,4,3,6,7,-1,7,Honduras - Liga Nacional - Apertura,0.12,0.62,-1,0.75,0.88,0.88,8.33,1.61,7
Real Sociedad,8,1,3,4,10,17,-7,6,Honduras - Liga Nacional - Apertura,0.12,0.5,-7,1.25,2.12,0.75,8.33,2.0,8
Victoria,8,1,2,5,13,18,-5,5,Honduras - Liga Nacional - Apertura,0.12,0.38,-5,1.62,2.25,0.62,8.33,2.63,9
Marathon,8,4,3,1,12,6,6,15,honduras2,0.5,0.88,6,1.5,0.75,1.88,2.0,1.14,1
Olimpia,8,4,2,2,12,7,5,14,honduras2,0.5,0.75,5,1.5,0.88,1.75,2.0,1.33,2
Real Espana,8,3,3,2,11,9,2,12,honduras2,0.38,0.75,2,1.38,1.12,1.5,2.63,1.33,3
Victoria,8,2,4,2,12,11,1,10,honduras2,0.25,0.75,1,1.5,1.38,1.25,4.0,1.33,4
Motagua,8,2,4,2,9,8,1,10,honduras2,0.25,0.75,1,1.12,1.0,1.25,4.0,1.33,4
Olancho,8,1,3,4,8,12,-4,6,honduras2,0.12,0.5,-4,1.0,1.5,0.75,8.33,2.0,5
Genesis,8,1,3,4,4,12,-8,6,honduras2,0.12,0.5,-8,0.5,1.5,0.75,8.33,2.0,5
Juticalpa,8,1,2,5,3,15,-12,5,honduras2,0.12,0.38,-12,0.38,1.88,0.62,8.33,2.63,6
Real Sociedad,8,0,4,4,5,11,-6,4,honduras2,0.0,0.5,-6,0.62,1.38,0.5,0.0,2.0,7
UPNFM,8,0,3,5,7,17,-10,3,honduras2,0.0,0.38,-10,0.88,2.12,0.38,0.0,2.63,8
LM Warriors,8,6,0,2,19,12,7,18,Hong Kong - Premier League,0.75,0.75,7,2.38,1.5,2.25,1.33,1.33,1
Tai Po,8,5,2,1,23,15,8,17,Hong Kong - Premier League,0.62,0.88,8,2.88,1.88,2.12,1.61,1.14,2
Eastern,8,4,3,1,17,9,8,15,Hong Kong - Premier League,0.5,0.88,8,2.12,1.12,1.88,2.0,1.14,3
Southern D.,8,4,2,2,14,11,3,14,Hong Kong - Premier League,0.5,0.75,3,1.75,1.38,1.75,2.0,1.33,4
North District,8,4,0,4,14,16,-2,12,Hong Kong - Premier League,0.5,0.5,-2,1.75,2.0,1.5,2.0,2.0,5
HK Rangers,8,3,1,4,15,12,3,10,Hong Kong - Premier League,0.38,0.5,3,1.88,1.5,1.25,2.63,2.0,6
Kitchee,8,3,1,4,9,11,-2,10,Hong Kong - Premier League,0.38,0.5,-2,1.12,1.38,1.25,2.63,2.0,6
Kowloon City,8,1,0,7,13,27,-14,3,Hong Kong - Premier League,0.12,0.12,-14,1.62,3.38,0.38,8.33,8.33,7
Hong Kong FC,8,0,1,7,9,24,-15,1,Hong Kong - Premier League,0.0,0.12,-15,1.12,3.0,0.12,0.0,8.33,8
Ferencvaros,8,7,1,0,23,6,17,22,Hungary - NB I,0.88,1.0,17,2.88,0.75,2.75,1.14,1.0,1
Gyor,8,5,2,1,14,7,7,17,Hungary - NB I,0.62,0.88,7,1.75,0.88,2.12,1.61,1.14,2
Puskas A.,8,4,3,1,16,12,4,15,Hungary - NB I,0.5,0.88,4,2.0,1.5,1.88,2.0,1.14,3
Paks,8,3,3,2,11,9,2,12,Hungary - NB I,0.38,0.75,2,1.38,1.12,1.5,2.63,1.33,4
Nyiregyhaza,8,3,3,2,7,13,-6,12,Hungary - NB I,0.38,0.75,-6,0.88,1.62,1.5,2.63,1.33,4
Debrecen,8,3,2,3,14,11,3,11,Hungary - NB I,0.38,0.62,3,1.75,1.38,1.38,2.63,1.61,5
Ujpest,8,2,4,2,10,10,0,10,Hungary - NB I,0.25,0.75,0,1.25,1.25,1.25,4.0,1.33,6
Zalaegerszegi,8,1,5,2,6,7,-1,8,Hungary - NB I,0.12,0.75,-1,0.75,0.88,1.0,8.33,1.33,7
DVTK,8,2,2,4,12,17,-5,8,Hungary - NB I,0.25,0.5,-5,1.5,2.12,1.0,4.0,2.0,7
MTK Budapest,8,1,3,4,9,13,-4,6,Hungary - NB I,0.12,0.5,-4,1.12,1.62,0.75,8.33,2.0,8
Kecskemeti TE,8,0,5,3,6,9,-3,5,Hungary - NB I,0.0,0.62,-3,0.75,1.12,0.62,0.0,1.61,9
Fehervar,8,0,1,7,2,16,-14,1,Hungary - NB I,0.0,0.12,-14,0.25,2.0,0.12,0.0,8.33,10
Mezokovesd,8,5,2,1,16,8,8,17,Hungary - NB II,0.62,0.88,8,2.0,1.0,2.12,1.61,1.14,1
Honved,8,4,3,1,12,5,7,15,Hungary - NB II,0.5,0.88,7,1.5,0.62,1.88,2.0,1.14,2
Vasas,8,4,1,3,12,10,2,13,Hungary - NB II,0.5,0.62,2,1.5,1.25,1.62,2.0,1.61,3
Kisvarda,8,3,4,1,13,13,0,13,Hungary - NB II,0.38,0.88,0,1.62,1.62,1.62,2.63,1.14,3
Szentlorinc,8,3,3,2,15,11,4,12,Hungary - NB II,0.38,0.75,4,1.88,1.38,1.5,2.63,1.33,4
Soroksar,8,3,3,2,14,12,2,12,Hungary - NB II,0.38,0.75,2,1.75,1.5,1.5,2.63,1.33,4
Kazincbarcika,8,3,3,2,10,11,-1,12,Hungary - NB II,0.38,0.75,-1,1.25,1.38,1.5,2.63,1.33,4
Budafoki,8,3,2,3,15,13,2,11,Hungary - NB II,0.38,0.62,2,1.88,1.62,1.38,2.63,1.61,5
Szeged,8,3,2,3,11,11,0,11,Hungary - NB II,0.38,0.62,0,1.38,1.38,1.38,2.63,1.61,5
Kozarmisleny,8,3,2,3,11,12,-1,11,Hungary - NB II,0.38,0.62,-1,1.38,1.5,1.38,2.63,1.61,5
BVSC,8,2,4,2,13,12,1,10,Hungary - NB II,0.25,0.75,1,1.62,1.5,1.25,4.0,1.33,6
Bekescsaba,8,2,3,3,10,13,-3,9,Hungary - NB II,0.25,0.62,-3,1.25,1.62,1.12,4.0,1.61,7
Ajka,8,1,5,2,3,4,-1,8,Hungary - NB II,0.12,0.75,-1,0.38,0.5,1.0,8.33,1.33,8
Csakvari,8,2,1,5,9,16,-7,7,Hungary - NB II,0.25,0.38,-7,1.12,2.0,0.88,4.0,2.63,9
Gyirmot,8,1,2,5,9,11,-2,5,Hungary - NB II,0.12,0.38,-2,1.12,1.38,0.62,8.33,2.63,10
Tatabanya,8,0,4,4,7,18,-11,4,Hungary - NB II,0.0,0.5,-11,0.88,2.25,0.5,0.0,2.0,11
Valur,8,5,1,2,18,9,9,16,Iceland - Besta deild,0.62,0.75,9,2.25,1.12,2.0,1.61,1.33,1
Breidablik,8,5,1,2,13,12,1,16,Iceland - Besta deild,0.62,0.75,1,1.62,1.5,2.0,1.61,1.33,1
Vikingur R.,8,4,2,2,13,11,2,14,Iceland - Besta deild,0.5,0.75,2,1.62,1.38,1.75,2.0,1.33,2
IBV,8,4,1,3,12,13,-1,13,Iceland - Besta deild,0.5,0.62,-1,1.5,1.62,1.62,2.0,1.61,3
Vestri,8,4,0,4,10,6,4,12,Iceland - Besta deild,0.5,0.5,4,1.25,0.75,1.5,2.0,2.0,4
KR Reykjavik,8,3,2,3,23,18,5,11,Iceland - Besta deild,0.38,0.62,5,2.88,2.25,1.38,2.63,1.61,5
Hafnarfjordur,8,3,2,3,14,11,3,11,Iceland - Besta deild,0.38,0.62,3,1.75,1.38,1.38,2.63,1.61,5
KA Akureyri,8,3,2,3,8,11,-3,11,Iceland - Besta deild,0.38,0.62,-3,1.0,1.38,1.38,2.63,1.61,5
Afturelding,8,3,1,4,8,11,-3,10,Iceland - Besta deild,0.38,0.5,-3,1.0,1.38,1.25,2.63,2.0,6
Fram,8,3,0,5,12,14,-2,9,Iceland - Besta deild,0.38,0.38,-2,1.5,1.75,1.12,2.63,2.63,7
Stjarnan,8,2,2,4,13,16,-3,8,Iceland - Besta deild,0.25,0.5,-3,1.62,2.0,1.0,4.0,2.0,8
IA Akranes,8,2,0,6,10,22,-12,6,Iceland - Besta deild,0.25,0.25,-12,1.25,2.75,0.75,4.0,4.0,9
IR Reykjavik,7,4,3,0,11,4,7,15,Iceland - 1. Deild,0.57,1.0,7,1.57,0.57,2.14,1.75,1.0,1
Njardvik,6,3,3,0,15,5,10,12,Iceland - 1. Deild,0.5,1.0,10,2.5,0.83,2.0,2.0,1.0,2
Volsungur,8,4,0,4,13,17,-4,12,Iceland - 1. Deild,0.5,0.5,-4,1.62,2.12,1.5,2.0,2.0,2
HK Kopavogur,7,3,2,2,12,8,4,11,Iceland - 1. Deild,0.43,0.71,4,1.71,1.14,1.57,2.33,1.41,3
Thor Akureyri,8,3,2,3,18,17,1,11,Iceland - 1. Deild,0.38,0.62,1,2.25,2.12,1.38,2.63,1.61,3
Grindavik,6,3,1,2,19,14,5,10,Iceland - 1. Deild,0.5,0.67,5,3.17,2.33,1.67,2.0,1.49,4
Throttur R.,6,3,1,2,11,9,2,10,Iceland - 1. Deild,0.5,0.67,2,1.83,1.5,1.67,2.0,1.49,4
Keflavik,5,3,0,2,13,7,6,9,Iceland - 1. Deild,0.6,0.6,6,2.6,1.4,1.8,1.67,1.67,5
Leiknir R.,7,2,1,4,9,20,-11,7,Iceland - 1. Deild,0.29,0.43,-11,1.29,2.86,1.0,3.45,2.33,6
Selfoss,7,2,0,5,6,15,-9,6,Iceland - 1. Deild,0.29,0.29,-9,0.86,2.14,0.86,3.45,3.45,7
Fylkir,6,1,2,3,7,10,-3,5,Iceland - 1. Deild,0.17,0.5,-3,1.17,1.67,0.83,5.88,2.0,8
Fjolnir,7,0,3,4,7,15,-8,3,Iceland - 1. Deild,0.0,0.43,-8,1.0,2.14,0.43,0.0,2.33,9
Aeggir,7,5,1,1,16,8,8,16,Iceland - 2. Deild,0.71,0.86,8,2.29,1.14,2.29,1.41,1.16,1
Throttur Vogar,7,5,0,2,11,6,5,15,Iceland - 2. Deild,0.71,0.71,5,1.57,0.86,2.14,1.41,1.41,2
Grotta,7,4,2,1,12,7,5,14,Iceland - 2. Deild,0.57,0.86,5,1.71,1.0,2.0,1.75,1.16,3
Haukar,7,4,2,1,12,8,4,14,Iceland - 2. Deild,0.57,0.86,4,1.71,1.14,2.0,1.75,1.16,3
Dalvik/Reynir,7,3,1,3,8,5,3,10,Iceland - 2. Deild,0.43,0.57,3,1.14,0.71,1.43,2.33,1.75,4
V. Olafsvik,7,2,3,2,12,9,3,9,Iceland - 2. Deild,0.29,0.71,3,1.71,1.29,1.29,3.45,1.41,5
Kormakur/Hvot,7,3,0,4,7,14,-7,9,Iceland - 2. Deild,0.43,0.43,-7,1.0,2.0,1.29,2.33,2.33,5
KFA,7,2,2,3,15,12,3,8,Iceland - 2. Deild,0.29,0.57,3,2.14,1.71,1.14,3.45,1.75,6
Vidir,7,2,2,3,8,9,-1,8,Iceland - 2. Deild,0.29,0.57,-1,1.14,1.29,1.14,3.45,1.75,6
KFG,7,2,1,4,11,14,-3,7,Iceland - 2. Deild,0.29,0.43,-3,1.57,2.0,1.0,3.45,2.33,7
Kari,7,2,0,5,7,12,-5,6,Iceland - 2. Deild,0.29,0.29,-5,1.0,1.71,0.86,3.45,3.45,8
Hottur/Huginn,7,0,2,5,5,20,-15,2,Iceland - 2. Deild,0.0,0.29,-15,0.71,2.86,0.29,0.0,3.45,9
Mohun Bagan,8,6,2,0,16,2,14,20,India - Super League,0.75,1.0,14,2.0,0.25,2.5,1.33,1.0,1
Goa,8,6,0,2,13,7,6,18,India - Super League,0.75,0.75,6,1.62,0.88,2.25,1.33,1.33,2
NorthEast Utd,8,4,2,2,15,7,8,14,India - Super League,0.5,0.75,8,1.88,0.88,1.75,2.0,1.33,3
East Bengal,8,4,2,2,11,11,0,14,India - Super League,0.5,0.75,0,1.38,1.38,1.75,2.0,1.33,3
Mumbai City,8,3,3,2,10,6,4,12,India - Super League,0.38,0.75,4,1.25,0.75,1.5,2.63,1.33,4
Odisha FC,8,3,3,2,13,11,2,12,India - Super League,0.38,0.75,2,1.62,1.38,1.5,2.63,1.33,4
Bengaluru,8,3,1,4,11,10,1,10,India - Super League,0.38,0.5,1,1.38,1.25,1.25,2.63,2.0,5
Chennaiyin,8,3,1,4,11,12,-1,10,India - Super League,0.38,0.5,-1,1.38,1.5,1.25,2.63,2.0,5
Jamshedpur,8,3,1,4,12,16,-4,10,India - Super League,0.38,0.5,-4,1.5,2.0,1.25,2.63,2.0,5
Kerala Blasters,8,2,3,3,7,10,-3,9,India - Super League,0.25,0.62,-3,0.88,1.25,1.12,4.0,1.61,6
Punjab,8,2,2,4,11,15,-4,8,India - Super League,0.25,0.5,-4,1.38,1.88,1.0,4.0,2.0,7
Hyderabad,8,2,2,4,10,16,-6,8,India - Super League,0.25,0.5,-6,1.25,2.0,1.0,4.0,2.0,7
Mohammedan,8,0,2,6,4,19,-15,2,India - Super League,0.0,0.25,-15,0.5,2.38,0.25,0.0,4.0,8
Gokulam,8,6,0,2,23,14,9,18,India - I-League,0.75,0.75,9,2.88,1.75,2.25,1.33,1.33,1
Inter Kashi,8,4,3,1,14,11,3,15,India - I-League,0.5,0.88,3,1.75,1.38,1.88,2.0,1.14,2
Churchill B.,8,3,5,0,18,9,9,14,India - I-League,0.38,1.0,9,2.25,1.12,1.75,2.63,1.0,3
Real Kashmir,8,4,2,2,12,12,0,14,India - I-League,0.5,0.75,0,1.5,1.5,1.75,2.0,1.33,3
Rajasthan,8,4,0,4,16,13,3,12,India - I-League,0.5,0.5,3,2.0,1.62,1.5,2.0,2.0,4
Sreenidi Deccan,8,3,3,2,11,10,1,12,India - I-League,0.38,0.75,1,1.38,1.25,1.5,2.63,1.33,4
Dempo,8,3,2,3,24,17,7,11,India - I-League,0.38,0.62,7,3.0,2.12,1.38,2.63,1.61,5
Aizawl,8,3,2,3,16,15,1,11,India - I-League,0.38,0.62,1,2.0,1.88,1.38,2.63,1.61,5
SC Bengaluru,8,2,2,4,11,18,-7,8,India - I-League,0.25,0.5,-7,1.38,2.25,1.0,4.0,2.0,6
Namdhari,8,2,1,5,8,14,-6,7,India - I-League,0.25,0.38,-6,1.0,1.75,0.88,4.0,2.63,7
Shillong Lajong,8,1,3,4,12,23,-11,6,India - I-League,0.12,0.5,-11,1.5,2.88,0.75,8.33,2.0,8
Delhi FC,8,1,1,6,7,16,-9,4,India - I-League,0.12,0.25,-9,0.88,2.0,0.5,8.33,4.0,9
Borneo,8,5,3,0,16,9,7,18,Indonesia - Liga 1,0.62,1.0,7,2.0,1.12,2.25,1.61,1.0,1
Malut United,8,5,2,1,16,8,8,17,Indonesia - Liga 1,0.62,0.88,8,2.0,1.0,2.12,1.61,1.14,2
Persib,8,4,3,1,17,10,7,15,Indonesia - Liga 1,0.5,0.88,7,2.12,1.25,1.88,2.0,1.14,3
PSM,8,4,2,2,14,10,4,14,Indonesia - Liga 1,0.5,0.75,4,1.75,1.25,1.75,2.0,1.33,4
Semen Padang,8,4,2,2,12,11,1,14,Indonesia - Liga 1,0.5,0.75,1,1.5,1.38,1.75,2.0,1.33,4
PSBS Biak N.,8,4,2,2,11,11,0,14,Indonesia - Liga 1,0.5,0.75,0,1.38,1.38,1.75,2.0,1.33,4
Persis Solo,8,4,1,3,12,9,3,13,Indonesia - Liga 1,0.5,0.62,3,1.5,1.12,1.62,2.0,1.61,5
Dewa Utd,8,3,3,2,11,5,6,12,Indonesia - Liga 1,0.38,0.75,6,1.38,0.62,1.5,2.63,1.33,6
PSS Sleman,8,4,0,4,12,13,-1,12,Indonesia - Liga 1,0.5,0.5,-1,1.5,1.62,1.5,2.0,2.0,6
Madura Utd,8,4,0,4,9,10,-1,12,Indonesia - Liga 1,0.5,0.5,-1,1.12,1.25,1.5,2.0,2.0,6
Bali Utd,8,3,1,4,9,10,-1,10,Indonesia - Liga 1,0.38,0.5,-1,1.12,1.25,1.25,2.63,2.0,7
Persebaya S.,8,1,6,1,10,11,-1,9,Indonesia - Liga 1,0.12,0.88,-1,1.25,1.38,1.12,8.33,1.14,8
Persija,8,2,2,4,6,7,-1,8,Indonesia - Liga 1,0.25,0.5,-1,0.75,0.88,1.0,4.0,2.0,9
Arema,8,2,2,4,10,14,-4,8,Indonesia - Liga 1,0.25,0.5,-4,1.25,1.75,1.0,4.0,2.0,9
Persik Kediri,8,1,4,3,11,11,0,7,Indonesia - Liga 1,0.12,0.62,0,1.38,1.38,0.88,8.33,1.61,10
Persita,8,2,1,5,8,14,-6,7,Indonesia - Liga 1,0.25,0.38,-6,1.0,1.75,0.88,4.0,2.63,10
Barito Putera,8,1,2,5,9,16,-7,5,Indonesia - Liga 1,0.12,0.38,-7,1.12,2.0,0.62,8.33,2.63,11
PSIS Semarang,8,0,1,7,8,23,-15,1,Indonesia - Liga 1,0.0,0.12,-15,1.0,2.88,0.12,0.0,8.33,12
Tractor Sazi,8,6,2,0,20,8,12,20,Iran - Pro League,0.75,1.0,12,2.5,1.0,2.5,1.33,1.0,1
Persepolis,8,5,1,2,12,6,6,16,Iran - Pro League,0.62,0.75,6,1.5,0.75,2.0,1.61,1.33,2
Zob Ahan,8,4,3,1,13,7,6,15,Iran - Pro League,0.5,0.88,6,1.62,0.88,1.88,2.0,1.14,3
Sepahan,8,4,3,1,12,6,6,15,Iran - Pro League,0.5,0.88,6,1.5,0.75,1.88,2.0,1.14,3
Foolad,8,3,3,2,8,8,0,12,Iran - Pro League,0.38,0.75,0,1.0,1.0,1.5,2.63,1.33,4
Gol Gohar,8,3,3,2,7,7,0,12,Iran - Pro League,0.38,0.75,0,0.88,0.88,1.5,2.63,1.33,4
K. Khorramabad,8,2,4,2,5,6,-1,10,Iran - Pro League,0.25,0.75,-1,0.62,0.75,1.25,4.0,1.33,5
Havadar,8,2,4,2,8,11,-3,10,Iran - Pro League,0.25,0.75,-3,1.0,1.38,1.25,4.0,1.33,5
Malavan,8,2,3,3,11,12,-1,9,Iran - Pro League,0.25,0.62,-1,1.38,1.5,1.12,4.0,1.61,6
Shams A. Qazvin,8,2,2,4,8,14,-6,8,Iran - Pro League,0.25,0.5,-6,1.0,1.75,1.0,4.0,2.0,7
Esteghlal,8,1,4,3,11,11,0,7,Iran - Pro League,0.12,0.62,0,1.38,1.38,0.88,8.33,1.61,8
E. Khuzestan,8,1,4,3,5,7,-2,7,Iran - Pro League,0.12,0.62,-2,0.62,0.88,0.88,8.33,1.61,8
Chadormalu,8,1,4,3,5,8,-3,7,Iran - Pro League,0.12,0.62,-3,0.62,1.0,0.88,8.33,1.61,8
Aluminium Arak,8,1,4,3,6,11,-5,7,Iran - Pro League,0.12,0.62,-5,0.75,1.38,0.88,8.33,1.61,8
Mes Rafsanjan,8,1,3,4,5,9,-4,6,Iran - Pro League,0.12,0.5,-4,0.62,1.12,0.75,8.33,2.0,9
N. Mazandaran,8,0,4,4,4,11,-7,4,Iran - Pro League,0.0,0.5,-7,0.5,1.38,0.5,0.0,2.0,10
Shamrock Rovers,8,5,3,0,17,5,12,18,Ireland - Premier Division,0.62,1.0,12,2.12,0.62,2.25,1.61,1.0,1
Bohemians,8,6,0,2,11,7,4,18,Ireland - Premier Division,0.75,0.75,4,1.38,0.88,2.25,1.33,1.33,1
Waterford,8,4,2,2,12,11,1,14,Ireland - Premier Division,0.5,0.75,1,1.5,1.38,1.75,2.0,1.33,2
Derry City,8,4,1,3,11,7,4,13,Ireland - Premier Division,0.5,0.62,4,1.38,0.88,1.62,2.0,1.61,3
Drogheda Utd,8,2,4,2,10,12,-2,10,Ireland - Premier Division,0.25,0.75,-2,1.25,1.5,1.25,4.0,1.33,4
St. Patricks,8,3,1,4,10,13,-3,10,Ireland - Premier Division,0.38,0.5,-3,1.25,1.62,1.25,2.63,2.0,4
Shelbourne,8,2,3,3,8,10,-2,9,Ireland - Premier Division,0.25,0.62,-2,1.0,1.25,1.12,4.0,1.61,5
Galway Utd,8,2,2,4,7,10,-3,8,Ireland - Premier Division,0.25,0.5,-3,0.88,1.25,1.0,4.0,2.0,6
Cork City,8,1,3,4,11,14,-3,6,Ireland - Premier Division,0.12,0.5,-3,1.38,1.75,0.75,8.33,2.0,7
Sligo Rovers,8,1,2,5,6,13,-7,5,Ireland - Premier Division,0.12,0.38,-7,0.75,1.62,0.62,8.33,2.63,8
Cobh Ramblers,8,7,0,1,16,7,9,21,Ireland - First Division,0.88,0.88,9,2.0,0.88,2.62,1.14,1.14,1
Bray Wanderers,8,5,1,2,20,10,10,16,Ireland - First Division,0.62,0.75,10,2.5,1.25,2.0,1.61,1.33,2
Dundalk,8,4,4,0,14,7,7,16,Ireland - First Division,0.5,1.0,7,1.75,0.88,2.0,2.0,1.0,2
Treaty Utd,8,4,1,3,14,7,7,13,Ireland - First Division,0.5,0.62,7,1.75,0.88,1.62,2.0,1.61,3
Kerry,8,3,1,4,9,13,-4,10,Ireland - First Division,0.38,0.5,-4,1.12,1.62,1.25,2.63,2.0,4
UC Dublin,8,3,1,4,6,10,-4,10,Ireland - First Division,0.38,0.5,-4,0.75,1.25,1.25,2.63,2.0,4
Wexford,8,2,2,4,9,11,-2,8,Ireland - First Division,0.25,0.5,-2,1.12,1.38,1.0,4.0,2.0,5
Athlone Town,8,1,3,4,7,11,-4,6,Ireland - First Division,0.12,0.5,-4,0.88,1.38,0.75,8.33,2.0,6
Longford Town,8,1,3,4,5,17,-12,6,Ireland - First Division,0.12,0.5,-12,0.62,2.12,0.75,8.33,2.0,6
Finn Harps,8,1,2,5,8,15,-7,5,Ireland - First Division,0.12,0.38,-7,1.0,1.88,0.62,8.33,2.63,7
M. Tel Aviv,8,5,2,1,24,8,16,17,Israel - Ligat HaAl,0.62,0.88,16,3.0,1.0,2.12,1.61,1.14,1
H. Beer Sheva,8,5,2,1,20,7,13,17,Israel - Ligat HaAl,0.62,0.88,13,2.5,0.88,2.12,1.61,1.14,1
H. Jerusalem,8,5,2,1,17,7,10,17,Israel - Ligat HaAl,0.62,0.88,10,2.12,0.88,2.12,1.61,1.14,1
Ashdod,8,4,4,0,15,8,7,16,Israel - Ligat HaAl,0.5,1.0,7,1.88,1.0,2.0,2.0,1.0,2
Sakhnin,8,4,1,3,7,9,-2,13,Israel - Ligat HaAl,0.5,0.62,-2,0.88,1.12,1.62,2.0,1.61,3
Hapoel Haifa,8,3,2,3,12,14,-2,11,Israel - Ligat HaAl,0.38,0.62,-2,1.5,1.75,1.38,2.63,1.61,4
M. Bnei Raina,8,3,1,4,10,10,0,10,Israel - Ligat HaAl,0.38,0.5,0,1.25,1.25,1.25,2.63,2.0,5
Hapoel Hadera,8,3,1,4,10,16,-6,10,Israel - Ligat HaAl,0.38,0.5,-6,1.25,2.0,1.25,2.63,2.0,5
Maccabi Haifa,8,3,1,4,9,19,-10,10,Israel - Ligat HaAl,0.38,0.5,-10,1.12,2.38,1.25,2.63,2.0,5
M. Petah Tikva,8,2,3,3,9,8,1,9,Israel - Ligat HaAl,0.25,0.62,1,1.12,1.0,1.12,4.0,1.61,6
Ironi Tiberias,8,2,3,3,9,10,-1,9,Israel - Ligat HaAl,0.25,0.62,-1,1.12,1.25,1.12,4.0,1.61,6
Maccabi Netanya,8,2,2,4,12,18,-6,8,Israel - Ligat HaAl,0.25,0.5,-6,1.5,2.25,1.0,4.0,2.0,7
Kiryat Shmona,8,2,0,6,6,14,-8,6,Israel - Ligat HaAl,0.25,0.25,-8,0.75,1.75,0.75,4.0,4.0,8
B. Jerusalem,8,1,1,6,6,17,-11,4,Israel - Ligat HaAl,0.12,0.25,-11,0.75,2.12,0.5,8.33,4.0,9
H. Petah Tikva,8,6,2,0,13,1,12,20,Israel - Leumit League,0.75,1.0,12,1.62,0.12,2.5,1.33,1.0,1
Hapoel Tel Aviv,8,6,1,1,17,4,13,19,Israel - Leumit League,0.75,0.88,13,2.12,0.5,2.38,1.33,1.14,2
Hapoel Akko,8,5,1,2,15,10,5,16,Israel - Leumit League,0.62,0.75,5,1.88,1.25,2.0,1.61,1.33,3
H. Ramat Gan,8,5,0,3,14,8,6,15,Israel - Leumit League,0.62,0.62,6,1.75,1.0,1.88,1.61,1.61,4
Maccabi Jaffa,8,4,3,1,14,9,5,15,Israel - Leumit League,0.5,0.88,5,1.75,1.12,1.88,2.0,1.14,4
Ramat Hasharon,8,3,3,2,15,12,3,12,Israel - Leumit League,0.38,0.75,3,1.88,1.5,1.5,2.63,1.33,5
M. Herziliya,8,4,0,4,10,13,-3,12,Israel - Leumit League,0.5,0.5,-3,1.25,1.62,1.5,2.0,2.0,5
Kafr Qasim,8,3,2,3,7,9,-2,11,Israel - Leumit League,0.38,0.62,-2,0.88,1.12,1.38,2.63,1.61,6
H. Nof Hagalil,8,2,4,2,7,8,-1,10,Israel - Leumit League,0.25,0.75,-1,0.88,1.0,1.25,4.0,1.33,7
H. Ironi Rishon,8,2,3,3,12,13,-1,9,Israel - Leumit League,0.25,0.62,-1,1.5,1.62,1.12,4.0,1.61,8
Hapoel Raanana,8,2,3,3,8,9,-1,9,Israel - Leumit League,0.25,0.62,-1,1.0,1.12,1.12,4.0,1.61,8
Hapoel Afula,8,2,2,4,7,9,-2,8,Israel - Leumit League,0.25,0.5,-2,0.88,1.12,1.0,4.0,2.0,9
H. Kfar Saba,8,2,1,5,6,13,-7,7,Israel - Leumit League,0.25,0.38,-7,0.75,1.62,0.88,4.0,2.63,10
Bnei Yehuda,8,2,0,6,13,19,-6,6,Israel - Leumit League,0.25,0.25,-6,1.62,2.38,0.75,4.0,4.0,11
H. Umm al-Fahm,8,1,2,5,9,17,-8,5,Israel - Leumit League,0.12,0.38,-8,1.12,2.12,0.62,8.33,2.63,12
H. Kfar Shalem,8,1,1,6,3,16,-13,4,Israel - Leumit League,0.12,0.25,-13,0.38,2.0,0.5,8.33,4.0,13
Como,8,6,1,1,13,5,8,19,Italy - Serie A,0.75,0.88,8,1.62,0.62,2.38,1.33,1.14,1
Napoli,8,5,3,0,12,3,9,18,Italy - Serie A,0.62,1.0,9,1.5,0.38,2.25,1.61,1.0,2
AS Roma,8,5,2,1,11,5,6,17,Italy - Serie A,0.62,0.88,6,1.38,0.62,2.12,1.61,1.14,3
AC Milan,8,5,1,2,16,8,8,16,Italy - Serie A,0.62,0.75,8,2.0,1.0,2.0,1.61,1.33,4
Atalanta,8,5,1,2,15,8,7,16,Italy - Serie A,0.62,0.75,7,1.88,1.0,2.0,1.61,1.33,4
Juventus,8,4,3,1,12,7,5,15,Italy - Serie A,0.5,0.88,5,1.5,0.88,1.88,2.0,1.14,5
Inter Milan,8,4,2,2,12,7,5,14,Italy - Serie A,0.5,0.75,5,1.5,0.88,1.75,2.0,1.33,6
Fiorentina,8,4,2,2,13,11,2,14,Italy - Serie A,0.5,0.75,2,1.62,1.38,1.75,2.0,1.33,6
Lazio,8,3,4,1,10,7,3,13,Italy - Serie A,0.38,0.88,3,1.25,0.88,1.62,2.63,1.14,7
Parma,8,2,4,2,9,9,0,10,Italy - Serie A,0.25,0.75,0,1.12,1.12,1.25,4.0,1.33,8
Lecce,8,2,3,3,6,9,-3,9,Italy - Serie A,0.25,0.62,-3,0.75,1.12,1.12,4.0,1.61,9
Venezia,8,2,3,3,9,13,-4,9,Italy - Serie A,0.25,0.62,-4,1.12,1.62,1.12,4.0,1.61,9
Genoa,8,2,2,4,9,11,-2,8,Italy - Serie A,0.25,0.5,-2,1.12,1.38,1.0,4.0,2.0,10
Empoli,8,2,2,4,9,12,-3,8,Italy - Serie A,0.25,0.5,-3,1.12,1.5,1.0,4.0,2.0,10
Cagliari,8,2,1,5,9,12,-3,7,Italy - Serie A,0.25,0.38,-3,1.12,1.5,0.88,4.0,2.63,11
Hellas Verona,8,1,4,3,5,8,-3,7,Italy - Serie A,0.12,0.62,-3,0.62,1.0,0.88,8.33,1.61,11
Bologna,8,1,3,4,7,13,-6,6,Italy - Serie A,0.12,0.5,-6,0.88,1.62,0.75,8.33,2.0,12
Torino,8,1,2,5,4,10,-6,5,Italy - Serie A,0.12,0.38,-6,0.5,1.25,0.62,8.33,2.63,13
Udinese,8,1,1,6,5,15,-10,4,Italy - Serie A,0.12,0.25,-10,0.62,1.88,0.5,8.33,4.0,14
Monza,8,1,0,7,4,17,-13,3,Italy - Serie A,0.12,0.12,-13,0.5,2.12,0.38,8.33,8.33,15
Pisa,8,5,1,2,14,8,6,16,Italy - Serie B,0.62,0.75,6,1.75,1.0,2.0,1.61,1.33,1
Mantova,8,4,2,2,13,10,3,14,Italy - Serie B,0.5,0.75,3,1.62,1.25,1.75,2.0,1.33,2
Sassuolo,8,4,1,3,16,11,5,13,Italy - Serie B,0.5,0.62,5,2.0,1.38,1.62,2.0,1.61,3
Palermo,8,4,1,3,16,12,4,13,Italy - Serie B,0.5,0.62,4,2.0,1.5,1.62,2.0,1.61,3
Cremonese,8,3,4,1,14,11,3,13,Italy - Serie B,0.38,0.88,3,1.75,1.38,1.62,2.63,1.14,3
Salernitana,8,4,0,4,10,8,2,12,Italy - Serie B,0.5,0.5,2,1.25,1.0,1.5,2.0,2.0,4
Sudtirol,8,3,3,2,11,10,1,12,Italy - Serie B,0.38,0.75,1,1.38,1.25,1.5,2.63,1.33,4
Brescia,8,3,3,2,9,8,1,12,Italy - Serie B,0.38,0.75,1,1.12,1.0,1.5,2.63,1.33,4
Juve Stabia,8,3,3,2,7,6,1,12,Italy - Serie B,0.38,0.75,1,0.88,0.75,1.5,2.63,1.33,4
Carrarese,8,3,3,2,9,9,0,12,Italy - Serie B,0.38,0.75,0,1.12,1.12,1.5,2.63,1.33,4
Reggiana,8,4,0,4,12,16,-4,12,Italy - Serie B,0.5,0.5,-4,1.5,2.0,1.5,2.0,2.0,4
Spezia,8,3,2,3,14,11,3,11,Italy - Serie B,0.38,0.62,3,1.75,1.38,1.38,2.63,1.61,5
Cesena,8,3,2,3,7,10,-3,11,Italy - Serie B,0.38,0.62,-3,0.88,1.25,1.38,2.63,1.61,5
Frosinone,8,2,4,2,10,9,1,10,Italy - Serie B,0.25,0.75,1,1.25,1.12,1.25,4.0,1.33,6
Modena,8,3,1,4,12,14,-2,10,Italy - Serie B,0.38,0.5,-2,1.5,1.75,1.25,2.63,2.0,6
Sampdoria,8,2,3,3,4,8,-4,9,Italy - Serie B,0.25,0.62,-4,0.5,1.0,1.12,4.0,1.61,7
Bari,8,2,2,4,9,12,-3,8,Italy - Serie B,0.25,0.5,-3,1.12,1.5,1.0,4.0,2.0,8
Catanzaro,8,1,4,3,11,14,-3,7,Italy - Serie B,0.12,0.62,-3,1.38,1.75,0.88,8.33,1.61,9
Cittadella,8,1,3,4,7,10,-3,6,Italy - Serie B,0.12,0.5,-3,0.88,1.25,0.75,8.33,2.0,10
Cosenza,8,1,2,5,7,15,-8,5,Italy - Serie B,0.12,0.38,-8,0.88,1.88,0.62,8.33,2.63,11
Renate,8,6,1,1,13,7,6,19,Italy - Serie C - Group A,0.75,0.88,6,1.62,0.88,2.38,1.33,1.14,1
FeralpiSalo,8,5,1,2,14,8,6,16,Italy - Serie C - Group A,0.62,0.75,6,1.75,1.0,2.0,1.61,1.33,2
AlbinoLeffe,8,5,1,2,14,10,4,16,Italy - Serie C - Group A,0.62,0.75,4,1.75,1.25,2.0,1.61,1.33,2
Vicenza,8,5,1,2,10,8,2,16,Italy - Serie C - Group A,0.62,0.75,2,1.25,1.0,2.0,1.61,1.33,2
Atalanta B,8,4,3,1,13,8,5,15,Italy - Serie C - Group A,0.5,0.88,5,1.62,1.0,1.88,2.0,1.14,3
Arzignano,8,5,0,3,10,6,4,15,Italy - Serie C - Group A,0.62,0.62,4,1.25,0.75,1.88,1.61,1.61,3
Giana Erminio,8,4,2,2,12,6,6,14,Italy - Serie C - Group A,0.5,0.75,6,1.5,0.75,1.75,2.0,1.33,4
Padova,8,4,2,2,11,9,2,14,Italy - Serie C - Group A,0.5,0.75,2,1.38,1.12,1.75,2.0,1.33,4
Trento,8,4,1,3,11,10,1,13,Italy - Serie C - Group A,0.5,0.62,1,1.38,1.25,1.62,2.0,1.61,5
Pro Patria,8,3,2,3,10,8,2,11,Italy - Serie C - Group A,0.38,0.62,2,1.25,1.0,1.38,2.63,1.61,6
Caldiero Terme,8,3,2,3,10,10,0,11,Italy - Serie C - Group A,0.38,0.62,0,1.25,1.25,1.38,2.63,1.61,6
Virtus Verona,8,2,4,2,8,8,0,10,Italy - Serie C - Group A,0.25,0.75,0,1.0,1.0,1.25,4.0,1.33,7
Novara,8,3,1,4,9,14,-5,10,Italy - Serie C - Group A,0.38,0.5,-5,1.12,1.75,1.25,2.63,2.0,7
Triestina,8,3,0,5,9,9,0,9,Italy - Serie C - Group A,0.38,0.38,0,1.12,1.12,1.12,2.63,2.63,8
Lecco,8,2,3,3,6,7,-1,9,Italy - Serie C - Group A,0.25,0.62,-1,0.75,0.88,1.12,4.0,1.61,8
Pergolettese,8,2,0,6,7,12,-5,6,Italy - Serie C - Group A,0.25,0.25,-5,0.88,1.5,0.75,4.0,4.0,9
Pro Vercelli,8,1,3,4,6,11,-5,6,Italy - Serie C - Group A,0.12,0.5,-5,0.75,1.38,0.75,8.33,2.0,9
Alcione,8,1,3,4,5,10,-5,6,Italy - Serie C - Group A,0.12,0.5,-5,0.62,1.25,0.75,8.33,2.0,9
Lumezzane,8,0,4,4,6,14,-8,4,Italy - Serie C - Group A,0.0,0.5,-8,0.75,1.75,0.5,0.0,2.0,10
Clodiense,8,1,0,7,8,17,-9,3,Italy - Serie C - Group A,0.12,0.12,-9,1.0,2.12,0.38,8.33,8.33,11
Entella,8,4,4,0,15,6,9,16,Italy - Serie C - Group B,0.5,1.0,9,1.88,0.75,2.0,2.0,1.0,1
Arezzo,8,5,0,3,12,7,5,15,Italy - Serie C - Group B,0.62,0.62,5,1.5,0.88,1.88,1.61,1.61,2
Perugia,8,4,2,2,12,7,5,14,Italy - Serie C - Group B,0.5,0.75,5,1.5,0.88,1.75,2.0,1.33,3
Lucchese,8,4,2,2,15,14,1,14,Italy - Serie C - Group B,0.5,0.75,1,1.88,1.75,1.75,2.0,1.33,3
Pescara,8,4,1,3,14,8,6,13,Italy - Serie C - Group B,0.5,0.62,6,1.75,1.0,1.62,2.0,1.61,4
Pontedera,8,3,3,2,13,10,3,12,Italy - Serie C - Group B,0.38,0.75,3,1.62,1.25,1.5,2.63,1.33,5
Pineto,8,3,3,2,10,14,-4,12,Italy - Serie C - Group B,0.38,0.75,-4,1.25,1.75,1.5,2.63,1.33,5
Torres,8,3,2,3,12,10,2,11,Italy - Serie C - Group B,0.38,0.62,2,1.5,1.25,1.38,2.63,1.61,6
Ternana,8,3,2,3,7,6,1,11,Italy - Serie C - Group B,0.38,0.62,1,0.88,0.75,1.38,2.63,1.61,6
AC Milan B,8,3,2,3,11,11,0,11,Italy - Serie C - Group B,0.38,0.62,0,1.38,1.38,1.38,2.63,1.61,6
Rimini,8,3,2,3,11,12,-1,11,Italy - Serie C - Group B,0.38,0.62,-1,1.38,1.5,1.38,2.63,1.61,6
Gubbio,8,3,2,3,7,10,-3,11,Italy - Serie C - Group B,0.38,0.62,-3,0.88,1.25,1.38,2.63,1.61,6
SPAL,8,2,4,2,9,9,0,10,Italy - Serie C - Group B,0.25,0.75,0,1.12,1.12,1.25,4.0,1.33,7
Campobasso,8,3,1,4,9,13,-4,10,Italy - Serie C - Group B,0.38,0.5,-4,1.12,1.62,1.25,2.63,2.0,7
Pianese,8,3,0,5,10,12,-2,9,Italy - Serie C - Group B,0.38,0.38,-2,1.25,1.5,1.12,2.63,2.63,8
Vis Pesaro,8,1,5,2,8,8,0,8,Italy - Serie C - Group B,0.12,0.75,0,1.0,1.0,1.0,8.33,1.33,9
Sestri Levante,8,2,2,4,10,14,-4,8,Italy - Serie C - Group B,0.25,0.5,-4,1.25,1.75,1.0,4.0,2.0,9
Athletic Carpi,8,2,2,4,6,11,-5,8,Italy - Serie C - Group B,0.25,0.5,-5,0.75,1.38,1.0,4.0,2.0,9
Ascoli,8,1,4,3,4,7,-3,7,Italy - Serie C - Group B,0.12,0.62,-3,0.5,0.88,0.88,8.33,1.61,10
Legnago Salus,8,1,3,4,7,13,-6,6,Italy - Serie C - Group B,0.12,0.5,-6,0.88,1.62,0.75,8.33,2.0,11
Avellino,8,8,0,0,13,4,9,24,Italy - Serie C - Group C,1.0,1.0,9,1.62,0.5,3.0,1.0,1.0,1
Catania,8,5,2,1,13,5,8,17,Italy - Serie C - Group C,0.62,0.88,8,1.62,0.62,2.12,1.61,1.14,2
Monopoli,8,4,2,2,9,6,3,14,Italy - Serie C - Group C,0.5,0.75,3,1.12,0.75,1.75,2.0,1.33,3
Crotone,8,4,2,2,14,12,2,14,Italy - Serie C - Group C,0.5,0.75,2,1.75,1.5,1.75,2.0,1.33,3
Casertana,8,4,1,3,13,6,7,13,Italy - Serie C - Group C,0.5,0.62,7,1.62,0.75,1.62,2.0,1.61,4
Picerno,8,3,4,1,9,5,4,13,Italy - Serie C - Group C,0.38,0.88,4,1.12,0.62,1.62,2.63,1.14,4
ACR Messina,8,4,1,3,14,12,2,13,Italy - Serie C - Group C,0.5,0.62,2,1.75,1.5,1.62,2.0,1.61,4
A. Cerignola,8,4,1,3,10,9,1,13,Italy - Serie C - Group C,0.5,0.62,1,1.25,1.12,1.62,2.0,1.61,4
Juventus U23,8,4,0,4,15,11,4,12,Italy - Serie C - Group C,0.5,0.5,4,1.88,1.38,1.5,2.0,2.0,5
Cavese,8,3,2,3,10,12,-2,11,Italy - Serie C - Group C,0.38,0.62,-2,1.25,1.5,1.38,2.63,1.61,6
Benevento,8,2,4,2,10,9,1,10,Italy - Serie C - Group C,0.25,0.75,1,1.25,1.12,1.25,4.0,1.33,7
Latina,8,3,1,4,7,13,-6,10,Italy - Serie C - Group C,0.38,0.5,-6,0.88,1.62,1.25,2.63,2.0,7
Potenza,8,2,3,3,12,12,0,9,Italy - Serie C - Group C,0.25,0.62,0,1.5,1.5,1.12,4.0,1.61,8
Trapani,8,3,0,5,7,10,-3,9,Italy - Serie C - Group C,0.38,0.38,-3,0.88,1.25,1.12,2.63,2.63,8
Altamura,8,3,0,5,9,13,-4,9,Italy - Serie C - Group C,0.38,0.38,-4,1.12,1.62,1.12,2.63,2.63,8
Giugliano,8,2,2,4,17,16,1,8,Italy - Serie C - Group C,0.25,0.5,1,2.12,2.0,1.0,4.0,2.0,9
Foggia,8,1,1,6,7,16,-9,4,Italy - Serie C - Group C,0.12,0.25,-9,0.88,2.0,0.5,8.33,4.0,10
Sorrento,8,1,1,6,4,17,-13,4,Italy - Serie C - Group C,0.12,0.25,-13,0.5,2.12,0.5,8.33,4.0,10
Taranto,0,0,0,0,0,0,0,0,Italy - Serie C - Group C,0.0,0.0,0,0.0,0.0,0.0,0.0,0.0,11
Turris,0,0,0,0,0,0,0,0,Italy - Serie C - Group C,0.0,0.0,0,0.0,0.0,0.0,0.0,0.0,11
Lavagnese,8,7,1,0,11,3,8,22,Italy - Serie D - Group A,0.88,1.0,8,1.38,0.38,2.75,1.14,1.0,1
Gozzano,8,5,3,0,14,7,7,18,Italy - Serie D - Group A,0.62,1.0,7,1.75,0.88,2.25,1.61,1.0,2
NovaRomentin,8,4,2,2,19,6,13,14,Italy - Serie D - Group A,0.5,0.75,13,2.38,0.75,1.75,2.0,1.33,3
Oltrepo,8,4,2,2,10,8,2,14,Italy - Serie D - Group A,0.5,0.75,2,1.25,1.0,1.75,2.0,1.33,3
Chieri,8,3,4,1,11,6,5,13,Italy - Serie D - Group A,0.38,0.88,5,1.38,0.75,1.62,2.63,1.14,4
Vado,8,4,1,3,9,6,3,13,Italy - Serie D - Group A,0.5,0.62,3,1.12,0.75,1.62,2.0,1.61,4
Bra,8,4,1,3,11,9,2,13,Italy - Serie D - Group A,0.5,0.62,2,1.38,1.12,1.62,2.0,1.61,4
Sanremese,8,3,2,3,7,6,1,11,Italy - Serie D - Group A,0.38,0.62,1,0.88,0.75,1.38,2.63,1.61,5
Ligorna,8,3,2,3,10,14,-4,11,Italy - Serie D - Group A,0.38,0.62,-4,1.25,1.75,1.38,2.63,1.61,5
Vogherese,8,2,4,2,7,7,0,10,Italy - Serie D - Group A,0.25,0.75,0,0.88,0.88,1.25,4.0,1.33,6
Saluzzo,8,2,4,2,6,6,0,10,Italy - Serie D - Group A,0.25,0.75,0,0.75,0.75,1.25,4.0,1.33,6
Borgaro Nobis,8,3,1,4,9,16,-7,10,Italy - Serie D - Group A,0.38,0.5,-7,1.12,2.0,1.25,2.63,2.0,6
Citta di Varese,8,2,3,3,8,9,-1,9,Italy - Serie D - Group A,0.25,0.62,-1,1.0,1.12,1.12,4.0,1.61,7
Asti,8,2,3,3,4,9,-5,9,Italy - Serie D - Group A,0.25,0.62,-5,0.5,1.12,1.12,4.0,1.61,7
Chisola,8,2,2,4,11,10,1,8,Italy - Serie D - Group A,0.25,0.5,1,1.38,1.25,1.0,4.0,2.0,8
Cairese,8,2,2,4,8,9,-1,8,Italy - Serie D - Group A,0.25,0.5,-1,1.0,1.12,1.0,4.0,2.0,8
Derthona,8,2,2,4,6,9,-3,8,Italy - Serie D - Group A,0.25,0.5,-3,0.75,1.12,1.0,4.0,2.0,8
Pro Imperia,8,1,1,6,5,15,-10,4,Italy - Serie D - Group A,0.12,0.25,-10,0.62,1.88,0.5,8.33,4.0,9
Fossano,8,1,0,7,5,18,-13,3,Italy - Serie D - Group A,0.12,0.12,-13,0.62,2.25,0.38,8.33,8.33,10
Albenga,0,0,0,0,0,0,0,0,Italy - Serie D - Group A,0.0,0.0,0,0.0,0.0,0.0,0.0,0.0,11
Desenxano,8,6,0,2,10,5,5,18,Italy - Serie D - Group B,0.75,0.75,5,1.25,0.62,2.25,1.33,1.33,1
Pro Palazzolo,8,5,2,1,15,6,9,17,Italy - Serie D - Group B,0.62,0.88,9,1.88,0.75,2.12,1.61,1.14,2
USD Casatese,8,5,0,3,16,7,9,15,Italy - Serie D - Group B,0.62,0.62,9,2.0,0.88,1.88,1.61,1.61,3
Ospitaletto,8,4,3,1,15,11,4,15,Italy - Serie D - Group B,0.5,0.88,4,1.88,1.38,1.88,2.0,1.14,3
Sondrio,8,5,0,3,11,9,2,15,Italy - Serie D - Group B,0.62,0.62,2,1.38,1.12,1.88,1.61,1.61,3
Castellanzese,8,3,5,0,14,9,5,14,Italy - Serie D - Group B,0.38,1.0,5,1.75,1.12,1.75,2.63,1.0,4
Club Milano,8,4,1,3,14,16,-2,13,Italy - Serie D - Group B,0.5,0.62,-2,1.75,2.0,1.62,2.0,1.61,5
Varesina,8,3,3,2,16,13,3,12,Italy - Serie D - Group B,0.38,0.75,3,2.0,1.62,1.5,2.63,1.33,6
F. Caratese,8,3,2,3,16,10,6,11,Italy - Serie D - Group B,0.38,0.62,6,2.0,1.25,1.38,2.63,1.61,7
Pro Sesto,8,3,2,3,11,12,-1,11,Italy - Serie D - Group B,0.38,0.62,-1,1.38,1.5,1.38,2.63,1.61,7
Chievo,8,3,1,4,15,7,8,10,Italy - Serie D - Group B,0.38,0.5,8,1.88,0.88,1.25,2.63,2.0,8
Sangiuliano C.,8,2,4,2,10,9,1,10,Italy - Serie D - Group B,0.25,0.75,1,1.25,1.12,1.25,4.0,1.33,8
Magenta,8,2,4,2,7,9,-2,10,Italy - Serie D - Group B,0.25,0.75,-2,0.88,1.12,1.25,4.0,1.33,8
Vigasio,8,3,1,4,8,11,-3,10,Italy - Serie D - Group B,0.38,0.5,-3,1.0,1.38,1.25,2.63,2.0,8
SantAngelo,8,2,2,4,9,12,-3,8,Italy - Serie D - Group B,0.25,0.5,-3,1.12,1.5,1.0,4.0,2.0,9
Arconatese,8,2,2,4,10,17,-7,8,Italy - Serie D - Group B,0.25,0.5,-7,1.25,2.12,1.0,4.0,2.0,9
Breno,8,2,1,5,9,22,-13,7,Italy - Serie D - Group B,0.25,0.38,-13,1.12,2.75,0.88,4.0,2.63,10
Crema,8,1,3,4,14,17,-3,6,Italy - Serie D - Group B,0.12,0.5,-3,1.75,2.12,0.75,8.33,2.0,11
Ciliverghe,8,1,2,5,7,18,-11,5,Italy - Serie D - Group B,0.12,0.38,-11,0.88,2.25,0.62,8.33,2.63,12
Fanfulla,8,0,4,4,6,13,-7,4,Italy - Serie D - Group B,0.0,0.5,-7,0.75,1.62,0.5,0.0,2.0,13
D. Bellunesi,8,4,4,0,16,8,8,16,Italy - Serie D - Group C,0.5,1.0,8,2.0,1.0,2.0,2.0,1.0,1
Villa Alme,8,5,1,2,12,9,3,16,Italy - Serie D - Group C,0.62,0.75,3,1.5,1.12,2.0,1.61,1.33,1
Mestre,8,5,1,2,6,3,3,16,Italy - Serie D - Group C,0.62,0.75,3,0.75,0.38,2.0,1.61,1.33,1
Adriese,8,5,0,3,14,8,6,15,Italy - Serie D - Group C,0.62,0.62,6,1.75,1.0,1.88,1.61,1.61,2
Treviso,8,4,3,1,11,6,5,15,Italy - Serie D - Group C,0.5,0.88,5,1.38,0.75,1.88,2.0,1.14,2
Brusaporto,8,4,2,2,10,6,4,14,Italy - Serie D - Group C,0.5,0.75,4,1.25,0.75,1.75,2.0,1.33,3
Real Calepina,8,4,2,2,12,9,3,14,Italy - Serie D - Group C,0.5,0.75,3,1.5,1.12,1.75,2.0,1.33,3
Luparense,8,3,3,2,10,8,2,12,Italy - Serie D - Group C,0.38,0.75,2,1.25,1.0,1.5,2.63,1.33,4
Brian Lignano,8,3,3,2,10,11,-1,12,Italy - Serie D - Group C,0.38,0.75,-1,1.25,1.38,1.5,2.63,1.33,4
Bassano Virtus,8,3,2,3,15,6,9,11,Italy - Serie D - Group C,0.38,0.62,9,1.88,0.75,1.38,2.63,1.61,5
Campodarsego,8,2,4,2,11,11,0,10,Italy - Serie D - Group C,0.25,0.75,0,1.38,1.38,1.25,4.0,1.33,6
Portogruaro,8,2,4,2,6,6,0,10,Italy - Serie D - Group C,0.25,0.75,0,0.75,0.75,1.25,4.0,1.33,6
Ciserano,8,2,4,2,7,8,-1,10,Italy - Serie D - Group C,0.25,0.75,-1,0.88,1.0,1.25,4.0,1.33,6
Este,8,2,4,2,10,13,-3,10,Italy - Serie D - Group C,0.25,0.75,-3,1.25,1.62,1.25,4.0,1.33,6
Cjarlins Muzane,8,2,3,3,11,16,-5,9,Italy - Serie D - Group C,0.25,0.62,-5,1.38,2.0,1.12,4.0,1.61,7
Calvi Noale,8,2,2,4,10,11,-1,8,Italy - Serie D - Group C,0.25,0.5,-1,1.25,1.38,1.0,4.0,2.0,8
Chions,8,2,2,4,10,13,-3,8,Italy - Serie D - Group C,0.25,0.5,-3,1.25,1.62,1.0,4.0,2.0,8
Caravaggio,8,1,3,4,5,11,-6,6,Italy - Serie D - Group C,0.12,0.5,-6,0.62,1.38,0.75,8.33,2.0,9
Lavis,8,1,0,7,6,18,-12,3,Italy - Serie D - Group C,0.12,0.12,-12,0.75,2.25,0.38,8.33,8.33,10
Montecchio M.,8,0,2,6,4,14,-10,2,Italy - Serie D - Group C,0.0,0.25,-10,0.5,1.75,0.25,0.0,4.0,11
Forli,8,7,0,1,21,9,12,21,Italy - Serie D - Group D,0.88,0.88,12,2.62,1.12,2.62,1.14,1.14,1
Lentigione,8,6,2,0,15,4,11,20,Italy - Serie D - Group D,0.75,1.0,11,1.88,0.5,2.5,1.33,1.0,2
Imolese,8,4,3,1,18,10,8,15,Italy - Serie D - Group D,0.5,0.88,8,2.25,1.25,1.88,2.0,1.14,3
Ravenna,8,4,1,3,19,14,5,13,Italy - Serie D - Group D,0.5,0.62,5,2.38,1.75,1.62,2.0,1.61,4
Cittadella Vis,8,3,3,2,13,9,4,12,Italy - Serie D - Group D,0.38,0.75,4,1.62,1.12,1.5,2.63,1.33,5
Pistoiese,8,4,0,4,10,6,4,12,Italy - Serie D - Group D,0.5,0.5,4,1.25,0.75,1.5,2.0,2.0,5
San Marino C.,8,3,3,2,15,14,1,12,Italy - Serie D - Group D,0.38,0.75,1,1.88,1.75,1.5,2.63,1.33,5
Progresso,8,3,2,3,11,9,2,11,Italy - Serie D - Group D,0.38,0.62,2,1.38,1.12,1.38,2.63,1.61,6
Sammaurese,8,3,2,3,5,4,1,11,Italy - Serie D - Group D,0.38,0.62,1,0.62,0.5,1.38,2.63,1.61,6
Piacenza,8,2,4,2,11,8,3,10,Italy - Serie D - Group D,0.25,0.75,3,1.38,1.0,1.25,4.0,1.33,7
Tau Altopascio,8,2,4,2,8,8,0,10,Italy - Serie D - Group D,0.25,0.75,0,1.0,1.0,1.25,4.0,1.33,7
Fiorenzuola,8,3,1,4,7,9,-2,10,Italy - Serie D - Group D,0.38,0.5,-2,0.88,1.12,1.25,2.63,2.0,7
Sasso Marconi,8,2,3,3,11,14,-3,9,Italy - Serie D - Group D,0.25,0.62,-3,1.38,1.75,1.12,4.0,1.61,8
Zenith Prato,8,2,3,3,9,13,-4,9,Italy - Serie D - Group D,0.25,0.62,-4,1.12,1.62,1.12,4.0,1.61,8
Tuttocuoio,8,1,5,2,9,10,-1,8,Italy - Serie D - Group D,0.12,0.75,-1,1.12,1.25,1.0,8.33,1.33,9
Prato,8,2,1,5,8,14,-6,7,Italy - Serie D - Group D,0.25,0.38,-6,1.0,1.75,0.88,4.0,2.63,10
Corticella,8,2,1,5,9,24,-15,7,Italy - Serie D - Group D,0.25,0.38,-15,1.12,3.0,0.88,4.0,2.63,10
United Riccione,8,0,0,8,1,21,-20,0,Italy - Serie D - Group D,0.0,0.0,-20,0.12,2.62,0.0,0.0,0.0,11
Ghiviborgo,8,5,2,1,23,10,13,17,Italy - Serie D - Group E,0.62,0.88,13,2.88,1.25,2.12,1.61,1.14,1
Orvietana,8,5,2,1,13,5,8,17,Italy - Serie D - Group E,0.62,0.88,8,1.62,0.62,2.12,1.61,1.14,1
Flaminia,8,5,2,1,16,10,6,17,Italy - Serie D - Group E,0.62,0.88,6,2.0,1.25,2.12,1.61,1.14,1
San Donato,8,3,3,2,9,5,4,12,Italy - Serie D - Group E,0.38,0.75,4,1.12,0.62,1.5,2.63,1.33,2
Fulgens Foligno,8,3,3,2,12,10,2,12,Italy - Serie D - Group E,0.38,0.75,2,1.5,1.25,1.5,2.63,1.33,2
S. Trestina,8,3,3,2,7,6,1,12,Italy - Serie D - Group E,0.38,0.75,1,0.88,0.75,1.5,2.63,1.33,2
Ostia Mare,8,3,3,2,11,12,-1,12,Italy - Serie D - Group E,0.38,0.75,-1,1.38,1.5,1.5,2.63,1.33,2
T. Traiana,8,2,5,1,7,7,0,11,Italy - Serie D - Group E,0.25,0.88,0,0.88,0.88,1.38,4.0,1.14,3
Seravezza,8,3,2,3,12,13,-1,11,Italy - Serie D - Group E,0.38,0.62,-1,1.5,1.62,1.38,2.63,1.61,3
Montevarchi,8,1,7,0,8,6,2,10,Italy - Serie D - Group E,0.12,1.0,2,1.0,0.75,1.25,8.33,1.0,4
Poggibonsi,8,3,1,4,3,5,-2,10,Italy - Serie D - Group E,0.38,0.5,-2,0.38,0.62,1.25,2.63,2.0,4
FC Siena,8,2,3,3,12,12,0,9,Italy - Serie D - Group E,0.25,0.62,0,1.5,1.5,1.12,4.0,1.61,5
Livorno,8,2,3,3,13,20,-7,9,Italy - Serie D - Group E,0.25,0.62,-7,1.62,2.5,1.12,4.0,1.61,5
Grosseto,8,1,5,2,8,8,0,8,Italy - Serie D - Group E,0.12,0.75,0,1.0,1.0,1.0,8.33,1.33,6
Figline,8,1,3,4,6,9,-3,6,Italy - Serie D - Group E,0.12,0.5,-3,0.75,1.12,0.75,8.33,2.0,7
Gavorrano,8,1,3,4,6,14,-8,6,Italy - Serie D - Group E,0.12,0.5,-8,0.75,1.75,0.75,8.33,2.0,7
Sangiovannese,8,1,2,5,7,12,-5,5,Italy - Serie D - Group E,0.12,0.38,-5,0.88,1.5,0.62,8.33,2.63,8
Fezzanese,8,1,2,5,10,19,-9,5,Italy - Serie D - Group E,0.12,0.38,-9,1.25,2.38,0.62,8.33,2.63,8
Avezzano,8,4,2,2,15,7,8,14,Italy - Serie D - Group F,0.5,0.75,8,1.88,0.88,1.75,2.0,1.33,1
Sambenedettese,8,4,2,2,12,7,5,14,Italy - Serie D - Group F,0.5,0.75,5,1.5,0.88,1.75,2.0,1.33,1
LAquila,8,4,2,2,11,8,3,14,Italy - Serie D - Group F,0.5,0.75,3,1.38,1.0,1.75,2.0,1.33,1
Teramo,8,4,1,3,12,9,3,13,Italy - Serie D - Group F,0.5,0.62,3,1.5,1.12,1.62,2.0,1.61,2
Fossombrone,8,3,4,1,9,7,2,13,Italy - Serie D - Group F,0.38,0.88,2,1.12,0.88,1.62,2.63,1.14,2
Termoli Calcio,8,3,4,1,10,10,0,13,Italy - Serie D - Group F,0.38,0.88,0,1.25,1.25,1.62,2.63,1.14,2
San Nicolo,8,4,1,3,11,12,-1,13,Italy - Serie D - Group F,0.5,0.62,-1,1.38,1.5,1.62,2.0,1.61,2
Castelfidardo,8,3,3,2,9,7,2,12,Italy - Serie D - Group F,0.38,0.75,2,1.12,0.88,1.5,2.63,1.33,3
Isernia,8,4,0,4,11,11,0,12,Italy - Serie D - Group F,0.5,0.5,0,1.38,1.38,1.5,2.0,2.0,3
Civitanovese,8,3,2,3,11,9,2,11,Italy - Serie D - Group F,0.38,0.62,2,1.38,1.12,1.38,2.63,1.61,4
Sora,8,3,2,3,10,8,2,11,Italy - Serie D - Group F,0.38,0.62,2,1.25,1.0,1.38,2.63,1.61,4
Chieti,8,3,1,4,8,11,-3,10,Italy - Serie D - Group F,0.38,0.5,-3,1.0,1.38,1.25,2.63,2.0,5
Ancona 1905,8,2,3,3,8,15,-7,9,Italy - Serie D - Group F,0.25,0.62,-7,1.0,1.88,1.12,4.0,1.61,6
V. Senigallia,8,1,5,2,9,11,-2,8,Italy - Serie D - Group F,0.12,0.75,-2,1.12,1.38,1.0,8.33,1.33,7
Atletico Ascoli,8,1,5,2,5,7,-2,8,Italy - Serie D - Group F,0.12,0.75,-2,0.62,0.88,1.0,8.33,1.33,7
Recanatese,8,2,2,4,7,11,-4,8,Italy - Serie D - Group F,0.25,0.5,-4,0.88,1.38,1.0,4.0,2.0,7
Roma City,8,1,3,4,7,10,-3,6,Italy - Serie D - Group F,0.12,0.5,-3,0.88,1.25,0.75,8.33,2.0,8
Fermana,8,1,2,5,5,10,-5,5,Italy - Serie D - Group F,0.12,0.38,-5,0.62,1.25,0.62,8.33,2.63,9
Guidonia,8,6,2,0,18,5,13,20,Italy - Serie D - Group G,0.75,1.0,13,2.25,0.62,2.5,1.33,1.0,1
Savoia,8,5,3,0,14,4,10,18,Italy - Serie D - Group G,0.62,1.0,10,1.75,0.5,2.25,1.61,1.0,2
Sarnese,8,5,2,1,12,8,4,17,Italy - Serie D - Group G,0.62,0.88,4,1.5,1.0,2.12,1.61,1.14,3
Gelbison,8,4,3,1,15,10,5,15,Italy - Serie D - Group G,0.5,0.88,5,1.88,1.25,1.88,2.0,1.14,4
Paganese,8,4,2,2,11,5,6,14,Italy - Serie D - Group G,0.5,0.75,6,1.38,0.62,1.75,2.0,1.33,5
Ilvamaddalena,8,4,1,3,13,10,3,13,Italy - Serie D - Group G,0.5,0.62,3,1.62,1.25,1.62,2.0,1.61,6
Olbia,8,3,3,2,12,10,2,12,Italy - Serie D - Group G,0.38,0.75,2,1.5,1.25,1.5,2.63,1.33,7
Latte Dolce,8,3,3,2,12,11,1,12,Italy - Serie D - Group G,0.38,0.75,1,1.5,1.38,1.5,2.63,1.33,7
CynthiAlbalonga,8,3,2,3,11,12,-1,11,Italy - Serie D - Group G,0.38,0.62,-1,1.38,1.5,1.38,2.63,1.61,8
R. Monterotondo,8,3,1,4,7,11,-4,10,Italy - Serie D - Group G,0.38,0.5,-4,0.88,1.38,1.25,2.63,2.0,9
Trastevere,8,2,3,3,13,14,-1,9,Italy - Serie D - Group G,0.25,0.62,-1,1.62,1.75,1.12,4.0,1.61,10
A. Lodigiani,8,2,3,3,11,12,-1,9,Italy - Serie D - Group G,0.25,0.62,-1,1.38,1.5,1.12,4.0,1.61,10
S. Ogliastra,8,2,3,3,11,13,-2,9,Italy - Serie D - Group G,0.25,0.62,-2,1.38,1.62,1.12,4.0,1.61,10
Anzio,8,2,3,3,9,15,-6,9,Italy - Serie D - Group G,0.25,0.62,-6,1.12,1.88,1.12,4.0,1.61,10
Cassino,8,2,2,4,7,10,-3,8,Italy - Serie D - Group G,0.25,0.5,-3,0.88,1.25,1.0,4.0,2.0,11
Puteolana,8,1,4,3,9,14,-5,7,Italy - Serie D - Group G,0.12,0.62,-5,1.12,1.75,0.88,8.33,1.61,12
Terracina,8,0,2,6,7,18,-11,2,Italy - Serie D - Group G,0.0,0.25,-11,0.88,2.25,0.25,0.0,4.0,13
Atletico Uri,8,0,0,8,5,15,-10,0,Italy - Serie D - Group G,0.0,0.0,-10,0.62,1.88,0.0,0.0,0.0,14
Casarano,8,6,1,1,20,9,11,19,Italy - Serie D - Group H,0.75,0.88,11,2.5,1.12,2.38,1.33,1.14,1
Nocerina,8,5,2,1,20,7,13,17,Italy - Serie D - Group H,0.62,0.88,13,2.5,0.88,2.12,1.61,1.14,2
Citta di Fasano,8,5,1,2,19,11,8,16,Italy - Serie D - Group H,0.62,0.75,8,2.38,1.38,2.0,1.61,1.33,3
Francavilla,8,4,1,3,8,9,-1,13,Italy - Serie D - Group H,0.5,0.62,-1,1.0,1.12,1.62,2.0,1.61,4
Manfredonia,8,3,3,2,14,11,3,12,Italy - Serie D - Group H,0.38,0.75,3,1.75,1.38,1.5,2.63,1.33,5
Brindisi,8,3,3,2,13,11,2,12,Italy - Serie D - Group H,0.38,0.75,2,1.62,1.38,1.5,2.63,1.33,5
Ischia,8,2,5,1,6,6,0,11,Italy - Serie D - Group H,0.25,0.88,0,0.75,0.75,1.38,4.0,1.14,6
Nardo,8,3,2,3,12,13,-1,11,Italy - Serie D - Group H,0.38,0.62,-1,1.5,1.62,1.38,2.63,1.61,6
V. Francavilla,8,2,4,2,12,9,3,10,Italy - Serie D - Group H,0.25,0.75,3,1.5,1.12,1.25,4.0,1.33,7
Martina Franca,8,2,4,2,7,6,1,10,Italy - Serie D - Group H,0.25,0.75,1,0.88,0.75,1.25,4.0,1.33,7
Matera,8,2,4,2,16,18,-2,10,Italy - Serie D - Group H,0.25,0.75,-2,2.0,2.25,1.25,4.0,1.33,7
Real Acerrana,8,3,1,4,10,12,-2,10,Italy - Serie D - Group H,0.38,0.5,-2,1.25,1.5,1.25,2.63,2.0,7
Ugento,8,3,1,4,9,13,-4,10,Italy - Serie D - Group H,0.38,0.5,-4,1.12,1.62,1.25,2.63,2.0,7
Gravina,8,2,3,3,11,10,1,9,Italy - Serie D - Group H,0.25,0.62,1,1.38,1.25,1.12,4.0,1.61,8
USD Palmese,8,2,3,3,9,10,-1,9,Italy - Serie D - Group H,0.25,0.62,-1,1.12,1.25,1.12,4.0,1.61,8
Fidelis Andria,8,1,4,3,6,10,-4,7,Italy - Serie D - Group H,0.12,0.62,-4,0.75,1.25,0.88,8.33,1.61,9
Costa DAmalfi,8,1,1,6,7,17,-10,4,Italy - Serie D - Group H,0.12,0.25,-10,0.88,2.12,0.5,8.33,4.0,10
Angri Calcio,8,1,1,6,7,24,-17,4,Italy - Serie D - Group H,0.12,0.25,-17,0.88,3.0,0.5,8.33,4.0,10
Siracusa,8,8,0,0,21,4,17,24,Italy - Serie D - Group I,1.0,1.0,17,2.62,0.5,3.0,1.0,1.0,1
Reggina,8,8,0,0,16,6,10,24,Italy - Serie D - Group I,1.0,1.0,10,2.0,0.75,3.0,1.0,1.0,1
Scafatese,8,5,0,3,17,11,6,15,Italy - Serie D - Group I,0.62,0.62,6,2.12,1.38,1.88,1.61,1.61,2
Sancataldese,8,4,2,2,8,6,2,14,Italy - Serie D - Group I,0.5,0.75,2,1.0,0.75,1.75,2.0,1.33,3
Nissa,8,4,1,3,15,15,0,13,Italy - Serie D - Group I,0.5,0.62,0,1.88,1.88,1.62,2.0,1.61,4
Pompei,8,4,1,3,9,11,-2,13,Italy - Serie D - Group I,0.5,0.62,-2,1.12,1.38,1.62,2.0,1.61,4
Acireale,8,2,5,1,10,8,2,11,Italy - Serie D - Group I,0.25,0.88,2,1.25,1.0,1.38,4.0,1.14,5
Enna,8,3,2,3,8,8,0,11,Italy - Serie D - Group I,0.38,0.62,0,1.0,1.0,1.38,2.63,1.61,5
Ragusa,8,3,1,4,11,11,0,10,Italy - Serie D - Group I,0.38,0.5,0,1.38,1.38,1.25,2.63,2.0,6
Paterno,8,2,4,2,8,10,-2,10,Italy - Serie D - Group I,0.25,0.75,-2,1.0,1.25,1.25,4.0,1.33,6
Licata,8,3,0,5,10,11,-1,9,Italy - Serie D - Group I,0.38,0.38,-1,1.25,1.38,1.12,2.63,2.63,7
CD S. Agata,8,2,2,4,12,14,-2,8,Italy - Serie D - Group I,0.25,0.5,-2,1.5,1.75,1.0,4.0,2.0,8
Sambiase,8,2,2,4,6,8,-2,8,Italy - Serie D - Group I,0.25,0.5,-2,0.75,1.0,1.0,4.0,2.0,8
Vibonese,8,2,2,4,8,12,-4,8,Italy - Serie D - Group I,0.25,0.5,-4,1.0,1.5,1.0,4.0,2.0,8
Igea Virtus,8,2,1,5,8,14,-6,7,Italy - Serie D - Group I,0.25,0.38,-6,1.0,1.75,0.88,4.0,2.63,9
Locri 1909,8,1,2,5,10,15,-5,5,Italy - Serie D - Group I,0.12,0.38,-5,1.25,1.88,0.62,8.33,2.63,10
CastrumFavara,8,0,3,5,6,15,-9,3,Italy - Serie D - Group I,0.0,0.38,-9,0.75,1.88,0.38,0.0,2.63,11
Akragas,0,0,0,0,0,0,0,0,Italy - Serie D - Group I,0.0,0.0,0,0.0,0.0,0.0,0.0,0.0,12
Roma U20,8,7,1,0,28,8,20,22,Italy - Primavera 1,0.88,1.0,20,3.5,1.0,2.75,1.14,1.0,1
Cagliari U20,8,6,2,0,15,4,11,20,Italy - Primavera 1,0.75,1.0,11,1.88,0.5,2.5,1.33,1.0,2
Torino U20,8,5,0,3,18,14,4,15,Italy - Primavera 1,0.62,0.62,4,2.25,1.75,1.88,1.61,1.61,3
H. Verona U20,8,4,2,2,11,5,6,14,Italy - Primavera 1,0.5,0.75,6,1.38,0.62,1.75,2.0,1.33,4
Inter Milan U20,8,4,2,2,8,5,3,14,Italy - Primavera 1,0.5,0.75,3,1.0,0.62,1.75,2.0,1.33,4
Fiorentina U20,8,4,1,3,17,10,7,13,Italy - Primavera 1,0.5,0.62,7,2.12,1.25,1.62,2.0,1.61,5
Cesena U20,8,4,1,3,12,15,-3,13,Italy - Primavera 1,0.5,0.62,-3,1.5,1.88,1.62,2.0,1.61,5
Lazio U20,8,3,3,2,8,6,2,12,Italy - Primavera 1,0.38,0.75,2,1.0,0.75,1.5,2.63,1.33,6
Cremonese U20,8,3,2,3,10,7,3,11,Italy - Primavera 1,0.38,0.62,3,1.25,0.88,1.38,2.63,1.61,7
Bologna U20,8,3,2,3,13,11,2,11,Italy - Primavera 1,0.38,0.62,2,1.62,1.38,1.38,2.63,1.61,7
Juventus U20,8,3,2,3,11,13,-2,11,Italy - Primavera 1,0.38,0.62,-2,1.38,1.62,1.38,2.63,1.61,7
Milan U20,8,3,1,4,12,9,3,10,Italy - Primavera 1,0.38,0.5,3,1.5,1.12,1.25,2.63,2.0,8
Atalanta U20,8,3,1,4,12,10,2,10,Italy - Primavera 1,0.38,0.5,2,1.5,1.25,1.25,2.63,2.0,8
Lecce U20,8,2,4,2,13,12,1,10,Italy - Primavera 1,0.25,0.75,1,1.62,1.5,1.25,4.0,1.33,8
Sassuolo U20,8,3,0,5,9,11,-2,9,Italy - Primavera 1,0.38,0.38,-2,1.12,1.38,1.12,2.63,2.63,9
Monza U20,8,2,2,4,10,15,-5,8,Italy - Primavera 1,0.25,0.5,-5,1.25,1.88,1.0,4.0,2.0,10
Empoli U20,8,2,2,4,8,14,-6,8,Italy - Primavera 1,0.25,0.5,-6,1.0,1.75,1.0,4.0,2.0,10
Genoa U20,8,2,1,5,11,16,-5,7,Italy - Primavera 1,0.25,0.38,-5,1.38,2.0,0.88,4.0,2.63,11
Sampdoria U20,8,2,1,5,7,15,-8,7,Italy - Primavera 1,0.25,0.38,-8,0.88,1.88,0.88,4.0,2.63,11
Udinese U20,8,0,0,8,1,34,-33,0,Italy - Primavera 1,0.0,0.0,-33,0.12,4.25,0.0,0.0,0.0,12
Mount Pleasant,8,7,0,1,19,3,16,21,Jamaica - Premier League,0.88,0.88,16,2.38,0.38,2.62,1.14,1.14,1
Cavalier,8,6,1,1,17,8,9,19,Jamaica - Premier League,0.75,0.88,9,2.12,1.0,2.38,1.33,1.14,2
Waterhouse,8,5,2,1,11,4,7,17,Jamaica - Premier League,0.62,0.88,7,1.38,0.5,2.12,1.61,1.14,3
Tivoli Gardens,8,4,4,0,10,6,4,16,Jamaica - Premier League,0.5,1.0,4,1.25,0.75,2.0,2.0,1.0,4
Portmore Utd,8,4,1,3,6,5,1,13,Jamaica - Premier League,0.5,0.62,1,0.75,0.62,1.62,2.0,1.61,5
Montego Bay,8,3,3,2,10,5,5,12,Jamaica - Premier League,0.38,0.75,5,1.25,0.62,1.5,2.63,1.33,6
Arnett Gardens,8,3,2,3,14,11,3,11,Jamaica - Premier League,0.38,0.62,3,1.75,1.38,1.38,2.63,1.61,7
Chapelton,8,3,2,3,8,11,-3,11,Jamaica - Premier League,0.38,0.62,-3,1.0,1.38,1.38,2.63,1.61,7
Humble Lions,8,2,2,4,9,12,-3,8,Jamaica - Premier League,0.25,0.5,-3,1.12,1.5,1.0,4.0,2.0,8
Harbour View,8,2,2,4,11,15,-4,8,Jamaica - Premier League,0.25,0.5,-4,1.38,1.88,1.0,4.0,2.0,8
Molynes Utd,8,2,1,5,9,15,-6,7,Jamaica - Premier League,0.25,0.38,-6,1.12,1.88,0.88,4.0,2.63,9
Racing United,8,2,1,5,7,14,-7,7,Jamaica - Premier League,0.25,0.38,-7,0.88,1.75,0.88,4.0,2.63,9
Dunbeholden,8,1,2,5,2,11,-9,5,Jamaica - Premier League,0.12,0.38,-9,0.25,1.38,0.62,8.33,2.63,10
Vere Utd,8,0,1,7,4,22,-18,1,Jamaica - Premier League,0.0,0.12,-18,0.5,2.75,0.12,0.0,8.33,11
Kashima Antlers,8,7,0,1,11,4,7,21,Japan - J1 League,0.88,0.88,7,1.38,0.5,2.62,1.14,1.14,1
Cerezo Osaka,8,5,1,2,14,9,5,16,Japan - J1 League,0.62,0.75,5,1.75,1.12,2.0,1.61,1.33,2
S. Hiroshima,8,5,0,3,10,6,4,15,Japan - J1 League,0.62,0.62,4,1.25,0.75,1.88,1.61,1.61,3
Vissel Kobe,8,5,0,3,14,11,3,15,Japan - J1 League,0.62,0.62,3,1.75,1.38,1.88,1.61,1.61,3
Kashiwa Reysol,8,4,2,2,10,9,1,14,Japan - J1 League,0.5,0.75,1,1.25,1.12,1.75,2.0,1.33,4
Kyoto Sanga,8,4,1,3,14,9,5,13,Japan - J1 League,0.5,0.62,5,1.75,1.12,1.62,2.0,1.61,5
Tokyo Verdy,8,4,1,3,6,6,0,13,Japan - J1 League,0.5,0.62,0,0.75,0.75,1.62,2.0,1.61,5
Nagoya G.,8,3,3,2,11,6,5,12,Japan - J1 League,0.38,0.75,5,1.38,0.75,1.5,2.63,1.33,6
K. Frontale,8,3,3,2,12,10,2,12,Japan - J1 League,0.38,0.75,2,1.5,1.25,1.5,2.63,1.33,6
Urawa RD,8,3,3,2,11,9,2,12,Japan - J1 League,0.38,0.75,2,1.38,1.12,1.5,2.63,1.33,6
Gamba Osaka,8,3,1,4,11,11,0,10,Japan - J1 League,0.38,0.5,0,1.38,1.38,1.25,2.63,2.0,7
Shimizu S-Pulse,8,3,1,4,12,14,-2,10,Japan - J1 League,0.38,0.5,-2,1.5,1.75,1.25,2.63,2.0,7
FC Tokyo,8,3,1,4,10,14,-4,10,Japan - J1 League,0.38,0.5,-4,1.25,1.75,1.25,2.63,2.0,7
Machida Zelvia,8,2,2,4,10,12,-2,8,Japan - J1 League,0.25,0.5,-2,1.25,1.5,1.0,4.0,2.0,8
Albirex Niigata,8,2,2,4,9,13,-4,8,Japan - J1 League,0.25,0.5,-4,1.12,1.62,1.0,4.0,2.0,8
Shonan Bellmare,8,2,2,4,5,9,-4,8,Japan - J1 League,0.25,0.5,-4,0.62,1.12,1.0,4.0,2.0,8
Fagiano Okayama,8,1,4,3,6,10,-4,7,Japan - J1 League,0.12,0.62,-4,0.75,1.25,0.88,8.33,1.61,9
Yokohama FC,8,2,1,5,6,12,-6,7,Japan - J1 League,0.25,0.38,-6,0.75,1.5,0.88,4.0,2.63,9
Yokohama M.,8,2,0,6,10,15,-5,6,Japan - J1 League,0.25,0.25,-5,1.25,1.88,0.75,4.0,4.0,10
Avispa Fukuoka,8,0,4,4,3,8,-5,4,Japan - J1 League,0.0,0.5,-5,0.38,1.0,0.5,0.0,2.0,11
Mito Hollyhock,8,6,2,0,12,3,9,20,Japan - J2 League,0.75,1.0,9,1.5,0.38,2.5,1.33,1.0,1
Tokushima V.,8,6,1,1,11,2,9,19,Japan - J2 League,0.75,0.88,9,1.38,0.25,2.38,1.33,1.14,2
Omiya Ardija,8,4,3,1,13,8,5,15,Japan - J2 League,0.5,0.88,5,1.62,1.0,1.88,2.0,1.14,3
Sagan Tosu,8,4,3,1,10,7,3,15,Japan - J2 League,0.5,0.88,3,1.25,0.88,1.88,2.0,1.14,3
Vegalta Sendai,8,4,3,1,11,9,2,15,Japan - J2 League,0.5,0.88,2,1.38,1.12,1.88,2.0,1.14,3
Oita Trinita,8,4,2,2,10,8,2,14,Japan - J2 League,0.5,0.75,2,1.25,1.0,1.75,2.0,1.33,4
Iwaki,8,3,3,2,15,12,3,12,Japan - J2 League,0.38,0.75,3,1.88,1.5,1.5,2.63,1.33,5
Jubilo Iwata,8,3,3,2,13,12,1,12,Japan - J2 League,0.38,0.75,1,1.62,1.5,1.5,2.63,1.33,5
V-V. Nagasaki,8,3,3,2,12,13,-1,12,Japan - J2 League,0.38,0.75,-1,1.5,1.62,1.5,2.63,1.33,5
Ventforet Kofu,8,3,2,3,8,6,2,11,Japan - J2 League,0.38,0.62,2,1.0,0.75,1.38,2.63,1.61,6
JEF Utd Chiba,8,2,4,2,6,5,1,10,Japan - J2 League,0.25,0.75,1,0.75,0.62,1.25,4.0,1.33,7
FC Imabari,8,2,3,3,7,8,-1,9,Japan - J2 League,0.25,0.62,-1,0.88,1.0,1.12,4.0,1.61,8
C. Sapporo,8,2,3,3,10,12,-2,9,Japan - J2 League,0.25,0.62,-2,1.25,1.5,1.12,4.0,1.61,8
R. Yamaguchi,8,2,2,4,5,9,-4,8,Japan - J2 League,0.25,0.5,-4,0.62,1.12,1.0,4.0,2.0,9
Fujieda MYFC,8,2,1,5,7,11,-4,7,Japan - J2 League,0.25,0.38,-4,0.88,1.38,0.88,4.0,2.63,10
Ehime FC,8,0,6,2,10,14,-4,6,Japan - J2 League,0.0,0.75,-4,1.25,1.75,0.75,0.0,1.33,11
M. Yamagata,8,1,2,5,6,11,-5,5,Japan - J2 League,0.12,0.38,-5,0.75,1.38,0.62,8.33,2.63,12
Blaublitz Akita,8,1,2,5,8,14,-6,5,Japan - J2 League,0.12,0.38,-6,1.0,1.75,0.62,8.33,2.63,12
R. Kumamoto,8,1,2,5,7,13,-6,5,Japan - J2 League,0.12,0.38,-6,0.88,1.62,0.62,8.33,2.63,12
Kataller Toyama,8,0,4,4,7,11,-4,4,Japan - J2 League,0.0,0.5,-4,0.88,1.38,0.5,0.0,2.0,13
Osaka,8,6,0,2,15,7,8,18,Japan - J3 League,0.75,0.75,8,1.88,0.88,2.25,1.33,1.33,1
Tochigi City,8,5,2,1,12,4,8,17,Japan - J3 League,0.62,0.88,8,1.5,0.5,2.12,1.61,1.14,2
T. Miyazaki,8,4,4,0,13,8,5,16,Japan - J3 League,0.5,1.0,5,1.62,1.0,2.0,2.0,1.0,3
V. Hachinohe,8,5,1,2,8,3,5,16,Japan - J3 League,0.62,0.75,5,1.0,0.38,2.0,1.61,1.33,3
Kagoshima Utd,8,4,2,2,15,10,5,14,Japan - J3 League,0.5,0.75,5,1.88,1.25,1.75,2.0,1.33,4
Kusatsu,8,2,5,1,12,10,2,11,Japan - J3 League,0.25,0.88,2,1.5,1.25,1.38,4.0,1.14,5
Gainare Tottori,8,3,2,3,7,5,2,11,Japan - J3 League,0.38,0.62,2,0.88,0.62,1.38,2.63,1.61,5
Tochigi SC,8,3,2,3,3,3,0,11,Japan - J3 League,0.38,0.62,0,0.38,0.38,1.38,2.63,1.61,5
Kochi United,8,3,2,3,17,18,-1,11,Japan - J3 League,0.38,0.62,-1,2.12,2.25,1.38,2.63,1.61,5
Fukushima Utd,8,3,2,3,14,19,-5,11,Japan - J3 League,0.38,0.62,-5,1.75,2.38,1.38,2.63,1.61,5
Matsumoto Y.,8,3,1,4,8,10,-2,10,Japan - J3 League,0.38,0.5,-2,1.0,1.25,1.25,2.63,2.0,6
Gifu,8,2,3,3,9,10,-1,9,Japan - J3 League,0.25,0.62,-1,1.12,1.25,1.12,4.0,1.61,7
G. Kitakyushu,8,2,3,3,5,6,-1,9,Japan - J3 League,0.25,0.62,-1,0.62,0.75,1.12,4.0,1.61,7
FC Ryukyu,8,2,2,4,7,9,-2,8,Japan - J3 League,0.25,0.5,-2,0.88,1.12,1.0,4.0,2.0,8
Nara Club,8,2,2,4,7,9,-2,8,Japan - J3 League,0.25,0.5,-2,0.88,1.12,1.0,4.0,2.0,8
AC Numazu,8,1,4,3,7,8,-1,7,Japan - J3 League,0.12,0.62,-1,0.88,1.0,0.88,8.33,1.61,9
Nagano Parceiro,8,1,4,3,5,8,-3,7,Japan - J3 League,0.12,0.62,-3,0.62,1.0,0.88,8.33,1.61,9
SC Sagamihara,8,1,4,3,10,14,-4,7,Japan - J3 League,0.12,0.62,-4,1.25,1.75,0.88,8.33,1.61,9
Z. Kanazawa,8,2,1,5,7,12,-5,7,Japan - J3 League,0.25,0.38,-5,0.88,1.5,0.88,4.0,2.63,9
Kamatamare S.,8,2,1,5,6,11,-5,7,Japan - J3 League,0.25,0.38,-5,0.75,1.38,0.88,4.0,2.63,9
Al Wihdat,8,6,2,0,18,6,12,20,Jordan - Premier League,0.75,1.0,12,2.25,0.75,2.5,1.33,1.0,1
Al Faysali,8,5,3,0,9,2,7,18,Jordan - Premier League,0.62,1.0,7,1.12,0.25,2.25,1.61,1.0,2
Al Hussein,8,3,4,1,20,7,13,13,Jordan - Premier League,0.38,0.88,13,2.5,0.88,1.62,2.63,1.14,3
Al Sareeh,8,3,3,2,9,8,1,12,Jordan - Premier League,0.38,0.75,1,1.12,1.0,1.5,2.63,1.33,4
Al Salt,8,3,2,3,6,6,0,11,Jordan - Premier League,0.38,0.62,0,0.75,0.75,1.38,2.63,1.61,5
Shabab Al Ordon,8,3,1,4,11,11,0,10,Jordan - Premier League,0.38,0.5,0,1.38,1.38,1.25,2.63,2.0,6
Al Ramtha,8,2,3,3,9,8,1,9,Jordan - Premier League,0.25,0.62,1,1.12,1.0,1.12,4.0,1.61,7
Aqaba,8,2,3,3,6,15,-9,9,Jordan - Premier League,0.25,0.62,-9,0.75,1.88,1.12,4.0,1.61,7
Al Jazeera,8,2,2,4,8,9,-1,8,Jordan - Premier League,0.25,0.5,-1,1.0,1.12,1.0,4.0,2.0,8
Al Ahli,8,2,2,4,7,15,-8,8,Jordan - Premier League,0.25,0.5,-8,0.88,1.88,1.0,4.0,2.0,8
Maan,8,2,1,5,8,14,-6,7,Jordan - Premier League,0.25,0.38,-6,1.0,1.75,0.88,4.0,2.63,9
Moghayer Al S.,8,1,0,7,4,18,-14,3,Jordan - Premier League,0.12,0.12,-14,0.5,2.25,0.38,8.33,8.33,10
Tobol,8,6,1,1,17,6,11,19,Kazakhstan - Premier League,0.75,0.88,11,2.12,0.75,2.38,1.33,1.14,1
FC Astana,8,5,2,1,15,8,7,17,Kazakhstan - Premier League,0.62,0.88,7,1.88,1.0,2.12,1.61,1.14,2
Kairat Almaty,8,5,1,2,15,7,8,16,Kazakhstan - Premier League,0.62,0.75,8,1.88,0.88,2.0,1.61,1.33,3
Okzhetpes,8,5,1,2,13,9,4,16,Kazakhstan - Premier League,0.62,0.75,4,1.62,1.12,2.0,1.61,1.33,3
Aktobe,8,5,0,3,10,8,2,15,Kazakhstan - Premier League,0.62,0.62,2,1.25,1.0,1.88,1.61,1.61,4
Ordabasy,8,4,2,2,12,6,6,14,Kazakhstan - Premier League,0.5,0.75,6,1.5,0.75,1.75,2.0,1.33,5
Yelimay Semey,8,4,1,3,9,6,3,13,Kazakhstan - Premier League,0.5,0.62,3,1.12,0.75,1.62,2.0,1.61,6
Kyzylzhar,8,3,2,3,12,12,0,11,Kazakhstan - Premier League,0.38,0.62,0,1.5,1.5,1.38,2.63,1.61,7
Kaisar K.,8,2,3,3,8,13,-5,9,Kazakhstan - Premier League,0.25,0.62,-5,1.0,1.62,1.12,4.0,1.61,8
Turan,8,2,2,4,7,9,-2,8,Kazakhstan - Premier League,0.25,0.5,-2,0.88,1.12,1.0,4.0,2.0,9
Zhetysu,8,1,4,3,6,11,-5,7,Kazakhstan - Premier League,0.12,0.62,-5,0.75,1.38,0.88,8.33,1.61,10
Ulytau,8,2,0,6,5,14,-9,6,Kazakhstan - Premier League,0.25,0.25,-9,0.62,1.75,0.75,4.0,4.0,11
Zhenys,8,0,4,4,6,11,-5,4,Kazakhstan - Premier League,0.0,0.5,-5,0.75,1.38,0.5,0.0,2.0,12
Atyrau,8,0,1,7,5,17,-12,1,Kazakhstan - Premier League,0.0,0.12,-12,0.62,2.12,0.12,0.0,8.33,13
Drita,8,5,2,1,14,6,8,17,Kosovo - Superliga,0.62,0.88,8,1.75,0.75,2.12,1.61,1.14,1
Ferizaj,8,5,0,3,14,11,3,15,Kosovo - Superliga,0.62,0.62,3,1.75,1.38,1.88,1.61,1.61,2
Gjilani,8,4,2,2,9,10,-1,14,Kosovo - Superliga,0.5,0.75,-1,1.12,1.25,1.75,2.0,1.33,3
Ballkani,8,4,1,3,11,9,2,13,Kosovo - Superliga,0.5,0.62,2,1.38,1.12,1.62,2.0,1.61,4
Llapi,8,3,3,2,7,3,4,12,Kosovo - Superliga,0.38,0.75,4,0.88,0.38,1.5,2.63,1.33,5
Malisheva,8,3,3,2,10,7,3,12,Kosovo - Superliga,0.38,0.75,3,1.25,0.88,1.5,2.63,1.33,5
Dukagjini,8,3,3,2,5,4,1,12,Kosovo - Superliga,0.38,0.75,1,0.62,0.5,1.5,2.63,1.33,5
Prishtina,8,0,6,2,7,9,-2,6,Kosovo - Superliga,0.0,0.75,-2,0.88,1.12,0.75,0.0,1.33,6
Suhareka,8,1,1,6,7,16,-9,4,Kosovo - Superliga,0.12,0.25,-9,0.88,2.0,0.5,8.33,4.0,7
Feronikeli,8,1,1,6,4,13,-9,4,Kosovo - Superliga,0.12,0.25,-9,0.5,1.62,0.5,8.33,4.0,7
Al Kuwait,8,6,2,0,22,7,15,20,Kuwait - Premier League,0.75,1.0,15,2.75,0.88,2.5,1.33,1.0,1
Al Arabi SC,8,5,2,1,14,7,7,17,Kuwait - Premier League,0.62,0.88,7,1.75,0.88,2.12,1.61,1.14,2
Al Nasar,8,4,1,3,16,10,6,13,Kuwait - Premier League,0.5,0.62,6,2.0,1.25,1.62,2.0,1.61,3
Al Fahaheel,8,3,4,1,16,11,5,13,Kuwait - Premier League,0.38,0.88,5,2.0,1.38,1.62,2.63,1.14,3
Al Qadsia,8,3,0,5,16,20,-4,9,Kuwait - Premier League,0.38,0.38,-4,2.0,2.5,1.12,2.63,2.63,4
Al Salmiyah,8,2,3,3,13,17,-4,9,Kuwait - Premier League,0.25,0.62,-4,1.62,2.12,1.12,4.0,1.61,4
Kazma,8,1,4,3,9,10,-1,7,Kuwait - Premier League,0.12,0.62,-1,1.12,1.25,0.88,8.33,1.61,5
Yarmouk,8,2,1,5,9,21,-12,7,Kuwait - Premier League,0.25,0.38,-12,1.12,2.62,0.88,4.0,2.63,5
Khaitan,8,1,2,5,5,11,-6,5,Kuwait - Premier League,0.12,0.38,-6,0.62,1.38,0.62,8.33,2.63,6
Al Tadhamon,8,1,1,6,5,21,-16,4,Kuwait - Premier League,0.12,0.25,-16,0.62,2.62,0.5,8.33,4.0,7
Riga FC,8,8,0,0,20,2,18,24,Latvia - Virsliga,1.0,1.0,18,2.5,0.25,3.0,1.0,1.0,1
RFS,8,5,1,2,22,8,14,16,Latvia - Virsliga,0.62,0.75,14,2.75,1.0,2.0,1.61,1.33,2
Liepaja,8,3,3,2,11,11,0,12,Latvia - Virsliga,0.38,0.75,0,1.38,1.38,1.5,2.63,1.33,3
Super Nova,8,2,5,1,12,11,1,11,Latvia - Virsliga,0.25,0.88,1,1.5,1.38,1.38,4.0,1.14,4
FS Jelgava,8,3,2,3,8,8,0,11,Latvia - Virsliga,0.38,0.62,0,1.0,1.0,1.38,2.63,1.61,4
Grobina,8,3,2,3,7,11,-4,11,Latvia - Virsliga,0.38,0.62,-4,0.88,1.38,1.38,2.63,1.61,4
Auda,8,2,3,3,10,10,0,9,Latvia - Virsliga,0.25,0.62,0,1.25,1.25,1.12,4.0,1.61,5
Daugavpils,8,2,2,4,6,12,-6,8,Latvia - Virsliga,0.25,0.5,-6,0.75,1.5,1.0,4.0,2.0,6
Tukums,8,1,3,4,8,15,-7,6,Latvia - Virsliga,0.12,0.5,-7,1.0,1.88,0.75,8.33,2.0,7
Metta,8,0,1,7,4,20,-16,1,Latvia - Virsliga,0.0,0.12,-16,0.5,2.5,0.12,0.0,8.33,8
Kauno Zalgiris,8,7,0,1,19,3,16,21,Lithuania - A Lyga,0.88,0.88,16,2.38,0.38,2.62,1.14,1.14,1
Suduva,8,4,3,1,14,6,8,15,Lithuania - A Lyga,0.5,0.88,8,1.75,0.75,1.88,2.0,1.14,2
Hegelmann L.,8,5,0,3,13,13,0,15,Lithuania - A Lyga,0.62,0.62,0,1.62,1.62,1.88,1.61,1.61,2
Panevezys,8,4,2,2,14,8,6,14,Lithuania - A Lyga,0.5,0.75,6,1.75,1.0,1.75,2.0,1.33,3
Siauliai,8,4,2,2,11,11,0,14,Lithuania - A Lyga,0.5,0.75,0,1.38,1.38,1.75,2.0,1.33,3
Dziugas Telsiai,8,3,2,3,6,5,1,11,Lithuania - A Lyga,0.38,0.62,1,0.75,0.62,1.38,2.63,1.61,4
Banga,8,3,1,4,6,9,-3,10,Lithuania - A Lyga,0.38,0.5,-3,0.75,1.12,1.25,2.63,2.0,5
Zalgiris,8,2,2,4,10,12,-2,8,Lithuania - A Lyga,0.25,0.5,-2,1.25,1.5,1.0,4.0,2.0,6
Riteriai,8,0,2,6,7,20,-13,2,Lithuania - A Lyga,0.0,0.25,-13,0.88,2.5,0.25,0.0,4.0,7
Dainava,8,0,2,6,5,18,-13,2,Lithuania - A Lyga,0.0,0.25,-13,0.62,2.25,0.25,0.0,4.0,7
TransINVEST,8,7,0,1,21,6,15,21,Lithuania - 1st League,0.88,0.88,15,2.62,0.75,2.62,1.14,1.14,1
Zalgiris B,8,6,1,1,21,11,10,19,Lithuania - 1st League,0.75,0.88,10,2.62,1.38,2.38,1.33,1.14,2
Tauras,8,5,3,0,12,4,8,18,Lithuania - 1st League,0.62,1.0,8,1.5,0.5,2.25,1.61,1.0,3
BFA Vilnius,8,5,1,2,17,11,6,16,Lithuania - 1st League,0.62,0.75,6,2.12,1.38,2.0,1.61,1.33,4
Babrungas,8,4,3,1,16,10,6,15,Lithuania - 1st League,0.5,0.88,6,2.0,1.25,1.88,2.0,1.14,5
Minija,8,5,0,3,9,9,0,15,Lithuania - 1st League,0.62,0.62,0,1.12,1.12,1.88,1.61,1.61,5
Neptuna K.,8,4,2,2,12,8,4,14,Lithuania - 1st League,0.5,0.75,4,1.5,1.0,1.75,2.0,1.33,6
Jonava,8,3,1,4,8,8,0,10,Lithuania - 1st League,0.38,0.5,0,1.0,1.0,1.25,2.63,2.0,7
Kauno Z. B,8,3,1,4,13,15,-2,10,Lithuania - 1st League,0.38,0.5,-2,1.62,1.88,1.25,2.63,2.0,7
Ekranas,8,3,1,4,11,14,-3,10,Lithuania - 1st League,0.38,0.5,-3,1.38,1.75,1.25,2.63,2.0,7
Siauliai B,8,2,1,5,14,19,-5,7,Lithuania - 1st League,0.25,0.38,-5,1.75,2.38,0.88,4.0,2.63,8
Panevezys B,8,2,1,5,9,16,-7,7,Lithuania - 1st League,0.25,0.38,-7,1.12,2.0,0.88,4.0,2.63,8
Nevezis,8,2,0,6,10,19,-9,6,Lithuania - 1st League,0.25,0.25,-9,1.25,2.38,0.75,4.0,4.0,9
Atmosfera,8,1,2,5,8,13,-5,5,Lithuania - 1st League,0.12,0.38,-5,1.0,1.62,0.62,8.33,2.63,10
Hegelmann B,8,1,2,5,8,17,-9,5,Lithuania - 1st League,0.12,0.38,-9,1.0,2.12,0.62,8.33,2.63,10
Be1 NFA,8,1,1,6,7,16,-9,4,Lithuania - 1st League,0.12,0.25,-9,0.88,2.0,0.5,8.33,4.0,11
UNA Strassen,8,6,0,2,20,5,15,18,Luxembourg - National Division,0.75,0.75,15,2.5,0.62,2.25,1.33,1.33,1
Mondorf,8,6,0,2,17,9,8,18,Luxembourg - National Division,0.75,0.75,8,2.12,1.12,2.25,1.33,1.33,1
Differdange,8,5,2,1,14,2,12,17,Luxembourg - National Division,0.62,0.88,12,1.75,0.25,2.12,1.61,1.14,2
Racing,8,5,2,1,14,3,11,17,Luxembourg - National Division,0.62,0.88,11,1.75,0.38,2.12,1.61,1.14,2
Niedercorn,8,5,0,3,16,8,8,15,Luxembourg - National Division,0.62,0.62,8,2.0,1.0,1.88,1.61,1.61,3
Rodange,8,4,3,1,11,6,5,15,Luxembourg - National Division,0.5,0.88,5,1.38,0.75,1.88,2.0,1.14,3
Hesperange,8,4,0,4,12,14,-2,12,Luxembourg - National Division,0.5,0.5,-2,1.5,1.75,1.5,2.0,2.0,4
Dudelange,8,3,2,3,17,9,8,11,Luxembourg - National Division,0.38,0.62,8,2.12,1.12,1.38,2.63,1.61,5
Petange,8,3,1,4,14,15,-1,10,Luxembourg - National Division,0.38,0.5,-1,1.75,1.88,1.25,2.63,2.0,6
Jeunesse Esch,8,3,1,4,8,13,-5,10,Luxembourg - National Division,0.38,0.5,-5,1.0,1.62,1.25,2.63,2.0,6
Wiltz,8,2,3,3,12,17,-5,9,Luxembourg - National Division,0.25,0.62,-5,1.5,2.12,1.12,4.0,1.61,7
Hostert,8,2,3,3,10,21,-11,9,Luxembourg - National Division,0.25,0.62,-11,1.25,2.62,1.12,4.0,1.61,7
V. Rosport,8,2,2,4,8,12,-4,8,Luxembourg - National Division,0.25,0.5,-4,1.0,1.5,1.0,4.0,2.0,8
Fola Esch,8,2,0,6,6,16,-10,6,Luxembourg - National Division,0.25,0.25,-10,0.75,2.0,0.75,4.0,4.0,9
Bettembourg,8,1,1,6,6,16,-10,4,Luxembourg - National Division,0.12,0.25,-10,0.75,2.0,0.5,8.33,4.0,10
Mondercange,8,1,0,7,6,25,-19,3,Luxembourg - National Division,0.12,0.12,-19,0.75,3.12,0.38,8.33,8.33,11
Johor Darul,8,8,0,0,31,1,30,24,Malaysia - Super League,1.0,1.0,30,3.88,0.12,3.0,1.0,1.0,1
Selangor,8,5,2,1,15,3,12,17,Malaysia - Super League,0.62,0.88,12,1.88,0.38,2.12,1.61,1.14,2
Kuching,8,5,2,1,16,7,9,17,Malaysia - Super League,0.62,0.88,9,2.0,0.88,2.12,1.61,1.14,2
Kuala Lumpur,8,4,2,2,15,11,4,14,Malaysia - Super League,0.5,0.75,4,1.88,1.38,1.75,2.0,1.33,3
Pahang,8,4,1,3,16,14,2,13,Malaysia - Super League,0.5,0.62,2,2.0,1.75,1.62,2.0,1.61,4
Perak,8,3,3,2,14,8,6,12,Malaysia - Super League,0.38,0.75,6,1.75,1.0,1.5,2.63,1.33,5
Pulau Pinang,8,3,3,2,16,12,4,12,Malaysia - Super League,0.38,0.75,4,2.0,1.5,1.5,2.63,1.33,5
Terengganu,8,3,2,3,15,9,6,11,Malaysia - Super League,0.38,0.62,6,1.88,1.12,1.38,2.63,1.61,6
Sabah,8,2,5,1,9,8,1,11,Malaysia - Super League,0.25,0.88,1,1.12,1.0,1.38,4.0,1.14,6
Negeri Sembilan,8,2,1,5,7,12,-5,7,Malaysia - Super League,0.25,0.38,-5,0.88,1.5,0.88,4.0,2.63,7
PDRM,8,2,0,6,5,15,-10,6,Malaysia - Super League,0.25,0.25,-10,0.62,1.88,0.75,4.0,4.0,8
Kedah,8,1,1,6,5,24,-19,4,Malaysia - Super League,0.12,0.25,-19,0.62,3.0,0.5,8.33,4.0,9
Kelantan United,8,0,0,8,4,40,-36,0,Malaysia - Super League,0.0,0.0,-36,0.5,5.0,0.0,0.0,0.0,10
Mosta,8,5,1,2,11,9,2,16,Malta - Premier League,0.62,0.75,2,1.38,1.12,2.0,1.61,1.33,1
Floriana,8,4,3,1,11,7,4,15,Malta - Premier League,0.5,0.88,4,1.38,0.88,1.88,2.0,1.14,2
Birkirkara,8,4,2,2,12,5,7,14,Malta - Premier League,0.5,0.75,7,1.5,0.62,1.75,2.0,1.33,3
Hibernians,8,4,2,2,13,12,1,14,Malta - Premier League,0.5,0.75,1,1.62,1.5,1.75,2.0,1.33,3
Marsaxlokk,8,4,1,3,13,6,7,13,Malta - Premier League,0.5,0.62,7,1.62,0.75,1.62,2.0,1.61,4
Sliema,8,4,0,4,13,12,1,12,Malta - Premier League,0.5,0.5,1,1.62,1.5,1.5,2.0,2.0,5
Hamrun Spartans,8,3,1,4,7,6,1,10,Malta - Premier League,0.38,0.5,1,0.88,0.75,1.25,2.63,2.0,6
Naxxar Lions,8,3,1,4,11,15,-4,10,Malta - Premier League,0.38,0.5,-4,1.38,1.88,1.25,2.63,2.0,6
Zabbar,8,2,2,4,10,9,1,8,Malta - Premier League,0.25,0.5,1,1.25,1.12,1.0,4.0,2.0,7
Gzira Utd,8,2,2,4,5,13,-8,8,Malta - Premier League,0.25,0.5,-8,0.62,1.62,1.0,4.0,2.0,7
Balzan,8,1,4,3,6,8,-2,7,Malta - Premier League,0.12,0.62,-2,0.75,1.0,0.88,8.33,1.61,8
Melita,8,1,3,4,10,20,-10,6,Malta - Premier League,0.12,0.5,-10,1.25,2.5,0.75,8.33,2.0,9
Cruz Azul,8,6,2,0,20,6,14,20,Mexico - Liga MX - Apertura,0.75,1.0,14,2.5,0.75,2.5,1.33,1.0,1
Toluca,8,5,2,1,21,7,14,17,Mexico - Liga MX - Apertura,0.62,0.88,14,2.62,0.88,2.12,1.61,1.14,2
A. San Luis,8,5,1,2,12,8,4,16,Mexico - Liga MX - Apertura,0.62,0.75,4,1.5,1.0,2.0,1.61,1.33,3
Pumas UNAM,8,4,3,1,8,3,5,15,Mexico - Liga MX - Apertura,0.5,0.88,5,1.0,0.38,1.88,2.0,1.14,4
Tijuana,8,4,3,1,10,9,1,15,Mexico - Liga MX - Apertura,0.5,0.88,1,1.25,1.12,1.88,2.0,1.14,4
CF America,8,4,2,2,15,10,5,14,Mexico - Liga MX - Apertura,0.5,0.75,5,1.88,1.25,1.75,2.0,1.33,5
Tigres,8,4,2,2,13,11,2,14,Mexico - Liga MX - Apertura,0.5,0.75,2,1.62,1.38,1.75,2.0,1.33,5
Juarez,8,4,1,3,13,15,-2,13,Mexico - Liga MX - Apertura,0.5,0.62,-2,1.62,1.88,1.62,2.0,1.61,6
Monterrey,8,3,3,2,12,7,5,12,Mexico - Liga MX - Apertura,0.38,0.75,5,1.5,0.88,1.5,2.63,1.33,7
Club Leon,8,2,5,1,13,9,4,11,Mexico - Liga MX - Apertura,0.25,0.88,4,1.62,1.12,1.38,4.0,1.14,8
Guadalajara,8,3,2,3,10,8,2,11,Mexico - Liga MX - Apertura,0.38,0.62,2,1.25,1.0,1.38,2.63,1.61,8
Queretaro,8,2,2,4,7,13,-6,8,Mexico - Liga MX - Apertura,0.25,0.5,-6,0.88,1.62,1.0,4.0,2.0,9
Atlas,8,1,5,2,6,12,-6,8,Mexico - Liga MX - Apertura,0.12,0.75,-6,0.75,1.5,1.0,8.33,1.33,9
Mazatlan,8,1,4,3,4,9,-5,7,Mexico - Liga MX - Apertura,0.12,0.62,-5,0.5,1.12,0.88,8.33,1.61,10
Pachuca,8,1,1,6,12,16,-4,4,Mexico - Liga MX - Apertura,0.12,0.25,-4,1.5,2.0,0.5,8.33,4.0,11
Necaxa,8,0,3,5,7,18,-11,3,Mexico - Liga MX - Apertura,0.0,0.38,-11,0.88,2.25,0.38,0.0,2.63,12
Puebla,8,1,0,7,7,18,-11,3,Mexico - Liga MX - Apertura,0.12,0.12,-11,0.88,2.25,0.38,8.33,8.33,12
Santos Laguna,8,0,2,6,4,16,-12,2,Mexico - Liga MX - Apertura,0.0,0.25,-12,0.5,2.0,0.25,0.0,4.0,13
Toluca,8,6,1,1,19,12,7,19,Mexico - Liga MX - Clausura,0.75,0.88,7,2.38,1.5,2.38,1.33,1.14,1
Tigres,8,5,2,1,10,6,4,17,Mexico - Liga MX - Clausura,0.62,0.88,4,1.25,0.75,2.12,1.61,1.14,2
Monterrey,8,5,1,2,16,9,7,16,Mexico - Liga MX - Clausura,0.62,0.75,7,2.0,1.12,2.0,1.61,1.33,3
Cruz Azul,8,4,4,0,13,7,6,16,Mexico - Liga MX - Clausura,0.5,1.0,6,1.62,0.88,2.0,2.0,1.0,3
CF America,8,4,2,2,14,3,11,14,Mexico - Liga MX - Clausura,0.5,0.75,11,1.75,0.38,1.75,2.0,1.33,4
Queretaro,8,4,1,3,9,7,2,13,Mexico - Liga MX - Clausura,0.5,0.62,2,1.12,0.88,1.62,2.0,1.61,5
Necaxa,8,4,1,3,15,16,-1,13,Mexico - Liga MX - Clausura,0.5,0.62,-1,1.88,2.0,1.62,2.0,1.61,5
Pachuca,8,3,3,2,16,12,4,12,Mexico - Liga MX - Clausura,0.38,0.75,4,2.0,1.5,1.5,2.63,1.33,6
Tijuana,8,4,0,4,16,14,2,12,Mexico - Liga MX - Clausura,0.5,0.5,2,2.0,1.75,1.5,2.0,2.0,6
A. San Luis,8,4,0,4,10,13,-3,12,Mexico - Liga MX - Clausura,0.5,0.5,-3,1.25,1.62,1.5,2.0,2.0,6
Atlas,8,3,2,3,16,16,0,11,Mexico - Liga MX - Clausura,0.38,0.62,0,2.0,2.0,1.38,2.63,1.61,7
Pumas UNAM,8,3,1,4,11,11,0,10,Mexico - Liga MX - Clausura,0.38,0.5,0,1.38,1.38,1.25,2.63,2.0,8
Guadalajara,8,2,4,2,6,7,-1,10,Mexico - Liga MX - Clausura,0.25,0.75,-1,0.75,0.88,1.25,4.0,1.33,8
Juarez,8,1,5,2,8,9,-1,8,Mexico - Liga MX - Clausura,0.12,0.75,-1,1.0,1.12,1.0,8.33,1.33,9
Club Leon,8,2,1,5,8,12,-4,7,Mexico - Liga MX - Clausura,0.25,0.38,-4,1.0,1.5,0.88,4.0,2.63,10
Mazatlan,8,1,3,4,7,15,-8,6,Mexico - Liga MX - Clausura,0.12,0.5,-8,0.88,1.88,0.75,8.33,2.0,11
Santos Laguna,8,1,0,7,8,21,-13,3,Mexico - Liga MX - Clausura,0.12,0.12,-13,1.0,2.62,0.38,8.33,8.33,12
Puebla,8,0,1,7,1,13,-12,1,Mexico - Liga MX - Clausura,0.0,0.12,-12,0.12,1.62,0.12,0.0,8.33,13
Buducnost,8,6,1,1,24,8,16,19,Montenegro - First League,0.75,0.88,16,3.0,1.0,2.38,1.33,1.14,1
Jedinstvo,8,3,4,1,15,12,3,13,Montenegro - First League,0.38,0.88,3,1.88,1.5,1.62,2.63,1.14,2
Otrant,8,3,3,2,17,12,5,12,Montenegro - First League,0.38,0.75,5,2.12,1.5,1.5,2.63,1.33,3
Sutjeska,8,3,2,3,10,10,0,11,Montenegro - First League,0.38,0.62,0,1.25,1.25,1.38,2.63,1.61,4
Decic,8,2,4,2,9,8,1,10,Montenegro - First League,0.25,0.75,1,1.12,1.0,1.25,4.0,1.33,5
Jezero,8,2,4,2,9,9,0,10,Montenegro - First League,0.25,0.75,0,1.12,1.12,1.25,4.0,1.33,5
Petrovac,8,2,2,4,7,9,-2,8,Montenegro - First League,0.25,0.5,-2,0.88,1.12,1.0,4.0,2.0,6
Mornar Bar,8,2,1,5,7,13,-6,7,Montenegro - First League,0.25,0.38,-6,0.88,1.62,0.88,4.0,2.63,7
Arsenal Tivat,8,1,4,3,5,14,-9,7,Montenegro - First League,0.12,0.62,-9,0.62,1.75,0.88,8.33,1.61,7
Bokelj,8,2,1,5,6,16,-10,7,Montenegro - First League,0.25,0.38,-10,0.75,2.0,0.88,4.0,2.63,7
Berkane,8,5,2,1,11,3,8,17,morocco,0.62,0.88,8,1.38,0.38,2.12,1.61,1.14,1
Difaa El Jadida,8,4,3,1,9,5,4,15,morocco,0.5,0.88,4,1.12,0.62,1.88,2.0,1.14,2
Wydad,8,3,5,0,13,5,8,14,morocco,0.38,1.0,8,1.62,0.62,1.75,2.63,1.0,3
FUS Rabat,8,4,2,2,13,8,5,14,morocco,0.5,0.75,5,1.62,1.0,1.75,2.0,1.33,3
Raja Casablanca,8,3,5,0,9,5,4,14,morocco,0.38,1.0,4,1.12,0.62,1.75,2.63,1.0,3
FAR Rabat,8,4,2,2,11,9,2,14,morocco,0.5,0.75,2,1.38,1.12,1.75,2.0,1.33,3
Meknes,8,3,3,2,9,7,2,12,morocco,0.38,0.75,2,1.12,0.88,1.5,2.63,1.33,4
Union Touarga,8,3,3,2,9,7,2,12,morocco,0.38,0.75,2,1.12,0.88,1.5,2.63,1.33,4
Olympic Safi,8,2,4,2,7,7,0,10,morocco,0.25,0.75,0,0.88,0.88,1.25,4.0,1.33,5
Maghreb de Fes,8,2,4,2,8,10,-2,10,morocco,0.25,0.75,-2,1.0,1.25,1.25,4.0,1.33,5
Hassania Agadir,8,2,3,3,11,9,2,9,morocco,0.25,0.62,2,1.38,1.12,1.12,4.0,1.61,6
Moghreb Tetouan,8,2,3,3,8,10,-2,9,morocco,0.25,0.62,-2,1.0,1.25,1.12,4.0,1.61,6
R. Zemamra,8,3,0,5,6,10,-4,9,morocco,0.38,0.38,-4,0.75,1.25,1.12,2.63,2.63,6
Ittihad Tanger,8,2,2,4,11,14,-3,8,morocco,0.25,0.5,-3,1.38,1.75,1.0,4.0,2.0,7
JS Sousalem,8,0,1,7,4,17,-13,1,morocco,0.0,0.12,-13,0.5,2.12,0.12,0.0,8.33,8
C. Mohammedia,8,0,1,7,3,17,-14,1,morocco,0.0,0.12,-14,0.38,2.12,0.12,0.0,8.33,8
Shan Utd,8,7,1,0,24,2,22,22,myanmar,0.88,1.0,22,3.0,0.25,2.75,1.14,1.0,1
Yangon Utd,8,5,2,1,21,6,15,17,myanmar,0.62,0.88,15,2.62,0.75,2.12,1.61,1.14,2
Sagaing Utd,8,4,2,2,16,13,3,14,myanmar,0.5,0.75,3,2.0,1.62,1.75,2.0,1.33,3
Thitsar Arman,8,4,1,3,15,12,3,13,myanmar,0.5,0.62,3,1.88,1.5,1.62,2.0,1.61,4
Yadanarbon,8,3,3,2,18,15,3,12,myanmar,0.38,0.75,3,2.25,1.88,1.5,2.63,1.33,5
Dagon,8,3,2,3,10,11,-1,11,myanmar,0.38,0.62,-1,1.25,1.38,1.38,2.63,1.61,6
Hantharwady,8,3,2,3,7,11,-4,11,myanmar,0.38,0.62,-4,0.88,1.38,1.38,2.63,1.61,6
Rakhine Utd,8,3,2,3,10,16,-6,11,myanmar,0.38,0.62,-6,1.25,2.0,1.38,2.63,1.61,6
Ayeyawady,8,2,0,6,9,16,-7,6,myanmar,0.25,0.25,-7,1.12,2.0,0.75,4.0,4.0,7
Ispe FC,8,1,3,4,4,14,-10,6,myanmar,0.12,0.5,-10,0.5,1.75,0.75,8.33,2.0,7
Dagon Port,8,1,2,5,12,21,-9,5,myanmar,0.12,0.38,-9,1.5,2.62,0.62,8.33,2.63,8
Myawady,8,1,2,5,11,20,-9,5,myanmar,0.12,0.38,-9,1.38,2.5,0.62,8.33,2.63,8
PSV Eindhoven,8,7,0,1,25,9,16,21,netherlands,0.88,0.88,16,3.12,1.12,2.62,1.14,1.14,1
Feyenoord,8,6,0,2,19,7,12,18,netherlands,0.75,0.75,12,2.38,0.88,2.25,1.33,1.33,2
FC Utrecht,8,4,3,1,16,6,10,15,netherlands,0.5,0.88,10,2.0,0.75,1.88,2.0,1.14,3
PEC Zwolle,8,4,3,1,13,10,3,15,netherlands,0.5,0.88,3,1.62,1.25,1.88,2.0,1.14,3
Sparta,8,4,2,2,14,8,6,14,netherlands,0.5,0.75,6,1.75,1.0,1.75,2.0,1.33,4
NEC Nijmegen,8,4,2,2,14,9,5,14,netherlands,0.5,0.75,5,1.75,1.12,1.75,2.0,1.33,4
Ajax Amsterdam,8,4,2,2,12,12,0,14,netherlands,0.5,0.75,0,1.5,1.5,1.75,2.0,1.33,4
AZ Alkmaar,8,3,3,2,13,8,5,12,netherlands,0.38,0.75,5,1.62,1.0,1.5,2.63,1.33,5
Heerenveen,8,4,0,4,10,11,-1,12,netherlands,0.5,0.5,-1,1.25,1.38,1.5,2.0,2.0,5
Heracles Almelo,8,3,1,4,9,16,-7,10,netherlands,0.38,0.5,-7,1.12,2.0,1.25,2.63,2.0,6
Fortuna Sittard,8,2,3,3,5,11,-6,9,netherlands,0.25,0.62,-6,0.62,1.38,1.12,4.0,1.61,7
FC Twente,8,2,2,4,10,12,-2,8,netherlands,0.25,0.5,-2,1.25,1.5,1.0,4.0,2.0,8
RKC Waalwijk,8,2,2,4,12,20,-8,8,netherlands,0.25,0.5,-8,1.5,2.5,1.0,4.0,2.0,8
FC Groningen,8,2,1,5,15,19,-4,7,netherlands,0.25,0.38,-4,1.88,2.38,0.88,4.0,2.63,9
Go Ahead Eagles,8,1,4,3,10,15,-5,7,netherlands,0.12,0.62,-5,1.25,1.88,0.88,8.33,1.61,9
Almere City,8,1,4,3,7,14,-7,7,netherlands,0.12,0.62,-7,0.88,1.75,0.88,8.33,1.61,9
NAC Breda,8,0,4,4,6,14,-8,4,netherlands,0.0,0.5,-8,0.75,1.75,0.5,0.0,2.0,10
Willem II,8,0,2,6,6,14,-8,2,netherlands,0.0,0.25,-8,0.75,1.75,0.25,0.0,4.0,11
Excelsior,8,7,0,1,21,5,16,21,netherlands2,0.88,0.88,16,2.62,0.62,2.62,1.14,1.14,1
FC Volendam,8,6,0,2,19,13,6,18,netherlands2,0.75,0.75,6,2.38,1.62,2.25,1.33,1.33,2
Telstar,8,5,2,1,18,8,10,17,netherlands2,0.62,0.88,10,2.25,1.0,2.12,1.61,1.14,3
Cambuur,8,5,1,2,15,15,0,16,netherlands2,0.62,0.75,0,1.88,1.88,2.0,1.61,1.33,4
FC Dordrecht,8,5,0,3,19,6,13,15,netherlands2,0.62,0.62,13,2.38,0.75,1.88,1.61,1.61,5
ADO Den Haag,8,4,3,1,19,12,7,15,netherlands2,0.5,0.88,7,2.38,1.5,1.88,2.0,1.14,5
Jong AZ,8,3,4,1,15,10,5,13,netherlands2,0.38,0.88,5,1.88,1.25,1.62,2.63,1.14,6
De Graafschap,8,4,1,3,13,9,4,13,netherlands2,0.5,0.62,4,1.62,1.12,1.62,2.0,1.61,6
FC Den Bosch,8,3,3,2,11,12,-1,12,netherlands2,0.38,0.75,-1,1.38,1.5,1.5,2.63,1.33,7
FC Eindhoven,8,3,3,2,12,14,-2,12,netherlands2,0.38,0.75,-2,1.5,1.75,1.5,2.63,1.33,7
FC Emmen,8,4,0,4,10,12,-2,12,netherlands2,0.5,0.5,-2,1.25,1.5,1.5,2.0,2.0,7
VVV,8,3,2,3,15,14,1,11,netherlands2,0.38,0.62,1,1.88,1.75,1.38,2.63,1.61,8
Vitesse Arnhem,8,2,3,3,12,10,2,9,netherlands2,0.25,0.62,2,1.5,1.25,1.12,4.0,1.61,9
TOP Oss,8,2,3,3,9,11,-2,9,netherlands2,0.25,0.62,-2,1.12,1.38,1.12,4.0,1.61,9
MVV Maastricht,8,2,1,5,10,11,-1,7,netherlands2,0.25,0.38,-1,1.25,1.38,0.88,4.0,2.63,10
Jong PSV,8,2,1,5,12,23,-11,7,netherlands2,0.25,0.38,-11,1.5,2.88,0.88,4.0,2.63,10
Jong Ajax,8,1,2,5,3,12,-9,5,netherlands2,0.12,0.38,-9,0.38,1.5,0.62,8.33,2.63,11
Jong Utrecht,8,1,2,5,6,18,-12,5,netherlands2,0.12,0.38,-12,0.75,2.25,0.62,8.33,2.63,11
Helmond Sport,8,0,4,4,8,16,-8,4,netherlands2,0.0,0.5,-8,1.0,2.0,0.5,0.0,2.0,12
Roda JC,8,1,1,6,6,17,-11,4,netherlands2,0.12,0.25,-11,0.75,2.12,0.5,8.33,4.0,12
Diriangen,8,7,1,0,29,1,28,22,nicaragua,0.88,1.0,28,3.62,0.12,2.75,1.14,1.0,1
Matagalpa,8,6,1,1,16,6,10,19,nicaragua,0.75,0.88,10,2.0,0.75,2.38,1.33,1.14,2
Real Esteli,8,4,3,1,13,9,4,15,nicaragua,0.5,0.88,4,1.62,1.12,1.88,2.0,1.14,3
Walter Ferreti,8,3,3,2,7,6,1,12,nicaragua,0.38,0.75,1,0.88,0.75,1.5,2.63,1.33,4
Managua FC,8,3,1,4,11,10,1,10,nicaragua,0.38,0.5,1,1.38,1.25,1.25,2.63,2.0,5
UNAN Managua,8,3,1,4,9,15,-6,10,nicaragua,0.38,0.5,-6,1.12,1.88,1.25,2.63,2.0,5
Jalapa,8,2,3,3,6,13,-7,9,nicaragua,0.25,0.62,-7,0.75,1.62,1.12,4.0,1.61,6
Export Sebaco,8,2,2,4,9,10,-1,8,nicaragua,0.25,0.5,-1,1.12,1.25,1.0,4.0,2.0,7
Rancho Santana,8,1,1,6,6,20,-14,4,nicaragua,0.12,0.25,-14,0.75,2.5,0.5,8.33,4.0,8
D. Ocotal,8,1,1,6,6,21,-15,4,nicaragua,0.12,0.25,-15,0.75,2.62,0.5,8.33,4.0,8
Real Esteli,8,8,0,0,20,10,10,24,nicaragua2,1.0,1.0,10,2.5,1.25,3.0,1.0,1.0,1
Managua FC,8,5,0,3,19,9,10,15,nicaragua2,0.62,0.62,10,2.38,1.12,1.88,1.61,1.61,2
Matagalpa,8,3,3,2,15,12,3,12,nicaragua2,0.38,0.75,3,1.88,1.5,1.5,2.63,1.33,3
Walter Ferreti,8,3,3,2,10,7,3,12,nicaragua2,0.38,0.75,3,1.25,0.88,1.5,2.63,1.33,3
Diriangen,8,3,2,3,12,14,-2,11,nicaragua2,0.38,0.62,-2,1.5,1.75,1.38,2.63,1.61,4
CS Sebaco,8,2,3,3,9,11,-2,9,nicaragua2,0.25,0.62,-2,1.12,1.38,1.12,4.0,1.61,5
Jalapa,8,2,2,4,10,11,-1,8,nicaragua2,0.25,0.5,-1,1.25,1.38,1.0,4.0,2.0,6
UNAN Managua,8,2,2,4,11,13,-2,8,nicaragua2,0.25,0.5,-2,1.38,1.62,1.0,4.0,2.0,6
D. Ocotal,8,2,1,5,9,16,-7,7,nicaragua2,0.25,0.38,-7,1.12,2.0,0.88,4.0,2.63,7
Rancho Santana,8,0,4,4,4,15,-11,4,nicaragua2,0.0,0.5,-11,0.5,1.88,0.5,0.0,2.0,8
Linfield,8,6,0,2,15,5,10,18,northernireland,0.75,0.75,10,1.88,0.62,2.25,1.33,1.33,1
Cliftonville,8,5,1,2,19,7,12,16,northernireland,0.62,0.75,12,2.38,0.88,2.0,1.61,1.33,2
Larne,8,3,5,0,11,8,3,14,northernireland,0.38,1.0,3,1.38,1.0,1.75,2.63,1.0,3
Portadown,8,4,2,2,11,9,2,14,northernireland,0.5,0.75,2,1.38,1.12,1.75,2.0,1.33,3
Coleraine,8,3,2,3,10,12,-2,11,northernireland,0.38,0.62,-2,1.25,1.5,1.38,2.63,1.61,4
Dungannon,8,3,2,3,10,12,-2,11,northernireland,0.38,0.62,-2,1.25,1.5,1.38,2.63,1.61,4
Glentoran,8,2,3,3,11,9,2,9,northernireland,0.25,0.62,2,1.38,1.12,1.12,4.0,1.61,5
Glenavon,8,2,2,4,10,10,0,8,northernireland,0.25,0.5,0,1.25,1.25,1.0,4.0,2.0,6
Crusaders,8,2,2,4,8,13,-5,8,northernireland,0.25,0.5,-5,1.0,1.62,1.0,4.0,2.0,6
Loughgall,8,2,2,4,10,17,-7,8,northernireland,0.25,0.5,-7,1.25,2.12,1.0,4.0,2.0,6
Ballymena Utd,8,2,1,5,10,16,-6,7,northernireland,0.25,0.38,-6,1.25,2.0,0.88,4.0,2.63,7
Carrick Rangers,8,1,3,4,8,15,-7,6,northernireland,0.12,0.5,-7,1.0,1.88,0.75,8.33,2.0,8
Annagh Utd,8,8,0,0,20,6,14,24,northernireland2,1.0,1.0,14,2.5,0.75,3.0,1.0,1.0,1
Newington,8,5,2,1,21,16,5,17,northernireland2,0.62,0.88,5,2.62,2.0,2.12,1.61,1.14,2
Bangor,8,4,2,2,17,13,4,14,northernireland2,0.5,0.75,4,2.12,1.62,1.75,2.0,1.33,3
Limavady,8,3,4,1,12,9,3,13,northernireland2,0.38,0.88,3,1.5,1.12,1.62,2.63,1.14,4
Institute,8,4,1,3,18,19,-1,13,northernireland2,0.5,0.62,-1,2.25,2.38,1.62,2.0,1.61,4
Ards,8,3,2,3,12,13,-1,11,northernireland2,0.38,0.62,-1,1.5,1.62,1.38,2.63,1.61,5
Ballinamallard,8,3,1,4,8,9,-1,10,northernireland2,0.38,0.5,-1,1.0,1.12,1.25,2.63,2.0,6
HW Welders,8,3,0,5,15,15,0,9,northernireland2,0.38,0.38,0,1.88,1.88,1.12,2.63,2.63,7
Newry City,8,1,3,4,11,17,-6,6,northernireland2,0.12,0.5,-6,1.38,2.12,0.75,8.33,2.0,8
Ballyclare,8,1,2,5,12,19,-7,5,northernireland2,0.12,0.38,-7,1.5,2.38,0.62,8.33,2.63,9
Armagh City,8,1,1,6,14,20,-6,4,northernireland2,0.12,0.25,-6,1.75,2.5,0.5,8.33,4.0,10
Dundela,8,1,1,6,5,14,-9,4,northernireland2,0.12,0.25,-9,0.62,1.75,0.5,8.33,4.0,10
Vardar,8,6,2,0,16,3,13,20,northmacedonia,0.75,1.0,13,2.0,0.38,2.5,1.33,1.0,1
Sileks,8,5,3,0,15,3,12,18,northmacedonia,0.62,1.0,12,1.88,0.38,2.25,1.61,1.0,2
Shkendija,8,5,2,1,18,10,8,17,northmacedonia,0.62,0.88,8,2.25,1.25,2.12,1.61,1.14,3
Brera Strumica,8,4,1,3,15,13,2,13,northmacedonia,0.5,0.62,2,1.88,1.62,1.62,2.0,1.61,4
Struga,8,2,6,0,11,7,4,12,northmacedonia,0.25,1.0,4,1.38,0.88,1.5,4.0,1.0,5
Tikves,8,3,3,2,12,9,3,12,northmacedonia,0.38,0.75,3,1.5,1.12,1.5,2.63,1.33,5
Besa,8,4,0,4,14,15,-1,12,northmacedonia,0.5,0.5,-1,1.75,1.88,1.5,2.0,2.0,5
Pelister,8,3,1,4,11,12,-1,10,northmacedonia,0.38,0.5,-1,1.38,1.5,1.25,2.63,2.0,6
Rabotnicki,8,2,2,4,7,9,-2,8,northmacedonia,0.25,0.5,-2,0.88,1.12,1.0,4.0,2.0,7
Shkupi,8,1,3,4,12,15,-3,6,northmacedonia,0.12,0.5,-3,1.5,1.88,0.75,8.33,2.0,8
Gostivar,8,1,1,6,6,18,-12,4,northmacedonia,0.12,0.25,-12,0.75,2.25,0.5,8.33,4.0,9
Voska Sport,8,0,0,8,1,24,-23,0,northmacedonia,0.0,0.0,-23,0.12,3.0,0.0,0.0,0.0,10
Viking,8,6,2,0,22,9,13,20,norway,0.75,1.0,13,2.75,1.12,2.5,1.33,1.0,1
Brann,8,5,2,1,17,12,5,17,norway,0.62,0.88,5,2.12,1.5,2.12,1.61,1.14,2
Bodo/Glimt,8,5,1,2,20,8,12,16,norway,0.62,0.75,12,2.5,1.0,2.0,1.61,1.33,3
Sandefjord,8,5,0,3,15,12,3,15,norway,0.62,0.62,3,1.88,1.5,1.88,1.61,1.61,4
Fredrikstad,8,4,2,2,11,8,3,14,norway,0.5,0.75,3,1.38,1.0,1.75,2.0,1.33,5
Rosenborg,8,3,4,1,8,6,2,13,norway,0.38,0.88,2,1.0,0.75,1.62,2.63,1.14,6
Tromso,8,4,1,3,15,14,1,13,norway,0.5,0.62,1,1.88,1.75,1.62,2.0,1.61,6
Bryne,8,4,0,4,15,17,-2,12,norway,0.5,0.5,-2,1.88,2.12,1.5,2.0,2.0,7
Molde,8,3,2,3,11,7,4,11,norway,0.38,0.62,4,1.38,0.88,1.38,2.63,1.61,8
Sarpsborg 08,8,2,4,2,13,9,4,10,norway,0.25,0.75,4,1.62,1.12,1.25,4.0,1.33,9
Kristiansund,8,3,1,4,9,12,-3,10,norway,0.38,0.5,-3,1.12,1.5,1.25,2.63,2.0,9
HamKam,8,2,2,4,8,16,-8,8,norway,0.25,0.5,-8,1.0,2.0,1.0,4.0,2.0,10
Valerenga,8,2,1,5,8,13,-5,7,norway,0.25,0.38,-5,1.0,1.62,0.88,4.0,2.63,11
Stromsgodset,8,2,0,6,13,16,-3,6,norway,0.25,0.25,-3,1.62,2.0,0.75,4.0,4.0,12
KFUM Oslo,8,0,2,6,4,15,-11,2,norway,0.0,0.25,-11,0.5,1.88,0.25,0.0,4.0,13
Haugesund,8,0,1,7,4,21,-17,1,norway,0.0,0.12,-17,0.5,2.62,0.12,0.0,8.33,14
Lillestrom,8,7,1,0,18,1,17,22,norway2,0.88,1.0,17,2.25,0.12,2.75,1.14,1.0,1
Sogndal,8,5,1,2,16,11,5,16,norway2,0.62,0.75,5,2.0,1.38,2.0,1.61,1.33,2
Start,8,4,2,2,15,10,5,14,norway2,0.5,0.75,5,1.88,1.25,1.75,2.0,1.33,3
Kongsvinger,8,4,1,3,18,11,7,13,norway2,0.5,0.62,7,2.25,1.38,1.62,2.0,1.61,4
Aalesund,8,3,4,1,13,9,4,13,norway2,0.38,0.88,4,1.62,1.12,1.62,2.63,1.14,4
Odd,8,4,1,3,12,10,2,13,norway2,0.5,0.62,2,1.5,1.25,1.62,2.0,1.61,4
Ranheim,8,4,1,3,12,10,2,13,norway2,0.5,0.62,2,1.5,1.25,1.62,2.0,1.61,4
Egersund,8,4,1,3,12,11,1,13,norway2,0.5,0.62,1,1.5,1.38,1.62,2.0,1.61,4
Hodd,8,4,1,3,9,9,0,13,norway2,0.5,0.62,0,1.12,1.12,1.62,2.0,1.61,4
Moss,8,4,0,4,10,17,-7,12,norway2,0.5,0.5,-7,1.25,2.12,1.5,2.0,2.0,5
Stabaek,8,3,2,3,11,11,0,11,norway2,0.38,0.62,0,1.38,1.38,1.38,2.63,1.61,6
Raufoss,8,2,4,2,9,10,-1,10,norway2,0.25,0.75,-1,1.12,1.25,1.25,4.0,1.33,7
Asane,8,2,2,4,8,12,-4,8,norway2,0.25,0.5,-4,1.0,1.5,1.0,4.0,2.0,8
Mjondalen,8,1,2,5,7,20,-13,5,norway2,0.12,0.38,-13,0.88,2.5,0.62,8.33,2.63,9
Skeid,8,0,3,5,9,17,-8,3,norway2,0.0,0.38,-8,1.12,2.12,0.38,0.0,2.63,10
Lyn,8,0,1,7,4,13,-9,1,norway2,0.0,0.12,-9,0.5,1.62,0.12,0.0,8.33,11
Sotra,8,5,2,1,20,8,12,17,norway3,0.62,0.88,12,2.5,1.0,2.12,1.61,1.14,1
Sandnes Ulf,8,3,4,1,17,12,5,13,norway3,0.38,0.88,5,2.12,1.5,1.62,2.63,1.14,2
Notodden,8,3,4,1,14,9,5,13,norway3,0.38,0.88,5,1.75,1.12,1.62,2.63,1.14,2
Eik Tonsberg,8,3,4,1,15,12,3,13,norway3,0.38,0.88,3,1.88,1.5,1.62,2.63,1.14,2
Sandviken,8,3,4,1,15,14,1,13,norway3,0.38,0.88,1,1.88,1.75,1.62,2.63,1.14,2
Arendal,8,2,6,0,17,11,6,12,norway3,0.25,1.0,6,2.12,1.38,1.5,4.0,1.0,3
V. Haugesund,8,3,3,2,14,14,0,12,norway3,0.38,0.75,0,1.75,1.75,1.5,2.63,1.33,3
Jerv,8,3,2,3,13,14,-1,11,norway3,0.38,0.62,-1,1.62,1.75,1.38,2.63,1.61,4
Brann B,8,3,1,4,16,23,-7,10,norway3,0.38,0.5,-7,2.0,2.88,1.25,2.63,2.0,5
Flekkeroy,8,2,2,4,17,22,-5,8,norway3,0.25,0.5,-5,2.12,2.75,1.0,4.0,2.0,6
Traef,8,2,2,4,6,11,-5,8,norway3,0.25,0.5,-5,0.75,1.38,1.0,4.0,2.0,6
Pors Grenland,8,1,3,4,11,15,-4,6,norway3,0.12,0.5,-4,1.38,1.88,0.75,8.33,2.0,7
Brattvag,8,1,3,4,19,24,-5,6,norway3,0.12,0.5,-5,2.38,3.0,0.75,8.33,2.0,7
Lysekloster,8,1,2,5,8,13,-5,5,norway3,0.12,0.38,-5,1.0,1.62,0.62,8.33,2.63,8
Strommen,8,6,0,2,18,9,9,18,norway4,0.75,0.75,9,2.25,1.12,2.25,1.33,1.33,1
Ull/Kisa,8,5,2,1,18,11,7,17,norway4,0.62,0.88,7,2.25,1.38,2.12,1.61,1.14,2
Tromsdalen,8,5,2,1,15,11,4,17,norway4,0.62,0.88,4,1.88,1.38,2.12,1.61,1.14,2
Grorud,8,5,1,2,15,10,5,16,norway4,0.62,0.75,5,1.88,1.25,2.0,1.61,1.33,3
Kjelsas,8,4,2,2,12,8,4,14,norway4,0.5,0.75,4,1.5,1.0,1.75,2.0,1.33,4
Levanger,8,3,4,1,15,11,4,13,norway4,0.38,0.88,4,1.88,1.38,1.62,2.63,1.14,5
Eidsvold,8,4,1,3,15,16,-1,13,norway4,0.5,0.62,-1,1.88,2.0,1.62,2.0,1.61,5
Honefoss,8,4,0,4,15,14,1,12,norway4,0.5,0.5,1,1.88,1.75,1.5,2.0,2.0,6
Stjordals-Blink,8,3,0,5,11,12,-1,9,norway4,0.38,0.38,-1,1.38,1.5,1.12,2.63,2.63,7
Strindheim,8,3,0,5,10,19,-9,9,norway4,0.38,0.38,-9,1.25,2.38,1.12,2.63,2.63,7
Asker,8,2,2,4,11,16,-5,8,norway4,0.25,0.5,-5,1.38,2.0,1.0,4.0,2.0,8
Follo,8,2,0,6,11,17,-6,6,norway4,0.25,0.25,-6,1.38,2.12,0.75,4.0,4.0,9
Rana,8,1,2,5,6,11,-5,5,norway4,0.12,0.38,-5,0.75,1.38,0.62,8.33,2.63,10
Alta,8,1,0,7,13,20,-7,3,norway4,0.12,0.12,-7,1.62,2.5,0.38,8.33,8.33,11
Frigg,8,8,0,0,27,7,20,24,norway5,1.0,1.0,20,3.38,0.88,3.0,1.0,1.0,1
Junkeren,8,7,1,0,35,7,28,22,norway5,0.88,1.0,28,4.38,0.88,2.75,1.14,1.0,2
Baerum,8,5,0,3,27,12,15,15,norway5,0.62,0.62,15,3.38,1.5,1.88,1.61,1.61,3
Ullern,8,5,0,3,21,13,8,15,norway5,0.62,0.62,8,2.62,1.62,1.88,1.61,1.61,3
Tromso B,8,5,0,3,18,12,6,15,norway5,0.62,0.62,6,2.25,1.5,1.88,1.61,1.61,3
Gamle Oslo,8,4,2,2,17,9,8,14,norway5,0.5,0.75,8,2.12,1.12,1.75,2.0,1.33,4
Floya,8,4,1,3,18,13,5,13,norway5,0.5,0.62,5,2.25,1.62,1.62,2.0,1.61,5
KFUM B,8,2,3,3,11,10,1,9,norway5,0.25,0.62,1,1.38,1.25,1.12,4.0,1.61,6
Harstad,8,3,0,5,15,16,-1,9,norway5,0.38,0.38,-1,1.88,2.0,1.12,2.63,2.63,6
Ulfstind,8,2,1,5,9,23,-14,7,norway5,0.25,0.38,-14,1.12,2.88,0.88,4.0,2.63,7
Skjervoy,8,2,1,5,12,34,-22,7,norway5,0.25,0.38,-22,1.5,4.25,0.88,4.0,2.63,7
Sortland,8,2,0,6,8,24,-16,6,norway5,0.25,0.25,-16,1.0,3.0,0.75,4.0,4.0,8
Funnefoss/V,8,1,1,6,12,30,-18,4,norway5,0.12,0.25,-18,1.5,3.75,0.5,8.33,4.0,9
Alta B,8,0,2,6,11,31,-20,2,norway5,0.0,0.25,-20,1.38,3.88,0.25,0.0,4.0,10
Trygg/Lade,8,6,2,0,35,8,27,20,norway6,0.75,1.0,27,4.38,1.0,2.5,1.33,1.0,1
Melhus,8,6,1,1,24,5,19,19,norway6,0.75,0.88,19,3.0,0.62,2.38,1.33,1.14,2
Rosenborg B,8,6,1,1,18,9,9,19,norway6,0.75,0.88,9,2.25,1.12,2.38,1.33,1.14,2
Spjelkavik,8,5,2,1,18,8,10,17,norway6,0.62,0.88,10,2.25,1.0,2.12,1.61,1.14,3
Volda,8,4,3,1,22,13,9,15,norway6,0.5,0.88,9,2.75,1.62,1.88,2.0,1.14,4
Kvik Trondheim,8,4,3,1,14,8,6,15,norway6,0.5,0.88,6,1.75,1.0,1.88,2.0,1.14,4
Aalesund B,8,4,0,4,18,26,-8,12,norway6,0.5,0.5,-8,2.25,3.25,1.5,2.0,2.0,5
Byasen,8,2,4,2,15,14,1,10,norway6,0.25,0.75,1,1.88,1.75,1.25,4.0,1.33,6
Molde B,8,3,0,5,18,21,-3,9,norway6,0.38,0.38,-3,2.25,2.62,1.12,2.63,2.63,7
Nardo,8,2,2,4,13,15,-2,8,norway6,0.25,0.5,-2,1.62,1.88,1.0,4.0,2.0,8
Tiller,8,1,2,5,11,22,-11,5,norway6,0.12,0.38,-11,1.38,2.75,0.62,8.33,2.63,9
Ranheim B,8,1,1,6,12,22,-10,4,norway6,0.12,0.25,-10,1.5,2.75,0.5,8.33,4.0,10
Kristiansund B,8,0,3,5,4,29,-25,3,norway6,0.0,0.38,-25,0.5,3.62,0.38,0.0,2.63,11
Surnadal,8,0,2,6,8,28,-20,2,norway6,0.0,0.25,-20,1.0,3.5,0.25,0.0,4.0,12
Lorenskog,8,7,0,1,32,5,27,21,norway7,0.88,0.88,27,4.0,0.62,2.62,1.14,1.14,1
Kongsvinger B,8,6,0,2,25,13,12,18,norway7,0.75,0.75,12,3.12,1.62,2.25,1.33,1.33,2
Lillehammer,8,5,2,1,18,10,8,17,norway7,0.62,0.88,8,2.25,1.25,2.12,1.61,1.14,3
Gjovik-Lyn,8,5,2,1,14,6,8,17,norway7,0.62,0.88,8,1.75,0.75,2.12,1.61,1.14,3
Skedsmo,8,5,0,3,23,13,10,15,norway7,0.62,0.62,10,2.88,1.62,1.88,1.61,1.61,4
Skjetten,8,4,1,3,22,21,1,13,norway7,0.5,0.62,1,2.75,2.62,1.62,2.0,1.61,5
Elverum,8,4,0,4,19,11,8,12,norway7,0.5,0.5,8,2.38,1.38,1.5,2.0,2.0,6
Bjorkelangen,8,4,0,4,12,14,-2,12,norway7,0.5,0.5,-2,1.5,1.75,1.5,2.0,2.0,6
Nordstrand,8,4,0,4,12,17,-5,12,norway7,0.5,0.5,-5,1.5,2.12,1.5,2.0,2.0,6
Lillestrom B,8,3,1,4,15,19,-4,10,norway7,0.38,0.5,-4,1.88,2.38,1.25,2.63,2.0,7
Assiden IF,8,3,0,5,20,20,0,9,norway7,0.38,0.38,0,2.5,2.5,1.12,2.63,2.63,8
Stromsgodset B,8,2,0,6,17,26,-9,6,norway7,0.25,0.25,-9,2.12,3.25,0.75,4.0,4.0,9
Ull/Kisa B,8,1,0,7,9,46,-37,3,norway7,0.12,0.12,-37,1.12,5.75,0.38,8.33,8.33,10
HamKam B,8,0,0,8,8,25,-17,0,norway7,0.0,0.0,-17,1.0,3.12,0.0,0.0,0.0,11
Bjarg,8,8,0,0,35,6,29,24,norway8,1.0,1.0,29,4.38,0.75,3.0,1.0,1.0,1
Fana,8,5,2,1,23,12,11,17,norway8,0.62,0.88,11,2.88,1.5,2.12,1.61,1.14,2
Forde,8,5,2,1,20,10,10,17,norway8,0.62,0.88,10,2.5,1.25,2.12,1.61,1.14,2
OS,8,5,0,3,30,13,17,15,norway8,0.62,0.62,17,3.75,1.62,1.88,1.61,1.61,3
Lyn B,8,4,3,1,18,14,4,15,norway8,0.5,0.88,4,2.25,1.75,1.88,2.0,1.14,3
Gneist,8,3,3,2,21,15,6,12,norway8,0.38,0.75,6,2.62,1.88,1.5,2.63,1.33,4
Sandefjord B,8,3,1,4,18,25,-7,10,norway8,0.38,0.5,-7,2.25,3.12,1.25,2.63,2.0,5
Lyngbo,8,2,3,3,12,13,-1,9,norway8,0.25,0.62,-1,1.5,1.62,1.12,4.0,1.61,6
Fjora,8,3,0,5,16,29,-13,9,norway8,0.38,0.38,-13,2.0,3.62,1.12,2.63,2.63,6
Askoy,8,2,2,4,11,15,-4,8,norway8,0.25,0.5,-4,1.38,1.88,1.0,4.0,2.0,7
Valerenga B,8,2,0,6,15,23,-8,6,norway8,0.25,0.25,-8,1.88,2.88,0.75,4.0,4.0,8
Loddefjord,8,2,0,6,11,21,-10,6,norway8,0.25,0.25,-10,1.38,2.62,0.75,4.0,4.0,8
Fyllingsdalen,8,2,0,6,13,25,-12,6,norway8,0.25,0.25,-12,1.62,3.12,0.75,4.0,4.0,8
Asane B,8,2,0,6,11,33,-22,6,norway8,0.25,0.25,-22,1.38,4.12,0.75,4.0,4.0,8
Vidar,8,6,0,2,29,6,23,18,norway9,0.75,0.75,23,3.62,0.75,2.25,1.33,1.33,1
Viking B,8,6,0,2,21,10,11,18,norway9,0.75,0.75,11,2.62,1.25,2.25,1.33,1.33,1
Madla,8,5,2,1,21,11,10,17,norway9,0.62,0.88,10,2.62,1.38,2.12,1.61,1.14,2
Vindbjart,8,5,0,3,17,14,3,15,norway9,0.62,0.62,3,2.12,1.75,1.88,1.61,1.61,3
Stord,8,4,2,2,14,12,2,14,norway9,0.5,0.75,2,1.75,1.5,1.75,2.0,1.33,4
Hinna,8,4,1,3,25,15,10,13,norway9,0.5,0.62,10,3.12,1.88,1.62,2.0,1.61,5
Torvastad,8,4,1,3,8,18,-10,13,norway9,0.5,0.62,-10,1.0,2.25,1.62,2.0,1.61,5
Djerv,8,3,1,4,21,17,4,10,norway9,0.38,0.5,4,2.62,2.12,1.25,2.63,2.0,6
Brodd,8,3,1,4,13,16,-3,10,norway9,0.38,0.5,-3,1.62,2.0,1.25,2.63,2.0,6
Haugesund B,8,3,0,5,12,16,-4,9,norway9,0.38,0.38,-4,1.5,2.0,1.12,2.63,2.63,7
Vag,8,2,2,4,22,25,-3,8,norway9,0.25,0.5,-3,2.75,3.12,1.0,4.0,2.0,8
Staal Jorpeland,8,2,1,5,17,27,-10,7,norway9,0.25,0.38,-10,2.12,3.38,0.88,4.0,2.63,9
Sola,8,2,1,5,12,30,-18,7,norway9,0.25,0.38,-18,1.5,3.75,0.88,4.0,2.63,9
Sandnes Ulf B,8,1,0,7,8,23,-15,3,norway9,0.12,0.12,-15,1.0,2.88,0.38,8.33,8.33,10
Kvik Halden,8,7,1,0,22,12,10,22,norway10,0.88,1.0,10,2.75,1.5,2.75,1.14,1.0,1
Sarpsborg 08 B,8,5,1,2,22,11,11,16,norway10,0.62,0.75,11,2.75,1.38,2.0,1.61,1.33,2
Fram,8,4,3,1,17,9,8,15,norway10,0.5,0.88,8,2.12,1.12,1.88,2.0,1.14,3
Orn Horten,8,4,2,2,19,10,9,14,norway10,0.5,0.75,9,2.38,1.25,1.75,2.0,1.33,4
Lokomotiv Oslo,8,4,2,2,14,10,4,14,norway10,0.5,0.75,4,1.75,1.25,1.75,2.0,1.33,4
Grei,8,4,1,3,20,13,7,13,norway10,0.5,0.62,7,2.5,1.62,1.62,2.0,1.61,5
Stabaek B,8,3,2,3,9,14,-5,11,norway10,0.38,0.62,-5,1.12,1.75,1.38,2.63,1.61,6
Fredrikstad B,8,3,1,4,19,25,-6,10,norway10,0.38,0.5,-6,2.38,3.12,1.25,2.63,2.0,7
Oppsal,8,2,3,3,13,15,-2,9,norway10,0.25,0.62,-2,1.62,1.88,1.12,4.0,1.61,8
Odd B,8,3,0,5,18,22,-4,9,norway10,0.38,0.38,-4,2.25,2.75,1.12,2.63,2.63,8
Pors Grenland B,8,2,2,4,11,14,-3,8,norway10,0.25,0.5,-3,1.38,1.75,1.0,4.0,2.0,9
IF Ready,8,2,1,5,10,16,-6,7,norway10,0.25,0.38,-6,1.25,2.0,0.88,4.0,2.63,10
Drobak-Frogn,8,1,3,4,9,21,-12,6,norway10,0.12,0.5,-12,1.12,2.62,0.75,8.33,2.0,11
Flint,8,1,0,7,11,22,-11,3,norway10,0.12,0.12,-11,1.38,2.75,0.38,8.33,8.33,12
Universitario,8,5,2,1,11,7,4,17,panama,0.62,0.88,4,1.38,0.88,2.12,1.61,1.14,1
Plaza Amador,8,4,3,1,10,6,4,15,panama,0.5,0.88,4,1.25,0.75,1.88,2.0,1.14,2
San Francisco,8,4,2,2,14,7,7,14,panama,0.5,0.75,7,1.75,0.88,1.75,2.0,1.33,3
Tauro,8,4,2,2,15,10,5,14,panama,0.5,0.75,5,1.88,1.25,1.75,2.0,1.33,3
San Miguelito,8,3,2,3,7,6,1,11,panama,0.38,0.62,1,0.88,0.75,1.38,2.63,1.61,4
Alianza,8,3,2,3,11,12,-1,11,panama,0.38,0.62,-1,1.38,1.5,1.38,2.63,1.61,4
Independiente,8,2,4,2,9,9,0,10,panama,0.25,0.75,0,1.12,1.12,1.25,4.0,1.33,5
Veraguas,8,3,1,4,10,17,-7,10,panama,0.38,0.5,-7,1.25,2.12,1.25,2.63,2.0,5
Herrera,8,2,3,3,11,11,0,9,panama,0.25,0.62,0,1.38,1.38,1.12,4.0,1.61,6
Costa del Este,8,2,2,4,8,14,-6,8,panama,0.25,0.5,-6,1.0,1.75,1.0,4.0,2.0,7
Arabe Unido,8,2,0,6,9,11,-2,6,panama,0.25,0.25,-2,1.12,1.38,0.75,4.0,4.0,8
UMECIT,8,1,3,4,7,12,-5,6,panama,0.12,0.5,-5,0.88,1.5,0.75,8.33,2.0,8
Cerro Porteno,8,5,2,1,16,6,10,17,paraguay,0.62,0.88,10,2.0,0.75,2.12,1.61,1.14,1
S. Ameliano,8,4,3,1,11,4,7,15,paraguay,0.5,0.88,7,1.38,0.5,1.88,2.0,1.14,2
S. Trinidense,8,4,3,1,11,7,4,15,paraguay,0.5,0.88,4,1.38,0.88,1.88,2.0,1.14,2
Guarani,8,5,0,3,14,11,3,15,paraguay,0.62,0.62,3,1.75,1.38,1.88,1.61,1.61,2
Nacional,8,3,2,3,13,10,3,11,paraguay,0.38,0.62,3,1.62,1.25,1.38,2.63,1.61,3
Olimpia,8,2,5,1,8,8,0,11,paraguay,0.25,0.88,0,1.0,1.0,1.38,4.0,1.14,3
Libertad,8,2,4,2,5,6,-1,10,paraguay,0.25,0.75,-1,0.62,0.75,1.25,4.0,1.33,4
D. Recoleta,8,1,4,3,6,11,-5,7,paraguay,0.12,0.62,-5,0.75,1.38,0.88,8.33,1.61,5
S. Luqueno,8,1,4,3,4,10,-6,7,paraguay,0.12,0.62,-6,0.5,1.25,0.88,8.33,1.61,5
G. Caballero,8,1,3,4,8,10,-2,6,paraguay,0.12,0.5,-2,1.0,1.25,0.75,8.33,2.0,6
A. Tembetary,8,1,3,4,6,14,-8,6,paraguay,0.12,0.5,-8,0.75,1.75,0.75,8.33,2.0,6
2 de Mayo,8,0,5,3,6,11,-5,5,paraguay,0.0,0.62,-5,0.75,1.38,0.62,0.0,1.61,7
Alianza A.,8,6,0,2,11,6,5,18,peru,0.75,0.75,5,1.38,0.75,2.25,1.33,1.33,1
Cusco,8,5,1,2,18,10,8,16,peru,0.62,0.75,8,2.25,1.25,2.0,1.61,1.33,2
S. Cristal,8,5,0,3,16,11,5,15,peru,0.62,0.62,5,2.0,1.38,1.88,1.61,1.61,3
Sport Huancayo,8,5,0,3,14,11,3,15,peru,0.62,0.62,3,1.75,1.38,1.88,1.61,1.61,3
Alianza Lima,8,4,2,2,7,6,1,14,peru,0.5,0.75,1,0.88,0.75,1.75,2.0,1.33,4
Universitario,8,4,1,3,16,8,8,13,peru,0.5,0.62,8,2.0,1.0,1.62,2.0,1.61,5
Cienciano,8,3,3,2,14,9,5,12,peru,0.38,0.75,5,1.75,1.12,1.5,2.63,1.33,6
Cajamarca,8,4,0,4,11,17,-6,12,peru,0.5,0.5,-6,1.38,2.12,1.5,2.0,2.0,6
Juan Pablo II C,8,3,2,3,13,15,-2,11,peru,0.38,0.62,-2,1.62,1.88,1.38,2.63,1.61,7
FBC Melgar,8,2,4,2,12,11,1,10,peru,0.25,0.75,1,1.5,1.38,1.25,4.0,1.33,8
D. Garcilaso,8,3,0,5,11,9,2,9,peru,0.38,0.38,2,1.38,1.12,1.12,2.63,2.63,9
Sport Boys,8,2,3,3,14,14,0,9,peru,0.25,0.62,0,1.75,1.75,1.12,4.0,1.61,9
Atletico Grau,8,1,6,1,11,11,0,9,peru,0.12,0.88,0,1.38,1.38,1.12,8.33,1.14,9
Los Chankas,8,2,3,3,11,13,-2,9,peru,0.25,0.62,-2,1.38,1.62,1.12,4.0,1.61,9
ADT,8,2,2,4,7,13,-6,8,peru,0.25,0.5,-6,0.88,1.62,1.0,4.0,2.0,10
Binacional,8,1,4,3,7,12,-5,7,peru,0.12,0.62,-5,0.88,1.5,0.88,8.33,1.61,11
Comerciantes U.,8,1,3,4,9,16,-7,6,peru,0.12,0.5,-7,1.12,2.0,0.75,8.33,2.0,12
A. Huanuco,8,1,2,5,5,13,-8,5,peru,0.12,0.38,-8,0.62,1.62,0.62,8.33,2.63,13
Ayacucho,8,1,2,5,5,14,-9,5,peru,0.12,0.38,-9,0.62,1.75,0.62,8.33,2.63,13
Manila Digger,8,6,1,1,20,4,16,19,philippines,0.75,0.88,16,2.5,0.5,2.38,1.33,1.14,1
Kaya FC,8,6,1,1,16,6,10,19,philippines,0.75,0.88,10,2.0,0.75,2.38,1.33,1.14,1
Davao Aguilas,8,4,3,1,12,3,9,15,philippines,0.5,0.88,9,1.5,0.38,1.88,2.0,1.14,2
One Taguig,8,4,2,2,16,6,10,14,philippines,0.5,0.75,10,2.0,0.75,1.75,2.0,1.33,3
Stallion,8,3,2,3,15,12,3,11,philippines,0.38,0.62,3,1.88,1.5,1.38,2.63,1.61,4
DH Cebu,8,3,2,3,11,9,2,11,philippines,0.38,0.62,2,1.38,1.12,1.38,2.63,1.61,4
Maharlika,8,3,0,5,9,14,-5,9,philippines,0.38,0.38,-5,1.12,1.75,1.12,2.63,2.63,5
PFF Development,8,1,3,4,9,20,-11,6,philippines,0.12,0.5,-11,1.12,2.5,0.75,8.33,2.0,6
Mendiola,8,1,1,6,5,37,-32,4,philippines,0.12,0.25,-32,0.62,4.62,0.5,8.33,4.0,7
Loyola,8,0,1,7,5,21,-16,1,philippines,0.0,0.12,-16,0.62,2.62,0.12,0.0,8.33,8
Lech Poznan,8,6,2,0,20,7,13,20,poland,0.75,1.0,13,2.5,0.88,2.5,1.33,1.0,1
Pogon Szczecin,8,4,2,2,18,12,6,14,poland,0.5,0.75,6,2.25,1.5,1.75,2.0,1.33,2
Rakow C.,8,4,2,2,12,7,5,14,poland,0.5,0.75,5,1.5,0.88,1.75,2.0,1.33,2
Lechia Gdansk,8,4,1,3,17,15,2,13,poland,0.5,0.62,2,2.12,1.88,1.62,2.0,1.61,3
Legia Warsaw,8,4,1,3,12,10,2,13,poland,0.5,0.62,2,1.5,1.25,1.62,2.0,1.61,3
Zaglebie Lubin,8,4,1,3,12,11,1,13,poland,0.5,0.62,1,1.5,1.38,1.62,2.0,1.61,3
Katowice,8,4,1,3,14,15,-1,13,poland,0.5,0.62,-1,1.75,1.88,1.62,2.0,1.61,3
Piast Gliwice,8,3,3,2,11,8,3,12,poland,0.38,0.75,3,1.38,1.0,1.5,2.63,1.33,4
Korona Kielce,8,3,3,2,12,11,1,12,poland,0.38,0.75,1,1.5,1.38,1.5,2.63,1.33,4
Cracovia Krakow,8,3,1,4,11,13,-2,10,poland,0.38,0.5,-2,1.38,1.62,1.25,2.63,2.0,5
Jagiellonia,8,2,4,2,9,11,-2,10,poland,0.25,0.75,-2,1.12,1.38,1.25,4.0,1.33,5
Motor Lublin,8,3,1,4,9,14,-5,10,poland,0.38,0.5,-5,1.12,1.75,1.25,2.63,2.0,5
Slask Wroclaw,8,2,3,3,10,13,-3,9,poland,0.25,0.62,-3,1.25,1.62,1.12,4.0,1.61,6
Stal Mielec,8,1,5,2,12,14,-2,8,poland,0.12,0.75,-2,1.5,1.75,1.0,8.33,1.33,7
Radomiak Radom,8,1,4,3,11,12,-1,7,poland,0.12,0.62,-1,1.38,1.5,0.88,8.33,1.61,8
Widzew Lodz,8,2,1,5,8,10,-2,7,poland,0.25,0.38,-2,1.0,1.25,0.88,4.0,2.63,8
Gornik Zabrze,8,1,4,3,6,8,-2,7,poland,0.12,0.62,-2,0.75,1.0,0.88,8.33,1.61,8
Puszcza Niepolo,8,0,3,5,12,25,-13,3,poland,0.0,0.38,-13,1.5,3.12,0.38,0.0,2.63,9
Wisla Krakow,8,6,1,1,18,7,11,19,poland2,0.75,0.88,11,2.25,0.88,2.38,1.33,1.14,1
Wisla Plock,8,5,2,1,14,7,7,17,poland2,0.62,0.88,7,1.75,0.88,2.12,1.61,1.14,2
Znicz Pruszkow,8,5,1,2,18,10,8,16,poland2,0.62,0.75,8,2.25,1.25,2.0,1.61,1.33,3
T. Nieciecza,8,5,1,2,15,11,4,16,poland2,0.62,0.75,4,1.88,1.38,2.0,1.61,1.33,3
Arka Gdynia,8,4,3,1,14,7,7,15,poland2,0.5,0.88,7,1.75,0.88,1.88,2.0,1.14,4
Tychy,8,4,3,1,13,9,4,15,poland2,0.5,0.88,4,1.62,1.12,1.88,2.0,1.14,4
Pogon Siedlce,8,4,2,2,13,8,5,14,poland2,0.5,0.75,5,1.62,1.0,1.75,2.0,1.33,5
Polonia Warszaw,8,3,3,2,11,8,3,12,poland2,0.38,0.75,3,1.38,1.0,1.5,2.63,1.33,6
LKS Lodz,8,4,0,4,14,12,2,12,poland2,0.5,0.5,2,1.75,1.5,1.5,2.0,2.0,6
Ruch Chorzow,8,3,2,3,15,14,1,11,poland2,0.38,0.62,1,1.88,1.75,1.38,2.63,1.61,7
Gornik Leczna,8,3,2,3,11,11,0,11,poland2,0.38,0.62,0,1.38,1.38,1.38,2.63,1.61,7
Miedz Legnica,8,3,2,3,10,14,-4,11,poland2,0.38,0.62,-4,1.25,1.75,1.38,2.63,1.61,7
Chrobry Glogow,8,2,3,3,11,11,0,9,poland2,0.25,0.62,0,1.38,1.38,1.12,4.0,1.61,8
K. Kolobrzeg,8,2,2,4,10,15,-5,8,poland2,0.25,0.5,-5,1.25,1.88,1.0,4.0,2.0,9
Odra Opole,8,2,1,5,9,10,-1,7,poland2,0.25,0.38,-1,1.12,1.25,0.88,4.0,2.63,10
Stalowa Wola,8,2,1,5,8,20,-12,7,poland2,0.25,0.38,-12,1.0,2.5,0.88,4.0,2.63,10
Warta Poznan,8,1,0,7,5,15,-10,3,poland2,0.12,0.12,-10,0.62,1.88,0.38,8.33,8.33,11
Stal Rzeszow,8,0,1,7,3,21,-18,1,poland2,0.0,0.12,-18,0.38,2.62,0.12,0.0,8.33,12
Podbeskidzie,8,5,2,1,14,4,10,17,poland3,0.62,0.88,10,1.75,0.5,2.12,1.61,1.14,1
Chojniczanka,8,4,4,0,16,8,8,16,poland3,0.5,1.0,8,2.0,1.0,2.0,2.0,1.0,2
Swit Skolwin,8,4,4,0,15,7,8,16,poland3,0.5,1.0,8,1.88,0.88,2.0,2.0,1.0,2
Kalisz,8,5,1,2,11,8,3,16,poland3,0.62,0.75,3,1.38,1.0,2.0,1.61,1.33,2
Jastrzebie,8,5,1,2,7,4,3,16,poland3,0.62,0.75,3,0.88,0.5,2.0,1.61,1.33,2
Polonia Bytom,8,4,2,2,16,10,6,14,poland3,0.5,0.75,6,2.0,1.25,1.75,2.0,1.33,3
Rekord Bielsko,8,4,1,3,13,10,3,13,poland3,0.5,0.62,3,1.62,1.25,1.62,2.0,1.61,4
Hutnik Krakow,8,4,0,4,15,13,2,12,poland3,0.5,0.5,2,1.88,1.62,1.5,2.0,2.0,5
Resovia Rzeszow,8,3,3,2,9,7,2,12,poland3,0.38,0.75,2,1.12,0.88,1.5,2.63,1.33,5
LKS Lodz B,8,3,2,3,10,8,2,11,poland3,0.38,0.62,2,1.25,1.0,1.38,2.63,1.61,6
O. Grudziadz,8,3,1,4,9,14,-5,10,poland3,0.38,0.5,-5,1.12,1.75,1.25,2.63,2.0,7
Wisla Pulawy,8,3,1,4,8,13,-5,10,poland3,0.38,0.5,-5,1.0,1.62,1.25,2.63,2.0,7
Zaglebie L. B,8,3,0,5,11,14,-3,9,poland3,0.38,0.38,-3,1.38,1.75,1.12,2.63,2.63,8
Z. Sosnowiec,8,1,4,3,7,12,-5,7,poland3,0.12,0.62,-5,0.88,1.5,0.88,8.33,1.61,9
Wieczysta K.,8,1,3,4,9,11,-2,6,poland3,0.12,0.5,-2,1.12,1.38,0.75,8.33,2.0,10
SKRA Czestochow,8,1,2,5,7,12,-5,5,poland3,0.12,0.38,-5,0.88,1.5,0.62,8.33,2.63,11
Pogon Grodzisk,8,1,2,5,10,18,-8,5,poland3,0.12,0.38,-8,1.25,2.25,0.62,8.33,2.63,11
Olimpia Elblag,8,0,3,5,7,21,-14,3,poland3,0.0,0.38,-14,0.88,2.62,0.38,0.0,2.63,12
Sporting CP,8,6,2,0,18,4,14,20,portugal,0.75,1.0,14,2.25,0.5,2.5,1.33,1.0,1
Benfica,8,5,3,0,22,8,14,18,portugal,0.62,1.0,14,2.75,1.0,2.25,1.61,1.0,2
FC Porto,8,6,0,2,14,10,4,18,portugal,0.75,0.75,4,1.75,1.25,2.25,1.33,1.33,2
Santa Clara,8,4,2,2,9,7,2,14,portugal,0.5,0.75,2,1.12,0.88,1.75,2.0,1.33,3
Famalicao,8,4,1,3,15,10,5,13,portugal,0.5,0.62,5,1.88,1.25,1.62,2.0,1.61,4
Sporting Braga,8,3,4,1,13,8,5,13,portugal,0.38,0.88,5,1.62,1.0,1.62,2.63,1.14,4
Guimaraes,8,4,1,3,11,10,1,13,portugal,0.5,0.62,1,1.38,1.25,1.62,2.0,1.61,4
Gil Vicente,8,3,2,3,10,7,3,11,portugal,0.38,0.62,3,1.25,0.88,1.38,2.63,1.61,5
Estoril,8,3,1,4,14,12,2,10,portugal,0.38,0.5,2,1.75,1.5,1.25,2.63,2.0,6
Farense,8,3,1,4,8,9,-1,10,portugal,0.38,0.5,-1,1.0,1.12,1.25,2.63,2.0,6
Arouca,8,2,3,3,10,10,0,9,portugal,0.25,0.62,0,1.25,1.25,1.12,4.0,1.61,7
Moreirense,8,2,3,3,11,13,-2,9,portugal,0.25,0.62,-2,1.38,1.62,1.12,4.0,1.61,7
Rio Ave,8,2,3,3,10,12,-2,9,portugal,0.25,0.62,-2,1.25,1.5,1.12,4.0,1.61,7
Casa Pia,8,2,3,3,7,9,-2,9,portugal,0.25,0.62,-2,0.88,1.12,1.12,4.0,1.61,7
Boavista,8,3,0,5,8,16,-8,9,portugal,0.38,0.38,-8,1.0,2.0,1.12,2.63,2.63,7
Estrela Amadora,8,2,0,6,3,12,-9,6,portugal,0.25,0.25,-9,0.38,1.5,0.75,4.0,4.0,8
Nacional,8,1,2,5,6,14,-8,5,portugal,0.12,0.38,-8,0.75,1.75,0.62,8.33,2.63,9
AVS,8,1,1,6,5,23,-18,4,portugal,0.12,0.25,-18,0.62,2.88,0.5,8.33,4.0,10
Alverca,8,6,2,0,13,3,10,20,portugal2,0.75,1.0,10,1.62,0.38,2.5,1.33,1.0,1
Vizela,8,5,3,0,12,7,5,18,portugal2,0.62,1.0,5,1.5,0.88,2.25,1.61,1.0,2
Tondela,8,5,1,2,13,8,5,16,portugal2,0.62,0.75,5,1.62,1.0,2.0,1.61,1.33,3
Benfica B,8,4,3,1,18,8,10,15,portugal2,0.5,0.88,10,2.25,1.0,1.88,2.0,1.14,4
Felgueiras,8,4,3,1,14,8,6,15,portugal2,0.5,0.88,6,1.75,1.0,1.88,2.0,1.14,4
Torreense,8,4,2,2,14,13,1,14,portugal2,0.5,0.75,1,1.75,1.62,1.75,2.0,1.33,5
Maritimo,8,3,4,1,11,8,3,13,portugal2,0.38,0.88,3,1.38,1.0,1.62,2.63,1.14,6
FC Porto B,8,4,1,3,12,10,2,13,portugal2,0.5,0.62,2,1.5,1.25,1.62,2.0,1.61,6
Uniao de Leiria,8,4,0,4,14,12,2,12,portugal2,0.5,0.5,2,1.75,1.5,1.5,2.0,2.0,7
Leixoes,8,3,2,3,11,12,-1,11,portugal2,0.38,0.62,-1,1.38,1.5,1.38,2.63,1.61,8
Feirense,8,3,1,4,8,10,-2,10,portugal2,0.38,0.5,-2,1.0,1.25,1.25,2.63,2.0,9
Mafra,8,3,0,5,10,16,-6,9,portugal2,0.38,0.38,-6,1.25,2.0,1.12,2.63,2.63,10
Academico Viseu,8,2,2,4,8,10,-2,8,portugal2,0.25,0.5,-2,1.0,1.25,1.0,4.0,2.0,11
Oliveirense,8,2,2,4,9,18,-9,8,portugal2,0.25,0.5,-9,1.12,2.25,1.0,4.0,2.0,11
Chaves,8,2,1,5,6,11,-5,7,portugal2,0.25,0.38,-5,0.75,1.38,0.88,4.0,2.63,12
Pacos Ferreira,8,2,0,6,6,10,-4,6,portugal2,0.25,0.25,-4,0.75,1.25,0.75,4.0,4.0,13
Portimonense,8,1,1,6,10,17,-7,4,portugal2,0.12,0.25,-7,1.25,2.12,0.5,8.33,4.0,14
Penafiel,8,0,2,6,5,13,-8,2,portugal2,0.0,0.25,-8,0.62,1.62,0.25,0.0,4.0,15
Al Sadd,8,8,0,0,25,1,24,24,qatar,1.0,1.0,24,3.12,0.12,3.0,1.0,1.0,1
Al Duhail,8,6,0,2,12,9,3,18,qatar,0.75,0.75,3,1.5,1.12,2.25,1.33,1.33,2
Al Rayyan,8,5,0,3,20,10,10,15,qatar,0.62,0.62,10,2.5,1.25,1.88,1.61,1.61,3
Al Shamal,8,4,1,3,15,9,6,13,qatar,0.5,0.62,6,1.88,1.12,1.62,2.0,1.61,4
Al Gharafa,8,4,1,3,12,13,-1,13,qatar,0.5,0.62,-1,1.5,1.62,1.62,2.0,1.61,4
Al Arabi,8,3,1,4,11,13,-2,10,qatar,0.38,0.5,-2,1.38,1.62,1.25,2.63,2.0,5
Al Shahaniya,8,3,1,4,11,18,-7,10,qatar,0.38,0.5,-7,1.38,2.25,1.25,2.63,2.0,5
Al Wakrah,8,2,2,4,6,13,-7,8,qatar,0.25,0.5,-7,0.75,1.62,1.0,4.0,2.0,6
Qatar SC,8,1,4,3,9,11,-2,7,qatar,0.12,0.62,-2,1.12,1.38,0.88,8.33,1.61,7
Umm Salal,8,2,1,5,7,11,-4,7,qatar,0.25,0.38,-4,0.88,1.38,0.88,4.0,2.63,7
Al Ahli Doha,8,2,1,5,9,20,-11,7,qatar,0.25,0.38,-11,1.12,2.5,0.88,4.0,2.63,7
Al Khor,8,2,0,6,9,18,-9,6,qatar,0.25,0.25,-9,1.12,2.25,0.75,4.0,4.0,8
CFR Cluj,8,5,3,0,19,5,14,18,romania,0.62,1.0,14,2.38,0.62,2.25,1.61,1.0,1
FCSB,8,5,3,0,10,2,8,18,romania,0.62,1.0,8,1.25,0.25,2.25,1.61,1.0,1
Univ. Craiova,8,5,1,2,11,6,5,16,romania,0.62,0.75,5,1.38,0.75,2.0,1.61,1.33,2
Din. Bucharest,8,4,2,2,10,6,4,14,romania,0.5,0.75,4,1.25,0.75,1.75,2.0,1.33,3
Rapid Bucharest,8,4,2,2,9,6,3,14,romania,0.5,0.75,3,1.12,0.75,1.75,2.0,1.33,3
Hermannstadt,8,4,2,2,9,7,2,14,romania,0.5,0.75,2,1.12,0.88,1.75,2.0,1.33,3
U. Cluj,8,3,3,2,9,8,1,12,romania,0.38,0.75,1,1.12,1.0,1.5,2.63,1.33,4
Botosani,8,3,3,2,8,7,1,12,romania,0.38,0.75,1,1.0,0.88,1.5,2.63,1.33,4
Sepsi OSK,8,3,2,3,8,9,-1,11,romania,0.38,0.62,-1,1.0,1.12,1.38,2.63,1.61,5
Farul Constanta,8,3,1,4,8,10,-2,10,romania,0.38,0.5,-2,1.0,1.25,1.25,2.63,2.0,6
P. Iasi,8,2,3,3,8,12,-4,9,romania,0.25,0.62,-4,1.0,1.5,1.12,4.0,1.61,7
Petrolul,8,2,2,4,6,8,-2,8,romania,0.25,0.5,-2,0.75,1.0,1.0,4.0,2.0,8
UTA Arad,8,2,2,4,5,10,-5,8,romania,0.25,0.5,-5,0.62,1.25,1.0,4.0,2.0,8
Otelul,8,2,1,5,7,11,-4,7,romania,0.25,0.38,-4,0.88,1.38,0.88,4.0,2.63,9
FC Buzau,8,1,1,6,6,16,-10,4,romania,0.12,0.25,-10,0.75,2.0,0.5,8.33,4.0,10
Unirea Slobozia,8,0,1,7,4,14,-10,1,romania,0.0,0.12,-10,0.5,1.75,0.12,0.0,8.33,11
Zenit,8,6,2,0,14,4,10,20,russia,0.75,1.0,10,1.75,0.5,2.5,1.33,1.0,1
CSKA Moscow,8,5,3,0,14,6,8,18,russia,0.62,1.0,8,1.75,0.75,2.25,1.61,1.0,2
FC Krasnodar,8,6,0,2,15,10,5,18,russia,0.75,0.75,5,1.88,1.25,2.25,1.33,1.33,2
Dinamo Moscow,8,4,2,2,13,11,2,14,russia,0.5,0.75,2,1.62,1.38,1.75,2.0,1.33,3
Spartak Moscow,8,4,1,3,15,8,7,13,russia,0.5,0.62,7,1.88,1.0,1.62,2.0,1.61,4
Lokomotiv M.,8,3,4,1,13,7,6,13,russia,0.38,0.88,6,1.62,0.88,1.62,2.63,1.14,4
Rubin Kazan,8,4,1,3,13,12,1,13,russia,0.5,0.62,1,1.62,1.5,1.62,2.0,1.61,4
Akron,8,3,1,4,11,14,-3,10,russia,0.38,0.5,-3,1.38,1.75,1.25,2.63,2.0,5
Krylya Sovetov,8,2,3,3,11,14,-3,9,russia,0.25,0.62,-3,1.38,1.75,1.12,4.0,1.61,6
Makhachkala,8,2,2,4,11,11,0,8,russia,0.25,0.5,0,1.38,1.38,1.0,4.0,2.0,7
Nizhny Novgorod,8,2,2,4,10,13,-3,8,russia,0.25,0.5,-3,1.25,1.62,1.0,4.0,2.0,7
Orenburg,8,2,2,4,9,14,-5,8,russia,0.25,0.5,-5,1.12,1.75,1.0,4.0,2.0,7
Rostov,8,1,3,4,6,10,-4,6,russia,0.12,0.5,-4,0.75,1.25,0.75,8.33,2.0,8
Akhmat Grozny,8,1,3,4,7,13,-6,6,russia,0.12,0.5,-6,0.88,1.62,0.75,8.33,2.0,8
Khimki,8,1,3,4,9,19,-10,6,russia,0.12,0.5,-10,1.12,2.38,0.75,8.33,2.0,8
Fakel Voronezh,8,0,4,4,3,8,-5,4,russia,0.0,0.5,-5,0.38,1.0,0.5,0.0,2.0,9
Chernomorets,8,6,2,0,14,4,10,20,russia2,0.75,1.0,10,1.75,0.5,2.5,1.33,1.0,1
Rodina Moskva,8,6,0,2,17,8,9,18,russia2,0.75,0.75,9,2.12,1.0,2.25,1.33,1.33,2
Ural,8,5,1,2,17,15,2,16,russia2,0.62,0.75,2,2.12,1.88,2.0,1.61,1.33,3
Rotor Volgograd,8,4,2,2,12,6,6,14,russia2,0.5,0.75,6,1.5,0.75,1.75,2.0,1.33,4
Torpedo Moscow,8,4,2,2,10,7,3,14,russia2,0.5,0.75,3,1.25,0.88,1.75,2.0,1.33,4
Baltika,8,3,4,1,10,5,5,13,russia2,0.38,0.88,5,1.25,0.62,1.62,2.63,1.14,5
Ufa,8,4,1,3,9,8,1,13,russia2,0.5,0.62,1,1.12,1.0,1.62,2.0,1.61,5
SKA Khabarovsk,8,4,0,4,12,10,2,12,russia2,0.5,0.5,2,1.5,1.25,1.5,2.0,2.0,6
Yenisey,8,3,3,2,8,11,-3,12,russia2,0.38,0.75,-3,1.0,1.38,1.5,2.63,1.33,6
PFC Sochi,8,3,1,4,14,10,4,10,russia2,0.38,0.5,4,1.75,1.25,1.25,2.63,2.0,7
Sokol Saratov,8,3,1,4,10,8,2,10,russia2,0.38,0.5,2,1.25,1.0,1.25,2.63,2.0,7
Tyumen,8,2,2,4,10,12,-2,8,russia2,0.25,0.5,-2,1.25,1.5,1.0,4.0,2.0,8
Neftekhimik,8,2,2,4,7,10,-3,8,russia2,0.25,0.5,-3,0.88,1.25,1.0,4.0,2.0,8
Arsenal Tula,8,2,2,4,6,11,-5,8,russia2,0.25,0.5,-5,0.75,1.38,1.0,4.0,2.0,8
Chayka,8,2,2,4,5,10,-5,8,russia2,0.25,0.5,-5,0.62,1.25,1.0,4.0,2.0,8
Kamaz,8,1,4,3,5,10,-5,7,russia2,0.12,0.62,-5,0.62,1.25,0.88,8.33,1.61,9
Shinnik,8,2,0,6,7,18,-11,6,russia2,0.25,0.25,-11,0.88,2.25,0.75,4.0,4.0,10
A. Vladikavkaz,8,1,1,6,9,19,-10,4,russia2,0.12,0.25,-10,1.12,2.38,0.5,8.33,4.0,11
Al Ittihad,8,7,0,1,18,9,9,21,saudiarabia,0.88,0.88,9,2.25,1.12,2.62,1.14,1.14,1
Al Hilal,8,5,3,0,22,10,12,18,saudiarabia,0.62,1.0,12,2.75,1.25,2.25,1.61,1.0,2
Al Ahli Jeddah,8,6,0,2,19,9,10,18,saudiarabia,0.75,0.75,10,2.38,1.12,2.25,1.33,1.33,2
Al Fateh,8,5,1,2,19,11,8,16,saudiarabia,0.62,0.75,8,2.38,1.38,2.0,1.61,1.33,3
Al Quadisiya,8,5,1,2,15,9,6,16,saudiarabia,0.62,0.75,6,1.88,1.12,2.0,1.61,1.33,3
Al Shabab,8,4,2,2,15,10,5,14,saudiarabia,0.5,0.75,5,1.88,1.25,1.75,2.0,1.33,4
Al Ittifaq,8,4,2,2,11,8,3,14,saudiarabia,0.5,0.75,3,1.38,1.0,1.75,2.0,1.33,4
Al Nassr,8,4,1,3,22,12,10,13,saudiarabia,0.5,0.62,10,2.75,1.5,1.62,2.0,1.61,5
Al Wahda,8,4,1,3,11,10,1,13,saudiarabia,0.5,0.62,1,1.38,1.25,1.62,2.0,1.61,5
Al Akhdoud,8,3,2,3,7,16,-9,11,saudiarabia,0.38,0.62,-9,0.88,2.0,1.38,2.63,1.61,6
Al Feiha,8,3,1,4,8,16,-8,10,saudiarabia,0.38,0.5,-8,1.0,2.0,1.25,2.63,2.0,7
Al Kholood,8,3,0,5,8,15,-7,9,saudiarabia,0.38,0.38,-7,1.0,1.88,1.12,2.63,2.63,8
Al Taawon,8,2,2,4,11,15,-4,8,saudiarabia,0.25,0.5,-4,1.38,1.88,1.0,4.0,2.0,9
Damak,8,2,1,5,7,9,-2,7,saudiarabia,0.25,0.38,-2,0.88,1.12,0.88,4.0,2.63,10
Al Orubah,8,2,1,5,11,21,-10,7,saudiarabia,0.25,0.38,-10,1.38,2.62,0.88,4.0,2.63,10
Al Riyadh,8,1,1,6,10,17,-7,4,saudiarabia,0.12,0.25,-7,1.25,2.12,0.5,8.33,4.0,11
Al Khaleej,8,1,1,6,8,19,-11,4,saudiarabia,0.12,0.25,-11,1.0,2.38,0.5,8.33,4.0,11
Al Raed,8,1,0,7,12,18,-6,3,saudiarabia,0.12,0.12,-6,1.5,2.25,0.38,8.33,8.33,12
Neom SC,8,7,1,0,30,6,24,22,saudiarabia2,0.88,1.0,24,3.75,0.75,2.75,1.14,1.0,1
Al Jabalain,8,6,1,1,17,7,10,19,saudiarabia2,0.75,0.88,10,2.12,0.88,2.38,1.33,1.14,2
Al Bukayriyah,8,6,1,1,15,5,10,19,saudiarabia2,0.75,0.88,10,1.88,0.62,2.38,1.33,1.14,2
Al Najma,8,6,0,2,12,6,6,18,saudiarabia2,0.75,0.75,6,1.5,0.75,2.25,1.33,1.33,3
Al Zulfi,8,3,4,1,11,10,1,13,saudiarabia2,0.38,0.88,1,1.38,1.25,1.62,2.63,1.14,4
Al Adalha,8,4,1,3,13,13,0,13,saudiarabia2,0.5,0.62,0,1.62,1.62,1.62,2.0,1.61,4
Al Batin,8,4,1,3,13,16,-3,13,saudiarabia2,0.5,0.62,-3,1.62,2.0,1.62,2.0,1.61,4
Al Tai,8,4,0,4,13,10,3,12,saudiarabia2,0.5,0.5,3,1.62,1.25,1.5,2.0,2.0,5
Abha,8,3,3,2,12,10,2,12,saudiarabia2,0.38,0.75,2,1.5,1.25,1.5,2.63,1.33,5
Al Jubail,8,3,3,2,8,7,1,12,saudiarabia2,0.38,0.75,1,1.0,0.88,1.5,2.63,1.33,5
Al Hazm,8,3,2,3,12,11,1,11,saudiarabia2,0.38,0.62,1,1.5,1.38,1.38,2.63,1.61,6
Al Faisaly,8,2,3,3,12,14,-2,9,saudiarabia2,0.25,0.62,-2,1.5,1.75,1.12,4.0,1.61,7
Ohod,8,2,2,4,8,12,-4,8,saudiarabia2,0.25,0.5,-4,1.0,1.5,1.0,4.0,2.0,8
Al Ain,8,1,3,4,7,14,-7,6,saudiarabia2,0.12,0.5,-7,0.88,1.75,0.75,8.33,2.0,9
Al Arabi,8,1,2,5,9,17,-8,5,saudiarabia2,0.12,0.38,-8,1.12,2.12,0.62,8.33,2.63,10
Jeddah,8,0,4,4,6,16,-10,4,saudiarabia2,0.0,0.5,-10,0.75,2.0,0.5,0.0,2.0,11
Al Safa,8,0,2,6,10,24,-14,2,saudiarabia2,0.0,0.25,-14,1.25,3.0,0.25,0.0,4.0,12
Al Jandal,8,0,1,7,6,16,-10,1,saudiarabia2,0.0,0.12,-10,0.75,2.0,0.12,0.0,8.33,13
Celtic,8,5,2,1,23,6,17,17,scotland,0.62,0.88,17,2.88,0.75,2.12,1.61,1.14,1
St. Mirren,8,4,3,1,16,10,6,15,scotland,0.5,0.88,6,2.0,1.25,1.88,2.0,1.14,2
Hibernian,8,4,2,2,17,9,8,14,scotland,0.5,0.75,8,2.12,1.12,1.75,2.0,1.33,3
Rangers,8,3,4,1,18,13,5,13,scotland,0.38,0.88,5,2.25,1.62,1.62,2.63,1.14,4
Hearts,8,4,1,3,9,7,2,13,scotland,0.5,0.62,2,1.12,0.88,1.62,2.0,1.61,4
Kilmarnock,8,4,0,4,11,16,-5,12,scotland,0.5,0.5,-5,1.38,2.0,1.5,2.0,2.0,5
Dundee Utd,8,4,0,4,7,14,-7,12,scotland,0.5,0.5,-7,0.88,1.75,1.5,2.0,2.0,5
Motherwell,8,3,2,3,10,13,-3,11,scotland,0.38,0.62,-3,1.25,1.62,1.38,2.63,1.61,6
Dundee FC,8,3,1,4,12,14,-2,10,scotland,0.38,0.5,-2,1.5,1.75,1.25,2.63,2.0,7
Aberdeen,8,3,1,4,10,15,-5,10,scotland,0.38,0.5,-5,1.25,1.88,1.25,2.63,2.0,7
St. Johnstone,8,2,0,6,6,14,-8,6,scotland,0.25,0.25,-8,0.75,1.75,0.75,4.0,4.0,8
Ross County,8,0,2,6,6,14,-8,2,scotland,0.0,0.25,-8,0.75,1.75,0.25,0.0,4.0,9
Livingston,8,5,1,2,17,6,11,16,scotland2,0.62,0.75,11,2.12,0.75,2.0,1.61,1.33,1
Raith Rovers,8,4,4,0,17,7,10,16,scotland2,0.5,1.0,10,2.12,0.88,2.0,2.0,1.0,1
Partick Thistle,8,4,2,2,8,5,3,14,scotland2,0.5,0.75,3,1.0,0.62,1.75,2.0,1.33,2
Falkirk,8,4,1,3,17,8,9,13,scotland2,0.5,0.62,9,2.12,1.0,1.62,2.0,1.61,3
Greenock Morton,8,3,2,3,10,13,-3,11,scotland2,0.38,0.62,-3,1.25,1.62,1.38,2.63,1.61,4
Airdrieonians,8,2,3,3,11,9,2,9,scotland2,0.25,0.62,2,1.38,1.12,1.12,4.0,1.61,5
Ayr Utd,8,2,3,3,8,12,-4,9,scotland2,0.25,0.62,-4,1.0,1.5,1.12,4.0,1.61,5
Dunfermline,8,2,2,4,2,8,-6,8,scotland2,0.25,0.5,-6,0.25,1.0,1.0,4.0,2.0,6
Hamilton,8,2,2,4,5,13,-8,8,scotland2,0.25,0.5,-8,0.62,1.62,1.0,4.0,2.0,6
Queens Park,8,0,2,6,4,22,-18,2,scotland2,0.0,0.25,-18,0.5,2.75,0.25,0.0,4.0,7
Queen of South,8,6,2,0,17,6,11,20,scotland3,0.75,1.0,11,2.12,0.75,2.5,1.33,1.0,1
Dumbarton,8,3,3,2,17,11,6,12,scotland3,0.38,0.75,6,2.12,1.38,1.5,2.63,1.33,2
Arbroath,8,3,3,2,10,11,-1,12,scotland3,0.38,0.75,-1,1.25,1.38,1.5,2.63,1.33,2
Alloa Athletic,8,3,2,3,14,12,2,11,scotland3,0.38,0.62,2,1.75,1.5,1.38,2.63,1.61,3
Inverness,8,3,2,3,11,9,2,11,scotland3,0.38,0.62,2,1.38,1.12,1.38,2.63,1.61,3
Cove Rangers,8,2,4,2,12,12,0,10,scotland3,0.25,0.75,0,1.5,1.5,1.25,4.0,1.33,4
Annan Athletic,8,3,0,5,12,15,-3,9,scotland3,0.38,0.38,-3,1.5,1.88,1.12,2.63,2.63,5
Kelty Hearts,8,2,3,3,9,15,-6,9,scotland3,0.25,0.62,-6,1.12,1.88,1.12,4.0,1.61,5
Montrose,8,2,2,4,12,14,-2,8,scotland3,0.25,0.5,-2,1.5,1.75,1.0,4.0,2.0,6
Stenhousemuir,8,1,3,4,6,15,-9,6,scotland3,0.12,0.5,-9,0.75,1.88,0.75,8.33,2.0,7
Peterhead,8,5,1,2,12,11,1,16,scotland4,0.62,0.75,1,1.5,1.38,2.0,1.61,1.33,1
Elgin City,8,5,0,3,12,7,5,15,scotland4,0.62,0.62,5,1.5,0.88,1.88,1.61,1.61,2
Clyde,8,4,1,3,17,11,6,13,scotland4,0.5,0.62,6,2.12,1.38,1.62,2.0,1.61,3
Spartans,8,4,0,4,13,11,2,12,scotland4,0.5,0.5,2,1.62,1.38,1.5,2.0,2.0,4
East Fife,8,4,0,4,12,12,0,12,scotland4,0.5,0.5,0,1.5,1.5,1.5,2.0,2.0,4
Stirling Albion,8,3,2,3,10,11,-1,11,scotland4,0.38,0.62,-1,1.25,1.38,1.38,2.63,1.61,5
Edinburgh City,8,3,1,4,11,12,-1,10,scotland4,0.38,0.5,-1,1.38,1.5,1.25,2.63,2.0,6
Forfar Athletic,8,2,4,2,3,5,-2,10,scotland4,0.25,0.75,-2,0.38,0.62,1.25,4.0,1.33,6
Bonnyrigg Rose,8,3,1,4,7,13,-6,10,scotland4,0.38,0.5,-6,0.88,1.62,1.25,2.63,2.0,6
Stranraer,8,2,0,6,8,12,-4,6,scotland4,0.25,0.25,-4,1.0,1.5,0.75,4.0,4.0,7
Red Star,8,5,2,1,20,14,6,17,serbia,0.62,0.88,6,2.5,1.75,2.12,1.61,1.14,1
Novi Pazar,8,4,3,1,17,14,3,15,serbia,0.5,0.88,3,2.12,1.75,1.88,2.0,1.14,2
IMT N. Beograd,8,4,2,2,14,9,5,14,serbia,0.5,0.75,5,1.75,1.12,1.75,2.0,1.33,3
Z. Pancevo,8,4,2,2,12,7,5,14,serbia,0.5,0.75,5,1.5,0.88,1.75,2.0,1.33,3
Vojvodina,8,4,2,2,12,10,2,14,serbia,0.5,0.75,2,1.5,1.25,1.75,2.0,1.33,3
Partizan,8,4,1,3,17,11,6,13,serbia,0.5,0.62,6,2.12,1.38,1.62,2.0,1.61,4
Radnicki Nis,8,3,3,2,13,11,2,12,serbia,0.38,0.75,2,1.62,1.38,1.5,2.63,1.33,5
Backa Topola,8,4,0,4,13,14,-1,12,serbia,0.5,0.5,-1,1.62,1.75,1.5,2.0,2.0,5
Cukaricki,8,2,4,2,10,11,-1,10,serbia,0.25,0.75,-1,1.25,1.38,1.25,4.0,1.33,6
Jedinstvo U.,8,3,1,4,10,13,-3,10,serbia,0.38,0.5,-3,1.25,1.62,1.25,2.63,2.0,6
S. Subotica,8,3,1,4,9,13,-4,10,serbia,0.38,0.5,-4,1.12,1.62,1.25,2.63,2.0,6
T. Odzaci,8,3,0,5,10,13,-3,9,serbia,0.38,0.38,-3,1.25,1.62,1.12,2.63,2.63,7
Radnicki 1923,8,2,2,4,13,15,-2,8,serbia,0.25,0.5,-2,1.62,1.88,1.0,4.0,2.0,8
Napredak,8,2,2,4,6,8,-2,8,serbia,0.25,0.5,-2,0.75,1.0,1.0,4.0,2.0,8
OFK Beograd,8,2,1,5,14,18,-4,7,serbia,0.25,0.38,-4,1.75,2.25,0.88,4.0,2.63,9
Mladost Lucani,8,1,2,5,7,16,-9,5,serbia,0.12,0.38,-9,0.88,2.0,0.62,8.33,2.63,10
R. Surdulica,8,6,1,1,18,8,10,19,serbia2,0.75,0.88,10,2.25,1.0,2.38,1.33,1.14,1
Trajal Krusevac,8,5,2,1,16,7,9,17,serbia2,0.62,0.88,9,2.0,0.88,2.12,1.61,1.14,2
Javor Ivanjica,8,5,1,2,13,7,6,16,serbia2,0.62,0.75,6,1.62,0.88,2.0,1.61,1.33,3
Mladost,8,4,1,3,15,13,2,13,serbia2,0.5,0.62,2,1.88,1.62,1.62,2.0,1.61,4
Graficar,8,3,4,1,12,11,1,13,serbia2,0.38,0.88,1,1.5,1.38,1.62,2.63,1.14,4
Dubocica,8,4,1,3,9,8,1,13,serbia2,0.5,0.62,1,1.12,1.0,1.62,2.0,1.61,4
Vozdovac,8,3,3,2,9,8,1,12,serbia2,0.38,0.75,1,1.12,1.0,1.5,2.63,1.33,5
Zemun,8,3,2,3,12,15,-3,11,serbia2,0.38,0.62,-3,1.5,1.88,1.38,2.63,1.61,6
Smederevo,8,3,1,4,8,11,-3,10,serbia2,0.38,0.5,-3,1.0,1.38,1.25,2.63,2.0,7
Sloboda Uzice,8,3,1,4,5,8,-3,10,serbia2,0.38,0.5,-3,0.62,1.0,1.25,2.63,2.0,7
Sloven Ruma,8,2,3,3,5,6,-1,9,serbia2,0.25,0.62,-1,0.62,0.75,1.12,4.0,1.61,8
S. Mitrovica,8,2,2,4,8,8,0,8,serbia2,0.25,0.5,0,1.0,1.0,1.0,4.0,2.0,9
Indija,8,2,2,4,7,10,-3,8,serbia2,0.25,0.5,-3,0.88,1.25,1.0,4.0,2.0,9
Vrsac,8,2,1,5,6,11,-5,7,serbia2,0.25,0.38,-5,0.75,1.38,0.88,4.0,2.63,10
Macva Sabac,8,2,1,5,6,13,-7,7,serbia2,0.25,0.38,-7,0.75,1.62,0.88,4.0,2.63,10
Borac Cacak,8,2,0,6,9,14,-5,6,serbia2,0.25,0.25,-5,1.12,1.75,0.75,4.0,4.0,11
DPMM FC,8,6,2,0,18,9,9,20,singapore,0.75,1.0,9,2.25,1.12,2.5,1.33,1.0,1
Khalsa,8,6,1,1,21,13,8,19,singapore,0.75,0.88,8,2.62,1.62,2.38,1.33,1.14,2
Tampines Rovers,8,5,1,2,16,5,11,16,singapore,0.62,0.75,11,2.0,0.62,2.0,1.61,1.33,3
Lion City,8,4,2,2,16,5,11,14,singapore,0.5,0.75,11,2.0,0.62,1.75,2.0,1.33,4
Geylang,8,3,1,4,18,23,-5,10,singapore,0.38,0.5,-5,2.25,2.88,1.25,2.63,2.0,5
A. Niigata (S),8,2,1,5,11,15,-4,7,singapore,0.25,0.38,-4,1.38,1.88,0.88,4.0,2.63,6
Hougang,8,1,2,5,13,19,-6,5,singapore,0.12,0.38,-6,1.62,2.38,0.62,8.33,2.63,7
Young Lions,8,1,2,5,7,23,-16,5,singapore,0.12,0.38,-16,0.88,2.88,0.62,8.33,2.63,7
Tanjong Pagar,8,0,4,4,10,18,-8,4,singapore,0.0,0.5,-8,1.25,2.25,0.5,0.0,2.0,8
S. Bratislava,8,6,1,1,22,11,11,19,slovakia,0.75,0.88,11,2.75,1.38,2.38,1.33,1.14,1
Ruzomberok,8,5,1,2,12,8,4,16,slovakia,0.62,0.75,4,1.5,1.0,2.0,1.61,1.33,2
DAC Streda,8,4,3,1,12,10,2,15,slovakia,0.5,0.88,2,1.5,1.25,1.88,2.0,1.14,3
Skalica,8,4,1,3,12,10,2,13,slovakia,0.5,0.62,2,1.5,1.25,1.62,2.0,1.61,4
Trencin,8,3,3,2,12,10,2,12,slovakia,0.38,0.75,2,1.5,1.25,1.5,2.63,1.33,5
FC Kosice,8,3,3,2,11,10,1,12,slovakia,0.38,0.75,1,1.38,1.25,1.5,2.63,1.33,5
Komarno,8,3,2,3,9,9,0,11,slovakia,0.38,0.62,0,1.12,1.12,1.38,2.63,1.61,6
Z. Michalovce,8,3,1,4,16,18,-2,10,slovakia,0.38,0.5,-2,2.0,2.25,1.25,2.63,2.0,7
Zilina,8,2,2,4,12,17,-5,8,slovakia,0.25,0.5,-5,1.5,2.12,1.0,4.0,2.0,8
Podbrezova,8,1,3,4,9,13,-4,6,slovakia,0.12,0.5,-4,1.12,1.62,0.75,8.33,2.0,9
Spartak Trnava,8,2,0,6,10,15,-5,6,slovakia,0.25,0.25,-5,1.25,1.88,0.75,4.0,4.0,9
Banska Bystrica,8,1,2,5,12,18,-6,5,slovakia,0.12,0.38,-6,1.5,2.25,0.62,8.33,2.63,10
Presov,8,7,0,1,18,6,12,21,slovakia2,0.88,0.88,12,2.25,0.75,2.62,1.14,1.14,1
Puchov,8,6,1,1,17,8,9,19,slovakia2,0.75,0.88,9,2.12,1.0,2.38,1.33,1.14,2
Zlate Moravce,8,6,0,2,15,6,9,18,slovakia2,0.75,0.75,9,1.88,0.75,2.25,1.33,1.33,3
Zvolen,8,5,0,3,14,10,4,15,slovakia2,0.62,0.62,4,1.75,1.25,1.88,1.61,1.61,4
P. Bystrica,8,4,2,2,11,8,3,14,slovakia2,0.5,0.75,3,1.38,1.0,1.75,2.0,1.33,5
Petrzalka,8,2,4,2,11,10,1,10,slovakia2,0.25,0.75,1,1.38,1.25,1.25,4.0,1.33,6
S. Lubovna,8,3,1,4,7,8,-1,10,slovakia2,0.38,0.5,-1,0.88,1.0,1.25,2.63,2.0,6
Humenne,8,2,3,3,6,10,-4,9,slovakia2,0.25,0.62,-4,0.75,1.25,1.12,4.0,1.61,7
L. Mikulas,8,2,2,4,11,11,0,8,slovakia2,0.25,0.5,0,1.38,1.38,1.0,4.0,2.0,8
Samorin,8,2,2,4,6,9,-3,8,slovakia2,0.25,0.5,-3,0.75,1.12,1.0,4.0,2.0,8
Zilina B,8,2,2,4,8,12,-4,8,slovakia2,0.25,0.5,-4,1.0,1.5,1.0,4.0,2.0,8
Malzenice,8,2,2,4,8,15,-7,8,slovakia2,0.25,0.5,-7,1.0,1.88,1.0,4.0,2.0,8
S. Bratislava B,8,0,4,4,10,18,-8,4,slovakia2,0.0,0.5,-8,1.25,2.25,0.5,0.0,2.0,9
Pohronie,8,0,2,6,7,19,-12,2,slovakia2,0.0,0.25,-12,0.88,2.38,0.25,0.0,4.0,10
Koper,8,5,3,0,18,7,11,18,slovenia,0.62,1.0,11,2.25,0.88,2.25,1.61,1.0,1
Maribor,8,4,3,1,14,7,7,15,slovenia,0.5,0.88,7,1.75,0.88,1.88,2.0,1.14,2
NK Celje,8,3,4,1,22,11,11,13,slovenia,0.38,0.88,11,2.75,1.38,1.62,2.63,1.14,3
Primorje,8,3,3,2,11,12,-1,12,slovenia,0.38,0.75,-1,1.38,1.5,1.5,2.63,1.33,4
NK Olimpija,8,2,5,1,14,8,6,11,slovenia,0.25,0.88,6,1.75,1.0,1.38,4.0,1.14,5
Bravo,8,2,4,2,9,8,1,10,slovenia,0.25,0.75,1,1.12,1.0,1.25,4.0,1.33,6
Domzale,8,2,3,3,9,11,-2,9,slovenia,0.25,0.62,-2,1.12,1.38,1.12,4.0,1.61,7
Radomlje,8,3,0,5,9,19,-10,9,slovenia,0.38,0.38,-10,1.12,2.38,1.12,2.63,2.63,7
Nafta,8,1,3,4,7,18,-11,6,slovenia,0.12,0.5,-11,0.88,2.25,0.75,8.33,2.0,8
Mura,8,0,2,6,5,15,-10,2,slovenia,0.0,0.25,-10,0.62,1.88,0.25,0.0,4.0,9
Mamelodi S.,8,7,0,1,19,2,17,21,southafrica,0.88,0.88,17,2.38,0.25,2.62,1.14,1.14,1
Stellenbosch,8,5,1,2,9,6,3,16,southafrica,0.62,0.75,3,1.12,0.75,2.0,1.61,1.33,2
Orlando Pirates,8,4,3,1,11,6,5,15,southafrica,0.5,0.88,5,1.38,0.75,1.88,2.0,1.14,3
Magesi,8,4,3,1,8,6,2,15,southafrica,0.5,0.88,2,1.0,0.75,1.88,2.0,1.14,3
Marumo G.,8,3,4,1,10,8,2,13,southafrica,0.38,0.88,2,1.25,1.0,1.62,2.63,1.14,4
Richards Bay,8,4,1,3,7,7,0,13,southafrica,0.5,0.62,0,0.88,0.88,1.62,2.0,1.61,4
Sekhukhune,8,3,3,2,11,9,2,12,southafrica,0.38,0.75,2,1.38,1.12,1.5,2.63,1.33,5
TS Galaxy,8,2,3,3,10,10,0,9,southafrica,0.25,0.62,0,1.25,1.25,1.12,4.0,1.61,6
AmaZulu,8,2,2,4,6,9,-3,8,southafrica,0.25,0.5,-3,0.75,1.12,1.0,4.0,2.0,7
SuperSport Utd,8,1,4,3,6,8,-2,7,southafrica,0.12,0.62,-2,0.75,1.0,0.88,8.33,1.61,8
Cape Town City,8,1,3,4,3,6,-3,6,southafrica,0.12,0.5,-3,0.38,0.75,0.75,8.33,2.0,9
Polokwane,8,1,3,4,5,10,-5,6,southafrica,0.12,0.5,-5,0.62,1.25,0.75,8.33,2.0,9
Golden Arrows,8,1,3,4,6,13,-7,6,southafrica,0.12,0.5,-7,0.75,1.62,0.75,8.33,2.0,9
Chippa Utd,8,1,3,4,3,11,-8,6,southafrica,0.12,0.5,-8,0.38,1.38,0.75,8.33,2.0,9
Kaizer Chiefs,8,0,4,4,5,10,-5,4,southafrica,0.0,0.5,-5,0.62,1.25,0.5,0.0,2.0,10
Royal AM,0,0,0,0,0,0,0,0,southafrica,0.0,0.0,0,0.0,0.0,0.0,0.0,0.0,11
Orbit College,8,5,2,1,9,2,7,17,southafrica2,0.62,0.88,7,1.12,0.25,2.12,1.61,1.14,1
Durban City,8,5,1,2,13,6,7,16,southafrica2,0.62,0.75,7,1.62,0.75,2.0,1.61,1.33,2
Black Leopards,8,5,1,2,14,9,5,16,southafrica2,0.62,0.75,5,1.75,1.12,2.0,1.61,1.33,2
Casric Stars,8,3,4,1,10,8,2,13,southafrica2,0.38,0.88,2,1.25,1.0,1.62,2.63,1.14,3
Baroka,8,3,3,2,13,11,2,12,southafrica2,0.38,0.75,2,1.62,1.38,1.5,2.63,1.33,4
Pretoria U.,8,3,2,3,8,9,-1,11,southafrica2,0.38,0.62,-1,1.0,1.12,1.38,2.63,1.61,5
Milford,8,3,1,4,8,10,-2,10,southafrica2,0.38,0.5,-2,1.0,1.25,1.25,2.63,2.0,6
Highbury,8,3,1,4,6,8,-2,10,southafrica2,0.38,0.5,-2,0.75,1.0,1.25,2.63,2.0,6
Upington City,8,2,3,3,5,5,0,9,southafrica2,0.25,0.62,0,0.62,0.62,1.12,4.0,1.61,7
Kruger United,8,2,3,3,6,11,-5,9,southafrica2,0.25,0.62,-5,0.75,1.38,1.12,4.0,1.61,7
Pretoria C.,8,3,0,5,7,14,-7,9,southafrica2,0.38,0.38,-7,0.88,1.75,1.12,2.63,2.63,7
Cape Town Spurs,8,1,5,2,7,5,2,8,southafrica2,0.12,0.75,2,0.88,0.62,1.0,8.33,1.33,8
Leruma United,8,1,5,2,8,9,-1,8,southafrica2,0.12,0.75,-1,1.0,1.12,1.0,8.33,1.33,8
Venda FC,8,1,5,2,7,8,-1,8,southafrica2,0.12,0.75,-1,0.88,1.0,1.0,8.33,1.33,8
JDR Stars,8,1,4,3,6,10,-4,7,southafrica2,0.12,0.62,-4,0.75,1.25,0.88,8.33,1.61,9
Hungry Lions,8,1,3,4,5,8,-3,6,southafrica2,0.12,0.5,-3,0.62,1.0,0.75,8.33,2.0,10
Jeonbuk Motors,8,6,2,0,14,3,11,20,southkorea,0.75,1.0,11,1.75,0.38,2.5,1.33,1.0,1
Pohang Steelers,8,5,1,2,12,6,6,16,southkorea,0.62,0.75,6,1.5,0.75,2.0,1.61,1.33,2
Ulsan,8,3,3,2,12,11,1,12,southkorea,0.38,0.75,1,1.5,1.38,1.5,2.63,1.33,3
Daejeon Citizen,8,3,3,2,8,10,-2,12,southkorea,0.38,0.75,-2,1.0,1.25,1.5,2.63,1.33,3
Gimcheon Sangmu,8,3,2,3,12,8,4,11,southkorea,0.38,0.62,4,1.5,1.0,1.38,2.63,1.61,4
Gwangju,8,3,2,3,6,8,-2,11,southkorea,0.38,0.62,-2,0.75,1.0,1.38,2.63,1.61,4
Suwon City,8,2,3,3,8,8,0,9,southkorea,0.25,0.62,0,1.0,1.0,1.12,4.0,1.61,5
Anyang,8,2,3,3,10,12,-2,9,southkorea,0.25,0.62,-2,1.25,1.5,1.12,4.0,1.61,5
Seoul,8,2,3,3,5,7,-2,9,southkorea,0.25,0.62,-2,0.62,0.88,1.12,4.0,1.61,5
Jeju Utd,8,2,2,4,8,12,-4,8,southkorea,0.25,0.5,-4,1.0,1.5,1.0,4.0,2.0,6
Gangwon,8,2,2,4,7,11,-4,8,southkorea,0.25,0.5,-4,0.88,1.38,1.0,4.0,2.0,6
Daegu,8,1,2,5,9,16,-7,5,southkorea,0.12,0.38,-7,1.12,2.0,0.62,8.33,2.63,7
Incheon Utd,8,7,1,0,20,4,16,22,southkorea2,0.88,1.0,16,2.5,0.5,2.75,1.14,1.0,1
Suwon Bluewings,8,6,2,0,22,10,12,20,southkorea2,0.75,1.0,12,2.75,1.25,2.5,1.33,1.0,2
Busan IPark,8,5,1,2,15,10,5,16,southkorea2,0.62,0.75,5,1.88,1.25,2.0,1.61,1.33,3
Jeonnam,8,4,3,1,13,9,4,15,southkorea2,0.5,0.88,4,1.62,1.12,1.88,2.0,1.14,4
Asan,8,4,2,2,12,8,4,14,southkorea2,0.5,0.75,4,1.5,1.0,1.75,2.0,1.33,5
Seoul E-Land,8,4,2,2,10,11,-1,14,southkorea2,0.5,0.75,-1,1.25,1.38,1.75,2.0,1.33,5
Ansan Greeners,8,3,2,3,6,9,-3,11,southkorea2,0.38,0.62,-3,0.75,1.12,1.38,2.63,1.61,6
Bucheon FC,8,2,3,3,10,12,-2,9,southkorea2,0.25,0.62,-2,1.25,1.5,1.12,4.0,1.61,7
Gyeongnam,8,3,0,5,9,13,-4,9,southkorea2,0.38,0.38,-4,1.12,1.62,1.12,2.63,2.63,7
Cheongju,8,2,2,4,8,13,-5,8,southkorea2,0.25,0.5,-5,1.0,1.62,1.0,4.0,2.0,8
Gimpo,8,2,1,5,5,11,-6,7,southkorea2,0.25,0.38,-6,0.62,1.38,0.88,4.0,2.63,9
Hwaseong,8,2,0,6,8,13,-5,6,southkorea2,0.25,0.25,-5,1.0,1.62,0.75,4.0,4.0,10
Seongnam,8,0,3,5,6,11,-5,3,southkorea2,0.0,0.38,-5,0.75,1.38,0.38,0.0,2.63,11
Cheonan City,8,0,2,6,6,16,-10,2,southkorea2,0.0,0.25,-10,0.75,2.0,0.25,0.0,4.0,12
FC Barcelona,8,7,0,1,19,10,9,21,spain,0.88,0.88,9,2.38,1.25,2.62,1.14,1.14,1
Real Madrid,8,7,0,1,15,7,8,21,spain,0.88,0.88,8,1.88,0.88,2.62,1.14,1.14,1
Villarreal,8,6,1,1,18,11,7,19,spain,0.75,0.88,7,2.25,1.38,2.38,1.33,1.14,2
Osasuna,8,5,2,1,14,9,5,17,spain,0.62,0.88,5,1.75,1.12,2.12,1.61,1.14,3
Atletico Madrid,8,5,1,2,19,6,13,16,spain,0.62,0.75,13,2.38,0.75,2.0,1.61,1.33,4
Athletic Bilbao,8,5,1,2,8,5,3,16,spain,0.62,0.75,3,1.0,0.62,2.0,1.61,1.33,4
Real Betis,8,3,3,2,16,13,3,12,spain,0.38,0.75,3,2.0,1.62,1.5,2.63,1.33,5
Valencia,8,3,3,2,10,7,3,12,spain,0.38,0.75,3,1.25,0.88,1.5,2.63,1.33,5
Celta Vigo,8,4,0,4,15,14,1,12,spain,0.5,0.5,1,1.88,1.75,1.5,2.0,2.0,5
Leganes,8,3,3,2,10,9,1,12,spain,0.38,0.75,1,1.25,1.12,1.5,2.63,1.33,5
Alaves,8,3,3,2,5,4,1,12,spain,0.38,0.75,1,0.62,0.5,1.5,2.63,1.33,5
Rayo Vallecano,8,3,3,2,8,10,-2,12,spain,0.38,0.75,-2,1.0,1.25,1.5,2.63,1.33,5
Mallorca,8,2,2,4,6,7,-1,8,spain,0.25,0.5,-1,0.75,0.88,1.0,4.0,2.0,6
Espanyol,8,2,1,5,7,11,-4,7,spain,0.25,0.38,-4,0.88,1.38,0.88,4.0,2.63,7
Girona,8,2,1,5,7,14,-7,7,spain,0.25,0.38,-7,0.88,1.75,0.88,4.0,2.63,7
Las Palmas,8,2,0,6,6,10,-4,6,spain,0.25,0.25,-4,0.75,1.25,0.75,4.0,4.0,8
Sevilla FC,8,1,2,5,8,14,-6,5,spain,0.12,0.38,-6,1.0,1.75,0.62,8.33,2.63,9
Real Sociedad,8,1,2,5,5,14,-9,5,spain,0.12,0.38,-9,0.62,1.75,0.62,8.33,2.63,9
Getafe,8,1,0,7,4,14,-10,3,spain,0.12,0.12,-10,0.5,1.75,0.38,8.33,8.33,10
Valladolid,8,0,0,8,7,21,-14,0,spain,0.0,0.0,-14,0.88,2.62,0.0,0.0,0.0,11
Real Oviedo,8,6,2,0,11,3,8,20,spain2,0.75,1.0,8,1.38,0.38,2.5,1.33,1.0,1
Levante,8,5,2,1,16,9,7,17,spain2,0.62,0.88,7,2.0,1.12,2.12,1.61,1.14,2
Mirandes,8,5,2,1,14,10,4,17,spain2,0.62,0.88,4,1.75,1.25,2.12,1.61,1.14,2
Almeria,8,5,1,2,15,8,7,16,spain2,0.62,0.75,7,1.88,1.0,2.0,1.61,1.33,3
Sporting Gijon,8,5,0,3,16,12,4,15,spain2,0.62,0.62,4,2.0,1.5,1.88,1.61,1.61,4
Elche,8,4,2,2,13,8,5,14,spain2,0.5,0.75,5,1.62,1.0,1.75,2.0,1.33,5
Granada,8,4,1,3,12,11,1,13,spain2,0.5,0.62,1,1.5,1.38,1.62,2.0,1.61,6
Eibar,8,3,3,2,12,8,4,12,spain2,0.38,0.75,4,1.5,1.0,1.5,2.63,1.33,7
Racing,8,3,3,2,12,11,1,12,spain2,0.38,0.75,1,1.5,1.38,1.5,2.63,1.33,7
Castellon,8,3,2,3,17,13,4,11,spain2,0.38,0.62,4,2.12,1.62,1.38,2.63,1.61,8
Malaga,8,3,2,3,8,9,-1,11,spain2,0.38,0.62,-1,1.0,1.12,1.38,2.63,1.61,8
Albacete,8,3,2,3,12,14,-2,11,spain2,0.38,0.62,-2,1.5,1.75,1.38,2.63,1.61,8
Real Zaragoza,8,3,2,3,12,16,-4,11,spain2,0.38,0.62,-4,1.5,2.0,1.38,2.63,1.61,8
Cadiz,8,3,1,4,12,11,1,10,spain2,0.38,0.5,1,1.5,1.38,1.25,2.63,2.0,9
Huesca,8,3,1,4,11,16,-5,10,spain2,0.38,0.5,-5,1.38,2.0,1.25,2.63,2.0,9
Cordoba,8,1,4,3,12,15,-3,7,spain2,0.12,0.62,-3,1.5,1.88,0.88,8.33,1.61,10
Racing Ferrol,8,2,1,5,4,11,-7,7,spain2,0.25,0.38,-7,0.5,1.38,0.88,4.0,2.63,10
Burgos,8,1,3,4,10,13,-3,6,spain2,0.12,0.5,-3,1.25,1.62,0.75,8.33,2.0,11
Cartagena,8,2,0,6,11,17,-6,6,spain2,0.25,0.25,-6,1.38,2.12,0.75,4.0,4.0,11
Eldense,8,1,3,4,9,16,-7,6,spain2,0.12,0.5,-7,1.12,2.0,0.75,8.33,2.0,11
Deportivo,8,1,2,5,11,15,-4,5,spain2,0.12,0.38,-4,1.38,1.88,0.62,8.33,2.63,12
Tenerife,8,0,5,3,2,6,-4,5,spain2,0.0,0.62,-4,0.25,0.75,0.62,0.0,1.61,12
Ponferradina,8,6,0,2,16,9,7,18,spain3,0.75,0.75,7,2.0,1.12,2.25,1.33,1.33,1
Real Sociedad B,8,5,2,1,10,5,5,17,spain3,0.62,0.88,5,1.25,0.62,2.12,1.61,1.14,2
FC Andorra,8,5,1,2,14,7,7,16,spain3,0.62,0.75,7,1.75,0.88,2.0,1.61,1.33,3
FC Barcelona B,8,5,0,3,15,11,4,15,spain3,0.62,0.62,4,1.88,1.38,1.88,1.61,1.61,4
Celta Vigo B,8,4,2,2,16,11,5,14,spain3,0.5,0.75,5,2.0,1.38,1.75,2.0,1.33,5
Tarazona,8,4,2,2,8,3,5,14,spain3,0.5,0.75,5,1.0,0.38,1.75,2.0,1.33,5
Athletic B. B,8,4,1,3,11,9,2,13,spain3,0.5,0.62,2,1.38,1.12,1.62,2.0,1.61,6
Amorebieta,8,4,0,4,11,10,1,12,spain3,0.5,0.5,1,1.38,1.25,1.5,2.0,2.0,7
Gimnastic T.,8,3,2,3,17,11,6,11,spain3,0.38,0.62,6,2.12,1.38,1.38,2.63,1.61,8
Osasuna B,8,3,2,3,12,11,1,11,spain3,0.38,0.62,1,1.5,1.38,1.38,2.63,1.61,8
Sestao River,8,3,2,3,11,13,-2,11,spain3,0.38,0.62,-2,1.38,1.62,1.38,2.63,1.61,8
Leonesa,8,3,1,4,7,9,-2,10,spain3,0.38,0.5,-2,0.88,1.12,1.25,2.63,2.0,9
Gimnastica,8,2,4,2,9,13,-4,10,spain3,0.25,0.75,-4,1.12,1.62,1.25,4.0,1.33,9
Zamora,8,2,3,3,7,8,-1,9,spain3,0.25,0.62,-1,0.88,1.0,1.12,4.0,1.61,10
Ourense CF,8,2,3,3,7,13,-6,9,spain3,0.25,0.62,-6,0.88,1.62,1.12,4.0,1.61,10
Arenteiro,8,1,4,3,5,10,-5,7,spain3,0.12,0.62,-5,0.62,1.25,0.88,8.33,1.61,11
Real Union,8,2,1,5,10,16,-6,7,spain3,0.25,0.38,-6,1.25,2.0,0.88,4.0,2.63,11
Lugo,8,2,1,5,6,13,-7,7,spain3,0.25,0.38,-7,0.75,1.62,0.88,4.0,2.63,11
Unionistas,8,1,3,4,3,10,-7,6,spain3,0.12,0.5,-7,0.38,1.25,0.75,8.33,2.0,12
Barakaldo,8,1,2,5,8,11,-3,5,spain3,0.12,0.38,-3,1.0,1.38,0.62,8.33,2.63,13
Ceuta,8,5,2,1,9,8,1,17,spain4,0.62,0.88,1,1.12,1.0,2.12,1.61,1.14,1
UD Ibiza,8,4,3,1,13,3,10,15,spain4,0.5,0.88,10,1.62,0.38,1.88,2.0,1.14,2
Algeciras,8,4,3,1,15,9,6,15,spain4,0.5,0.88,6,1.88,1.12,1.88,2.0,1.14,2
Real Murcia,8,4,3,1,8,5,3,15,spain4,0.5,0.88,3,1.0,0.62,1.88,2.0,1.14,2
Real Madrid B,8,3,4,1,12,5,7,13,spain4,0.38,0.88,7,1.5,0.62,1.62,2.63,1.14,3
Merida,8,3,4,1,9,5,4,13,spain4,0.38,0.88,4,1.12,0.62,1.62,2.63,1.14,3
Marbella,8,4,1,3,14,12,2,13,spain4,0.5,0.62,2,1.75,1.5,1.62,2.0,1.61,3
Alcorcon,8,4,1,3,11,10,1,13,spain4,0.5,0.62,1,1.38,1.25,1.62,2.0,1.61,3
Atletico M. B,8,3,3,2,11,7,4,12,spain4,0.38,0.75,4,1.38,0.88,1.5,2.63,1.33,4
Sanluqueno,8,3,3,2,9,10,-1,12,spain4,0.38,0.75,-1,1.12,1.25,1.5,2.63,1.33,4
Villarreal B,8,3,2,3,10,9,1,11,spain4,0.38,0.62,1,1.25,1.12,1.38,2.63,1.61,5
Antequera,8,3,2,3,11,12,-1,11,spain4,0.38,0.62,-1,1.38,1.5,1.38,2.63,1.61,5
Yeclano,8,2,3,3,8,9,-1,9,spain4,0.25,0.62,-1,1.0,1.12,1.12,4.0,1.61,6
Sevilla FC B,8,2,3,3,7,11,-4,9,spain4,0.25,0.62,-4,0.88,1.38,1.12,4.0,1.61,6
Alcoyano,8,2,2,4,8,10,-2,8,spain4,0.25,0.5,-2,1.0,1.25,1.0,4.0,2.0,7
Fuenlabrada,8,2,2,4,12,15,-3,8,spain4,0.25,0.5,-3,1.5,1.88,1.0,4.0,2.0,7
Intercity,8,2,1,5,5,10,-5,7,spain4,0.25,0.38,-5,0.62,1.25,0.88,4.0,2.63,8
Real Betis B,8,1,3,4,7,15,-8,6,spain4,0.12,0.5,-8,0.88,1.88,0.75,8.33,2.0,9
Recreativo H.,8,1,2,5,4,14,-10,5,spain4,0.12,0.38,-10,0.5,1.75,0.62,8.33,2.63,10
Hercules,8,1,1,6,10,14,-4,4,spain4,0.12,0.25,-4,1.25,1.75,0.5,8.33,4.0,11
Pontevedra,8,6,1,1,16,11,5,19,spain5,0.75,0.88,5,2.0,1.38,2.38,1.33,1.14,1
Numancia,8,5,0,3,17,7,10,15,spain5,0.62,0.62,10,2.12,0.88,1.88,1.61,1.61,2
Escobedo,8,4,3,1,15,6,9,15,spain5,0.5,0.88,9,1.88,0.75,1.88,2.0,1.14,2
Coruxo,8,4,3,1,11,5,6,15,spain5,0.5,0.88,6,1.38,0.62,1.88,2.0,1.14,2
D. Fabril,8,4,2,2,16,8,8,14,spain5,0.5,0.75,8,2.0,1.0,1.75,2.0,1.33,3
Real Aviles,8,4,2,2,11,10,1,14,spain5,0.5,0.75,1,1.38,1.25,1.75,2.0,1.33,3
Rayo Cantabria,8,4,1,3,13,8,5,13,spain5,0.5,0.62,5,1.62,1.0,1.62,2.0,1.61,4
Langreo,8,3,3,2,10,8,2,12,spain5,0.38,0.75,2,1.25,1.0,1.5,2.63,1.33,5
Compostela,8,3,2,3,10,10,0,11,spain5,0.38,0.62,0,1.25,1.25,1.38,2.63,1.61,6
Bergantinos,8,3,2,3,12,13,-1,11,spain5,0.38,0.62,-1,1.5,1.62,1.38,2.63,1.61,6
Torrelavega,8,3,1,4,16,14,2,10,spain5,0.38,0.5,2,2.0,1.75,1.25,2.63,2.0,7
Salamanca CF,8,3,1,4,8,11,-3,10,spain5,0.38,0.5,-3,1.0,1.38,1.25,2.63,2.0,7
Marino de L.,8,2,3,3,10,10,0,9,spain5,0.25,0.62,0,1.25,1.25,1.12,4.0,1.61,8
Llanera,8,2,3,3,8,13,-5,9,spain5,0.25,0.62,-5,1.0,1.62,1.12,4.0,1.61,8
Real Avila,8,2,2,4,9,12,-3,8,spain5,0.25,0.5,-3,1.12,1.5,1.0,4.0,2.0,9
Valladolid B,8,2,1,5,9,16,-7,7,spain5,0.25,0.38,-7,1.12,2.0,0.88,4.0,2.63,10
Laredo,8,1,3,4,6,17,-11,6,spain5,0.12,0.5,-11,0.75,2.12,0.75,8.33,2.0,11
Guijuelo,8,1,0,7,4,20,-16,3,spain5,0.12,0.12,-16,0.5,2.5,0.38,8.33,8.33,12
Arenas Club,8,6,2,0,15,4,11,20,spain6,0.75,1.0,11,1.88,0.5,2.5,1.33,1.0,1
Alaves B,8,5,3,0,14,7,7,18,spain6,0.62,1.0,7,1.75,0.88,2.25,1.61,1.0,2
SD Logrones,8,5,2,1,12,6,6,17,spain6,0.62,0.88,6,1.5,0.75,2.12,1.61,1.14,3
Utebo,8,5,2,1,13,8,5,17,spain6,0.62,0.88,5,1.62,1.0,2.12,1.61,1.14,3
Teruel,8,5,1,2,11,5,6,16,spain6,0.62,0.75,6,1.38,0.62,2.0,1.61,1.33,4
Barbastro,8,4,2,2,9,5,4,14,spain6,0.5,0.75,4,1.12,0.62,1.75,2.0,1.33,5
Real Zaragoza B,8,4,2,2,12,9,3,14,spain6,0.5,0.75,3,1.5,1.12,1.75,2.0,1.33,5
UD Logrones,8,4,1,3,9,4,5,13,spain6,0.5,0.62,5,1.12,0.5,1.62,2.0,1.61,6
Tudelano,8,3,2,3,12,9,3,11,spain6,0.38,0.62,3,1.5,1.12,1.38,2.63,1.61,7
Gernika,8,3,2,3,9,11,-2,11,spain6,0.38,0.62,-2,1.12,1.38,1.38,2.63,1.61,7
Calahorra,8,3,1,4,6,9,-3,10,spain6,0.38,0.5,-3,0.75,1.12,1.25,2.63,2.0,8
Anguiano,8,2,2,4,4,10,-6,8,spain6,0.25,0.5,-6,0.5,1.25,1.0,4.0,2.0,9
Subiza,8,2,1,5,12,13,-1,7,spain6,0.25,0.38,-1,1.5,1.62,0.88,4.0,2.63,10
Eibar B,8,1,4,3,5,8,-3,7,spain6,0.12,0.62,-3,0.62,1.0,0.88,8.33,1.61,10
Alfaro,8,2,0,6,7,16,-9,6,spain6,0.25,0.25,-9,0.88,2.0,0.75,4.0,4.0,11
Ejea,8,0,5,3,6,9,-3,5,spain6,0.0,0.62,-3,0.75,1.12,0.62,0.0,1.61,12
Izarra,8,1,0,7,8,19,-11,3,spain6,0.12,0.12,-11,1.0,2.38,0.38,8.33,8.33,13
Real Sociedad C,8,1,0,7,4,16,-12,3,spain6,0.12,0.12,-12,0.5,2.0,0.38,8.33,8.33,13
Europa,8,7,1,0,16,2,14,22,spain7,0.88,1.0,14,2.0,0.25,2.75,1.14,1.0,1
Andratx,8,6,1,1,13,6,7,19,spain7,0.75,0.88,7,1.62,0.75,2.38,1.33,1.14,2
Sabadell,8,6,0,2,21,6,15,18,spain7,0.75,0.75,15,2.62,0.75,2.25,1.33,1.33,3
A. Baleares,8,5,3,0,15,5,10,18,spain7,0.62,1.0,10,1.88,0.62,2.25,1.61,1.0,3
Olot,8,5,2,1,14,8,6,17,spain7,0.62,0.88,6,1.75,1.0,2.12,1.61,1.14,4
Torrent,8,4,1,3,12,9,3,13,spain7,0.5,0.62,3,1.5,1.12,1.62,2.0,1.61,5
Cornella,8,4,1,3,12,11,1,13,spain7,0.5,0.62,1,1.5,1.38,1.62,2.0,1.61,5
SD Ibiza,8,4,1,3,10,9,1,13,spain7,0.5,0.62,1,1.25,1.12,1.62,2.0,1.61,5
Terrassa,8,4,0,4,12,11,1,12,spain7,0.5,0.5,1,1.5,1.38,1.5,2.0,2.0,6
Sant Andreu,8,3,2,3,18,13,5,11,spain7,0.38,0.62,5,2.25,1.62,1.38,2.63,1.61,7
Valencia B,8,3,2,3,11,12,-1,11,spain7,0.38,0.62,-1,1.38,1.5,1.38,2.63,1.61,7
Espanyol B,8,2,3,3,7,7,0,9,spain7,0.25,0.62,0,0.88,0.88,1.12,4.0,1.61,8
Ilicitano,8,2,2,4,7,10,-3,8,spain7,0.25,0.5,-3,0.88,1.25,1.0,4.0,2.0,9
Pena Deportiva,8,1,4,3,8,10,-2,7,spain7,0.12,0.62,-2,1.0,1.25,0.88,8.33,1.61,10
Lleida,8,1,3,4,4,10,-6,6,spain7,0.12,0.5,-6,0.5,1.25,0.75,8.33,2.0,11
Mallorca B,8,2,0,6,8,19,-11,6,spain7,0.25,0.25,-11,1.0,2.38,0.75,4.0,4.0,11
Badalona,8,0,0,8,5,24,-19,0,spain7,0.0,0.0,-19,0.62,3.0,0.0,0.0,0.0,12
Alzira,8,0,0,8,1,22,-21,0,spain7,0.0,0.0,-21,0.12,2.75,0.0,0.0,0.0,12
Antoniano,8,6,1,1,14,7,7,19,spain8,0.75,0.88,7,1.75,0.88,2.38,1.33,1.14,1
Torremolinos,8,6,0,2,17,6,11,18,spain8,0.75,0.75,11,2.12,0.75,2.25,1.33,1.33,2
CD Estepona,8,5,2,1,11,7,4,17,spain8,0.62,0.88,4,1.38,0.88,2.12,1.61,1.14,3
La Union,8,5,1,2,11,5,6,16,spain8,0.62,0.75,6,1.38,0.62,2.0,1.61,1.33,4
Villanovense,8,5,1,2,10,5,5,16,spain8,0.62,0.75,5,1.25,0.62,2.0,1.61,1.33,4
UCAM Murcia,8,4,2,2,13,8,5,14,spain8,0.5,0.75,5,1.62,1.0,1.75,2.0,1.33,5
Xerez CD,8,4,1,3,12,8,4,13,spain8,0.5,0.62,4,1.5,1.0,1.62,2.0,1.61,6
Aguilas CF,8,4,0,4,5,7,-2,12,spain8,0.5,0.5,-2,0.62,0.88,1.5,2.0,2.0,7
Cadiz B,8,3,2,3,10,8,2,11,spain8,0.38,0.62,2,1.25,1.0,1.38,2.63,1.61,8
Almeria B,8,3,2,3,8,10,-2,11,spain8,0.38,0.62,-2,1.0,1.25,1.38,2.63,1.61,8
Xerez D. FC,8,3,1,4,7,11,-4,10,spain8,0.38,0.5,-4,0.88,1.38,1.25,2.63,2.0,9
Linares,8,2,3,3,8,9,-1,9,spain8,0.25,0.62,-1,1.0,1.12,1.12,4.0,1.61,10
D. Minera,8,3,0,5,12,15,-3,9,spain8,0.38,0.38,-3,1.5,1.88,1.12,2.63,2.63,10
Don Benito,8,2,2,4,10,13,-3,8,spain8,0.25,0.5,-3,1.25,1.62,1.0,4.0,2.0,11
Orihuela,8,2,2,4,5,9,-4,8,spain8,0.25,0.5,-4,0.62,1.12,1.0,4.0,2.0,11
Linense,8,2,1,5,4,8,-4,7,spain8,0.25,0.38,-4,0.5,1.0,0.88,4.0,2.63,12
Granada B,8,1,0,7,1,14,-13,3,spain8,0.12,0.12,-13,0.12,1.75,0.38,8.33,8.33,13
San Fernando,8,0,2,6,1,11,-10,2,spain8,0.0,0.25,-10,0.12,1.38,0.25,0.0,4.0,14
S. Sebastian R.,8,6,2,0,14,4,10,20,spain9,0.75,1.0,10,1.75,0.5,2.5,1.33,1.0,1
Cacereno,8,5,3,0,17,6,11,18,spain9,0.62,1.0,11,2.12,0.75,2.25,1.61,1.0,2
Talavera CF,8,4,2,2,11,5,6,14,spain9,0.5,0.75,6,1.38,0.62,1.75,2.0,1.33,3
Guadalajara,8,4,1,3,13,11,2,13,spain9,0.5,0.62,2,1.62,1.38,1.62,2.0,1.61,4
Navalcarnero,8,4,1,3,11,9,2,13,spain9,0.5,0.62,2,1.38,1.12,1.62,2.0,1.61,4
Real Madrid C,8,4,1,3,9,7,2,13,spain9,0.5,0.62,2,1.12,0.88,1.62,2.0,1.61,4
CD Mostoles,8,4,0,4,17,13,4,12,spain9,0.5,0.5,4,2.12,1.62,1.5,2.0,2.0,5
Melilla,8,3,3,2,13,13,0,12,spain9,0.38,0.75,0,1.62,1.62,1.5,2.63,1.33,5
R. Majadahonda,8,3,3,2,6,6,0,12,spain9,0.38,0.75,0,0.75,0.75,1.5,2.63,1.33,5
Union Adarve,8,2,3,3,5,5,0,9,spain9,0.25,0.62,0,0.62,0.62,1.12,4.0,1.61,6
Illescas,8,2,3,3,10,11,-1,9,spain9,0.25,0.62,-1,1.25,1.38,1.12,4.0,1.61,6
Conquense,8,2,3,3,7,11,-4,9,spain9,0.25,0.62,-4,0.88,1.38,1.12,4.0,1.61,6
Colonia M.,8,2,3,3,10,15,-5,9,spain9,0.25,0.62,-5,1.25,1.88,1.12,4.0,1.61,6
Getafe B,8,2,2,4,10,13,-3,8,spain9,0.25,0.5,-3,1.25,1.62,1.0,4.0,2.0,7
CD Coria,8,1,4,3,8,13,-5,7,spain9,0.12,0.62,-5,1.0,1.62,0.88,8.33,1.61,8
Atletico Paso,8,1,3,4,9,14,-5,6,spain9,0.12,0.5,-5,1.12,1.75,0.75,8.33,2.0,9
Tenerife B,8,1,3,4,9,14,-5,6,spain9,0.12,0.5,-5,1.12,1.75,0.75,8.33,2.0,9
Yaiza,8,0,4,4,5,14,-9,4,spain9,0.0,0.5,-9,0.62,1.75,0.5,0.0,2.0,10
Mjallby,8,6,1,1,15,6,9,19,sweden,0.75,0.88,9,1.88,0.75,2.38,1.33,1.14,1
Elfsborg,8,6,0,2,19,11,8,18,sweden,0.75,0.75,8,2.38,1.38,2.25,1.33,1.33,2
Hammarby,8,4,3,1,12,6,6,15,sweden,0.5,0.88,6,1.5,0.75,1.88,2.0,1.14,3
Malmo FF,8,4,2,2,15,6,9,14,sweden,0.5,0.75,9,1.88,0.75,1.75,2.0,1.33,4
GAIS,8,3,4,1,12,8,4,13,sweden,0.38,0.88,4,1.5,1.0,1.62,2.63,1.14,5
IFK Goteborg,8,4,1,3,12,9,3,13,sweden,0.5,0.62,3,1.5,1.12,1.62,2.0,1.61,5
AIK,8,3,4,1,10,8,2,13,sweden,0.38,0.88,2,1.25,1.0,1.62,2.63,1.14,5
Djurgarden,8,3,2,3,7,11,-4,11,sweden,0.38,0.62,-4,0.88,1.38,1.38,2.63,1.61,6
Halmstad,8,3,1,4,10,16,-6,10,sweden,0.38,0.5,-6,1.25,2.0,1.25,2.63,2.0,7
Hacken,8,2,3,3,12,14,-2,9,sweden,0.25,0.62,-2,1.5,1.75,1.12,4.0,1.61,8
Sirius,8,2,2,4,14,14,0,8,sweden,0.25,0.5,0,1.75,1.75,1.0,4.0,2.0,9
Norrkoping,8,2,2,4,10,14,-4,8,sweden,0.25,0.5,-4,1.25,1.75,1.0,4.0,2.0,9
Oster,8,2,2,4,5,10,-5,8,sweden,0.25,0.5,-5,0.62,1.25,1.0,4.0,2.0,9
Degerfors,8,2,1,5,11,19,-8,7,sweden,0.25,0.38,-8,1.38,2.38,0.88,4.0,2.63,10
Brommapojkarna,8,1,1,6,7,13,-6,4,sweden,0.12,0.25,-6,0.88,1.62,0.5,8.33,4.0,11
Varnamo,8,0,3,5,8,17,-9,3,sweden,0.0,0.38,-9,1.0,2.12,0.38,0.0,2.63,12
Orgryte,8,5,2,1,23,9,14,17,sweden2,0.62,0.88,14,2.88,1.12,2.12,1.61,1.14,1
Kalmar,8,4,4,0,14,4,10,16,sweden2,0.5,1.0,10,1.75,0.5,2.0,2.0,1.0,2
Varberg BoIS,8,5,1,2,16,9,7,16,sweden2,0.62,0.75,7,2.0,1.12,2.0,1.61,1.33,2
Landskrona,8,4,2,2,13,13,0,14,sweden2,0.5,0.75,0,1.62,1.62,1.75,2.0,1.33,3
Falkenberg,8,3,4,1,15,9,6,13,sweden2,0.38,0.88,6,1.88,1.12,1.62,2.63,1.14,4
Oddevold,8,4,1,3,13,13,0,13,sweden2,0.5,0.62,0,1.62,1.62,1.62,2.0,1.61,4
Utsikten,8,2,6,0,20,15,5,12,sweden2,0.25,1.0,5,2.5,1.88,1.5,4.0,1.0,5
Vasteras,8,3,3,2,14,15,-1,12,sweden2,0.38,0.75,-1,1.75,1.88,1.5,2.63,1.33,5
Ostersunds,8,3,2,3,9,8,1,11,sweden2,0.38,0.62,1,1.12,1.0,1.38,2.63,1.61,6
Brage,8,3,2,3,10,10,0,11,sweden2,0.38,0.62,0,1.25,1.25,1.38,2.63,1.61,6
GIF Sundsvall,8,3,2,3,9,10,-1,11,sweden2,0.38,0.62,-1,1.12,1.25,1.38,2.63,1.61,6
Helsingborg,8,2,3,3,7,11,-4,9,sweden2,0.25,0.62,-4,0.88,1.38,1.12,4.0,1.61,7
Sandviken,8,2,1,5,7,16,-9,7,sweden2,0.25,0.38,-9,0.88,2.0,0.88,4.0,2.63,8
Trelleborg,8,1,2,5,5,13,-8,5,sweden2,0.12,0.38,-8,0.62,1.62,0.62,8.33,2.63,9
Orebro,8,0,3,5,11,19,-8,3,sweden2,0.0,0.38,-8,1.38,2.38,0.38,0.0,2.63,10
Umea,8,0,2,6,7,19,-12,2,sweden2,0.0,0.25,-12,0.88,2.38,0.25,0.0,4.0,11
FC Basel,8,7,0,1,30,11,19,21,switzerland,0.88,0.88,19,3.75,1.38,2.62,1.14,1.14,1
Winterthur,8,5,2,1,13,7,6,17,switzerland,0.62,0.88,6,1.62,0.88,2.12,1.61,1.14,2
Lausanne Sport,8,3,3,2,14,11,3,12,switzerland,0.38,0.75,3,1.75,1.38,1.5,2.63,1.33,3
Grasshopper,8,4,0,4,13,10,3,12,switzerland,0.5,0.5,3,1.62,1.25,1.5,2.0,2.0,3
Servette,8,3,3,2,15,15,0,12,switzerland,0.38,0.75,0,1.88,1.88,1.5,2.63,1.33,3
BSC Young Boys,8,3,3,2,14,14,0,12,switzerland,0.38,0.75,0,1.75,1.75,1.5,2.63,1.33,3
St. Gallen,8,3,3,2,9,11,-2,12,switzerland,0.38,0.75,-2,1.12,1.38,1.5,2.63,1.33,3
Sion,8,2,3,3,7,10,-3,9,switzerland,0.25,0.62,-3,0.88,1.25,1.12,4.0,1.61,4
FC Zurich,8,2,1,5,13,15,-2,7,switzerland,0.25,0.38,-2,1.62,1.88,0.88,4.0,2.63,5
Yverdon,8,1,4,3,9,19,-10,7,switzerland,0.12,0.62,-10,1.12,2.38,0.88,8.33,1.61,5
Lugano,8,1,3,4,8,16,-8,6,switzerland,0.12,0.5,-8,1.0,2.0,0.75,8.33,2.0,6
Luzern,8,1,1,6,12,18,-6,4,switzerland,0.12,0.25,-6,1.5,2.25,0.5,8.33,4.0,7
Thun,8,6,1,1,21,7,14,19,switzerland2,0.75,0.88,14,2.62,0.88,2.38,1.33,1.14,1
Bellinzona,8,5,2,1,17,15,2,17,switzerland2,0.62,0.88,2,2.12,1.88,2.12,1.61,1.14,2
Lausanne Ouchy,8,4,3,1,12,7,5,15,switzerland2,0.5,0.88,5,1.5,0.88,1.88,2.0,1.14,3
Wil,8,4,2,2,16,18,-2,14,switzerland2,0.5,0.75,-2,2.0,2.25,1.75,2.0,1.33,4
Vaduz,8,3,2,3,10,12,-2,11,switzerland2,0.38,0.62,-2,1.25,1.5,1.38,2.63,1.61,5
Stade Nyonnais,8,3,1,4,8,12,-4,10,switzerland2,0.38,0.5,-4,1.0,1.5,1.25,2.63,2.0,6
Aarau,8,1,5,2,13,14,-1,8,switzerland2,0.12,0.75,-1,1.62,1.75,1.0,8.33,1.33,7
Etoile Carouge,8,2,1,5,13,12,1,7,switzerland2,0.25,0.38,1,1.62,1.5,0.88,4.0,2.63,8
Neuchatel Xamax,8,1,2,5,9,14,-5,5,switzerland2,0.12,0.38,-5,1.12,1.75,0.62,8.33,2.63,9
Schaffhausen,8,1,1,6,9,17,-8,4,switzerland2,0.12,0.25,-8,1.12,2.12,0.5,8.33,4.0,10
Bangkok Utd,8,7,1,0,22,7,15,22,thailand,0.88,1.0,15,2.75,0.88,2.75,1.14,1.0,1
Ratchaburi,8,6,0,2,26,13,13,18,thailand,0.75,0.75,13,3.25,1.62,2.25,1.33,1.33,2
Pathum Utd,8,5,2,1,15,10,5,17,thailand,0.62,0.88,5,1.88,1.25,2.12,1.61,1.14,3
Buriram Utd,8,5,1,2,21,8,13,16,thailand,0.62,0.75,13,2.62,1.0,2.0,1.61,1.33,4
Prachuap,8,4,1,3,16,12,4,13,thailand,0.5,0.62,4,2.0,1.5,1.62,2.0,1.61,5
Port FC,8,3,3,2,13,11,2,12,thailand,0.38,0.75,2,1.62,1.38,1.5,2.63,1.33,6
Chiangrai Utd,8,3,1,4,13,13,0,10,thailand,0.38,0.5,0,1.62,1.62,1.25,2.63,2.0,7
Muang Thong Utd,8,3,1,4,12,14,-2,10,thailand,0.38,0.5,-2,1.5,1.75,1.25,2.63,2.0,7
Rayong,8,3,1,4,12,14,-2,10,thailand,0.38,0.5,-2,1.5,1.75,1.25,2.63,2.0,7
Lamphun Warrior,8,2,3,3,8,9,-1,9,thailand,0.25,0.62,-1,1.0,1.12,1.12,4.0,1.61,8
Uthai Thani,8,1,5,2,7,8,-1,8,thailand,0.12,0.75,-1,0.88,1.0,1.0,8.33,1.33,9
Sukhothai,8,1,4,3,15,18,-3,7,thailand,0.12,0.62,-3,1.88,2.25,0.88,8.33,1.61,10
Khon Kaen Utd,8,2,1,5,10,22,-12,7,thailand,0.25,0.38,-12,1.25,2.75,0.88,4.0,2.63,10
N. Ratchasima,8,1,2,5,9,20,-11,5,thailand,0.12,0.38,-11,1.12,2.5,0.62,8.33,2.63,11
Nakhon Pathom,8,1,2,5,9,20,-11,5,thailand,0.12,0.38,-11,1.12,2.5,0.62,8.33,2.63,11
N. Bua Pitchaya,8,1,2,5,5,18,-13,5,thailand,0.12,0.38,-13,0.62,2.25,0.62,8.33,2.63,11
Chonburi,8,7,0,1,16,7,9,21,thailand2,0.88,0.88,9,2.0,0.88,2.62,1.14,1.14,1
Ayutthaya Utd,8,4,2,2,19,8,11,14,thailand2,0.5,0.75,11,2.38,1.0,1.75,2.0,1.33,2
Police Tero,8,4,2,2,12,11,1,14,thailand2,0.5,0.75,1,1.5,1.38,1.75,2.0,1.33,2
Kanchanaburi,8,3,4,1,17,10,7,13,thailand2,0.38,0.88,7,2.12,1.25,1.62,2.63,1.14,3
Chainat,8,4,1,3,13,10,3,13,thailand2,0.5,0.62,3,1.62,1.25,1.62,2.0,1.61,3
Chanthaburi,8,3,3,2,11,13,-2,12,thailand2,0.38,0.75,-2,1.38,1.62,1.5,2.63,1.33,4
Mahasarakham,8,2,5,1,9,7,2,11,thailand2,0.25,0.88,2,1.12,0.88,1.38,4.0,1.14,5
Chiangmai Utd,8,3,2,3,10,10,0,11,thailand2,0.38,0.62,0,1.25,1.25,1.38,2.63,1.61,5
Nakhon Si,8,3,2,3,9,9,0,11,thailand2,0.38,0.62,0,1.12,1.12,1.38,2.63,1.61,5
Lampang,8,3,2,3,9,10,-1,11,thailand2,0.38,0.62,-1,1.12,1.25,1.38,2.63,1.61,5
Phrae Utd,8,2,4,2,16,12,4,10,thailand2,0.25,0.75,4,2.0,1.5,1.25,4.0,1.33,6
Kasetsart,8,2,3,3,8,9,-1,9,thailand2,0.25,0.62,-1,1.0,1.12,1.12,4.0,1.61,7
Bangkok FC,8,2,3,3,12,15,-3,9,thailand2,0.25,0.62,-3,1.5,1.88,1.12,4.0,1.61,7
Trat FC,8,2,2,4,10,12,-2,8,thailand2,0.25,0.5,-2,1.25,1.5,1.0,4.0,2.0,8
Sisaket Utd,8,2,1,5,5,14,-9,7,thailand2,0.25,0.38,-9,0.62,1.75,0.88,4.0,2.63,9
Pattaya United,8,1,1,6,5,18,-13,4,thailand2,0.12,0.25,-13,0.62,2.25,0.5,8.33,4.0,10
Suphanburi,8,0,3,5,9,19,-10,3,thailand2,0.0,0.38,-10,1.12,2.38,0.38,0.0,2.63,11
Samut Prakan,0,0,0,0,0,0,0,0,thailand2,0.0,0.0,0,0.0,0.0,0.0,0.0,0.0,12
Galatasaray,8,8,0,0,22,2,20,24,turkey,1.0,1.0,20,2.75,0.25,3.0,1.0,1.0,1
Fenerbahce,8,5,1,2,19,13,6,16,turkey,0.62,0.75,6,2.38,1.62,2.0,1.61,1.33,2
Rizespor,8,5,0,3,17,11,6,15,turkey,0.62,0.62,6,2.12,1.38,1.88,1.61,1.61,3
Trabzonspor,8,4,3,1,13,9,4,15,turkey,0.5,0.88,4,1.62,1.12,1.88,2.0,1.14,3
Besiktas,8,4,2,2,17,8,9,14,turkey,0.5,0.75,9,2.12,1.0,1.75,2.0,1.33,4
Alanyaspor,8,4,2,2,11,8,3,14,turkey,0.5,0.75,3,1.38,1.0,1.75,2.0,1.33,4
Samsunspor,8,4,1,3,11,9,2,13,turkey,0.5,0.62,2,1.38,1.12,1.62,2.0,1.61,5
Konyaspor,8,4,0,4,11,10,1,12,turkey,0.5,0.5,1,1.38,1.25,1.5,2.0,2.0,6
Kayserispor,8,3,3,2,11,11,0,12,turkey,0.38,0.75,0,1.38,1.38,1.5,2.63,1.33,6
Basaksehir,8,4,0,4,15,18,-3,12,turkey,0.5,0.5,-3,1.88,2.25,1.5,2.0,2.0,6
Goztepe,8,3,2,3,13,14,-1,11,turkey,0.38,0.62,-1,1.62,1.75,1.38,2.63,1.61,7
Kasimpasa,8,2,3,3,13,11,2,9,turkey,0.25,0.62,2,1.62,1.38,1.12,4.0,1.61,8
Eyupspor,8,3,0,5,11,15,-4,9,turkey,0.38,0.38,-4,1.38,1.88,1.12,2.63,2.63,8
Antalyaspor,8,2,2,4,5,10,-5,8,turkey,0.25,0.5,-5,0.62,1.25,1.0,4.0,2.0,9
Hatayspor,8,2,1,5,18,22,-4,7,turkey,0.25,0.38,-4,2.25,2.75,0.88,4.0,2.63,10
Bodrumspor,8,1,4,3,4,10,-6,7,turkey,0.12,0.62,-6,0.5,1.25,0.88,8.33,1.61,10
Gaziantep,8,1,3,4,8,13,-5,6,turkey,0.12,0.5,-5,1.0,1.62,0.75,8.33,2.0,11
Sivasspor,8,1,2,5,6,14,-8,5,turkey,0.12,0.38,-8,0.75,1.75,0.62,8.33,2.63,12
Adana Demirspor,8,1,1,6,8,25,-17,4,turkey,0.12,0.25,-17,1.0,3.12,0.5,8.33,4.0,13
Genclerbirligi,8,6,2,0,18,2,16,20,turkey2,0.75,1.0,16,2.25,0.25,2.5,1.33,1.0,1
Istanbulspor,8,6,0,2,20,8,12,18,turkey2,0.75,0.75,12,2.5,1.0,2.25,1.33,1.33,2
Boluspor,8,5,2,1,29,10,19,17,turkey2,0.62,0.88,19,3.62,1.25,2.12,1.61,1.14,3
Igdir,8,4,3,1,22,3,19,15,turkey2,0.5,0.88,19,2.75,0.38,1.88,2.0,1.14,4
Bandirmaspor,8,3,5,0,11,7,4,14,turkey2,0.38,1.0,4,1.38,0.88,1.75,2.63,1.0,5
Amed SK,8,4,2,2,10,8,2,14,turkey2,0.5,0.75,2,1.25,1.0,1.75,2.0,1.33,5
Kocaelispor,8,4,1,3,24,17,7,13,turkey2,0.5,0.62,7,3.0,2.12,1.62,2.0,1.61,6
Erzurum BB,8,4,1,3,9,5,4,13,turkey2,0.5,0.62,4,1.12,0.62,1.62,2.0,1.61,6
F. Karagumruk,8,4,1,3,7,6,1,13,turkey2,0.5,0.62,1,0.88,0.75,1.62,2.0,1.61,6
Sakaryaspor,8,4,0,4,8,12,-4,12,turkey2,0.5,0.5,-4,1.0,1.5,1.5,2.0,2.0,7
Manisa BB,8,3,2,3,12,11,1,11,turkey2,0.38,0.62,1,1.5,1.38,1.38,2.63,1.61,8
Erokspor,8,3,2,3,12,13,-1,11,turkey2,0.38,0.62,-1,1.5,1.62,1.38,2.63,1.61,8
Ankaragucu,8,3,1,4,11,14,-3,10,turkey2,0.38,0.5,-3,1.38,1.75,1.25,2.63,2.0,9
Umraniyespor,8,2,3,3,6,6,0,9,turkey2,0.25,0.62,0,0.75,0.75,1.12,4.0,1.61,10
Keciorengucu,8,3,0,5,12,13,-1,9,turkey2,0.38,0.38,-1,1.5,1.62,1.12,2.63,2.63,10
Corum,8,2,3,3,11,14,-3,9,turkey2,0.25,0.62,-3,1.38,1.75,1.12,4.0,1.61,10
Pendikspor,8,2,2,4,9,13,-4,8,turkey2,0.25,0.5,-4,1.12,1.62,1.0,4.0,2.0,11
Sanliurfaspor,8,2,0,6,8,14,-6,6,turkey2,0.25,0.25,-6,1.0,1.75,0.75,4.0,4.0,12
Adanaspor,8,1,0,7,6,27,-21,3,turkey2,0.12,0.12,-21,0.75,3.38,0.38,8.33,8.33,13
Y. Malatyaspor,8,0,0,8,3,45,-42,0,turkey2,0.0,0.0,-42,0.38,5.62,0.0,0.0,0.0,14
B. Petrolspor,8,7,0,1,18,4,14,21,turkey3,0.88,0.88,14,2.25,0.5,2.62,1.14,1.14,1
Sariyer,8,6,1,1,15,7,8,19,turkey3,0.75,0.88,8,1.88,0.88,2.38,1.33,1.14,2
Adana,8,5,2,1,15,8,7,17,turkey3,0.62,0.88,7,1.88,1.0,2.12,1.61,1.14,3
Kastamonuspor,8,5,2,1,13,9,4,17,turkey3,0.62,0.88,4,1.62,1.12,2.12,1.61,1.14,3
Ankaraspor,8,4,2,2,15,6,9,14,turkey3,0.5,0.75,9,1.88,0.75,1.75,2.0,1.33,4
Trabzon FK,8,4,2,2,12,5,7,14,turkey3,0.5,0.75,7,1.5,0.62,1.75,2.0,1.33,4
B. Anadolu,8,4,2,2,14,12,2,14,turkey3,0.5,0.75,2,1.75,1.5,1.75,2.0,1.33,4
Altay,8,4,1,3,13,10,3,13,turkey3,0.5,0.62,3,1.62,1.25,1.62,2.0,1.61,5
Kepez Belediyes,8,3,2,3,10,8,2,11,turkey3,0.38,0.62,2,1.25,1.0,1.38,2.63,1.61,6
Inegolspor,8,3,1,4,14,14,0,10,turkey3,0.38,0.5,0,1.75,1.75,1.25,2.63,2.0,7
Fethiyespor,8,3,1,4,6,13,-7,10,turkey3,0.38,0.5,-7,0.75,1.62,1.25,2.63,2.0,7
Karakopru,8,3,0,5,13,11,2,9,turkey3,0.38,0.38,2,1.62,1.38,1.12,2.63,2.63,8
24 Erzincanspor,8,2,2,4,11,14,-3,8,turkey3,0.25,0.5,-3,1.38,1.75,1.0,4.0,2.0,9
Altinordu,8,2,2,4,7,13,-6,8,turkey3,0.25,0.5,-6,0.88,1.62,1.0,4.0,2.0,9
Kirklarelispor,8,2,1,5,9,13,-4,7,turkey3,0.25,0.38,-4,1.12,1.62,0.88,4.0,2.63,10
Iskenderun,8,1,3,4,9,12,-3,6,turkey3,0.12,0.5,-3,1.12,1.5,0.75,8.33,2.0,11
Isparta Davrazs,8,1,1,6,10,24,-14,4,turkey3,0.12,0.25,-14,1.25,3.0,0.5,8.33,4.0,12
Afyonspor,8,0,0,8,0,24,-24,0,turkey3,0.0,0.0,-24,0.0,3.0,0.0,0.0,0.0,13
Elazigspor,8,7,0,1,16,4,12,21,turkey4,0.88,0.88,12,2.0,0.5,2.62,1.14,1.14,1
Karacabey,8,6,1,1,13,4,9,19,turkey4,0.75,0.88,9,1.62,0.5,2.38,1.33,1.14,2
Yeni Mersin,8,5,2,1,19,3,16,17,turkey4,0.62,0.88,16,2.38,0.38,2.12,1.61,1.14,3
Serik Belediyes,8,5,1,2,27,11,16,16,turkey4,0.62,0.75,16,3.38,1.38,2.0,1.61,1.33,4
Erbaaspor,8,5,0,3,20,19,1,15,turkey4,0.62,0.62,1,2.5,2.38,1.88,1.61,1.61,5
Van Spor,8,4,2,2,13,9,4,14,turkey4,0.5,0.75,4,1.62,1.12,1.75,2.0,1.33,6
Menemen B.,8,4,1,3,12,11,1,13,turkey4,0.5,0.62,1,1.5,1.38,1.62,2.0,1.61,7
Karaman,8,3,4,1,11,10,1,13,turkey4,0.38,0.88,1,1.38,1.25,1.62,2.63,1.14,7
A. Demirspor,8,3,2,3,19,14,5,11,turkey4,0.38,0.62,5,2.38,1.75,1.38,2.63,1.61,8
Aksaray B.,8,3,2,3,12,13,-1,11,turkey4,0.38,0.62,-1,1.5,1.62,1.38,2.63,1.61,8
Somaspor,8,3,2,3,10,13,-3,11,turkey4,0.38,0.62,-3,1.25,1.62,1.38,2.63,1.61,8
Beyoglu Yeni C.,8,3,1,4,15,11,4,10,turkey4,0.38,0.5,4,1.88,1.38,1.25,2.63,2.0,9
Diyarbekirspor,8,3,1,4,7,14,-7,10,turkey4,0.38,0.5,-7,0.88,1.75,1.25,2.63,2.0,9
Bucaspor,8,3,0,5,12,20,-8,9,turkey4,0.38,0.38,-8,1.5,2.5,1.12,2.63,2.63,10
Derince,8,2,1,5,13,16,-3,7,turkey4,0.25,0.38,-3,1.62,2.0,0.88,4.0,2.63,11
Arnavutkoy B.,8,2,1,5,14,19,-5,7,turkey4,0.25,0.38,-5,1.75,2.38,0.88,4.0,2.63,11
Giresunspor,8,0,1,7,4,19,-15,1,turkey4,0.0,0.12,-15,0.5,2.38,0.12,0.0,8.33,12
Nazillispor,8,0,0,8,5,32,-27,0,turkey4,0.0,0.0,-27,0.62,4.0,0.0,0.0,0.0,13
Musspor,8,7,1,0,22,6,16,22,turkey5,0.88,1.0,16,2.75,0.75,2.75,1.14,1.0,1
Bursaspor,8,6,1,1,19,6,13,19,turkey5,0.75,0.88,13,2.38,0.75,2.38,1.33,1.14,2
Karsiyaka,8,5,1,2,20,9,11,16,turkey5,0.62,0.75,11,2.5,1.12,2.0,1.61,1.33,3
Kutahyaspor,8,4,2,2,16,15,1,14,turkey5,0.5,0.75,1,2.0,1.88,1.75,2.0,1.33,4
Anadolu U.,8,4,2,2,10,9,1,14,turkey5,0.5,0.75,1,1.25,1.12,1.75,2.0,1.33,4
Artvin Hopaspor,8,4,1,3,12,7,5,13,turkey5,0.5,0.62,5,1.5,0.88,1.62,2.0,1.61,5
Duzcespor,8,4,1,3,8,10,-2,13,turkey5,0.5,0.62,-2,1.0,1.25,1.62,2.0,1.61,5
Silifke,8,4,0,4,11,11,0,12,turkey5,0.5,0.5,0,1.38,1.38,1.5,2.0,2.0,6
Ergene Velimese,8,4,0,4,8,15,-7,12,turkey5,0.5,0.5,-7,1.0,1.88,1.5,2.0,2.0,6
Tokat,8,3,2,3,12,8,4,11,turkey5,0.38,0.62,4,1.5,1.0,1.38,2.63,1.61,7
Kusadasispor,8,2,2,4,6,13,-7,8,turkey5,0.25,0.5,-7,0.75,1.62,1.0,4.0,2.0,8
K. Bulvarspor,8,2,2,4,10,20,-10,8,turkey5,0.25,0.5,-10,1.25,2.5,1.0,4.0,2.0,8
Kirsehir B.,8,1,3,4,4,10,-6,6,turkey5,0.12,0.5,-6,0.5,1.25,0.75,8.33,2.0,9
Kahramanmar.,8,1,2,5,4,8,-4,5,turkey5,0.12,0.38,-4,0.5,1.0,0.62,8.33,2.63,10
Elaziz K.,8,0,4,4,5,10,-5,4,turkey5,0.0,0.5,-5,0.62,1.25,0.5,0.0,2.0,11
Viven Bornova,8,1,0,7,7,17,-10,3,turkey5,0.12,0.12,-10,0.88,2.12,0.38,8.33,8.33,12
Tire 2021 FK,8,7,1,0,21,2,19,22,turkey6,0.88,1.0,19,2.62,0.25,2.75,1.14,1.0,1
Beykoz Ishaklis,8,6,0,2,20,8,12,18,turkey6,0.75,0.75,12,2.5,1.0,2.25,1.33,1.33,2
Mazidagi,8,5,2,1,19,5,14,17,turkey6,0.62,0.88,14,2.38,0.62,2.12,1.61,1.14,3
Muglaspor,8,5,1,2,14,6,8,16,turkey6,0.62,0.75,8,1.75,0.75,2.0,1.61,1.33,4
Cayelispor,8,4,3,1,12,5,7,15,turkey6,0.5,0.88,7,1.5,0.62,1.88,2.0,1.14,5
Balikesirspor,8,4,2,2,14,8,6,14,turkey6,0.5,0.75,6,1.75,1.0,1.75,2.0,1.33,6
Turk Metal 1963,8,4,2,2,16,13,3,14,turkey6,0.5,0.75,3,2.0,1.62,1.75,2.0,1.33,6
Inegol Kafkas,8,3,2,3,13,8,5,11,turkey6,0.38,0.62,5,1.62,1.0,1.38,2.63,1.61,7
Amasyaspor,8,3,2,3,13,11,2,11,turkey6,0.38,0.62,2,1.62,1.38,1.38,2.63,1.61,7
Usakspor,8,2,4,2,8,9,-1,10,turkey6,0.25,0.75,-1,1.0,1.12,1.25,4.0,1.33,8
Silivrispor,8,2,2,4,11,12,-1,8,turkey6,0.25,0.5,-1,1.38,1.5,1.0,4.0,2.0,9
Etimesgut,8,2,2,4,10,14,-4,8,turkey6,0.25,0.5,-4,1.25,1.75,1.0,4.0,2.0,9
Kelkit,8,2,1,5,10,15,-5,7,turkey6,0.25,0.38,-5,1.25,1.88,0.88,4.0,2.63,10
Fatsa B.,8,1,1,6,4,19,-15,4,turkey6,0.12,0.25,-15,0.5,2.38,0.5,8.33,4.0,11
Nevsehirspor,8,1,1,6,4,30,-26,4,turkey6,0.12,0.25,-26,0.5,3.75,0.5,8.33,4.0,11
Adiyaman,8,0,0,8,0,24,-24,0,turkey6,0.0,0.0,-24,0.0,3.0,0.0,0.0,0.0,12
Aliaga FAS,8,7,1,0,21,5,16,22,turkey7,0.88,1.0,16,2.62,0.62,2.75,1.14,1.0,1
Ayvalikgucu,8,5,3,0,11,4,7,18,turkey7,0.62,1.0,7,1.38,0.5,2.25,1.61,1.0,2
Corluspor,8,4,3,1,18,9,9,15,turkey7,0.5,0.88,9,2.25,1.12,1.88,2.0,1.14,3
Yozgat Bld Bozo,8,4,1,3,15,14,1,13,turkey7,0.5,0.62,1,1.88,1.75,1.62,2.0,1.61,4
Kucukcekmece,8,3,3,2,11,8,3,12,turkey7,0.38,0.75,3,1.38,1.0,1.5,2.63,1.33,5
Orduspor,8,3,2,3,16,8,8,11,turkey7,0.38,0.62,8,2.0,1.0,1.38,2.63,1.61,6
Alanya 1221,8,3,2,3,14,11,3,11,turkey7,0.38,0.62,3,1.75,1.38,1.38,2.63,1.61,6
Pazarspor,8,3,2,3,13,11,2,11,turkey7,0.38,0.62,2,1.62,1.38,1.38,2.63,1.61,6
Efeler 09,8,2,5,1,6,5,1,11,turkey7,0.25,0.88,1,0.75,0.62,1.38,4.0,1.14,6
Cankaya FK,8,3,1,4,11,21,-10,10,turkey7,0.38,0.5,-10,1.38,2.62,1.25,2.63,2.0,7
K. Idmanyurdu,8,2,3,3,8,9,-1,9,turkey7,0.25,0.62,-1,1.0,1.12,1.12,4.0,1.61,8
1923 M.,8,2,3,3,11,13,-2,9,turkey7,0.25,0.62,-2,1.38,1.62,1.12,4.0,1.61,8
Bayburt,8,2,3,3,5,12,-7,9,turkey7,0.25,0.62,-7,0.62,1.5,1.12,4.0,1.61,8
Osmaniyespor,8,2,0,6,11,24,-13,6,turkey7,0.25,0.25,-13,1.38,3.0,0.75,4.0,4.0,9
1922 Konyaspor,8,1,2,5,9,15,-6,5,turkey7,0.12,0.38,-6,1.12,1.88,0.62,8.33,2.63,10
Viransehir,8,1,0,7,4,15,-11,3,turkey7,0.12,0.12,-11,0.5,1.88,0.38,8.33,8.33,11
Sebat G.,8,6,1,1,20,10,10,19,turkey8,0.75,0.88,10,2.5,1.25,2.38,1.33,1.14,1
Kirikkale B.,8,6,1,1,15,9,6,19,turkey8,0.75,0.88,6,1.88,1.12,2.38,1.33,1.14,1
Mardin BB,8,5,3,0,22,10,12,18,turkey8,0.62,1.0,12,2.75,1.25,2.25,1.61,1.0,2
Agri 1970,8,5,3,0,11,6,5,18,turkey8,0.62,1.0,5,1.38,0.75,2.25,1.61,1.0,2
Z. Komurspor,8,5,2,1,12,5,7,17,turkey8,0.62,0.88,7,1.5,0.62,2.12,1.61,1.14,3
K. Istiklalspor,8,5,1,2,19,11,8,16,turkey8,0.62,0.75,8,2.38,1.38,2.0,1.61,1.33,4
Erciyes,8,3,1,4,12,16,-4,10,turkey8,0.38,0.5,-4,1.5,2.0,1.25,2.63,2.0,5
Nigde Belediyes,8,2,2,4,8,11,-3,8,turkey8,0.25,0.5,-3,1.0,1.38,1.0,4.0,2.0,6
Edirnespor,8,2,2,4,12,16,-4,8,turkey8,0.25,0.5,-4,1.5,2.0,1.0,4.0,2.0,6
Tepecik,8,2,2,4,10,15,-5,8,turkey8,0.25,0.5,-5,1.25,1.88,1.0,4.0,2.0,6
Turgutluspor,8,2,2,4,9,15,-6,8,turkey8,0.25,0.5,-6,1.12,1.88,1.0,4.0,2.0,6
Polatli B.,8,2,1,5,9,13,-4,7,turkey8,0.25,0.38,-4,1.12,1.62,0.88,4.0,2.63,7
Orduspor 1967,8,2,1,5,10,16,-6,7,turkey8,0.25,0.38,-6,1.25,2.0,0.88,4.0,2.63,7
Denizlispor,8,0,6,2,7,9,-2,6,turkey8,0.0,0.75,-2,0.88,1.12,0.75,0.0,1.33,8
Nilufer B.,8,1,2,5,4,9,-5,5,turkey8,0.12,0.38,-5,0.5,1.12,0.62,8.33,2.63,9
Coruhlu,8,1,0,7,11,20,-9,3,turkey8,0.12,0.12,-9,1.38,2.5,0.38,8.33,8.33,10
Al Wasl,8,6,1,1,20,10,10,19,uae,0.75,0.88,10,2.5,1.25,2.38,1.33,1.14,1
Al Ain,8,4,3,1,14,4,10,15,uae,0.5,0.88,10,1.75,0.5,1.88,2.0,1.14,2
Shabab Al Ahli,8,4,3,1,15,9,6,15,uae,0.5,0.88,6,1.88,1.12,1.88,2.0,1.14,2
Al Wahda,8,3,5,0,17,10,7,14,uae,0.38,1.0,7,2.12,1.25,1.75,2.63,1.0,3
Al Nasr,8,3,3,2,12,12,0,12,uae,0.38,0.75,0,1.5,1.5,1.5,2.63,1.33,4
Al Bataeh,8,3,2,3,9,11,-2,11,uae,0.38,0.62,-2,1.12,1.38,1.38,2.63,1.61,5
Al Sharjah,8,3,1,4,15,14,1,10,uae,0.38,0.5,1,1.88,1.75,1.25,2.63,2.0,6
Ittihad Kalba,8,3,1,4,13,14,-1,10,uae,0.38,0.5,-1,1.62,1.75,1.25,2.63,2.0,6
Al Urooba,8,3,1,4,11,15,-4,10,uae,0.38,0.5,-4,1.38,1.88,1.25,2.63,2.0,6
Khorfakkan,8,2,3,3,12,19,-7,9,uae,0.25,0.62,-7,1.5,2.38,1.12,4.0,1.61,7
Bani Yas,8,2,2,4,12,18,-6,8,uae,0.25,0.5,-6,1.5,2.25,1.0,4.0,2.0,8
Al Jazira,8,1,4,3,9,14,-5,7,uae,0.12,0.62,-5,1.12,1.75,0.88,8.33,1.61,9
Dibba Al Hisn,8,2,0,6,11,15,-4,6,uae,0.25,0.25,-4,1.38,1.88,0.75,4.0,4.0,10
Ajman,8,1,3,4,10,15,-5,6,uae,0.12,0.5,-5,1.25,1.88,0.75,8.33,2.0,10
Oleksandria,8,5,2,1,12,6,6,17,ukraine,0.62,0.88,6,1.5,0.75,2.12,1.61,1.14,1
Dynamo Kyiv,8,4,4,0,15,4,11,16,ukraine,0.5,1.0,11,1.88,0.5,2.0,2.0,1.0,2
Shakhtar,8,4,3,1,18,10,8,15,ukraine,0.5,0.88,8,2.25,1.25,1.88,2.0,1.14,3
Kolos Kovalivka,8,4,3,1,11,6,5,15,ukraine,0.5,0.88,5,1.38,0.75,1.88,2.0,1.14,3
Karpaty Lviv,8,4,2,2,15,13,2,14,ukraine,0.5,0.75,2,1.88,1.62,1.75,2.0,1.33,4
Obolon,8,4,2,2,7,6,1,14,ukraine,0.5,0.75,1,0.88,0.75,1.75,2.0,1.33,4
Kryvbas KR,8,3,3,2,10,4,6,12,ukraine,0.38,0.75,6,1.25,0.5,1.5,2.63,1.33,5
Rukh Lviv,8,3,3,2,8,7,1,12,ukraine,0.38,0.75,1,1.0,0.88,1.5,2.63,1.33,5
Polessya,8,2,5,1,8,6,2,11,ukraine,0.25,0.88,2,1.0,0.75,1.38,4.0,1.14,6
Zorya Luhansk,8,2,2,4,7,10,-3,8,ukraine,0.25,0.5,-3,0.88,1.25,1.0,4.0,2.0,7
Chornomorets,8,2,2,4,6,10,-4,8,ukraine,0.25,0.5,-4,0.75,1.25,1.0,4.0,2.0,7
Inhulets,8,2,2,4,6,13,-7,8,ukraine,0.25,0.5,-7,0.75,1.62,1.0,4.0,2.0,7
Veres,8,2,1,5,6,16,-10,7,ukraine,0.25,0.38,-10,0.75,2.0,0.88,4.0,2.63,8
Vorskla Poltava,8,1,3,4,7,10,-3,6,ukraine,0.12,0.5,-3,0.88,1.25,0.75,8.33,2.0,9
LNZ Cherkasy,8,0,6,2,3,7,-4,6,ukraine,0.0,0.75,-4,0.38,0.88,0.75,0.0,1.33,9
Livyi Bereh,8,1,1,6,6,15,-9,4,ukraine,0.12,0.25,-9,0.75,1.88,0.5,8.33,4.0,10
Dnipro-1,0,0,0,0,0,0,0,0,ukraine,0.0,0.0,0,0.0,0.0,0.0,0.0,0.0,11
Penarol,8,7,0,1,15,7,8,21,uruguay,0.88,0.88,8,1.88,0.88,2.62,1.14,1.14,1
Nacional,8,6,1,1,21,7,14,19,uruguay,0.75,0.88,14,2.62,0.88,2.38,1.33,1.14,2
Juventud,8,5,1,2,10,6,4,16,uruguay,0.62,0.75,4,1.25,0.75,2.0,1.61,1.33,3
Boston River,8,5,1,2,8,6,2,16,uruguay,0.62,0.75,2,1.0,0.75,2.0,1.61,1.33,3
Liverpool M.,8,4,3,1,8,4,4,15,uruguay,0.5,0.88,4,1.0,0.5,1.88,2.0,1.14,4
Racing CM,8,3,4,1,6,4,2,13,uruguay,0.38,0.88,2,0.75,0.5,1.62,2.63,1.14,5
Defensor S.,8,3,2,3,9,8,1,11,uruguay,0.38,0.62,1,1.12,1.0,1.38,2.63,1.61,6
Cerro Largo,8,3,2,3,7,9,-2,11,uruguay,0.38,0.62,-2,0.88,1.12,1.38,2.63,1.61,6
Montevideo City,8,2,3,3,8,9,-1,9,uruguay,0.25,0.62,-1,1.0,1.12,1.12,4.0,1.61,7
Progreso,8,2,3,3,8,10,-2,9,uruguay,0.25,0.62,-2,1.0,1.25,1.12,4.0,1.61,7
River Plate,8,2,1,5,3,8,-5,7,uruguay,0.25,0.38,-5,0.38,1.0,0.88,4.0,2.63,8
Danubio,8,1,3,4,5,9,-4,6,uruguay,0.12,0.5,-4,0.62,1.12,0.75,8.33,2.0,9
Wanderers,8,1,3,4,5,9,-4,6,uruguay,0.12,0.5,-4,0.62,1.12,0.75,8.33,2.0,9
Cerro,8,1,3,4,7,14,-7,6,uruguay,0.12,0.5,-7,0.88,1.75,0.75,8.33,2.0,9
Plaza Colonia,8,1,2,5,5,9,-4,5,uruguay,0.12,0.38,-4,0.62,1.12,0.62,8.33,2.63,10
Miramar Misione,8,1,2,5,8,14,-6,5,uruguay,0.12,0.38,-6,1.0,1.75,0.62,8.33,2.63,10
Philadelphia,8,5,3,0,16,9,7,18,usa,0.62,1.0,7,2.0,1.12,2.25,1.61,1.0,1
Nashville SC,8,4,4,0,18,10,8,16,usa,0.5,1.0,8,2.25,1.25,2.0,2.0,1.0,2
New England,8,4,4,0,15,7,8,16,usa,0.5,1.0,8,1.88,0.88,2.0,2.0,1.0,2
San Diego,8,5,1,2,14,6,8,16,usa,0.62,0.75,8,1.75,0.75,2.0,1.61,1.33,2
Vancouver,8,4,4,0,13,6,7,16,usa,0.5,1.0,7,1.62,0.75,2.0,2.0,1.0,2
New York RB,8,5,0,3,18,10,8,15,usa,0.62,0.62,8,2.25,1.25,1.88,1.61,1.61,3
Los Angeles FC,8,3,5,0,20,12,8,14,usa,0.38,1.0,8,2.5,1.5,1.75,2.63,1.0,4
Orlando City,8,4,2,2,16,10,6,14,usa,0.5,0.75,6,2.0,1.25,1.75,2.0,1.33,4
Minnesota Utd,8,4,2,2,15,9,6,14,usa,0.5,0.75,6,1.88,1.12,1.75,2.0,1.33,4
New York City,8,4,2,2,9,7,2,14,usa,0.5,0.75,2,1.12,0.88,1.75,2.0,1.33,4
Portland,8,4,2,2,11,10,1,14,usa,0.5,0.75,1,1.38,1.25,1.75,2.0,1.33,4
Chicago Fire,8,4,1,3,21,17,4,13,usa,0.5,0.62,4,2.62,2.12,1.62,2.0,1.61,5
Houston Dynamo,8,4,1,3,14,11,3,13,usa,0.5,0.62,3,1.75,1.38,1.62,2.0,1.61,5
Seattle,8,4,1,3,12,13,-1,13,usa,0.5,0.62,-1,1.5,1.62,1.62,2.0,1.61,5
SJ Earthquakes,8,3,3,2,15,11,4,12,usa,0.38,0.75,4,1.88,1.38,1.5,2.63,1.33,6
Inter Miami,8,3,2,3,23,21,2,11,usa,0.38,0.62,2,2.88,2.62,1.38,2.63,1.61,7
Cincinnati,8,3,2,3,12,13,-1,11,usa,0.38,0.62,-1,1.5,1.62,1.38,2.63,1.61,7
Columbus Crew,8,2,4,2,15,17,-2,10,usa,0.25,0.75,-2,1.88,2.12,1.25,4.0,1.33,8
Sporting KC,8,2,3,3,11,12,-1,9,usa,0.25,0.62,-1,1.38,1.5,1.12,4.0,1.61,9
DC United,8,2,3,3,6,14,-8,9,usa,0.25,0.62,-8,0.75,1.75,1.12,4.0,1.61,9
Atlanta Utd,8,2,2,4,10,14,-4,8,usa,0.25,0.5,-4,1.25,1.75,1.0,4.0,2.0,10
Austin,8,1,4,3,6,10,-4,7,usa,0.12,0.62,-4,0.75,1.25,0.88,8.33,1.61,11
Colorado Rapids,8,2,1,5,5,11,-6,7,usa,0.25,0.38,-6,0.62,1.38,0.88,4.0,2.63,11
Dallas,8,1,4,3,8,15,-7,7,usa,0.12,0.62,-7,1.0,1.88,0.88,8.33,1.61,11
Toronto,8,2,0,6,10,11,-1,6,usa,0.25,0.25,-1,1.25,1.38,0.75,4.0,4.0,12
Real Salt Lake,8,1,3,4,8,11,-3,6,usa,0.12,0.5,-3,1.0,1.38,0.75,8.33,2.0,12
Charlotte,8,2,0,6,12,20,-8,6,usa,0.25,0.25,-8,1.5,2.5,0.75,4.0,4.0,12
St. Louis City,8,1,2,5,9,17,-8,5,usa,0.12,0.38,-8,1.12,2.12,0.62,8.33,2.63,13
CF Montreal,8,1,2,5,8,19,-11,5,usa,0.12,0.38,-11,1.0,2.38,0.62,8.33,2.63,13
Charleston,8,7,1,0,22,8,14,22,usa2,0.88,1.0,14,2.75,1.0,2.75,1.14,1.0,1
Louisville City,8,5,3,0,12,4,8,18,usa2,0.62,1.0,8,1.5,0.5,2.25,1.61,1.0,2
Phoenix Rising,8,5,2,1,15,9,6,17,usa2,0.62,0.88,6,1.88,1.12,2.12,1.61,1.14,3
Loudoun Utd,8,5,1,2,15,7,8,16,usa2,0.62,0.75,8,1.88,0.88,2.0,1.61,1.33,4
North Carolina,8,5,1,2,13,8,5,16,usa2,0.62,0.75,5,1.62,1.0,2.0,1.61,1.33,4
New Mexico,8,5,1,2,11,6,5,16,usa2,0.62,0.75,5,1.38,0.75,2.0,1.61,1.33,4
El Paso,8,4,3,1,13,8,5,15,usa2,0.5,0.88,5,1.62,1.0,1.88,2.0,1.14,5
FC Tulsa,8,4,2,2,12,7,5,14,usa2,0.5,0.75,5,1.5,0.88,1.75,2.0,1.33,6
Miami FC,8,4,1,3,10,9,1,13,usa2,0.5,0.62,1,1.25,1.12,1.62,2.0,1.61,7
Rhode Island,8,3,2,3,8,5,3,11,usa2,0.38,0.62,3,1.0,0.62,1.38,2.63,1.61,8
Pittsburgh,8,3,1,4,7,7,0,10,usa2,0.38,0.5,0,0.88,0.88,1.25,2.63,2.0,9
Detroit City,8,2,4,2,9,10,-1,10,usa2,0.25,0.75,-1,1.12,1.25,1.25,4.0,1.33,9
Oakland Roots,8,3,1,4,8,13,-5,10,usa2,0.38,0.5,-5,1.0,1.62,1.25,2.63,2.0,9
Sacramento R.,8,2,3,3,11,8,3,9,usa2,0.25,0.62,3,1.38,1.0,1.12,4.0,1.61,10
Monterey Bay,8,2,3,3,6,9,-3,9,usa2,0.25,0.62,-3,0.75,1.12,1.12,4.0,1.61,10
Orange County,8,3,0,5,8,13,-5,9,usa2,0.38,0.38,-5,1.0,1.62,1.12,2.63,2.63,10
Birmingham L.,8,2,2,4,8,10,-2,8,usa2,0.25,0.5,-2,1.0,1.25,1.0,4.0,2.0,11
San Antonio,8,2,2,4,10,13,-3,8,usa2,0.25,0.5,-3,1.25,1.62,1.0,4.0,2.0,11
Colorado S.,8,1,4,3,8,11,-3,7,usa2,0.12,0.62,-3,1.0,1.38,0.88,8.33,1.61,12
Indy Eleven,8,1,4,3,14,18,-4,7,usa2,0.12,0.62,-4,1.75,2.25,0.88,8.33,1.61,12
Hartford A.,8,1,3,4,9,14,-5,6,usa2,0.12,0.5,-5,1.12,1.75,0.75,8.33,2.0,13
Las Vegas L.,8,1,2,5,3,15,-12,5,usa2,0.12,0.38,-12,0.38,1.88,0.62,8.33,2.63,14
Lexington,8,0,3,5,4,14,-10,3,usa2,0.0,0.38,-10,0.5,1.75,0.38,0.0,2.63,15
Tampa Bay,8,0,2,6,8,17,-9,2,usa2,0.0,0.25,-9,1.0,2.12,0.25,0.0,4.0,16
Spokane V.,8,6,2,0,15,3,12,20,usa3,0.75,1.0,12,1.88,0.38,2.5,1.33,1.0,1
Charlotte I.,8,5,1,2,17,12,5,16,usa3,0.62,0.75,5,2.12,1.5,2.0,1.61,1.33,2
Chattanooga RW,8,4,3,1,12,8,4,15,usa3,0.5,0.88,4,1.5,1.0,1.88,2.0,1.14,3
One Knoxville,8,3,4,1,10,8,2,13,usa3,0.38,0.88,2,1.25,1.0,1.62,2.63,1.14,4
Alta,8,3,3,2,11,10,1,12,usa3,0.38,0.75,1,1.38,1.25,1.5,2.63,1.33,5
Naples,8,3,2,3,11,9,2,11,usa3,0.38,0.62,2,1.38,1.12,1.38,2.63,1.61,6
Texoma,8,3,2,3,10,14,-4,11,usa3,0.38,0.62,-4,1.25,1.75,1.38,2.63,1.61,6
Forward Madison,8,1,6,1,7,7,0,9,usa3,0.12,0.88,0,0.88,0.88,1.12,8.33,1.14,7
Portland Hearts,8,1,5,2,8,9,-1,8,usa3,0.12,0.75,-1,1.0,1.12,1.0,8.33,1.33,8
Union Omaha,8,2,2,4,8,12,-4,8,usa3,0.25,0.5,-4,1.0,1.5,1.0,4.0,2.0,8
Richmond K.,8,1,4,3,12,14,-2,7,usa3,0.12,0.62,-2,1.5,1.75,0.88,8.33,1.61,9
Westchester SC,8,1,4,3,14,17,-3,7,usa3,0.12,0.62,-3,1.75,2.12,0.88,8.33,1.61,9
Tormenta,8,2,1,5,10,14,-4,7,usa3,0.25,0.38,-4,1.25,1.75,0.88,4.0,2.63,9
Greenville,8,1,3,4,7,13,-6,6,usa3,0.12,0.5,-6,0.88,1.62,0.75,8.33,2.0,10
Carabobo,8,5,3,0,6,1,5,18,venezuela,0.62,1.0,5,0.75,0.12,2.25,1.61,1.0,1
D. La Guaira,8,5,2,1,14,7,7,17,venezuela,0.62,0.88,7,1.75,0.88,2.12,1.61,1.14,2
UCV,8,5,2,1,9,4,5,17,venezuela,0.62,0.88,5,1.12,0.5,2.12,1.61,1.14,2
Monagas,8,4,2,2,15,11,4,14,venezuela,0.5,0.75,4,1.88,1.38,1.75,2.0,1.33,3
D. Tachira,8,3,4,1,13,8,5,13,venezuela,0.38,0.88,5,1.62,1.0,1.62,2.63,1.14,4
A. Anzoategui,8,3,4,1,10,7,3,13,venezuela,0.38,0.88,3,1.25,0.88,1.62,2.63,1.14,4
Puerto Cabello,8,3,3,2,6,5,1,12,venezuela,0.38,0.75,1,0.75,0.62,1.5,2.63,1.33,5
Metropolitanos,8,2,3,3,11,13,-2,9,venezuela,0.25,0.62,-2,1.38,1.62,1.12,4.0,1.61,6
Rayo Zuliano,8,3,0,5,9,11,-2,9,venezuela,0.38,0.38,-2,1.12,1.38,1.12,2.63,2.63,6
Caracas,8,2,3,3,9,12,-3,9,venezuela,0.25,0.62,-3,1.12,1.5,1.12,4.0,1.61,6
Portuguesa,8,2,2,4,9,12,-3,8,venezuela,0.25,0.5,-3,1.12,1.5,1.0,4.0,2.0,7
Yaracuyanos,8,1,2,5,8,16,-8,5,venezuela,0.12,0.38,-8,1.0,2.0,0.62,8.33,2.63,8
Zamora,8,1,1,6,5,10,-5,4,venezuela,0.12,0.25,-5,0.62,1.25,0.5,8.33,4.0,9
E. Merida,8,1,1,6,10,17,-7,4,venezuela,0.12,0.25,-7,1.25,2.12,0.5,8.33,4.0,9
Nasaf Qarshi,8,6,2,0,19,6,13,20,uzbekistan,0.75,1.0,13,2.38,0.75,2.5,1.33,1.0,1
D. Samarqand,8,5,3,0,13,7,6,18,uzbekistan,0.62,1.0,6,1.62,0.88,2.25,1.61,1.0,2
Neftchi,8,5,2,1,17,10,7,17,uzbekistan,0.62,0.88,7,2.12,1.25,2.12,1.61,1.14,3
Pakhtakor,8,5,0,3,19,8,11,15,uzbekistan,0.62,0.62,11,2.38,1.0,1.88,1.61,1.61,4
Navbahor,8,5,0,3,16,9,7,15,uzbekistan,0.62,0.62,7,2.0,1.12,1.88,1.61,1.61,4
AGMK,8,4,2,2,14,11,3,14,uzbekistan,0.5,0.75,3,1.75,1.38,1.75,2.0,1.33,5
Termez Surkhon,8,4,1,3,9,7,2,13,uzbekistan,0.5,0.62,2,1.12,0.88,1.62,2.0,1.61,6
Bunyodkor,8,2,4,2,9,8,1,10,uzbekistan,0.25,0.75,1,1.12,1.0,1.25,4.0,1.33,7
Sogdiana,8,2,3,3,10,10,0,9,uzbekistan,0.25,0.62,0,1.25,1.25,1.12,4.0,1.61,8
Andijan,8,3,0,5,10,13,-3,9,uzbekistan,0.38,0.38,-3,1.25,1.62,1.12,2.63,2.63,8
Mashal,8,2,3,3,7,12,-5,9,uzbekistan,0.25,0.62,-5,0.88,1.5,1.12,4.0,1.61,8
Kokand-1912,8,3,0,5,6,13,-7,9,uzbekistan,0.38,0.38,-7,0.75,1.62,1.12,2.63,2.63,8
Xorazm,8,2,2,4,8,6,2,8,uzbekistan,0.25,0.5,2,1.0,0.75,1.0,4.0,2.0,9
Qizilqum,8,2,2,4,8,17,-9,8,uzbekistan,0.25,0.5,-9,1.0,2.12,1.0,4.0,2.0,9
Shurtan,8,1,1,6,4,16,-12,4,uzbekistan,0.12,0.25,-12,0.5,2.0,0.5,8.33,4.0,10
Buxoro,8,0,2,6,5,20,-15,2,uzbekistan,0.0,0.25,-15,0.62,2.5,0.25,0.0,4.0,11
Nam Dinh,8,6,2,0,20,6,14,20,vietnam,0.75,1.0,14,2.5,0.75,2.5,1.33,1.0,1
Ha Noi,8,6,1,1,17,7,10,19,vietnam,0.75,0.88,10,2.12,0.88,2.38,1.33,1.14,2
Cong An Nhan,8,5,2,1,16,6,10,17,vietnam,0.62,0.88,10,2.0,0.75,2.12,1.61,1.14,3
Hong Linh Ha T.,8,4,2,2,8,6,2,14,vietnam,0.5,0.75,2,1.0,0.75,1.75,2.0,1.33,4
Hai Phong,8,3,3,2,8,6,2,12,vietnam,0.38,0.75,2,1.0,0.75,1.5,2.63,1.33,5
Da Nang,8,3,3,2,9,12,-3,12,vietnam,0.38,0.75,-3,1.12,1.5,1.5,2.63,1.33,5
Viettel,8,2,4,2,17,13,4,10,vietnam,0.25,0.75,4,2.12,1.62,1.25,4.0,1.33,6
Gia Lai,8,3,1,4,12,15,-3,10,vietnam,0.38,0.5,-3,1.5,1.88,1.25,2.63,2.0,6
Binh Dinh,8,2,2,4,9,16,-7,8,vietnam,0.25,0.5,-7,1.12,2.0,1.0,4.0,2.0,7
Song Lam Nghe,8,1,4,3,7,9,-2,7,vietnam,0.12,0.62,-2,0.88,1.12,0.88,8.33,1.61,8
Quang Nam,8,1,3,4,7,11,-4,6,vietnam,0.12,0.5,-4,0.88,1.38,0.75,8.33,2.0,9
Ho Chi Minh,8,1,3,4,5,13,-8,6,vietnam,0.12,0.5,-8,0.62,1.62,0.75,8.33,2.0,9
Thanh Hoa,8,1,2,5,9,13,-4,5,vietnam,0.12,0.38,-4,1.12,1.62,0.62,8.33,2.63,10
Binh Duong,8,1,2,5,6,17,-11,5,vietnam,0.12,0.38,-11,0.75,2.12,0.62,8.33,2.63,10
Phu Dong,8,7,1,0,17,1,16,22,vietnam2,0.88,1.0,16,2.12,0.12,2.75,1.14,1.0,1
Binh Phuoc,8,6,2,0,14,3,11,20,vietnam2,0.75,1.0,11,1.75,0.38,2.5,1.33,1.0,2
PVF-CAND,8,5,1,2,12,5,7,16,vietnam2,0.62,0.75,7,1.5,0.62,2.0,1.61,1.33,3
Dong Nai,8,3,3,2,9,5,4,12,vietnam2,0.38,0.75,4,1.12,0.62,1.5,2.63,1.33,4
S. Khanh Hoa,8,3,2,3,7,10,-3,11,vietnam2,0.38,0.62,-3,0.88,1.25,1.38,2.63,1.61,5
Ho Chi Minh B,8,2,4,2,6,8,-2,10,vietnam2,0.25,0.75,-2,0.75,1.0,1.25,4.0,1.33,6
Dong Thap,8,2,2,4,8,8,0,8,vietnam2,0.25,0.5,0,1.0,1.0,1.0,4.0,2.0,7
Hoa Binh,8,1,5,2,9,11,-2,8,vietnam2,0.12,0.75,-2,1.12,1.38,1.0,8.33,1.33,7
Hue,8,1,2,5,4,11,-7,5,vietnam2,0.12,0.38,-7,0.5,1.38,0.62,8.33,2.63,8
Long An,8,0,5,3,1,8,-7,5,vietnam2,0.0,0.62,-7,0.12,1.0,0.62,0.0,1.61,8
Ba Ria Vung Tau,8,0,2,6,2,17,-15,2,vietnam2,0.0,0.25,-15,0.25,2.12,0.25,0.0,4.0,9
The New Saints,8,7,0,1,21,4,17,21,wales,0.88,0.88,17,2.62,0.5,2.62,1.14,1.14,1
Flint,8,6,1,1,18,11,7,19,wales,0.75,0.88,7,2.25,1.38,2.38,1.33,1.14,2
Barry,8,5,1,2,18,11,7,16,wales,0.62,0.75,7,2.25,1.38,2.0,1.61,1.33,3
Connahs Quay,8,4,1,3,13,7,6,13,wales,0.5,0.62,6,1.62,0.88,1.62,2.0,1.61,4
Penybont,8,4,1,3,13,14,-1,13,wales,0.5,0.62,-1,1.62,1.75,1.62,2.0,1.61,4
Caernarfon,8,3,1,4,14,14,0,10,wales,0.38,0.5,0,1.75,1.75,1.25,2.63,2.0,5
Briton Ferry,8,3,1,4,9,15,-6,10,wales,0.38,0.5,-6,1.12,1.88,1.25,2.63,2.0,5
Cardiff MU,8,2,3,3,8,13,-5,9,wales,0.25,0.62,-5,1.0,1.62,1.12,4.0,1.61,6
Haverfordwest,8,1,4,3,7,13,-6,7,wales,0.12,0.62,-6,0.88,1.62,0.88,8.33,1.61,7
Newtown,8,1,3,4,10,16,-6,6,wales,0.12,0.5,-6,1.25,2.0,0.75,8.33,2.0,8
Bala Town,8,1,2,5,7,16,-9,5,wales,0.12,0.38,-9,0.88,2.0,0.62,8.33,2.63,9
Aberystwyth,8,1,1,6,6,14,-8,4,wales,0.12,0.25,-8,0.75,1.75,0.5,8.33,4.0,10
