Team_Home,GP,W,D,L,GF,GA,GD,Pts_Overall,Liga,PIO,PIO_HA,GD_Overall,GF_AVG_Overall,PPG_Overall,Odd_Justa_MO,Odd_Justa_HA,Rank_Overall
Teuta Durres,8,3,4,1,4,2,2,13,Albania - Abissnet Superiore,0.38,0.88,2,0.5,1.62,2.63,1.14,1
Skenderbeu K.,8,3,3,2,10,7,3,12,Albania - Abissnet Superiore,0.38,0.75,3,1.25,1.5,2.63,1.33,2
Bylis,8,3,2,3,6,8,-2,11,Albania - Abissnet Superiore,0.38,0.62,-2,0.75,1.38,2.63,1.61,3
KF Tirana,8,2,4,2,12,8,4,10,Albania - Abissnet Superiore,0.25,0.75,4,1.5,1.25,4.0,1.33,4
Vllaznia S.,8,2,4,2,9,6,3,10,Albania - Abissnet Superiore,0.25,0.75,3,1.12,1.25,4.0,1.33,4
Egnatia R.,8,2,4,2,9,7,2,10,Albania - Abissnet Superiore,0.25,0.75,2,1.12,1.25,4.0,1.33,4
Partizani T.,8,3,1,4,4,8,-4,10,Albania - Abissnet Superiore,0.38,0.5,-4,0.5,1.25,2.63,2.0,4
Dinamo Tirana,8,2,2,4,7,13,-6,8,Albania - Abissnet Superiore,0.25,0.5,-6,0.88,1.0,4.0,2.0,5
Laci,8,1,2,5,4,10,-6,5,Albania - Abissnet Superiore,0.12,0.38,-6,0.5,0.62,8.33,2.63,6
Boca Juniors,8,7,0,1,16,4,12,21,Argentina - Liga Profesional,0.88,0.88,12,2.0,2.62,1.14,1.14,1
Huracan,8,5,3,0,13,5,8,18,Argentina - Liga Profesional,0.62,1.0,8,1.62,2.25,1.61,1.0,2
Independiente,8,4,4,0,13,4,9,16,Argentina - Liga Profesional,0.5,1.0,9,1.62,2.0,2.0,1.0,3
Argentinos Jrs,8,4,3,1,12,7,5,15,Argentina - Liga Profesional,0.5,0.88,5,1.5,1.88,2.0,1.14,4
Rosario Central,8,4,3,1,10,5,5,15,Argentina - Liga Profesional,0.5,0.88,5,1.25,1.88,2.0,1.14,4
Tigre,8,5,0,3,12,8,4,15,Argentina - Liga Profesional,0.62,0.62,4,1.5,1.88,1.61,1.61,4
Racing Club,8,4,1,3,12,8,4,13,Argentina - Liga Profesional,0.5,0.62,4,1.5,1.62,2.0,1.61,5
River Plate,8,3,4,1,10,6,4,13,Argentina - Liga Profesional,0.38,0.88,4,1.25,1.62,2.63,1.14,5
Newells,8,3,4,1,8,5,3,13,Argentina - Liga Profesional,0.38,0.88,3,1.0,1.62,2.63,1.14,5
Barracas C.,8,3,3,2,9,7,2,12,Argentina - Liga Profesional,0.38,0.75,2,1.12,1.5,2.63,1.33,6
Platense,8,3,3,2,6,4,2,12,Argentina - Liga Profesional,0.38,0.75,2,0.75,1.5,2.63,1.33,6
San Lorenzo,8,3,3,2,7,7,0,12,Argentina - Liga Profesional,0.38,0.75,0,0.88,1.5,2.63,1.33,6
Union Santa Fe,8,3,2,3,7,7,0,11,Argentina - Liga Profesional,0.38,0.62,0,0.88,1.38,2.63,1.61,7
D. Riestra,8,2,5,1,3,4,-1,11,Argentina - Liga Profesional,0.25,0.88,-1,0.38,1.38,4.0,1.14,7
Lanus,8,1,7,0,8,5,3,10,Argentina - Liga Profesional,0.12,1.0,3,1.0,1.25,8.33,1.0,8
I. Rivadavia,8,2,4,2,8,10,-2,10,Argentina - Liga Profesional,0.25,0.75,-2,1.0,1.25,4.0,1.33,8
Velez Sarsfield,8,3,1,4,5,7,-2,10,Argentina - Liga Profesional,0.38,0.5,-2,0.62,1.25,2.63,2.0,8
Aldosivi,8,2,3,3,12,14,-2,9,Argentina - Liga Profesional,0.25,0.62,-2,1.5,1.12,4.0,1.61,9
Belgrano,8,2,3,3,7,12,-5,9,Argentina - Liga Profesional,0.25,0.62,-5,0.88,1.12,4.0,1.61,9
T. de Cordoba,8,1,5,2,5,5,0,8,Argentina - Liga Profesional,0.12,0.75,0,0.62,1.0,8.33,1.33,10
Sarmiento,8,1,5,2,5,6,-1,8,Argentina - Liga Profesional,0.12,0.75,-1,0.62,1.0,8.33,1.33,10
Estudiantes,8,2,2,4,8,10,-2,8,Argentina - Liga Profesional,0.25,0.5,-2,1.0,1.0,4.0,2.0,10
Godoy Cruz,8,1,5,2,4,8,-4,8,Argentina - Liga Profesional,0.12,0.75,-4,0.5,1.0,8.33,1.33,10
Defensa y J.,8,2,2,4,5,13,-8,8,Argentina - Liga Profesional,0.25,0.5,-8,0.62,1.0,4.0,2.0,10
Instituto,8,2,1,5,8,15,-7,7,Argentina - Liga Profesional,0.25,0.38,-7,1.0,0.88,4.0,2.63,11
Gimnasia,8,1,3,4,4,10,-6,6,Argentina - Liga Profesional,0.12,0.5,-6,0.5,0.75,8.33,2.0,12
SM San Juan,8,2,0,6,4,10,-6,6,Argentina - Liga Profesional,0.25,0.25,-6,0.5,0.75,4.0,4.0,12
Central Cordoba,8,1,2,5,6,12,-6,5,Argentina - Liga Profesional,0.12,0.38,-6,0.75,0.62,8.33,2.63,13
A. Tucuman,8,1,1,6,7,12,-5,4,Argentina - Liga Profesional,0.12,0.25,-5,0.88,0.5,8.33,4.0,14
Quilmes,8,5,2,1,12,5,7,17,Argentina - Primera Nacional,0.62,0.88,7,1.5,2.12,1.61,1.14,1
E. Rio Cuarto,8,5,2,1,9,3,6,17,Argentina - Primera Nacional,0.62,0.88,6,1.12,2.12,1.61,1.14,1
Chacarita J.,8,5,1,2,13,6,7,16,Argentina - Primera Nacional,0.62,0.75,7,1.62,2.0,1.61,1.33,2
G. Mendoza,8,4,4,0,10,3,7,16,Argentina - Primera Nacional,0.5,1.0,7,1.25,2.0,2.0,1.0,2
Atlanta,8,4,4,0,8,3,5,16,Argentina - Primera Nacional,0.5,1.0,5,1.0,2.0,2.0,1.0,2
Atletico Mitre,8,4,3,1,8,2,6,15,Argentina - Primera Nacional,0.5,0.88,6,1.0,1.88,2.0,1.14,3
D. de Belgrano,8,4,3,1,9,4,5,15,Argentina - Primera Nacional,0.5,0.88,5,1.12,1.88,2.0,1.14,3
Gimnasia Jujuy,8,4,2,2,8,3,5,14,Argentina - Primera Nacional,0.5,0.75,5,1.0,1.75,2.0,1.33,4
Ferro Carril,8,4,2,2,7,3,4,14,Argentina - Primera Nacional,0.5,0.75,4,0.88,1.75,2.0,1.33,4
SM Tucuman,8,3,5,0,7,3,4,14,Argentina - Primera Nacional,0.38,1.0,4,0.88,1.75,2.63,1.0,4
Tristan Suarez,8,3,4,1,7,5,2,13,Argentina - Primera Nacional,0.38,0.88,2,0.88,1.62,2.63,1.14,5
D. Madryn,8,3,4,1,5,3,2,13,Argentina - Primera Nacional,0.38,0.88,2,0.62,1.62,2.63,1.14,5
CA Estudiantes,8,4,1,3,6,6,0,13,Argentina - Primera Nacional,0.5,0.62,0,0.75,1.62,2.0,1.61,5
Los Andes,8,3,3,2,9,6,3,12,Argentina - Primera Nacional,0.38,0.75,3,1.12,1.5,2.63,1.33,6
Deportivo Moron,8,3,3,2,8,5,3,12,Argentina - Primera Nacional,0.38,0.75,3,1.0,1.5,2.63,1.33,6
Agropecuario,8,4,0,4,9,9,0,12,Argentina - Primera Nacional,0.5,0.5,0,1.12,1.5,2.0,2.0,6
San Telmo,8,3,3,2,6,7,-1,12,Argentina - Primera Nacional,0.38,0.75,-1,0.75,1.5,2.63,1.33,6
All Boys,8,3,1,4,12,11,1,10,Argentina - Primera Nacional,0.38,0.5,1,1.5,1.25,2.63,2.0,7
Almagro,8,2,4,2,7,8,-1,10,Argentina - Primera Nacional,0.25,0.75,-1,0.88,1.25,4.0,1.33,7
Racing Cordoba,8,2,4,2,8,11,-3,10,Argentina - Primera Nacional,0.25,0.75,-3,1.0,1.25,4.0,1.33,7
Chaco For Ever,8,3,1,4,6,9,-3,10,Argentina - Primera Nacional,0.38,0.5,-3,0.75,1.25,2.63,2.0,7
Nueva Chicago,8,2,3,3,8,8,0,9,Argentina - Primera Nacional,0.25,0.62,0,1.0,1.12,4.0,1.61,8
Patronato,8,2,3,3,6,8,-2,9,Argentina - Primera Nacional,0.25,0.62,-2,0.75,1.12,4.0,1.61,8
Deportivo Maipu,8,2,3,3,7,10,-3,9,Argentina - Primera Nacional,0.25,0.62,-3,0.88,1.12,4.0,1.61,8
Temperley,8,3,0,5,6,11,-5,9,Argentina - Primera Nacional,0.38,0.38,-5,0.75,1.12,2.63,2.63,8
San Miguel,8,1,5,2,8,8,0,8,Argentina - Primera Nacional,0.12,0.75,0,1.0,1.0,8.33,1.33,9
Colegiales,8,2,2,4,2,4,-2,8,Argentina - Primera Nacional,0.25,0.5,-2,0.25,1.0,4.0,2.0,9
Central Norte,8,2,2,4,6,9,-3,8,Argentina - Primera Nacional,0.25,0.5,-3,0.75,1.0,4.0,2.0,9
Gimnasia y Tiro,8,1,4,3,4,6,-2,7,Argentina - Primera Nacional,0.12,0.62,-2,0.5,0.88,8.33,1.61,10
Argentino Merlo,8,6,1,1,15,6,9,19,Argentina - Primera B,0.75,0.88,9,1.88,2.38,1.33,1.14,1
A. Quilmes,8,5,2,1,12,4,8,17,Argentina - Primera B,0.62,0.88,8,1.5,2.12,1.61,1.14,2
Comunicaciones,8,5,2,1,12,6,6,17,Argentina - Primera B,0.62,0.88,6,1.5,2.12,1.61,1.14,2
Villa Dalmine,8,5,2,1,7,2,5,17,Argentina - Primera B,0.62,0.88,5,0.88,2.12,1.61,1.14,2
Deportivo Merlo,8,4,3,1,8,4,4,15,Argentina - Primera B,0.5,0.88,4,1.0,1.88,2.0,1.14,3
Excursionistas,8,4,2,2,16,9,7,14,Argentina - Primera B,0.5,0.75,7,2.0,1.75,2.0,1.33,4
D. Armenio,8,4,1,3,13,8,5,13,Argentina - Primera B,0.5,0.62,5,1.62,1.62,2.0,1.61,5
Colegiales,8,4,1,3,9,7,2,13,Argentina - Primera B,0.5,0.62,2,1.12,1.62,2.0,1.61,5
Midland,8,3,3,2,10,7,3,12,Argentina - Primera B,0.38,0.75,3,1.25,1.5,2.63,1.33,6
Sacachispas,8,3,2,3,4,6,-2,11,Argentina - Primera B,0.38,0.62,-2,0.5,1.38,2.63,1.61,7
Liniers,8,2,4,2,5,5,0,10,Argentina - Primera B,0.25,0.75,0,0.62,1.25,4.0,1.33,8
S. Italiano,8,2,3,3,9,9,0,9,Argentina - Primera B,0.25,0.62,0,1.12,1.12,4.0,1.61,9
Flandria,8,2,3,3,7,9,-2,9,Argentina - Primera B,0.25,0.62,-2,0.88,1.12,4.0,1.61,9
SM Burzaco,8,3,0,5,5,9,-4,9,Argentina - Primera B,0.38,0.38,-4,0.62,1.12,2.63,2.63,9
Dock Sud,8,2,2,4,5,8,-3,8,Argentina - Primera B,0.25,0.5,-3,0.62,1.0,4.0,2.0,10
Los Andes,8,2,2,4,5,9,-4,8,Argentina - Primera B,0.25,0.5,-4,0.62,1.0,4.0,2.0,10
Acassuso,8,2,2,4,5,12,-7,8,Argentina - Primera B,0.25,0.5,-7,0.62,1.0,4.0,2.0,10
UAI Urquiza,8,2,2,4,10,18,-8,8,Argentina - Primera B,0.25,0.5,-8,1.25,1.0,4.0,2.0,10
V. San Carlos,8,2,1,5,5,9,-4,7,Argentina - Primera B,0.25,0.38,-4,0.62,0.88,4.0,2.63,11
D. Laferrere,8,1,4,3,4,9,-5,7,Argentina - Primera B,0.12,0.62,-5,0.5,0.88,8.33,1.61,11
Canuelas,8,2,0,6,6,11,-5,6,Argentina - Primera B,0.25,0.25,-5,0.75,0.75,4.0,4.0,12
Fenix,8,1,1,6,5,12,-7,4,Argentina - Primera B,0.12,0.25,-7,0.62,0.5,8.33,4.0,13
G. Chivilcoy,6,4,2,0,7,3,4,14,Argentina - Torneo Federal,0.67,1.0,4,1.17,2.33,1.49,1.0,1
D. Rincon,6,4,0,2,10,5,5,12,Argentina - Torneo Federal,0.67,0.67,5,1.67,2.0,1.49,1.49,2
Sarmiento DLB,6,4,0,2,10,5,5,12,Argentina - Torneo Federal,0.67,0.67,5,1.67,2.0,1.49,1.49,2
Olimpo Bahia B.,6,3,3,0,6,3,3,12,Argentina - Torneo Federal,0.5,1.0,3,1.0,2.0,2.0,1.0,2
Ciudad Bolivar,5,3,2,0,10,2,8,11,Argentina - Torneo Federal,0.6,1.0,8,2.0,2.2,1.67,1.0,3
S. Belgrano,6,3,2,1,9,4,5,11,Argentina - Torneo Federal,0.5,0.83,5,1.5,1.83,2.0,1.2,3
Villa Mitre,6,3,2,1,8,4,4,11,Argentina - Torneo Federal,0.5,0.83,4,1.33,1.83,2.0,1.2,3
Huracan Las H.,6,3,2,1,7,6,1,11,Argentina - Torneo Federal,0.5,0.83,1,1.17,1.83,2.0,1.2,3
Douglas Haig,6,2,4,0,6,3,3,10,Argentina - Torneo Federal,0.33,1.0,3,1.0,1.67,3.03,1.0,4
Circulo D.,6,3,1,2,9,7,2,10,Argentina - Torneo Federal,0.5,0.67,2,1.5,1.67,2.0,1.49,4
A. Rafaela,6,3,1,2,9,8,1,10,Argentina - Torneo Federal,0.5,0.67,1,1.5,1.67,2.0,1.49,4
Cipolletti,6,3,0,3,10,5,5,9,Argentina - Torneo Federal,0.5,0.5,5,1.67,1.5,2.0,2.0,5
I. Chivilcoy,6,2,3,1,8,4,4,9,Argentina - Torneo Federal,0.33,0.83,4,1.33,1.5,3.03,1.2,5
S. Las Parejas,6,2,3,1,6,3,3,9,Argentina - Torneo Federal,0.33,0.83,3,1.0,1.5,3.03,1.2,5
Guillermo Brown,6,3,0,3,10,12,-2,9,Argentina - Torneo Federal,0.5,0.5,-2,1.67,1.5,2.0,2.0,5
Sol de America,5,2,2,1,10,5,5,8,Argentina - Torneo Federal,0.4,0.8,5,2.0,1.6,2.5,1.25,6
SM Formosa,5,2,2,1,6,3,3,8,Argentina - Torneo Federal,0.4,0.8,3,1.2,1.6,2.5,1.25,6
SM Mendoza,5,2,2,1,7,6,1,8,Argentina - Torneo Federal,0.4,0.8,1,1.4,1.6,2.5,1.25,6
Argentino MM,6,2,2,2,5,5,0,8,Argentina - Torneo Federal,0.33,0.67,0,0.83,1.33,3.03,1.49,6
J. Antoniana,5,2,1,2,6,4,2,7,Argentina - Torneo Federal,0.4,0.6,2,1.2,1.4,2.5,1.67,7
Costa Brava,6,1,4,1,6,5,1,7,Argentina - Torneo Federal,0.17,0.83,1,1.0,1.17,5.88,1.2,7
Bartolom√© Mitre,5,2,1,2,5,4,1,7,Argentina - Torneo Federal,0.4,0.6,1,1.0,1.4,2.5,1.67,7
Juventud U. U.,5,1,4,0,5,4,1,7,Argentina - Torneo Federal,0.2,1.0,1,1.0,1.4,5.0,1.0,7
Santamarina,6,1,4,1,6,6,0,7,Argentina - Torneo Federal,0.17,0.83,0,1.0,1.17,5.88,1.2,7
Ben Hur,6,2,1,3,6,7,-1,7,Argentina - Torneo Federal,0.33,0.5,-1,1.0,1.17,3.03,2.0,7
Kimberley,6,2,1,3,3,4,-1,7,Argentina - Torneo Federal,0.33,0.5,-1,0.5,1.17,3.03,2.0,7
D. Belgrano VR,6,1,4,1,2,3,-1,7,Argentina - Torneo Federal,0.17,0.83,-1,0.33,1.17,5.88,1.2,7
Sarmiento R.,6,2,0,4,5,10,-5,6,Argentina - Torneo Federal,0.33,0.33,-5,0.83,1.0,3.03,3.03,8
Crucero del N.,5,2,0,3,6,13,-7,6,Argentina - Torneo Federal,0.4,0.4,-7,1.2,1.2,2.5,2.5,8
Noah,8,8,0,0,27,3,24,24,Armenia - Premier League,1.0,1.0,24,3.38,3.0,1.0,1.0,1
Urartu,8,6,1,1,17,7,10,19,Armenia - Premier League,0.75,0.88,10,2.12,2.38,1.33,1.14,2
Ararat-Armenia,8,5,1,2,17,10,7,16,Armenia - Premier League,0.62,0.75,7,2.12,2.0,1.61,1.33,3
Van,8,4,3,1,12,7,5,15,Armenia - Premier League,0.5,0.88,5,1.5,1.88,2.0,1.14,4
Ararat Yerevan,8,3,2,3,13,12,1,11,Armenia - Premier League,0.38,0.62,1,1.62,1.38,2.63,1.61,5
BKMA,8,3,2,3,10,13,-3,11,Armenia - Premier League,0.38,0.62,-3,1.25,1.38,2.63,1.61,5
Pyunik,8,3,1,4,16,15,1,10,Armenia - Premier League,0.38,0.5,1,2.0,1.25,2.63,2.0,6
West Armenia,8,3,0,5,8,24,-16,9,Armenia - Premier League,0.38,0.38,-16,1.0,1.12,2.63,2.63,7
Alashkert,8,0,4,4,7,14,-7,4,Armenia - Premier League,0.0,0.5,-7,0.88,0.5,0.0,2.0,8
Shirak,8,1,1,6,7,20,-13,4,Armenia - Premier League,0.12,0.25,-13,0.88,0.5,8.33,4.0,8
Gandzasar,8,0,1,7,4,21,-17,1,Armenia - Premier League,0.0,0.12,-17,0.5,0.12,0.0,8.33,9
WS Wanderers,8,5,3,0,21,9,12,18,Australia - A-League,0.62,1.0,12,2.62,2.25,1.61,1.0,1
Melbourne City,8,5,2,1,14,9,5,17,Australia - A-League,0.62,0.88,5,1.75,2.12,1.61,1.14,2
Western United,8,5,0,3,20,11,9,15,Australia - A-League,0.62,0.62,9,2.5,1.88,1.61,1.61,3
Auckland,8,3,5,0,20,11,9,14,Australia - A-League,0.38,1.0,9,2.5,1.75,2.63,1.0,4
Melbourne V.,8,4,2,2,17,14,3,14,Australia - A-League,0.5,0.75,3,2.12,1.75,2.0,1.33,4
Sydney FC,8,3,4,1,16,13,3,13,Australia - A-League,0.38,0.88,3,2.0,1.62,2.63,1.14,5
Newcastle Jets,8,3,2,3,19,16,3,11,Australia - A-League,0.38,0.62,3,2.38,1.38,2.63,1.61,6
Macarthur FC,8,2,3,3,18,18,0,9,Australia - A-League,0.25,0.62,0,2.25,1.12,4.0,1.61,7
Brisbane Roar,8,2,3,3,11,15,-4,9,Australia - A-League,0.25,0.62,-4,1.38,1.12,4.0,1.61,7
Adelaide Utd,8,1,3,4,19,25,-6,6,Australia - A-League,0.12,0.5,-6,2.38,0.75,8.33,2.0,8
Perth Glory,8,1,2,5,9,16,-7,5,Australia - A-League,0.12,0.38,-7,1.12,0.62,8.33,2.63,9
Wellington,8,1,2,5,11,21,-10,5,Australia - A-League,0.12,0.38,-10,1.38,0.62,8.33,2.63,9
Central Coast,8,1,2,5,8,22,-14,5,Australia - A-League,0.12,0.38,-14,1.0,0.62,8.33,2.63,9
Avondale,8,7,0,1,24,6,18,21,Australia - NPL Victoria,0.88,0.88,18,3.0,2.62,1.14,1.14,1
Oakleigh C.,8,7,0,1,21,5,16,21,Australia - NPL Victoria,0.88,0.88,16,2.62,2.62,1.14,1.14,1
Heidelberg Utd,8,6,1,1,22,8,14,19,Australia - NPL Victoria,0.75,0.88,14,2.75,2.38,1.33,1.14,2
Dandenong T.,8,6,1,1,18,9,9,19,Australia - NPL Victoria,0.75,0.88,9,2.25,2.38,1.33,1.14,2
Preston Lions,8,3,2,3,10,10,0,11,Australia - NPL Victoria,0.38,0.62,0,1.25,1.38,2.63,1.61,3
M. Victory B,8,3,2,3,13,15,-2,11,Australia - NPL Victoria,0.38,0.62,-2,1.62,1.38,2.63,1.61,3
Hume City,8,3,2,3,11,14,-3,11,Australia - NPL Victoria,0.38,0.62,-3,1.38,1.38,2.63,1.61,3
Green Gully,8,3,2,3,9,13,-4,11,Australia - NPL Victoria,0.38,0.62,-4,1.12,1.38,2.63,1.61,3
St. Albans,8,3,0,5,14,15,-1,9,Australia - NPL Victoria,0.38,0.38,-1,1.75,1.12,2.63,2.63,4
Dandenong City,8,2,2,4,11,14,-3,8,Australia - NPL Victoria,0.25,0.5,-3,1.38,1.0,4.0,2.0,5
Melbourne K.,8,2,0,6,8,16,-8,6,Australia - NPL Victoria,0.25,0.25,-8,1.0,0.75,4.0,4.0,6
Port Melbourne,8,2,0,6,6,21,-15,6,Australia - NPL Victoria,0.25,0.25,-15,0.75,0.75,4.0,4.0,6
Altona Magic,8,0,3,5,1,11,-10,3,Australia - NPL Victoria,0.0,0.38,-10,0.12,0.38,0.0,2.63,7
South Melbourne,8,0,3,5,5,16,-11,3,Australia - NPL Victoria,0.0,0.38,-11,0.62,0.38,0.0,2.63,7
Moreton City E.,4,4,0,0,10,4,6,12,Australia - NPL Queensland,1.0,1.0,6,2.5,3.0,1.0,1.0,1
Gold C. Knights,3,3,0,0,6,1,5,9,Australia - NPL Queensland,1.0,1.0,5,2.0,3.0,1.0,1.0,2
Gold C. Utd,4,3,0,1,6,4,2,9,Australia - NPL Queensland,0.75,0.75,2,1.5,2.25,1.33,1.33,2
Peninsula,4,2,1,1,8,3,5,7,Australia - NPL Queensland,0.5,0.75,5,2.0,1.75,2.0,1.33,3
Q. Lions,5,2,1,2,9,7,2,7,Australia - NPL Queensland,0.4,0.6,2,1.8,1.4,2.5,1.67,3
Olympic FC,3,2,0,1,6,2,4,6,Australia - NPL Queensland,0.67,0.67,4,2.0,2.0,1.49,1.49,4
Eastern Suburbs,3,1,2,0,6,4,2,5,Australia - NPL Queensland,0.33,1.0,2,2.0,1.67,3.03,1.0,5
Brisbane City,4,1,0,3,5,9,-4,3,Australia - NPL Queensland,0.25,0.25,-4,1.25,0.75,4.0,4.0,6
St George W.,5,0,2,3,4,10,-6,2,Australia - NPL Queensland,0.0,0.4,-6,0.8,0.4,0.0,2.5,7
Wynnum Wolves,3,0,1,2,3,7,-4,1,Australia - NPL Queensland,0.0,0.33,-4,1.0,0.33,0.0,3.03,8
SC Wanderers,3,0,1,2,2,6,-4,1,Australia - NPL Queensland,0.0,0.33,-4,0.67,0.33,0.0,3.03,8
Brisbane Roar B,3,0,0,3,1,9,-8,0,Australia - NPL Queensland,0.0,0.0,-8,0.33,0.0,0.0,0.0,9
Austria Wien,8,6,1,1,16,6,10,19,Austria - Bundesliga,0.75,0.88,10,2.0,2.38,1.33,1.14,1
Wolfsberger AC,8,5,1,2,19,11,8,16,Austria - Bundesliga,0.62,0.75,8,2.38,2.0,1.61,1.33,2
Salzburg,8,4,4,0,12,5,7,16,Austria - Bundesliga,0.5,1.0,7,1.5,2.0,2.0,1.0,2
BW Linz,8,5,1,2,13,9,4,16,Austria - Bundesliga,0.62,0.75,4,1.62,2.0,1.61,1.33,2
Sturm Graz,8,4,2,2,15,13,2,14,Austria - Bundesliga,0.5,0.75,2,1.88,1.75,2.0,1.33,3
LASK Linz,8,3,2,3,10,12,-2,11,Austria - Bundesliga,0.38,0.62,-2,1.25,1.38,2.63,1.61,4
Hartberg,8,2,3,3,7,13,-6,9,Austria - Bundesliga,0.25,0.62,-6,0.88,1.12,4.0,1.61,5
Rapid Wien,8,2,1,5,14,12,2,7,Austria - Bundesliga,0.25,0.38,2,1.75,0.88,4.0,2.63,6
Altach,8,1,4,3,8,15,-7,7,Austria - Bundesliga,0.12,0.62,-7,1.0,0.88,8.33,1.61,6
Tirol,8,1,3,4,9,13,-4,6,Austria - Bundesliga,0.12,0.5,-4,1.12,0.75,8.33,2.0,7
A. Klagenfurt,8,1,3,4,9,14,-5,6,Austria - Bundesliga,0.12,0.5,-5,1.12,0.75,8.33,2.0,7
Grazer AK,8,1,1,6,9,19,-10,4,Austria - Bundesliga,0.12,0.25,-10,1.12,0.5,8.33,4.0,8
Ried,8,5,2,1,17,6,11,17,Austria - 2. Liga,0.62,0.88,11,2.12,2.12,1.61,1.14,1
Kapfenberger,8,5,1,2,18,13,5,16,Austria - 2. Liga,0.62,0.75,5,2.25,2.0,1.61,1.33,2
Admira Wacker,8,4,3,1,15,10,5,15,Austria - 2. Liga,0.5,0.88,5,1.88,1.88,2.0,1.14,3
Liefering,8,5,0,3,13,9,4,15,Austria - 2. Liga,0.62,0.62,4,1.62,1.88,1.61,1.61,3
Stripfing,8,3,4,1,13,11,2,13,Austria - 2. Liga,0.38,0.88,2,1.62,1.62,2.63,1.14,4
First Vienna,8,4,1,3,13,12,1,13,Austria - 2. Liga,0.5,0.62,1,1.62,1.62,2.0,1.61,4
St. Polten,8,3,3,2,16,11,5,12,Austria - 2. Liga,0.38,0.75,5,2.0,1.5,2.63,1.33,5
SV Horn,8,3,2,3,9,8,1,11,Austria - 2. Liga,0.38,0.62,1,1.12,1.38,2.63,1.61,6
Sturm Graz B,8,3,2,3,8,9,-1,11,Austria - 2. Liga,0.38,0.62,-1,1.0,1.38,2.63,1.61,6
Floridsdorfer,8,3,2,3,8,10,-2,11,Austria - 2. Liga,0.38,0.62,-2,1.0,1.38,2.63,1.61,6
Bregenz,8,3,0,5,14,14,0,9,Austria - 2. Liga,0.38,0.38,0,1.75,1.12,2.63,2.63,7
Voitsberg,8,2,2,4,9,12,-3,8,Austria - 2. Liga,0.25,0.5,-3,1.12,1.0,4.0,2.0,8
A. Lustenau,8,2,2,4,5,8,-3,8,Austria - 2. Liga,0.25,0.5,-3,0.62,1.0,4.0,2.0,8
Amstetten,8,1,4,3,10,12,-2,7,Austria - 2. Liga,0.12,0.62,-2,1.25,0.88,8.33,1.61,9
Rapid Wien B,8,2,1,5,5,17,-12,7,Austria - 2. Liga,0.25,0.38,-12,0.62,0.88,4.0,2.63,9
Lafnitz,8,0,3,5,11,23,-12,3,Austria - 2. Liga,0.0,0.38,-12,1.38,0.38,0.0,2.63,10
Qarabag,8,6,2,0,18,4,14,20,Azerbaijan - Premier League,0.75,1.0,14,2.25,2.5,1.33,1.0,1
Zira,8,6,1,1,16,5,11,19,Azerbaijan - Premier League,0.75,0.88,11,2.0,2.38,1.33,1.14,2
Shamakhi,8,4,1,3,8,9,-1,13,Azerbaijan - Premier League,0.5,0.62,-1,1.0,1.62,2.0,1.61,3
Neftci,8,3,2,3,9,11,-2,11,Azerbaijan - Premier League,0.38,0.62,-2,1.12,1.38,2.63,1.61,4
Araz,8,1,6,1,8,8,0,9,Azerbaijan - Premier League,0.12,0.88,0,1.0,1.12,8.33,1.14,5
Turan,8,2,3,3,7,11,-4,9,Azerbaijan - Premier League,0.25,0.62,-4,0.88,1.12,4.0,1.61,5
Kapaz,8,2,3,3,4,8,-4,9,Azerbaijan - Premier League,0.25,0.62,-4,0.5,1.12,4.0,1.61,5
Sabah,8,1,4,3,11,13,-2,7,Azerbaijan - Premier League,0.12,0.62,-2,1.38,0.88,8.33,1.61,6
Sumqayit,8,2,1,5,10,14,-4,7,Azerbaijan - Premier League,0.25,0.38,-4,1.25,0.88,4.0,2.63,6
Sebail,8,0,3,5,5,13,-8,3,Azerbaijan - Premier League,0.0,0.38,-8,0.62,0.38,0.0,2.63,7
Al-Muharraq,8,7,0,1,20,6,14,21,Bahrain - Premier League,0.88,0.88,14,2.5,2.62,1.14,1.14,1
Khalidiya,8,6,2,0,18,8,10,20,Bahrain - Premier League,0.75,1.0,10,2.25,2.5,1.33,1.0,2
Al Shabbab,8,3,2,3,9,8,1,11,Bahrain - Premier League,0.38,0.62,1,1.12,1.38,2.63,1.61,3
Al Riffa,8,3,2,3,11,11,0,11,Bahrain - Premier League,0.38,0.62,0,1.38,1.38,2.63,1.61,3
Malkiya,8,2,5,1,6,6,0,11,Bahrain - Premier League,0.25,0.88,0,0.75,1.38,4.0,1.14,3
Sitra,8,2,4,2,9,7,2,10,Bahrain - Premier League,0.25,0.75,2,1.12,1.25,4.0,1.33,4
East Riffa,8,1,5,2,8,10,-2,8,Bahrain - Premier League,0.12,0.75,-2,1.0,1.0,8.33,1.33,5
Al Ahli M.,8,2,2,4,11,14,-3,8,Bahrain - Premier League,0.25,0.5,-3,1.38,1.0,4.0,2.0,5
Bahrain SC,8,2,2,4,8,15,-7,8,Bahrain - Premier League,0.25,0.5,-7,1.0,1.0,4.0,2.0,5
AAli FC,8,1,4,3,9,13,-4,7,Bahrain - Premier League,0.12,0.62,-4,1.12,0.88,8.33,1.61,6
Manama,8,1,3,4,6,14,-8,6,Bahrain - Premier League,0.12,0.5,-8,0.75,0.75,8.33,2.0,7
Al-Najma,8,1,2,5,7,13,-6,5,Bahrain - Premier League,0.12,0.38,-6,0.88,0.62,8.33,2.63,8
Mohammedan,8,7,0,1,18,5,13,21,Bangladesh - Premier League,0.88,0.88,13,2.25,2.62,1.14,1.14,1
Abahani,8,6,2,0,18,2,16,20,Bangladesh - Premier League,0.75,1.0,16,2.25,2.5,1.33,1.0,2
Bashundhara K.,8,4,2,2,19,6,13,14,Bangladesh - Premier League,0.5,0.75,13,2.38,1.75,2.0,1.33,3
Fortis,8,3,4,1,9,5,4,13,Bangladesh - Premier League,0.38,0.88,4,1.12,1.62,2.63,1.14,4
Rahmatgonj,8,4,0,4,20,12,8,12,Bangladesh - Premier League,0.5,0.5,8,2.5,1.5,2.0,2.0,5
B. Police,8,3,1,4,8,13,-5,10,Bangladesh - Premier League,0.38,0.5,-5,1.0,1.25,2.63,2.0,6
Fakirerpool,8,3,0,5,10,23,-13,9,Bangladesh - Premier League,0.38,0.38,-13,1.25,1.12,2.63,2.63,7
Brothers Union,8,2,2,4,9,9,0,8,Bangladesh - Premier League,0.25,0.5,0,1.12,1.0,4.0,2.0,8
Dhaka Wanderers,8,1,1,6,6,27,-21,4,Bangladesh - Premier League,0.12,0.25,-21,0.75,0.5,8.33,4.0,9
Chittagong,8,1,0,7,2,17,-15,3,Bangladesh - Premier League,0.12,0.12,-15,0.25,0.38,8.33,8.33,10
Slavia Mozyr,5,4,1,0,12,4,8,13,Belarus - Vysshaya Liga,0.8,1.0,8,2.4,2.6,1.25,1.0,1
Maxline,5,4,1,0,11,3,8,13,Belarus - Vysshaya Liga,0.8,1.0,8,2.2,2.6,1.25,1.0,1
FC Minsk,5,3,1,1,8,6,2,10,Belarus - Vysshaya Liga,0.6,0.8,2,1.6,2.0,1.67,1.25,2
Neman Grodno,4,3,0,1,8,2,6,9,Belarus - Vysshaya Liga,0.75,0.75,6,2.0,2.25,1.33,1.33,3
Isloch,5,2,3,0,10,6,4,9,Belarus - Vysshaya Liga,0.4,1.0,4,2.0,1.8,2.5,1.0,3
Vitebsk,5,2,1,2,10,6,4,7,Belarus - Vysshaya Liga,0.4,0.6,4,2.0,1.4,2.5,1.67,4
T. Zhodino,5,1,4,0,3,2,1,7,Belarus - Vysshaya Liga,0.2,1.0,1,0.6,1.4,5.0,1.0,4
BATE Borisov,5,2,1,2,3,3,0,7,Belarus - Vysshaya Liga,0.4,0.6,0,0.6,1.4,2.5,1.67,4
Dinamo Minsk,4,2,1,1,3,4,-1,7,Belarus - Vysshaya Liga,0.5,0.75,-1,0.75,1.75,2.0,1.33,4
Dinamo Brest,5,1,3,1,5,5,0,6,Belarus - Vysshaya Liga,0.2,0.8,0,1.0,1.2,5.0,1.25,5
Gomel,5,1,2,2,2,3,-1,5,Belarus - Vysshaya Liga,0.2,0.6,-1,0.4,1.0,5.0,1.67,6
Slutsk,5,1,1,3,4,5,-1,4,Belarus - Vysshaya Liga,0.2,0.4,-1,0.8,0.8,5.0,2.5,7
Naftan,5,1,1,3,4,11,-7,4,Belarus - Vysshaya Liga,0.2,0.4,-7,0.8,0.8,5.0,2.5,7
Arsenal D.,5,0,3,2,5,9,-4,3,Belarus - Vysshaya Liga,0.0,0.6,-4,1.0,0.6,0.0,1.67,8
Smorgon,5,0,1,4,2,9,-7,1,Belarus - Vysshaya Liga,0.0,0.2,-7,0.4,0.2,0.0,5.0,9
Molodechno,5,0,0,5,3,15,-12,0,Belarus - Vysshaya Liga,0.0,0.0,-12,0.6,0.0,0.0,0.0,10
BATE B,4,3,1,0,16,5,11,10,Belarus - First League,0.75,1.0,11,4.0,2.5,1.33,1.0,1
Lida,4,3,0,1,12,7,5,9,Belarus - First League,0.75,0.75,5,3.0,2.25,1.33,1.33,2
Ostrovets,4,3,0,1,10,6,4,9,Belarus - First League,0.75,0.75,4,2.5,2.25,1.33,1.33,2
Volna Pinsk,4,2,2,0,11,8,3,8,Belarus - First League,0.5,1.0,3,2.75,2.0,2.0,1.0,3
Dinamo Minsk B,4,2,2,0,6,3,3,8,Belarus - First League,0.5,1.0,3,1.5,2.0,2.0,1.0,3
Dnepr Mogilev,4,2,1,1,7,8,-1,7,Belarus - First League,0.5,0.75,-1,1.75,1.75,2.0,1.33,4
Niva,4,1,3,0,7,6,1,6,Belarus - First League,0.25,1.0,1,1.75,1.5,4.0,1.0,5
Slonim,4,2,0,2,5,7,-2,6,Belarus - First League,0.5,0.5,-2,1.25,1.5,2.0,2.0,5
Bumprom,4,1,2,1,5,4,1,5,Belarus - First League,0.25,0.75,1,1.25,1.25,4.0,1.33,6
Lokomotiv Gomel,4,1,2,1,6,7,-1,5,Belarus - First League,0.25,0.75,-1,1.5,1.25,4.0,1.33,6
Baranovichi,3,1,1,1,5,5,0,4,Belarus - First League,0.33,0.67,0,1.67,1.33,3.03,1.49,7
ABFF U19,4,1,1,2,3,4,-1,4,Belarus - First League,0.25,0.5,-1,0.75,1.0,4.0,2.0,7
Uni X L. Minsk,4,1,1,2,6,9,-3,4,Belarus - First League,0.25,0.5,-3,1.5,1.0,4.0,2.0,7
Orsha,4,1,0,3,5,12,-7,3,Belarus - First League,0.25,0.25,-7,1.25,0.75,4.0,4.0,8
Belshina,3,0,2,1,4,6,-2,2,Belarus - First League,0.0,0.67,-2,1.33,0.67,0.0,1.49,9
Gomel B,4,0,2,2,4,6,-2,2,Belarus - First League,0.0,0.5,-2,1.0,0.5,0.0,2.0,9
Osipovichy,4,0,2,2,6,9,-3,2,Belarus - First League,0.0,0.5,-3,1.5,0.5,0.0,2.0,9
Minsk B,4,0,0,4,3,9,-6,0,Belarus - First League,0.0,0.0,-6,0.75,0.0,0.0,0.0,10
KRC Genk,8,6,2,0,11,5,6,20,Belgium - Pro League,0.75,1.0,6,1.38,2.5,1.33,1.0,1
Royale Union SG,8,6,0,2,18,6,12,18,Belgium - Pro League,0.75,0.75,12,2.25,2.25,1.33,1.33,2
Anderlecht,8,5,0,3,12,6,6,15,Belgium - Pro League,0.62,0.62,6,1.5,1.88,1.61,1.61,3
Westerlo,8,4,2,2,13,10,3,14,Belgium - Pro League,0.5,0.75,3,1.62,1.75,2.0,1.33,4
Gent,8,3,4,1,10,8,2,13,Belgium - Pro League,0.38,0.88,2,1.25,1.62,2.63,1.14,5
Club Brugge,8,3,3,2,14,11,3,12,Belgium - Pro League,0.38,0.75,3,1.75,1.5,2.63,1.33,6
OH Leuven,8,3,3,2,9,9,0,12,Belgium - Pro League,0.38,0.75,0,1.12,1.5,2.63,1.33,6
KV Mechelen,8,3,2,3,9,11,-2,11,Belgium - Pro League,0.38,0.62,-2,1.12,1.38,2.63,1.61,7
Antwerp,8,2,4,2,7,8,-1,10,Belgium - Pro League,0.25,0.75,-1,0.88,1.25,4.0,1.33,8
Charleroi,8,2,3,3,13,10,3,9,Belgium - Pro League,0.25,0.62,3,1.62,1.12,4.0,1.61,9
Sint-Truiden,8,2,3,3,14,13,1,9,Belgium - Pro League,0.25,0.62,1,1.75,1.12,4.0,1.61,9
Kortrijk,8,2,2,4,11,13,-2,8,Belgium - Pro League,0.25,0.5,-2,1.38,1.0,4.0,2.0,10
Standard Liege,8,2,2,4,7,13,-6,8,Belgium - Pro League,0.25,0.5,-6,0.88,1.0,4.0,2.0,10
Cercle Brugge,8,0,5,3,6,12,-6,5,Belgium - Pro League,0.0,0.62,-6,0.75,0.62,0.0,1.61,11
Beerschot,8,1,2,5,5,13,-8,5,Belgium - Pro League,0.12,0.38,-8,0.62,0.62,8.33,2.63,11
Dender,8,1,1,6,6,17,-11,4,Belgium - Pro League,0.12,0.25,-11,0.75,0.5,8.33,4.0,12
Lokeren-Temse,8,7,0,1,15,4,11,21,Belgium - Challenger Pro League,0.88,0.88,11,1.88,2.62,1.14,1.14,1
La Louviere,8,6,2,0,15,6,9,20,Belgium - Challenger Pro League,0.75,1.0,9,1.88,2.5,1.33,1.0,2
Beveren,8,6,1,1,17,8,9,19,Belgium - Challenger Pro League,0.75,0.88,9,2.12,2.38,1.33,1.14,3
RWDM,8,5,1,2,10,4,6,16,Belgium - Challenger Pro League,0.62,0.75,6,1.25,2.0,1.61,1.33,4
Club Brugge B,8,4,1,3,13,9,4,13,Belgium - Challenger Pro League,0.5,0.62,4,1.62,1.62,2.0,1.61,5
Zulte-Waregem,8,4,1,3,13,10,3,13,Belgium - Challenger Pro League,0.5,0.62,3,1.62,1.62,2.0,1.61,5
Patro Eisden,8,3,3,2,8,7,1,12,Belgium - Challenger Pro League,0.38,0.75,1,1.0,1.5,2.63,1.33,6
RFC Liege,8,3,2,3,15,14,1,11,Belgium - Challenger Pro League,0.38,0.62,1,1.88,1.38,2.63,1.61,7
Eupen,8,3,2,3,8,10,-2,11,Belgium - Challenger Pro League,0.38,0.62,-2,1.0,1.38,2.63,1.61,7
Lierse K.,8,3,1,4,9,8,1,10,Belgium - Challenger Pro League,0.38,0.5,1,1.12,1.25,2.63,2.0,8
Lommel SK,8,3,1,4,8,8,0,10,Belgium - Challenger Pro League,0.38,0.5,0,1.0,1.25,2.63,2.0,8
Francs Borains,8,2,0,6,8,15,-7,6,Belgium - Challenger Pro League,0.25,0.25,-7,1.0,0.75,4.0,4.0,9
Seraing,8,0,3,5,7,19,-12,3,Belgium - Challenger Pro League,0.0,0.38,-12,0.88,0.38,0.0,2.63,10
Anderlecht B,8,0,2,6,9,22,-13,2,Belgium - Challenger Pro League,0.0,0.25,-13,1.12,0.25,0.0,4.0,11
KRC Genk B,8,0,1,7,4,17,-13,1,Belgium - Challenger Pro League,0.0,0.12,-13,0.5,0.12,0.0,8.33,12
Deinze,0,0,0,0,0,0,0,0,Belgium - Challenger Pro League,0.0,0.0,0,0.0,0.0,0.0,0.0,13
Always Ready,4,4,0,0,7,2,5,12,Bolivia - Primera Div. - Apertura,1.0,1.0,5,1.75,3.0,1.0,1.0,1
ABB,4,3,1,0,4,0,4,10,Bolivia - Primera Div. - Apertura,0.75,1.0,4,1.0,2.5,1.33,1.0,2
Bolivar,4,3,0,1,13,6,7,9,Bolivia - Primera Div. - Apertura,0.75,0.75,7,3.25,2.25,1.33,1.33,3
The Strongest,4,3,0,1,10,5,5,9,Bolivia - Primera Div. - Apertura,0.75,0.75,5,2.5,2.25,1.33,1.33,3
Blooming,4,3,0,1,9,5,4,9,Bolivia - Primera Div. - Apertura,0.75,0.75,4,2.25,2.25,1.33,1.33,3
Aurora,4,2,0,2,11,9,2,6,Bolivia - Primera Div. - Apertura,0.5,0.5,2,2.75,1.5,2.0,2.0,4
Gualberto V. SJ,4,2,0,2,5,7,-2,6,Bolivia - Primera Div. - Apertura,0.5,0.5,-2,1.25,1.5,2.0,2.0,4
U. de Vinto,4,1,2,1,6,5,1,5,Bolivia - Primera Div. - Apertura,0.25,0.75,1,1.5,1.25,4.0,1.33,5
Real Tomayapo,4,1,2,1,4,5,-1,5,Bolivia - Primera Div. - Apertura,0.25,0.75,-1,1.0,1.25,4.0,1.33,5
Nacional Potosi,4,1,1,2,5,5,0,4,Bolivia - Primera Div. - Apertura,0.25,0.5,0,1.25,1.0,4.0,2.0,6
SA Bulo Bulo,4,1,1,2,4,6,-2,4,Bolivia - Primera Div. - Apertura,0.25,0.5,-2,1.0,1.0,4.0,2.0,6
I. Petrolero,4,1,1,2,2,5,-3,4,Bolivia - Primera Div. - Apertura,0.25,0.5,-3,0.5,1.0,4.0,2.0,6
Guabira,4,1,0,3,9,13,-4,3,Bolivia - Primera Div. - Apertura,0.25,0.25,-4,2.25,0.75,4.0,4.0,7
Real Oruro,4,0,2,2,2,5,-3,2,Bolivia - Primera Div. - Apertura,0.0,0.5,-3,0.5,0.5,0.0,2.0,8
Oriente P.,4,0,2,2,3,8,-5,2,Bolivia - Primera Div. - Apertura,0.0,0.5,-5,0.75,0.5,0.0,2.0,8
Wilstermann,4,0,0,4,1,9,-8,0,Bolivia - Primera Div. - Apertura,0.0,0.0,-8,0.25,0.0,0.0,0.0,9
Bolivar,8,6,1,1,28,11,17,19,Bolivia - Primera Div. - Clausura,0.75,0.88,17,3.5,2.38,1.33,1.14,1
The Strongest,8,6,0,2,26,11,15,18,Bolivia - Primera Div. - Clausura,0.75,0.75,15,3.25,2.25,1.33,1.33,2
Always Ready,8,4,1,3,20,13,7,13,Bolivia - Primera Div. - Clausura,0.5,0.62,7,2.5,1.62,2.0,1.61,3
Gualberto V. SJ,8,4,1,3,18,12,6,13,Bolivia - Primera Div. - Clausura,0.5,0.62,6,2.25,1.62,2.0,1.61,3
Nacional Potosi,8,4,1,3,16,12,4,13,Bolivia - Primera Div. - Clausura,0.5,0.62,4,2.0,1.62,2.0,1.61,3
Royal Pari,8,4,1,3,11,10,1,13,Bolivia - Primera Div. - Clausura,0.5,0.62,1,1.38,1.62,2.0,1.61,3
Aurora,8,3,3,2,19,14,5,12,Bolivia - Primera Div. - Clausura,0.38,0.75,5,2.38,1.5,2.63,1.33,4
Real Tomayapo,8,4,0,4,14,12,2,12,Bolivia - Primera Div. - Clausura,0.5,0.5,2,1.75,1.5,2.0,2.0,4
Blooming,8,3,3,2,10,13,-3,12,Bolivia - Primera Div. - Clausura,0.38,0.75,-3,1.25,1.5,2.63,1.33,4
Guabira,8,3,2,3,10,10,0,11,Bolivia - Primera Div. - Clausura,0.38,0.62,0,1.25,1.38,2.63,1.61,5
Wilstermann,8,2,4,2,11,13,-2,10,Bolivia - Primera Div. - Clausura,0.25,0.75,-2,1.38,1.25,4.0,1.33,6
I. Petrolero,8,3,0,5,13,20,-7,9,Bolivia - Primera Div. - Clausura,0.38,0.38,-7,1.62,1.12,2.63,2.63,7
SA Bulo Bulo,8,2,2,4,14,22,-8,8,Bolivia - Primera Div. - Clausura,0.25,0.5,-8,1.75,1.0,4.0,2.0,8
Oriente P.,8,2,1,5,14,23,-9,7,Bolivia - Primera Div. - Clausura,0.25,0.38,-9,1.75,0.88,4.0,2.63,9
U. de Vinto,8,2,1,5,8,17,-9,7,Bolivia - Primera Div. - Clausura,0.25,0.38,-9,1.0,0.88,4.0,2.63,9
Santa Cruz,8,1,0,7,7,27,-20,3,Bolivia - Primera Div. - Clausura,0.12,0.12,-20,0.88,0.38,8.33,8.33,10
Palmeiras,5,4,1,0,7,2,5,13,Brazil - Serie A,0.8,1.0,5,1.4,2.6,1.25,1.0,1
Flamengo,5,3,2,0,11,2,9,11,Brazil - Serie A,0.6,1.0,9,2.2,2.2,1.67,1.0,2
Bragantino,5,3,1,1,6,4,2,10,Brazil - Serie A,0.6,0.8,2,1.2,2.0,1.67,1.25,3
Fluminense,5,3,1,1,6,4,2,10,Brazil - Serie A,0.6,0.8,2,1.2,2.0,1.67,1.25,3
Ceara,5,2,1,2,7,6,1,7,Brazil - Serie A,0.4,0.6,1,1.4,1.4,2.5,1.67,4
Sao Paulo,5,1,4,0,5,4,1,7,Brazil - Serie A,0.2,1.0,1,1.0,1.4,5.0,1.0,4
Corinthians,5,2,1,2,6,6,0,7,Brazil - Serie A,0.4,0.6,0,1.2,1.4,2.5,1.67,4
Cruzeiro,5,2,1,2,6,6,0,7,Brazil - Serie A,0.4,0.6,0,1.2,1.4,2.5,1.67,4
Vasco da Gama,5,2,1,2,6,7,-1,7,Brazil - Serie A,0.4,0.6,-1,1.2,1.4,2.5,1.67,4
Juventude,5,2,1,2,6,11,-5,7,Brazil - Serie A,0.4,0.6,-5,1.2,1.4,2.5,1.67,4
Mirassol,5,1,3,1,9,7,2,6,Brazil - Serie A,0.2,0.8,2,1.8,1.2,5.0,1.25,5
Internacional,5,1,3,1,5,3,2,6,Brazil - Serie A,0.2,0.8,2,1.0,1.2,5.0,1.25,5
Bahia,5,1,3,1,5,7,-2,6,Brazil - Serie A,0.2,0.8,-2,1.0,1.2,5.0,1.25,5
Fortaleza,5,1,2,2,5,5,0,5,Brazil - Serie A,0.2,0.6,0,1.0,1.0,5.0,1.67,6
Botafogo,5,1,2,2,4,4,0,5,Brazil - Serie A,0.2,0.6,0,0.8,1.0,5.0,1.67,6
Vitoria,5,1,2,2,6,8,-2,5,Brazil - Serie A,0.2,0.6,-2,1.2,1.0,5.0,1.67,6
Atletico MG,5,1,2,2,4,6,-2,5,Brazil - Serie A,0.2,0.6,-2,0.8,1.0,5.0,1.67,6
Santos,5,1,1,3,6,7,-1,4,Brazil - Serie A,0.2,0.4,-1,1.2,0.8,5.0,2.5,7
Gremio,5,1,1,3,4,10,-6,4,Brazil - Serie A,0.2,0.4,-6,0.8,0.8,5.0,2.5,7
Sport Recife,5,0,1,4,3,8,-5,1,Brazil - Serie A,0.0,0.2,-5,0.6,0.2,0.0,5.0,8
Athletico PR,4,3,0,1,7,4,3,9,Brazil - Serie B,0.75,0.75,3,1.75,2.25,1.33,1.33,1
America MG,4,3,0,1,5,3,2,9,Brazil - Serie B,0.75,0.75,2,1.25,2.25,1.33,1.33,1
CRB,4,3,0,1,4,3,1,9,Brazil - Serie B,0.75,0.75,1,1.0,2.25,1.33,1.33,1
Avai,4,2,2,0,6,3,3,8,Brazil - Serie B,0.5,1.0,3,1.5,2.0,2.0,1.0,2
Remo,4,2,2,0,6,3,3,8,Brazil - Serie B,0.5,1.0,3,1.5,2.0,2.0,1.0,2
Cuiaba,3,2,1,0,5,3,2,7,Brazil - Serie B,0.67,1.0,2,1.67,2.33,1.49,1.0,3
Vila Nova,4,2,1,1,5,3,2,7,Brazil - Serie B,0.5,0.75,2,1.25,1.75,2.0,1.33,3
Goias,4,2,1,1,5,4,1,7,Brazil - Serie B,0.5,0.75,1,1.25,1.75,2.0,1.33,3
Coritiba,4,2,1,1,3,2,1,7,Brazil - Serie B,0.5,0.75,1,0.75,1.75,2.0,1.33,3
Chapecoense,4,2,0,2,4,3,1,6,Brazil - Serie B,0.5,0.5,1,1.0,1.5,2.0,2.0,4
Novorizontino,4,1,3,0,3,2,1,6,Brazil - Serie B,0.25,1.0,1,0.75,1.5,4.0,1.0,4
Ferroviaria,3,1,2,0,3,1,2,5,Brazil - Serie B,0.33,1.0,2,1.0,1.67,3.03,1.0,5
Criciuma,4,1,1,2,7,5,2,4,Brazil - Serie B,0.25,0.5,2,1.75,1.0,4.0,2.0,6
Atletico GO,3,1,1,1,5,5,0,4,Brazil - Serie B,0.33,0.67,0,1.67,1.33,3.03,1.49,6
Operario PR,4,1,1,2,3,4,-1,4,Brazil - Serie B,0.25,0.5,-1,0.75,1.0,4.0,2.0,6
Botafogo SP,4,0,2,2,3,6,-3,2,Brazil - Serie B,0.0,0.5,-3,0.75,0.5,0.0,2.0,7
Paysandu,4,0,1,3,1,5,-4,1,Brazil - Serie B,0.0,0.25,-4,0.25,0.25,0.0,4.0,8
Amazonas,4,0,1,3,1,6,-5,1,Brazil - Serie B,0.0,0.25,-5,0.25,0.25,0.0,4.0,8
Volta Redonda,3,0,0,3,0,3,-3,0,Brazil - Serie B,0.0,0.0,-3,0.0,0.0,0.0,0.0,9
Athletic Club,4,0,0,4,3,11,-8,0,Brazil - Serie B,0.0,0.0,-8,0.75,0.0,0.0,0.0,9
Londrina,2,2,0,0,5,1,4,6,Brazil - Serie C,1.0,1.0,4,2.5,3.0,1.0,1.0,1
Maringa,2,2,0,0,4,2,2,6,Brazil - Serie C,1.0,1.0,2,2.0,3.0,1.0,1.0,1
Botafogo PB,2,1,1,0,3,0,3,4,Brazil - Serie C,0.5,1.0,3,1.5,2.0,2.0,1.0,2
Tombense,2,1,1,0,3,2,1,4,Brazil - Serie C,0.5,1.0,1,1.5,2.0,2.0,1.0,2
Ponte Preta,2,1,1,0,2,1,1,4,Brazil - Serie C,0.5,1.0,1,1.0,2.0,2.0,1.0,2
Brusque,2,1,1,0,1,0,1,4,Brazil - Serie C,0.5,1.0,1,0.5,2.0,2.0,1.0,2
Ituano,2,1,1,0,1,0,1,4,Brazil - Serie C,0.5,1.0,1,0.5,2.0,2.0,1.0,2
Itabaiana,2,1,0,1,4,4,0,3,Brazil - Serie C,0.5,0.5,0,2.0,1.5,2.0,2.0,3
Caxias,2,1,0,1,2,2,0,3,Brazil - Serie C,0.5,0.5,0,1.0,1.5,2.0,2.0,3
Ypiranga,2,1,0,1,4,5,-1,3,Brazil - Serie C,0.5,0.5,-1,2.0,1.5,2.0,2.0,3
Confianca,2,1,0,1,2,4,-2,3,Brazil - Serie C,0.5,0.5,-2,1.0,1.5,2.0,2.0,3
ABC,2,0,2,0,2,2,0,2,Brazil - Serie C,0.0,1.0,0,1.0,1.0,0.0,1.0,4
CSA,2,0,2,0,2,2,0,2,Brazil - Serie C,0.0,1.0,0,1.0,1.0,0.0,1.0,4
Figueirense,2,0,1,1,3,4,-1,1,Brazil - Serie C,0.0,0.5,-1,1.5,0.5,0.0,2.0,5
Anapolis,2,0,1,1,1,2,-1,1,Brazil - Serie C,0.0,0.5,-1,0.5,0.5,0.0,2.0,5
Nautico,2,0,1,1,1,2,-1,1,Brazil - Serie C,0.0,0.5,-1,0.5,0.5,0.0,2.0,5
Sao Bernardo,2,0,1,1,1,2,-1,1,Brazil - Serie C,0.0,0.5,-1,0.5,0.5,0.0,2.0,5
Retro,2,0,1,1,0,1,-1,1,Brazil - Serie C,0.0,0.5,-1,0.0,0.5,0.0,2.0,5
Guarani,2,0,0,2,2,4,-2,0,Brazil - Serie C,0.0,0.0,-2,1.0,0.0,0.0,0.0,6
Floresta,2,0,0,2,0,3,-3,0,Brazil - Serie C,0.0,0.0,-3,0.0,0.0,0.0,0.0,6
ASA,1,1,0,0,3,0,3,3,Brazil - Serie D,1.0,1.0,3,3.0,3.0,1.0,1.0,1
Tuna Luso,1,1,0,0,3,0,3,3,Brazil - Serie D,1.0,1.0,3,3.0,3.0,1.0,1.0,1
Inter Limeira,1,1,0,0,3,1,2,3,Brazil - Serie D,1.0,1.0,2,3.0,3.0,1.0,1.0,1
CFRJ . Marica,1,1,0,0,2,0,2,3,Brazil - Serie D,1.0,1.0,2,2.0,3.0,1.0,1.0,1
Mixto,1,1,0,0,4,3,1,3,Brazil - Serie D,1.0,1.0,1,4.0,3.0,1.0,1.0,1
Pouso Alegre,1,1,0,0,3,2,1,3,Brazil - Serie D,1.0,1.0,1,3.0,3.0,1.0,1.0,1
Azuriz,1,1,0,0,2,1,1,3,Brazil - Serie D,1.0,1.0,1,2.0,3.0,1.0,1.0,1
Ceilandia,1,1,0,0,2,1,1,3,Brazil - Serie D,1.0,1.0,1,2.0,3.0,1.0,1.0,1
Central,1,1,0,0,2,1,1,3,Brazil - Serie D,1.0,1.0,1,2.0,3.0,1.0,1.0,1
Lagarto,1,1,0,0,2,1,1,3,Brazil - Serie D,1.0,1.0,1,2.0,3.0,1.0,1.0,1
Aguia de Maraba,1,1,0,0,1,0,1,3,Brazil - Serie D,1.0,1.0,1,1.0,3.0,1.0,1.0,1
Aparecidense,1,1,0,0,1,0,1,3,Brazil - Serie D,1.0,1.0,1,1.0,3.0,1.0,1.0,1
Brasil de P.,1,1,0,0,1,0,1,3,Brazil - Serie D,1.0,1.0,1,1.0,3.0,1.0,1.0,1
Cianorte,1,1,0,0,1,0,1,3,Brazil - Serie D,1.0,1.0,1,1.0,3.0,1.0,1.0,1
Iguatu,1,1,0,0,1,0,1,3,Brazil - Serie D,1.0,1.0,1,1.0,3.0,1.0,1.0,1
Itabirito,1,1,0,0,1,0,1,3,Brazil - Serie D,1.0,1.0,1,1.0,3.0,1.0,1.0,1
Jequi√©,1,1,0,0,1,0,1,3,Brazil - Serie D,1.0,1.0,1,1.0,3.0,1.0,1.0,1
Joinville,1,1,0,0,1,0,1,3,Brazil - Serie D,1.0,1.0,1,1.0,3.0,1.0,1.0,1
Luverdense,1,1,0,0,1,0,1,3,Brazil - Serie D,1.0,1.0,1,1.0,3.0,1.0,1.0,1
Santa Cruz,1,1,0,0,1,0,1,3,Brazil - Serie D,1.0,1.0,1,1.0,3.0,1.0,1.0,1
Santa Cruz de N,1,1,0,0,1,0,1,3,Brazil - Serie D,1.0,1.0,1,1.0,3.0,1.0,1.0,1
Boavista,1,0,1,0,2,2,0,1,Brazil - Serie D,0.0,1.0,0,2.0,1.0,0.0,1.0,2
Maracana,1,0,1,0,2,2,0,1,Brazil - Serie D,0.0,1.0,0,2.0,1.0,0.0,1.0,2
Portuguesa,1,0,1,0,2,2,0,1,Brazil - Serie D,0.0,1.0,0,2.0,1.0,0.0,1.0,2
Tocantinopolis,1,0,1,0,2,2,0,1,Brazil - Serie D,0.0,1.0,0,2.0,1.0,0.0,1.0,2
Altos,1,0,1,0,1,1,0,1,Brazil - Serie D,0.0,1.0,0,1.0,1.0,0.0,1.0,2
Cascavel,1,0,1,0,1,1,0,1,Brazil - Serie D,0.0,1.0,0,1.0,1.0,0.0,1.0,2
Independencia,1,0,1,0,1,1,0,1,Brazil - Serie D,0.0,1.0,0,1.0,1.0,0.0,1.0,2
Manauara,1,0,1,0,1,1,0,1,Brazil - Serie D,0.0,1.0,0,1.0,1.0,0.0,1.0,2
Flamengo,8,7,1,0,22,0,22,22,Brazil - Carioca,0.88,1.0,22,2.75,2.75,1.14,1.0,1
Fluminense,8,4,3,1,12,7,5,15,Brazil - Carioca,0.5,0.88,5,1.5,1.88,2.0,1.14,2
Vasco da Gama,8,4,2,2,11,7,4,14,Brazil - Carioca,0.5,0.75,4,1.38,1.75,2.0,1.33,3
Volta Redonda,8,4,2,2,11,10,1,14,Brazil - Carioca,0.5,0.75,1,1.38,1.75,2.0,1.33,3
Sampaio Correa,8,3,3,2,11,9,2,12,Brazil - Carioca,0.38,0.75,2,1.38,1.5,2.63,1.33,4
Madureira,8,3,2,3,7,5,2,11,Brazil - Carioca,0.38,0.62,2,0.88,1.38,2.63,1.61,5
Boavista,8,1,7,0,7,5,2,10,Brazil - Carioca,0.12,1.0,2,0.88,1.25,8.33,1.0,6
Botafogo,8,3,1,4,7,8,-1,10,Brazil - Carioca,0.38,0.5,-1,0.88,1.25,2.63,2.0,6
Nova Iguacu,8,2,3,3,4,7,-3,9,Brazil - Carioca,0.25,0.62,-3,0.5,1.12,4.0,1.61,7
CFRJ . Marica,8,1,2,5,7,15,-8,5,Brazil - Carioca,0.12,0.38,-8,0.88,0.62,8.33,2.63,8
Portuguesa RJ,8,1,1,6,9,21,-12,4,Brazil - Carioca,0.12,0.25,-12,1.12,0.5,8.33,4.0,9
Bangu,8,0,3,5,4,18,-14,3,Brazil - Carioca,0.0,0.38,-14,0.5,0.38,0.0,2.63,10
Atletico MG,8,4,4,0,9,2,7,16,Brazil - Mineiro,0.5,1.0,7,1.12,2.0,2.0,1.0,1
Tombense,8,5,1,2,8,5,3,16,Brazil - Mineiro,0.62,0.75,3,1.0,2.0,1.61,1.33,1
Betim,8,4,3,1,12,5,7,15,Brazil - Mineiro,0.5,0.88,7,1.5,1.88,2.0,1.14,2
America MG,8,3,4,1,14,5,9,13,Brazil - Mineiro,0.38,0.88,9,1.75,1.62,2.63,1.14,3
Athletic Club,8,4,0,4,12,12,0,12,Brazil - Mineiro,0.5,0.5,0,1.5,1.5,2.0,2.0,4
Cruzeiro,8,3,2,3,11,9,2,11,Brazil - Mineiro,0.38,0.62,2,1.38,1.38,2.63,1.61,5
Democrata GV,8,3,2,3,8,9,-1,11,Brazil - Mineiro,0.38,0.62,-1,1.0,1.38,2.63,1.61,5
Uberlandia,8,2,3,3,10,10,0,9,Brazil - Mineiro,0.25,0.62,0,1.25,1.12,4.0,1.61,6
Itabirito,8,2,2,4,7,11,-4,8,Brazil - Mineiro,0.25,0.5,-4,0.88,1.0,4.0,2.0,7
Pouso Alegre,8,2,2,4,7,15,-8,8,Brazil - Mineiro,0.25,0.5,-8,0.88,1.0,4.0,2.0,7
Aymores,8,1,4,3,3,5,-2,7,Brazil - Mineiro,0.12,0.62,-2,0.38,0.88,8.33,1.61,8
Villa Nova,8,1,1,6,4,17,-13,4,Brazil - Mineiro,0.12,0.25,-13,0.5,0.5,8.33,4.0,9
Anapolis,8,6,0,2,13,6,7,18,Brazil - Goiano,0.75,0.75,7,1.62,2.25,1.33,1.33,1
Vila Nova,8,4,3,1,8,5,3,15,Brazil - Goiano,0.5,0.88,3,1.0,1.88,2.0,1.14,2
Atletico GO,8,4,2,2,10,6,4,14,Brazil - Goiano,0.5,0.75,4,1.25,1.75,2.0,1.33,3
CRAC,8,4,2,2,7,4,3,14,Brazil - Goiano,0.5,0.75,3,0.88,1.75,2.0,1.33,3
Goias,8,4,2,2,7,5,2,14,Brazil - Goiano,0.5,0.75,2,0.88,1.75,2.0,1.33,3
Goianesia,8,2,4,2,11,9,2,10,Brazil - Goiano,0.25,0.75,2,1.38,1.25,4.0,1.33,4
ABECAT Ouvidore,8,3,1,4,8,10,-2,10,Brazil - Goiano,0.38,0.5,-2,1.0,1.25,2.63,2.0,4
Goiatuba EC,8,2,4,2,4,6,-2,10,Brazil - Goiano,0.25,0.75,-2,0.5,1.25,4.0,1.33,4
Jataiense,8,3,0,5,10,10,0,9,Brazil - Goiano,0.38,0.38,0,1.25,1.12,2.63,2.63,5
Goiania,8,2,1,5,8,14,-6,7,Brazil - Goiano,0.25,0.38,-6,1.0,0.88,4.0,2.63,6
Aparecidense,8,1,3,4,4,7,-3,6,Brazil - Goiano,0.12,0.5,-3,0.5,0.75,8.33,2.0,7
Inhumas,8,1,2,5,5,13,-8,5,Brazil - Goiano,0.12,0.38,-8,0.62,0.62,8.33,2.63,8
Santa Cruz,8,6,1,1,13,3,10,19,Brazil - Pernambucano,0.75,0.88,10,1.62,2.38,1.33,1.14,1
Nautico,8,5,0,3,14,8,6,15,Brazil - Pernambucano,0.62,0.62,6,1.75,1.88,1.61,1.61,2
Sport Recife,8,4,2,2,16,7,9,14,Brazil - Pernambucano,0.5,0.75,9,2.0,1.75,2.0,1.33,3
Maguary PE,8,4,2,2,10,9,1,14,Brazil - Pernambucano,0.5,0.75,1,1.25,1.75,2.0,1.33,3
Retro,8,3,3,2,7,7,0,12,Brazil - Pernambucano,0.38,0.75,0,0.88,1.5,2.63,1.33,4
Decisao,8,3,3,2,10,11,-1,12,Brazil - Pernambucano,0.38,0.75,-1,1.25,1.5,2.63,1.33,4
Jaguar,8,3,1,4,10,16,-6,10,Brazil - Pernambucano,0.38,0.5,-6,1.25,1.25,2.63,2.0,5
Central,8,2,2,4,8,9,-1,8,Brazil - Pernambucano,0.25,0.5,-1,1.0,1.0,4.0,2.0,6
Afogados,8,0,4,4,4,12,-8,4,Brazil - Pernambucano,0.0,0.5,-8,0.5,0.5,0.0,2.0,7
Petrolina,8,0,2,6,3,13,-10,2,Brazil - Pernambucano,0.0,0.25,-10,0.38,0.25,0.0,4.0,8
Corinthians,8,5,3,0,13,7,6,18,Brazil - Paulista,0.62,1.0,6,1.62,2.25,1.61,1.0,1
Palmeiras,8,4,4,0,15,6,9,16,Brazil - Paulista,0.5,1.0,9,1.88,2.0,2.0,1.0,2
Ponte Preta,8,5,1,2,9,6,3,16,Brazil - Paulista,0.62,0.75,3,1.12,2.0,1.61,1.33,2
Santos,8,4,2,2,15,8,7,14,Brazil - Paulista,0.5,0.75,7,1.88,1.75,2.0,1.33,3
Bragantino,8,4,2,2,10,5,5,14,Brazil - Paulista,0.5,0.75,5,1.25,1.75,2.0,1.33,3
Sao Bernardo,8,4,2,2,12,11,1,14,Brazil - Paulista,0.5,0.75,1,1.5,1.75,2.0,1.33,3
Novorizontino,8,3,4,1,8,6,2,13,Brazil - Paulista,0.38,0.88,2,1.0,1.62,2.63,1.14,4
Portuguesa,8,2,5,1,12,10,2,11,Brazil - Paulista,0.25,0.88,2,1.5,1.38,4.0,1.14,5
Velo Clube,8,2,4,2,10,10,0,10,Brazil - Paulista,0.25,0.75,0,1.25,1.25,4.0,1.33,6
Sao Paulo,8,2,3,3,12,11,1,9,Brazil - Paulista,0.25,0.62,1,1.5,1.12,4.0,1.61,7
Botafogo SP,8,2,3,3,8,10,-2,9,Brazil - Paulista,0.25,0.62,-2,1.0,1.12,4.0,1.61,7
Mirassol,8,2,1,5,10,17,-7,7,Brazil - Paulista,0.25,0.38,-7,1.25,0.88,4.0,2.63,8
Guarani,8,1,3,4,10,13,-3,6,Brazil - Paulista,0.12,0.5,-3,1.25,0.75,8.33,2.0,9
Agua Santa,8,0,4,4,5,13,-8,4,Brazil - Paulista,0.0,0.5,-8,0.62,0.5,0.0,2.0,10
Noroeste,8,0,3,5,9,16,-7,3,Brazil - Paulista,0.0,0.38,-7,1.12,0.38,0.0,2.63,11
Inter Limeira,8,0,3,5,5,15,-10,3,Brazil - Paulista,0.0,0.38,-10,0.62,0.38,0.0,2.63,11
Treze,8,5,2,1,17,7,10,17,Brazil - Paraibano,0.62,0.88,10,2.12,2.12,1.61,1.14,1
Sousa,8,5,2,1,12,3,9,17,Brazil - Paraibano,0.62,0.88,9,1.5,2.12,1.61,1.14,1
Botafogo PB,8,5,1,2,15,6,9,16,Brazil - Paraibano,0.62,0.75,9,1.88,2.0,1.61,1.33,2
Serra Branca,8,4,2,2,20,8,12,14,Brazil - Paraibano,0.5,0.75,12,2.5,1.75,2.0,1.33,3
Campinense,8,4,2,2,14,9,5,14,Brazil - Paraibano,0.5,0.75,5,1.75,1.75,2.0,1.33,3
Pombal,8,2,3,3,7,8,-1,9,Brazil - Paraibano,0.25,0.62,-1,0.88,1.12,4.0,1.61,4
Nacional Patos,8,2,3,3,13,17,-4,9,Brazil - Paraibano,0.25,0.62,-4,1.62,1.12,4.0,1.61,4
EC de Patos,8,2,1,5,11,16,-5,7,Brazil - Paraibano,0.25,0.38,-5,1.38,0.88,4.0,2.63,5
Auto Esporte,8,1,3,4,8,15,-7,6,Brazil - Paraibano,0.12,0.5,-7,1.0,0.75,8.33,2.0,6
Picuiense,8,0,1,7,5,33,-28,1,Brazil - Paraibano,0.0,0.12,-28,0.62,0.12,0.0,8.33,7
Santa Catarina,8,4,3,1,14,9,5,15,Brazil - Catarinense,0.5,0.88,5,1.75,1.88,2.0,1.14,1
Brusque,8,4,2,2,12,6,6,14,Brazil - Catarinense,0.5,0.75,6,1.5,1.75,2.0,1.33,2
Avai,8,4,1,3,12,6,6,13,Brazil - Catarinense,0.5,0.62,6,1.5,1.62,2.0,1.61,3
Criciuma,8,3,4,1,10,4,6,13,Brazil - Catarinense,0.38,0.88,6,1.25,1.62,2.63,1.14,3
Figueirense,8,4,1,3,16,11,5,13,Brazil - Catarinense,0.5,0.62,5,2.0,1.62,2.0,1.61,3
Barra FC,8,3,3,2,6,7,-1,12,Brazil - Catarinense,0.38,0.75,-1,0.75,1.5,2.63,1.33,4
Marcilio Dias,8,2,4,2,7,8,-1,10,Brazil - Catarinense,0.25,0.75,-1,0.88,1.25,4.0,1.33,5
Concordia,8,3,1,4,8,15,-7,10,Brazil - Catarinense,0.38,0.5,-7,1.0,1.25,2.63,2.0,5
Chapecoense,8,1,6,1,10,9,1,9,Brazil - Catarinense,0.12,0.88,1,1.25,1.12,8.33,1.14,6
Joinville,8,2,3,3,9,14,-5,9,Brazil - Catarinense,0.25,0.62,-5,1.12,1.12,4.0,1.61,6
Caravaggio,8,2,1,5,5,12,-7,7,Brazil - Catarinense,0.25,0.38,-7,0.62,0.88,4.0,2.63,7
Hercilio Luz,8,1,2,5,6,13,-7,5,Brazil - Catarinense,0.12,0.38,-7,0.75,0.62,8.33,2.63,8
Internacional,8,6,2,0,16,4,12,20,Brazil - Gaucho,0.75,1.0,12,2.0,2.5,1.33,1.0,1
Juventude,8,6,1,1,14,6,8,19,Brazil - Gaucho,0.75,0.88,8,1.75,2.38,1.33,1.14,2
Gremio,8,5,2,1,19,3,16,17,Brazil - Gaucho,0.62,0.88,16,2.38,2.12,1.61,1.14,3
Caxias,8,4,2,2,8,9,-1,14,Brazil - Gaucho,0.5,0.75,-1,1.0,1.75,2.0,1.33,4
Ypiranga,8,3,3,2,6,6,0,12,Brazil - Gaucho,0.38,0.75,0,0.75,1.5,2.63,1.33,5
Guarany de Bage,8,2,3,3,6,6,0,9,Brazil - Gaucho,0.25,0.62,0,0.75,1.12,4.0,1.61,6
Sao Luiz,8,2,3,3,7,13,-6,9,Brazil - Gaucho,0.25,0.62,-6,0.88,1.12,4.0,1.61,6
Brasil de P.,8,1,4,3,5,10,-5,7,Brazil - Gaucho,0.12,0.62,-5,0.62,0.88,8.33,1.61,7
Monsoon,8,2,1,5,7,14,-7,7,Brazil - Gaucho,0.25,0.38,-7,0.88,0.88,4.0,2.63,7
Pelotas,8,1,3,4,6,13,-7,6,Brazil - Gaucho,0.12,0.5,-7,0.75,0.75,8.33,2.0,8
EC Sao Jose,8,0,5,3,5,10,-5,5,Brazil - Gaucho,0.0,0.62,-5,0.62,0.62,0.0,1.61,9
Avenida,8,0,3,5,4,9,-5,3,Brazil - Gaucho,0.0,0.38,-5,0.5,0.38,0.0,2.63,10
Ludogorets,8,6,1,1,15,4,11,19,Bulgaria - Parva Liga,0.75,0.88,11,1.88,2.38,1.33,1.14,1
Arda,8,5,2,1,21,6,15,17,Bulgaria - Parva Liga,0.62,0.88,15,2.62,2.12,1.61,1.14,2
CSKA Sofia,8,4,3,1,10,5,5,15,Bulgaria - Parva Liga,0.5,0.88,5,1.25,1.88,2.0,1.14,3
Slavia Sofia,8,4,2,2,18,15,3,14,Bulgaria - Parva Liga,0.5,0.75,3,2.25,1.75,2.0,1.33,4
Levski Sofia,8,3,4,1,12,9,3,13,Bulgaria - Parva Liga,0.38,0.88,3,1.5,1.62,2.63,1.14,5
Spartak Varna,8,4,1,3,11,11,0,13,Bulgaria - Parva Liga,0.5,0.62,0,1.38,1.62,2.0,1.61,5
Cherno More,8,2,5,1,8,10,-2,11,Bulgaria - Parva Liga,0.25,0.88,-2,1.0,1.38,4.0,1.14,6
Lokomotiv Sofia,8,3,1,4,10,14,-4,10,Bulgaria - Parva Liga,0.38,0.5,-4,1.25,1.25,2.63,2.0,7
CSKA 1948 Sofia,8,3,0,5,13,13,0,9,Bulgaria - Parva Liga,0.38,0.38,0,1.62,1.12,2.63,2.63,8
Beroe,8,2,2,4,8,10,-2,8,Bulgaria - Parva Liga,0.25,0.5,-2,1.0,1.0,4.0,2.0,9
Botev Plovdiv,8,1,5,2,9,12,-3,8,Bulgaria - Parva Liga,0.12,0.75,-3,1.12,1.0,8.33,1.33,9
Lok. Plovdiv,8,2,2,4,4,7,-3,8,Bulgaria - Parva Liga,0.25,0.5,-3,0.5,1.0,4.0,2.0,9
Botev Vratsa,8,2,2,4,7,11,-4,8,Bulgaria - Parva Liga,0.25,0.5,-4,0.88,1.0,4.0,2.0,9
L. Krumovgrad,8,2,2,4,3,10,-7,8,Bulgaria - Parva Liga,0.25,0.5,-7,0.38,1.0,4.0,2.0,9
Septemvri Sofia,8,2,1,5,11,16,-5,7,Bulgaria - Parva Liga,0.25,0.38,-5,1.38,0.88,4.0,2.63,10
Hebar,8,2,1,5,6,13,-7,7,Bulgaria - Parva Liga,0.25,0.38,-7,0.75,0.88,4.0,2.63,10
A. Ottawa,3,2,1,0,9,5,4,7,Canada - Premier League,0.67,1.0,4,3.0,2.33,1.49,1.0,1
HFX Wanderers,3,2,1,0,7,4,3,7,Canada - Premier League,0.67,1.0,3,2.33,2.33,1.49,1.0,1
Forge,3,2,1,0,4,1,3,7,Canada - Premier League,0.67,1.0,3,1.33,2.33,1.49,1.0,1
York Utd,3,1,0,2,5,5,0,3,Canada - Premier League,0.33,0.33,0,1.67,1.0,3.03,3.03,2
Pacific,3,1,0,2,3,5,-2,3,Canada - Premier League,0.33,0.33,-2,1.0,1.0,3.03,3.03,2
Cavalry,2,0,1,1,1,2,-1,1,Canada - Premier League,0.0,0.5,-1,0.5,0.5,0.0,2.0,3
Valour,2,0,1,1,1,3,-2,1,Canada - Premier League,0.0,0.5,-2,0.5,0.5,0.0,2.0,3
Vancouver FC,3,0,1,2,2,7,-5,1,Canada - Premier League,0.0,0.33,-5,0.67,0.33,0.0,3.03,3
Audax Italiano,8,5,1,2,15,9,6,16,Chile - Primera Division,0.62,0.75,6,1.88,2.0,1.61,1.33,1
Palestino,8,5,1,2,12,6,6,16,Chile - Primera Division,0.62,0.75,6,1.5,2.0,1.61,1.33,1
Coquimbo Unido,8,4,4,0,9,3,6,16,Chile - Primera Division,0.5,1.0,6,1.12,2.0,2.0,1.0,1
Huachipato,8,4,2,2,12,6,6,14,Chile - Primera Division,0.5,0.75,6,1.5,1.75,2.0,1.33,2
U. Catolica,7,4,2,1,10,6,4,14,Chile - Primera Division,0.57,0.86,4,1.43,2.0,1.75,1.16,2
OHiggins,8,3,4,1,8,5,3,13,Chile - Primera Division,0.38,0.88,3,1.0,1.62,2.63,1.14,3
Cobresal,8,3,3,2,10,8,2,12,Chile - Primera Division,0.38,0.75,2,1.25,1.5,2.63,1.33,4
Union La Calera,8,3,2,3,10,7,3,11,Chile - Primera Division,0.38,0.62,3,1.25,1.38,2.63,1.61,5
U. de Chile,6,3,1,2,11,6,5,10,Chile - Primera Division,0.5,0.67,5,1.83,1.67,2.0,1.49,6
La Serena,8,3,1,4,9,14,-5,10,Chile - Primera Division,0.38,0.5,-5,1.12,1.25,2.63,2.0,6
Colo-Colo,5,2,1,2,7,5,2,7,Chile - Primera Division,0.4,0.6,2,1.4,1.4,2.5,1.67,7
Nublense,8,1,4,3,5,14,-9,7,Chile - Primera Division,0.12,0.62,-9,0.62,0.88,8.33,1.61,7
Union Espanola,7,2,0,5,8,12,-4,6,Chile - Primera Division,0.29,0.29,-4,1.14,0.86,3.45,3.45,8
Everton,8,1,3,4,6,12,-6,6,Chile - Primera Division,0.12,0.5,-6,0.75,0.75,8.33,2.0,8
D. Limache,8,1,2,5,10,15,-5,5,Chile - Primera Division,0.12,0.38,-5,1.25,0.62,8.33,2.63,9
D. Iquique,7,0,1,6,4,18,-14,1,Chile - Primera Division,0.0,0.14,-14,0.57,0.14,0.0,7.14,10
S. Wanderers,7,4,2,1,10,6,4,14,Chile - Primera B,0.57,0.86,4,1.43,2.0,1.75,1.16,1
San Marcos,7,4,1,2,9,6,3,13,Chile - Primera B,0.57,0.71,3,1.29,1.86,1.75,1.41,2
Copiapo,7,3,3,1,11,6,5,12,Chile - Primera B,0.43,0.86,5,1.57,1.71,2.33,1.16,3
San Luis,7,3,3,1,8,6,2,12,Chile - Primera B,0.43,0.86,2,1.14,1.71,2.33,1.16,3
Recoleta,7,3,2,2,7,8,-1,11,Chile - Primera B,0.43,0.71,-1,1.0,1.57,2.33,1.41,4
Cobreloa,7,2,4,1,10,8,2,10,Chile - Primera B,0.29,0.86,2,1.43,1.43,3.45,1.16,5
U. Concepcion,7,3,1,3,7,6,1,10,Chile - Primera B,0.43,0.57,1,1.0,1.43,2.33,1.75,5
Concepcion,7,3,1,3,10,11,-1,10,Chile - Primera B,0.43,0.57,-1,1.43,1.43,2.33,1.75,5
Curico Unido,7,2,3,2,9,9,0,9,Chile - Primera B,0.29,0.71,0,1.29,1.29,3.45,1.41,6
Rangers,7,2,3,2,8,8,0,9,Chile - Primera B,0.29,0.71,0,1.14,1.29,3.45,1.41,6
Antofagasta,7,2,3,2,9,12,-3,9,Chile - Primera B,0.29,0.71,-3,1.29,1.29,3.45,1.41,6
Magallanes,7,2,2,3,7,7,0,8,Chile - Primera B,0.29,0.57,0,1.0,1.14,3.45,1.75,7
S. Morning,7,2,2,3,6,6,0,8,Chile - Primera B,0.29,0.57,0,0.86,1.14,3.45,1.75,7
CD Santa Cruz,7,2,1,4,8,12,-4,7,Chile - Primera B,0.29,0.43,-4,1.14,1.0,3.45,2.33,8
Deportes Temuco,7,1,2,4,7,11,-4,5,Chile - Primera B,0.14,0.43,-4,1.0,0.71,7.14,2.33,9
U. San Felipe,7,0,3,4,5,9,-4,3,Chile - Primera B,0.0,0.43,-4,0.71,0.43,0.0,2.33,10
S. Shenhua,8,6,2,0,19,10,9,20,China - Super League,0.75,1.0,9,2.38,2.5,1.33,1.0,1
Chengdu,8,5,2,1,13,5,8,17,China - Super League,0.62,0.88,8,1.62,2.12,1.61,1.14,2
Shandong T.,8,5,1,2,20,15,5,16,China - Super League,0.62,0.75,5,2.5,2.0,1.61,1.33,3
Shanghai Port,7,4,2,1,16,10,6,14,China - Super League,0.57,0.86,6,2.29,2.0,1.75,1.16,4
Beijing Guoan,7,3,4,0,19,10,9,13,China - Super League,0.43,1.0,9,2.71,1.86,2.33,1.0,5
Tianjin T.,8,3,4,1,13,12,1,13,China - Super League,0.38,0.88,1,1.62,1.62,2.63,1.14,5
Qingdao West C.,7,3,3,1,15,14,1,12,China - Super League,0.43,0.86,1,2.14,1.71,2.33,1.16,6
Meizhou Hakka,8,3,2,3,17,15,2,11,China - Super League,0.38,0.62,2,2.12,1.38,2.63,1.61,7
Zhejiang,8,2,3,3,13,11,2,9,China - Super League,0.25,0.62,2,1.62,1.12,4.0,1.61,8
Yunnan Yukun,8,2,3,3,9,13,-4,9,China - Super League,0.25,0.62,-4,1.12,1.12,4.0,1.61,8
Dalian Yingbo,8,2,3,3,7,11,-4,9,China - Super League,0.25,0.62,-4,0.88,1.12,4.0,1.61,8
Henan SL,7,2,1,4,10,11,-1,7,China - Super League,0.29,0.43,-1,1.43,1.0,3.45,2.33,9
Sichuan Jiuniu,8,2,0,6,9,21,-12,6,China - Super League,0.25,0.25,-12,1.12,0.75,4.0,4.0,10
Changchun Yatai,8,1,2,5,7,13,-6,5,China - Super League,0.12,0.38,-6,0.88,0.62,8.33,2.63,11
Wuhan Three T.,8,1,2,5,9,18,-9,5,China - Super League,0.12,0.38,-9,1.12,0.62,8.33,2.63,11
Qingdao Hainiu,8,0,2,6,6,13,-7,2,China - Super League,0.0,0.25,-7,0.75,0.25,0.0,4.0,12
S. Gongfu,4,3,1,0,8,2,6,10,China - League One,0.75,1.0,6,2.0,2.5,1.33,1.0,1
Chongqing T.,4,3,1,0,8,3,5,10,China - League One,0.75,1.0,5,2.0,2.5,1.33,1.0,1
Liaoning Tieren,4,3,0,1,8,3,5,9,China - League One,0.75,0.75,5,2.0,2.25,1.33,1.33,2
Guangdong GZP,4,2,1,1,7,3,4,7,China - League One,0.5,0.75,4,1.75,1.75,2.0,1.33,3
Nantong Zhiyun,4,2,1,1,3,2,1,7,China - League One,0.5,0.75,1,0.75,1.75,2.0,1.33,3
Suzhou Dongwu,4,1,3,0,2,0,2,6,China - League One,0.25,1.0,2,0.5,1.5,4.0,1.0,4
Nanjing City,5,1,3,1,4,4,0,6,China - League One,0.2,0.8,0,0.8,1.2,5.0,1.25,4
Shenzhen J.,4,2,0,2,5,6,-1,6,China - League One,0.5,0.5,-1,1.25,1.5,2.0,2.0,4
Shaanxi Union,5,1,2,2,6,6,0,5,China - League One,0.2,0.6,0,1.2,1.0,5.0,1.67,5
Heilongjiang IC,4,1,2,1,5,6,-1,5,China - League One,0.25,0.75,-1,1.25,1.25,4.0,1.33,5
Dalian Kuncheng,5,1,2,2,4,6,-2,5,China - League One,0.2,0.6,-2,0.8,1.0,5.0,1.67,5
Shanghai Jiadin,4,1,1,2,3,5,-2,4,China - League One,0.25,0.5,-2,0.75,1.0,4.0,2.0,6
Yanbian Longdin,5,1,1,3,5,11,-6,4,China - League One,0.2,0.4,-6,1.0,0.8,5.0,2.5,6
Qingdao RL,4,0,3,1,2,3,-1,3,China - League One,0.0,0.75,-1,0.5,0.75,0.0,1.33,7
Foshan Nanshi,4,1,0,3,3,7,-4,3,China - League One,0.25,0.25,-4,0.75,0.75,4.0,4.0,7
Guangxi Baoyun,4,0,1,3,0,6,-6,1,China - League One,0.0,0.25,-6,0.0,0.25,0.0,4.0,8
Guangzhou Dande,5,4,0,1,10,3,7,12,China - League Two,0.8,0.8,7,2.0,2.4,1.25,1.25,1
Wenzhou Pro.,5,3,2,0,7,2,5,11,China - League Two,0.6,1.0,5,1.4,2.2,1.67,1.0,2
Changchun Xidu,5,3,1,1,6,3,3,10,China - League Two,0.6,0.8,3,1.2,2.0,1.67,1.25,3
Guizhou Zhuchen,5,3,1,1,6,4,2,10,China - League Two,0.6,0.8,2,1.2,2.0,1.67,1.25,3
Wuxi Wugou,5,2,3,0,7,2,5,9,China - League Two,0.4,1.0,5,1.4,1.8,2.5,1.0,4
Haikou M.,5,2,3,0,6,3,3,9,China - League Two,0.4,1.0,3,1.2,1.8,2.5,1.0,4
Shandong T. B,5,2,3,0,6,3,3,9,China - League Two,0.4,1.0,3,1.2,1.8,2.5,1.0,4
Langfang Glory,5,2,3,0,6,4,2,9,China - League Two,0.4,1.0,2,1.2,1.8,2.5,1.0,4
Jiangxi Lushan,5,2,3,0,5,3,2,9,China - League Two,0.4,1.0,2,1.0,1.8,2.5,1.0,4
Chengdu Rongche,5,2,2,1,6,4,2,8,China - League Two,0.4,0.8,2,1.2,1.6,2.5,1.25,5
Guangxi H.,5,2,2,1,4,3,1,8,China - League Two,0.4,0.8,1,0.8,1.6,2.5,1.25,5
Ganzhou Ruishi,5,1,4,0,4,3,1,7,China - League Two,0.2,1.0,1,0.8,1.4,5.0,1.0,6
Shanghai Port B,5,2,0,3,8,6,2,6,China - League Two,0.4,0.4,2,1.6,1.2,2.5,2.5,7
Rizhao Yuqi,5,1,3,1,3,3,0,6,China - League Two,0.2,0.8,0,0.6,1.2,5.0,1.25,7
Nantong Haimen,5,1,3,1,4,7,-3,6,China - League Two,0.2,0.8,-3,0.8,1.2,5.0,1.25,7
Shenzhen 2028,5,1,2,2,2,4,-2,5,China - League Two,0.2,0.6,-2,0.4,1.0,5.0,1.67,8
Beijing IT,5,1,1,3,4,5,-1,4,China - League Two,0.2,0.4,-1,0.8,0.8,5.0,2.5,9
Xian Ronghai,5,0,4,1,1,6,-5,4,China - League Two,0.0,0.8,-5,0.2,0.8,0.0,1.25,9
Wuhan Three Tow,5,0,3,2,2,4,-2,3,China - League Two,0.0,0.6,-2,0.4,0.6,0.0,1.67,10
Quanzhou Yassin,5,0,3,2,1,4,-3,3,China - League Two,0.0,0.6,-3,0.2,0.6,0.0,1.67,10
Hubei Istar,5,0,3,2,1,5,-4,3,China - League Two,0.0,0.6,-4,0.2,0.6,0.0,1.67,10
Taian Tiankuang,5,0,1,4,2,6,-4,1,China - League Two,0.0,0.2,-4,0.4,0.2,0.0,5.0,11
Guangdong Mingt,5,0,1,4,2,9,-7,1,China - League Two,0.0,0.2,-7,0.4,0.2,0.0,5.0,11
Guangxi Lanhang,5,0,1,4,1,8,-7,1,China - League Two,0.0,0.2,-7,0.2,0.2,0.0,5.0,11
Junior,8,6,2,0,12,5,7,20,Colombia - Primera A - Apertura,0.75,1.0,7,1.5,2.5,1.33,1.0,1
A. Bucaramanga,8,4,2,2,12,6,6,14,Colombia - Primera A - Apertura,0.5,0.75,6,1.5,1.75,2.0,1.33,2
Millonarios,8,4,2,2,10,5,5,14,Colombia - Primera A - Apertura,0.5,0.75,5,1.25,1.75,2.0,1.33,2
Deportes Tolima,8,4,2,2,14,10,4,14,Colombia - Primera A - Apertura,0.5,0.75,4,1.75,1.75,2.0,1.33,2
I. Medelin,8,3,4,1,6,3,3,13,Colombia - Primera A - Apertura,0.38,0.88,3,0.75,1.62,2.63,1.14,3
Deportivo Pasto,8,3,4,1,9,7,2,13,Colombia - Primera A - Apertura,0.38,0.88,2,1.12,1.62,2.63,1.14,3
A. Nacional,8,3,3,2,10,8,2,12,Colombia - Primera A - Apertura,0.38,0.75,2,1.25,1.5,2.63,1.33,4
D. Pereira,8,3,3,2,10,8,2,12,Colombia - Primera A - Apertura,0.38,0.75,2,1.25,1.5,2.63,1.33,4
America de Cali,8,3,3,2,9,7,2,12,Colombia - Primera A - Apertura,0.38,0.75,2,1.12,1.5,2.63,1.33,4
Once Caldas,8,3,2,3,8,6,2,11,Colombia - Primera A - Apertura,0.38,0.62,2,1.0,1.38,2.63,1.61,5
Deportivo Cali,8,2,5,1,6,5,1,11,Colombia - Primera A - Apertura,0.25,0.88,1,0.75,1.38,4.0,1.14,5
Santa Fe,8,3,2,3,9,10,-1,11,Colombia - Primera A - Apertura,0.38,0.62,-1,1.12,1.38,2.63,1.61,5
Fortaleza CEIF,8,2,3,3,5,9,-4,9,Colombia - Primera A - Apertura,0.25,0.62,-4,0.62,1.12,4.0,1.61,6
La Equidad,8,2,2,4,7,11,-4,8,Colombia - Primera A - Apertura,0.25,0.5,-4,0.88,1.0,4.0,2.0,7
Envigado,8,2,2,4,7,14,-7,8,Colombia - Primera A - Apertura,0.25,0.5,-7,0.88,1.0,4.0,2.0,7
A. Petrolera,8,2,1,5,4,11,-7,7,Colombia - Primera A - Apertura,0.25,0.38,-7,0.5,0.88,4.0,2.63,8
R. Aguilas,8,1,3,4,3,6,-3,6,Colombia - Primera A - Apertura,0.12,0.5,-3,0.38,0.75,8.33,2.0,9
Llaneros,8,2,0,6,4,8,-4,6,Colombia - Primera A - Apertura,0.25,0.25,-4,0.5,0.75,4.0,4.0,9
Union Magdalena,8,0,4,4,6,10,-4,4,Colombia - Primera A - Apertura,0.0,0.5,-4,0.75,0.5,0.0,2.0,10
Boyaca Chico,8,0,4,4,4,15,-11,4,Colombia - Primera A - Apertura,0.0,0.5,-11,0.5,0.5,0.0,2.0,10
I. Medelin,8,5,2,1,15,6,9,17,Colombia - Primera A - Clausura,0.62,0.88,9,1.88,2.12,1.61,1.14,1
Millonarios,8,5,2,1,11,4,7,17,Colombia - Primera A - Clausura,0.62,0.88,7,1.38,2.12,1.61,1.14,1
Junior,8,4,3,1,11,4,7,15,Colombia - Primera A - Clausura,0.5,0.88,7,1.38,1.88,2.0,1.14,2
Santa Fe,8,4,3,1,12,6,6,15,Colombia - Primera A - Clausura,0.5,0.88,6,1.5,1.88,2.0,1.14,2
D. Pereira,8,4,3,1,12,9,3,15,Colombia - Primera A - Clausura,0.5,0.88,3,1.5,1.88,2.0,1.14,2
Deportes Tolima,8,4,2,2,9,4,5,14,Colombia - Primera A - Clausura,0.5,0.75,5,1.12,1.75,2.0,1.33,3
Deportivo Pasto,8,4,1,3,14,11,3,13,Colombia - Primera A - Clausura,0.5,0.62,3,1.75,1.62,2.0,1.61,4
A. Nacional,8,3,4,1,9,7,2,13,Colombia - Primera A - Clausura,0.38,0.88,2,1.12,1.62,2.63,1.14,4
A. Bucaramanga,8,3,3,2,12,7,5,12,Colombia - Primera A - Clausura,0.38,0.75,5,1.5,1.5,2.63,1.33,5
America de Cali,8,3,2,3,10,10,0,11,Colombia - Primera A - Clausura,0.38,0.62,0,1.25,1.38,2.63,1.61,6
Fortaleza CEIF,8,3,1,4,9,8,1,10,Colombia - Primera A - Clausura,0.38,0.5,1,1.12,1.25,2.63,2.0,7
La Equidad,8,2,3,3,12,13,-1,9,Colombia - Primera A - Clausura,0.25,0.62,-1,1.5,1.12,4.0,1.61,8
Patriotas,8,2,2,4,12,14,-2,8,Colombia - Primera A - Clausura,0.25,0.5,-2,1.5,1.0,4.0,2.0,9
Deportivo Cali,8,2,2,4,5,9,-4,8,Colombia - Primera A - Clausura,0.25,0.5,-4,0.62,1.0,4.0,2.0,9
A. Petrolera,8,2,2,4,7,12,-5,8,Colombia - Primera A - Clausura,0.25,0.5,-5,0.88,1.0,4.0,2.0,9
Jaguares de C.,8,2,2,4,7,14,-7,8,Colombia - Primera A - Clausura,0.25,0.5,-7,0.88,1.0,4.0,2.0,9
Envigado,8,2,1,5,5,9,-4,7,Colombia - Primera A - Clausura,0.25,0.38,-4,0.62,0.88,4.0,2.63,10
Boyaca Chico,8,2,1,5,5,15,-10,7,Colombia - Primera A - Clausura,0.25,0.38,-10,0.62,0.88,4.0,2.63,10
Once Caldas,8,1,2,5,4,12,-8,5,Colombia - Primera A - Clausura,0.12,0.38,-8,0.5,0.62,8.33,2.63,11
R. Aguilas,8,1,1,6,4,15,-11,4,Colombia - Primera A - Clausura,0.12,0.25,-11,0.5,0.5,8.33,4.0,12
Saprissa,8,5,2,1,13,7,6,17,Costa Rica - Primera Div. - Apertura,0.62,0.88,6,1.62,2.12,1.61,1.14,1
Alajuelense,8,5,1,2,13,6,7,16,Costa Rica - Primera Div. - Apertura,0.62,0.75,7,1.62,2.0,1.61,1.33,2
Santos Guapiles,8,5,1,2,14,8,6,16,Costa Rica - Primera Div. - Apertura,0.62,0.75,6,1.75,2.0,1.61,1.33,2
Guanacasteca,8,4,1,3,11,11,0,13,Costa Rica - Primera Div. - Apertura,0.5,0.62,0,1.38,1.62,2.0,1.61,3
Herediano,8,3,3,2,11,9,2,12,Costa Rica - Primera Div. - Apertura,0.38,0.75,2,1.38,1.5,2.63,1.33,4
San Carlos,8,2,5,1,11,11,0,11,Costa Rica - Primera Div. - Apertura,0.25,0.88,0,1.38,1.38,4.0,1.14,5
Cartagines,8,3,1,4,15,18,-3,10,Costa Rica - Primera Div. - Apertura,0.38,0.5,-3,1.88,1.25,2.63,2.0,6
Zeledon,8,3,1,4,9,12,-3,10,Costa Rica - Primera Div. - Apertura,0.38,0.5,-3,1.12,1.25,2.63,2.0,6
M. Liberia,8,2,2,4,9,11,-2,8,Costa Rica - Primera Div. - Apertura,0.25,0.5,-2,1.12,1.0,4.0,2.0,7
Sporting SJ,8,2,1,5,10,11,-1,7,Costa Rica - Primera Div. - Apertura,0.25,0.38,-1,1.25,0.88,4.0,2.63,8
Santa Ana,8,2,1,5,7,11,-4,7,Costa Rica - Primera Div. - Apertura,0.25,0.38,-4,0.88,0.88,4.0,2.63,8
Puntarenas,8,2,1,5,8,16,-8,7,Costa Rica - Primera Div. - Apertura,0.25,0.38,-8,1.0,0.88,4.0,2.63,8
Banik Ostrava,8,7,1,0,18,5,13,22,CzechRepublic - 1. Liga,0.88,1.0,13,2.25,2.75,1.14,1.0,1
Slavia Prague,8,6,1,1,16,4,12,19,CzechRepublic - 1. Liga,0.75,0.88,12,2.0,2.38,1.33,1.14,2
Karvina,8,5,2,1,14,11,3,17,CzechRepublic - 1. Liga,0.62,0.88,3,1.75,2.12,1.61,1.14,3
Viktoria Plzen,8,5,1,2,15,9,6,16,CzechRepublic - 1. Liga,0.62,0.75,6,1.88,2.0,1.61,1.33,4
Sparta Prague,8,5,1,2,13,9,4,16,CzechRepublic - 1. Liga,0.62,0.75,4,1.62,2.0,1.61,1.33,4
Slovan Liberec,8,4,3,1,12,4,8,15,CzechRepublic - 1. Liga,0.5,0.88,8,1.5,1.88,2.0,1.14,5
Jablonec,8,4,3,1,9,4,5,15,CzechRepublic - 1. Liga,0.5,0.88,5,1.12,1.88,2.0,1.14,5
Teplice,8,3,3,2,7,6,1,12,CzechRepublic - 1. Liga,0.38,0.75,1,0.88,1.5,2.63,1.33,6
Sigma Olomouc,8,3,2,3,12,9,3,11,CzechRepublic - 1. Liga,0.38,0.62,3,1.5,1.38,2.63,1.61,7
Hradec Kralove,8,3,2,3,11,9,2,11,CzechRepublic - 1. Liga,0.38,0.62,2,1.38,1.38,2.63,1.61,7
Dukla Praha,8,2,4,2,7,8,-1,10,CzechRepublic - 1. Liga,0.25,0.75,-1,0.88,1.25,4.0,1.33,8
Bohemians,8,1,2,5,4,10,-6,5,CzechRepublic - 1. Liga,0.12,0.38,-6,0.5,0.62,8.33,2.63,9
Pardubice,8,1,1,6,5,14,-9,4,CzechRepublic - 1. Liga,0.12,0.25,-9,0.62,0.5,8.33,4.0,10
Slovacko,8,1,1,6,5,19,-14,4,CzechRepublic - 1. Liga,0.12,0.25,-14,0.62,0.5,8.33,4.0,10
Mlada Boleslav,8,1,0,7,6,13,-7,3,CzechRepublic - 1. Liga,0.12,0.12,-7,0.75,0.38,8.33,8.33,11
C. Budejovice,8,0,1,7,5,18,-13,1,CzechRepublic - 1. Liga,0.0,0.12,-13,0.62,0.12,0.0,8.33,12
Viborg,8,5,3,0,19,10,9,18,Denmark - Superligaen,0.62,1.0,9,2.38,2.25,1.61,1.0,1
Brondby IF,8,4,3,1,15,12,3,15,Denmark - Superligaen,0.5,0.88,3,1.88,1.88,2.0,1.14,2
Silkeborg,8,4,1,3,17,9,8,13,Denmark - Superligaen,0.5,0.62,8,2.12,1.62,2.0,1.61,3
FC Midtjylland,8,4,1,3,16,12,4,13,Denmark - Superligaen,0.5,0.62,4,2.0,1.62,2.0,1.61,3
SonderjyskE,8,4,1,3,11,12,-1,13,Denmark - Superligaen,0.5,0.62,-1,1.38,1.62,2.0,1.61,3
FC Kobenhavn,8,3,2,3,11,11,0,11,Denmark - Superligaen,0.38,0.62,0,1.38,1.38,2.63,1.61,4
Nordsjaelland,8,3,1,4,11,10,1,10,Denmark - Superligaen,0.38,0.5,1,1.38,1.25,2.63,2.0,5
Randers FC,8,3,1,4,17,19,-2,10,Denmark - Superligaen,0.38,0.5,-2,2.12,1.25,2.63,2.0,5
Lyngby,8,2,3,3,8,10,-2,9,Denmark - Superligaen,0.25,0.62,-2,1.0,1.12,4.0,1.61,6
Vejle BK,8,2,2,4,11,18,-7,8,Denmark - Superligaen,0.25,0.5,-7,1.38,1.0,4.0,2.0,7
AGF Aarhus,8,1,3,4,10,14,-4,6,Denmark - Superligaen,0.12,0.5,-4,1.25,0.75,8.33,2.0,8
Aalborg BK,8,1,3,4,9,18,-9,6,Denmark - Superligaen,0.12,0.5,-9,1.12,0.75,8.33,2.0,8
Hillerod,8,5,2,1,14,5,9,17,Denmark - 1st Division,0.62,0.88,9,1.75,2.12,1.61,1.14,1
AC Horsens,8,5,0,3,14,15,-1,15,Denmark - 1st Division,0.62,0.62,-1,1.75,1.88,1.61,1.61,2
Hvidovre,8,4,2,2,7,6,1,14,Denmark - 1st Division,0.5,0.75,1,0.88,1.75,2.0,1.33,3
Kolding IF,8,4,1,3,13,10,3,13,Denmark - 1st Division,0.5,0.62,3,1.62,1.62,2.0,1.61,4
Fredericia,8,4,1,3,9,6,3,13,Denmark - 1st Division,0.5,0.62,3,1.12,1.62,2.0,1.61,4
Odense BK,8,3,3,2,14,8,6,12,Denmark - 1st Division,0.38,0.75,6,1.75,1.5,2.63,1.33,5
B 93,8,2,4,2,9,12,-3,10,Denmark - 1st Division,0.25,0.75,-3,1.12,1.25,4.0,1.33,6
Hobro,8,2,3,3,8,9,-1,9,Denmark - 1st Division,0.25,0.62,-1,1.0,1.12,4.0,1.61,7
HB Koge,8,1,4,3,6,11,-5,7,Denmark - 1st Division,0.12,0.62,-5,0.75,0.88,8.33,1.61,8
Roskilde,8,1,3,4,11,15,-4,6,Denmark - 1st Division,0.12,0.5,-4,1.38,0.75,8.33,2.0,9
Vendsyssel,8,1,3,4,8,12,-4,6,Denmark - 1st Division,0.12,0.5,-4,1.0,0.75,8.33,2.0,9
Esbjerg,8,2,0,6,9,15,-6,6,Denmark - 1st Division,0.25,0.25,-6,1.12,0.75,4.0,4.0,9
AB Copenhagen,8,5,1,2,20,11,9,16,Denmark - 2nd Division,0.62,0.75,9,2.5,2.0,1.61,1.33,1
Aarhus Fremad,8,5,1,2,12,3,9,16,Denmark - 2nd Division,0.62,0.75,9,1.5,2.0,1.61,1.33,1
Middelfart,8,5,1,2,12,9,3,16,Denmark - 2nd Division,0.62,0.75,3,1.5,2.0,1.61,1.33,1
Skive,8,4,2,2,9,6,3,14,Denmark - 2nd Division,0.5,0.75,3,1.12,1.75,2.0,1.33,2
Naestved,8,4,1,3,10,9,1,13,Denmark - 2nd Division,0.5,0.62,1,1.25,1.62,2.0,1.61,3
BK Frem,8,3,2,3,9,7,2,11,Denmark - 2nd Division,0.38,0.62,2,1.12,1.38,2.63,1.61,4
Ishoj,8,3,2,3,8,9,-1,11,Denmark - 2nd Division,0.38,0.62,-1,1.0,1.38,2.63,1.61,4
Fremad Amager,8,3,1,4,10,11,-1,10,Denmark - 2nd Division,0.38,0.5,-1,1.25,1.25,2.63,2.0,5
Hellerup IK,8,3,0,5,6,16,-10,9,Denmark - 2nd Division,0.38,0.38,-10,0.75,1.12,2.63,2.63,6
Helsingor,8,1,5,2,9,11,-2,8,Denmark - 2nd Division,0.12,0.75,-2,1.12,1.0,8.33,1.33,7
Nykobing,8,1,2,5,8,13,-5,5,Denmark - 2nd Division,0.12,0.38,-5,1.0,0.62,8.33,2.63,8
Thisted,8,1,2,5,8,16,-8,5,Denmark - 2nd Division,0.12,0.38,-8,1.0,0.62,8.33,2.63,8
I. del Valle,8,5,3,0,18,5,13,18,Ecuador - Liga Pro 1st Stage,0.62,1.0,13,2.25,2.25,1.61,1.0,1
Barcelona SC,8,6,0,2,13,10,3,18,Ecuador - Liga Pro 1st Stage,0.75,0.75,3,1.62,2.25,1.33,1.33,1
Cuniburo,8,5,2,1,18,9,9,17,Ecuador - Liga Pro 1st Stage,0.62,0.88,9,2.25,2.12,1.61,1.14,2
LDU Quito,8,4,2,2,13,5,8,14,Ecuador - Liga Pro 1st Stage,0.5,0.75,8,1.62,1.75,2.0,1.33,3
Orense,8,4,1,3,9,13,-4,13,Ecuador - Liga Pro 1st Stage,0.5,0.62,-4,1.12,1.62,2.0,1.61,4
U. Catolica,8,3,3,2,12,8,4,12,Ecuador - Liga Pro 1st Stage,0.38,0.75,4,1.5,1.5,2.63,1.33,5
Libertad,8,3,3,2,13,13,0,12,Ecuador - Liga Pro 1st Stage,0.38,0.75,0,1.62,1.5,2.63,1.33,5
Emelec,8,2,4,2,6,7,-1,10,Ecuador - Liga Pro 1st Stage,0.25,0.75,-1,0.75,1.25,4.0,1.33,6
Mushuc Runa,8,2,3,3,9,9,0,9,Ecuador - Liga Pro 1st Stage,0.25,0.62,0,1.12,1.12,4.0,1.61,7
Aucas,8,2,3,3,9,12,-3,9,Ecuador - Liga Pro 1st Stage,0.25,0.62,-3,1.12,1.12,4.0,1.61,7
Manta,8,2,3,3,11,15,-4,9,Ecuador - Liga Pro 1st Stage,0.25,0.62,-4,1.38,1.12,4.0,1.61,7
Macara,8,1,4,3,4,6,-2,7,Ecuador - Liga Pro 1st Stage,0.12,0.62,-2,0.5,0.88,8.33,1.61,8
D. Cuenca,8,2,1,5,5,11,-6,7,Ecuador - Liga Pro 1st Stage,0.25,0.38,-6,0.62,0.88,4.0,2.63,8
Delfin,8,1,4,3,5,13,-8,7,Ecuador - Liga Pro 1st Stage,0.12,0.62,-8,0.62,0.88,8.33,1.61,8
Tecnico U.,8,1,3,4,7,11,-4,6,Ecuador - Liga Pro 1st Stage,0.12,0.5,-4,0.88,0.75,8.33,2.0,9
El Nacional,8,1,2,5,8,12,-4,5,Ecuador - Liga Pro 1st Stage,0.12,0.38,-4,1.0,0.62,8.33,2.63,10
Cumbaya,5,3,2,0,10,3,7,11,Ecuador - Serie B,0.6,1.0,7,2.0,2.2,1.67,1.0,1
Gualaceo,5,2,3,0,8,6,2,9,Ecuador - Serie B,0.4,1.0,2,1.6,1.8,2.5,1.0,2
Nueve Octubre,5,2,2,1,4,3,1,8,Ecuador - Serie B,0.4,0.8,1,0.8,1.6,2.5,1.25,3
Guayaquil City,5,2,1,2,8,6,2,7,Ecuador - Serie B,0.4,0.6,2,1.6,1.4,2.5,1.67,4
Leones Norte,5,1,4,0,7,5,2,7,Ecuador - Serie B,0.2,1.0,2,1.4,1.4,5.0,1.0,4
San Antonio,5,2,1,2,4,5,-1,7,Ecuador - Serie B,0.4,0.6,-1,0.8,1.4,2.5,1.67,4
Vargas Torres,5,1,3,1,4,4,0,6,Ecuador - Serie B,0.2,0.8,0,0.8,1.2,5.0,1.25,5
Vinotinto,5,2,0,3,7,8,-1,6,Ecuador - Serie B,0.4,0.4,-1,1.4,1.2,2.5,2.5,5
22 de Julio,5,1,3,1,3,6,-3,6,Ecuador - Serie B,0.2,0.8,-3,0.6,1.2,5.0,1.25,5
I. Juniors,5,1,1,3,6,9,-3,4,Ecuador - Serie B,0.2,0.4,-3,1.2,0.8,5.0,2.5,6
Imbabura,5,0,3,2,5,8,-3,3,Ecuador - Serie B,0.0,0.6,-3,1.0,0.6,0.0,1.67,7
Chacaritas,5,0,3,2,4,7,-3,3,Ecuador - Serie B,0.0,0.6,-3,0.8,0.6,0.0,1.67,7
Pyramids FC,8,6,2,0,13,4,9,20,Egypt - Premier League,0.75,1.0,9,1.62,2.5,1.33,1.0,1
Zamalek,8,5,3,0,14,3,11,18,Egypt - Premier League,0.62,1.0,11,1.75,2.25,1.61,1.0,2
El Gouna,8,5,2,1,11,4,7,17,Egypt - Premier League,0.62,0.88,7,1.38,2.12,1.61,1.14,3
Al Ahly,8,5,2,1,12,6,6,17,Egypt - Premier League,0.62,0.88,6,1.5,2.12,1.61,1.14,3
Al Masry,8,4,3,1,13,4,9,15,Egypt - Premier League,0.5,0.88,9,1.62,1.88,2.0,1.14,4
National Bank,8,4,3,1,14,9,5,15,Egypt - Premier League,0.5,0.88,5,1.75,1.88,2.0,1.14,4
Ghazl El M.,8,4,0,4,8,9,-1,12,Egypt - Premier League,0.5,0.5,-1,1.0,1.5,2.0,2.0,5
Pharco,8,3,2,3,6,7,-1,11,Egypt - Premier League,0.38,0.62,-1,0.75,1.38,2.63,1.61,6
ZED FC,8,2,4,2,11,8,3,10,Egypt - Premier League,0.25,0.75,3,1.38,1.25,4.0,1.33,7
El Geish,8,2,3,3,6,8,-2,9,Egypt - Premier League,0.25,0.62,-2,0.75,1.12,4.0,1.61,8
Ceramica C.,8,2,2,4,11,11,0,8,Egypt - Premier League,0.25,0.5,0,1.38,1.0,4.0,2.0,9
ENPPI,8,2,2,4,6,12,-6,8,Egypt - Premier League,0.25,0.5,-6,0.75,1.0,4.0,2.0,9
Petrojet,8,2,2,4,9,16,-7,8,Egypt - Premier League,0.25,0.5,-7,1.12,1.0,4.0,2.0,9
Haras El Hodood,8,2,1,5,7,12,-5,7,Egypt - Premier League,0.25,0.38,-5,0.88,0.88,4.0,2.63,10
Ismaily,8,1,3,4,3,12,-9,6,Egypt - Premier League,0.12,0.5,-9,0.38,0.75,8.33,2.0,11
Smouha,8,2,0,6,3,12,-9,6,Egypt - Premier League,0.25,0.25,-9,0.38,0.75,4.0,4.0,11
Modern Sport,8,1,2,5,8,12,-4,5,Egypt - Premier League,0.12,0.38,-4,1.0,0.62,8.33,2.63,12
Al Ittihad,8,1,2,5,6,12,-6,5,Egypt - Premier League,0.12,0.38,-6,0.75,0.62,8.33,2.63,12
Aston Villa,8,6,1,1,18,9,9,19,Premier League,0.75,0.88,9,2.25,2.38,1.33,1.14,2
Liverpool,8,6,1,1,15,7,8,19,Premier League,0.75,0.88,8,1.88,2.38,1.33,1.14,2
Wolverhampton,8,6,1,1,13,7,6,19,Premier League,0.75,0.88,6,1.62,2.38,1.33,1.14,2
Newcastle Utd,8,6,0,2,20,11,9,18,Premier League,0.75,0.75,9,2.5,2.25,1.33,1.33,3
Manchester City,8,4,2,2,12,7,5,14,Premier League,0.5,0.75,5,1.5,1.75,2.0,1.33,6
Chelsea,8,4,2,2,11,6,5,14,Premier League,0.5,0.75,5,1.38,1.75,2.0,1.33,6
Crystal Palace,8,4,2,2,12,13,-1,14,Premier League,0.5,0.75,-1,1.5,1.75,2.0,1.33,6
Arsenal,8,3,4,1,10,5,5,13,Premier League,0.38,0.88,5,1.25,1.62,2.63,1.14,7
Nottm Forest,8,4,1,3,12,10,2,13,Premier League,0.5,0.62,2,1.5,1.62,2.0,1.61,7
Brentford,8,3,3,2,13,8,5,12,Premier League,0.38,0.75,5,1.62,1.5,2.63,1.33,8
Brighton,8,3,2,3,15,15,0,11,Premier League,0.38,0.62,0,1.88,1.38,2.63,1.61,9
West Ham Utd,8,2,3,3,8,8,0,9,Premier League,0.25,0.62,0,1.0,1.12,4.0,1.61,11
Manchester Utd,8,2,3,3,10,11,-1,9,Premier League,0.25,0.62,-1,1.25,1.12,4.0,1.61,11
Fulham,8,3,0,5,10,12,-2,9,Premier League,0.38,0.38,-2,1.25,1.12,2.63,2.63,11
Everton,8,1,5,2,7,9,-2,8,Premier League,0.12,0.75,-2,0.88,1.0,8.33,1.33,12
Tottenham,8,2,1,5,12,14,-2,7,Premier League,0.25,0.38,-2,1.5,0.88,4.0,2.63,13
Bournemouth,8,1,3,4,8,11,-3,6,Premier League,0.12,0.5,-3,1.0,0.75,8.33,2.0,14
Ipswich Town,8,1,1,6,10,21,-11,4,Premier League,0.12,0.25,-11,1.25,0.5,8.33,4.0,16
Southampton,8,0,2,6,5,21,-16,2,Premier League,0.0,0.25,-16,0.62,0.25,0.0,4.0,17
Leicester City,8,0,1,7,2,18,-16,1,Premier League,0.0,0.12,-16,0.25,0.12,0.0,8.33,18
Burnley,8,6,2,0,12,5,7,20,Premier League,0.75,1.0,7,1.5,2.5,1.33,1.0,1
Leeds Utd,8,5,3,0,17,6,11,18,Premier League,0.62,1.0,11,2.12,2.25,1.61,1.0,3
Swansea City,8,5,1,2,10,6,4,16,Premier League,0.62,0.75,4,1.25,2.0,1.61,1.33,4
Luton Town,8,4,3,1,9,5,4,15,Premier League,0.5,0.88,4,1.12,1.88,2.0,1.14,5
Millwall,8,5,0,3,9,9,0,15,Premier League,0.62,0.62,0,1.12,1.88,1.61,1.61,5
Derby County,8,4,2,2,12,7,5,14,Premier League,0.5,0.75,5,1.5,1.75,2.0,1.33,6
Bristol City,8,4,2,2,11,10,1,14,Premier League,0.5,0.75,1,1.38,1.75,2.0,1.33,6
Stoke City,8,4,2,2,9,10,-1,14,Premier League,0.5,0.75,-1,1.12,1.75,2.0,1.33,6
Middlesbrough,8,4,1,3,9,7,2,13,Premier League,0.5,0.62,2,1.12,1.62,2.0,1.61,7
Plymouth,8,4,1,3,12,12,0,13,Premier League,0.5,0.62,0,1.5,1.62,2.0,1.61,7
Hull City,8,3,2,3,7,7,0,11,Premier League,0.38,0.62,0,0.88,1.38,2.63,1.61,9
Sheffield Utd,8,3,1,4,9,8,1,10,Premier League,0.38,0.5,1,1.12,1.25,2.63,2.0,10
Portsmouth,8,3,1,4,12,12,0,10,Premier League,0.38,0.5,0,1.5,1.25,2.63,2.0,10
Blackburn,8,3,1,4,9,9,0,10,Premier League,0.38,0.5,0,1.12,1.25,2.63,2.0,10
Coventry City,8,3,1,4,10,11,-1,10,Premier League,0.38,0.5,-1,1.25,1.25,2.63,2.0,10
Oxford Utd,8,3,1,4,7,9,-2,10,Premier League,0.38,0.5,-2,0.88,1.25,2.63,2.0,10
QP Rangers,8,2,3,3,11,12,-1,9,Premier League,0.25,0.62,-1,1.38,1.12,4.0,1.61,11
Sheffield Wed,8,2,2,4,8,11,-3,8,Premier League,0.25,0.5,-3,1.0,1.0,4.0,2.0,12
Sunderland,8,2,2,4,4,8,-4,8,Premier League,0.25,0.5,-4,0.5,1.0,4.0,2.0,12
Cardiff City,8,1,4,3,7,10,-3,7,Premier League,0.12,0.62,-3,0.88,0.88,8.33,1.61,13
Watford,8,2,1,5,5,8,-3,7,Premier League,0.25,0.38,-3,0.62,0.88,4.0,2.63,13
Preston,8,1,3,4,9,13,-4,6,Premier League,0.12,0.5,-4,1.12,0.75,8.33,2.0,14
West Brom,8,1,2,5,6,12,-6,5,Premier League,0.12,0.38,-6,0.75,0.62,8.33,2.63,15
Norwich City,8,1,1,6,10,17,-7,4,Premier League,0.12,0.25,-7,1.25,0.5,8.33,4.0,16
Birmingham City,8,6,2,0,19,8,11,20,League One,0.75,1.0,11,2.38,2.5,1.33,1.0,1
Charlton,8,6,1,1,17,8,9,19,League One,0.75,0.88,9,2.12,2.38,1.33,1.14,2
Stockport,8,6,1,1,14,5,9,19,League One,0.75,0.88,9,1.75,2.38,1.33,1.14,2
Leyton Orient,8,6,1,1,16,10,6,19,League One,0.75,0.88,6,2.0,2.38,1.33,1.14,2
Wrexham,8,5,3,0,12,4,8,18,League One,0.62,1.0,8,1.5,2.25,1.61,1.0,3
Wycombe,8,5,1,2,8,7,1,16,League One,0.62,0.75,1,1.0,2.0,1.61,1.33,4
Lincoln City,8,4,3,1,14,6,8,15,League One,0.5,0.88,8,1.75,1.88,2.0,1.14,5
Blackpool,8,5,0,3,15,9,6,15,League One,0.62,0.62,6,1.88,1.88,1.61,1.61,5
Reading,8,4,2,2,13,8,5,14,League One,0.5,0.75,5,1.62,1.75,2.0,1.33,6
Peterborough,8,3,2,3,12,14,-2,11,League One,0.38,0.62,-2,1.5,1.38,2.63,1.61,7
Burton Albion,8,3,1,4,10,10,0,10,League One,0.38,0.5,0,1.25,1.25,2.63,2.0,8
Wigan Athletic,8,2,4,2,5,5,0,10,League One,0.25,0.75,0,0.62,1.25,4.0,1.33,8
Crawley Town,8,3,1,4,14,16,-2,10,League One,0.38,0.5,-2,1.75,1.25,2.63,2.0,8
Rotherham,8,3,1,4,11,15,-4,10,League One,0.38,0.5,-4,1.38,1.25,2.63,2.0,8
Northampton,8,2,3,3,11,9,2,9,League One,0.25,0.62,2,1.38,1.12,4.0,1.61,9
Cambridge Utd,8,2,3,3,8,9,-1,9,League One,0.25,0.62,-1,1.0,1.12,4.0,1.61,9
Exeter City,8,2,3,3,6,10,-4,9,League One,0.25,0.62,-4,0.75,1.12,4.0,1.61,9
Stevenage,8,2,1,5,7,12,-5,7,League One,0.25,0.38,-5,0.88,0.88,4.0,2.63,10
Mansfield,8,2,1,5,12,19,-7,7,League One,0.25,0.38,-7,1.5,0.88,4.0,2.63,10
Barnsley,8,1,3,4,14,18,-4,6,League One,0.12,0.5,-4,1.75,0.75,8.33,2.0,11
Huddersfield,8,2,0,6,9,15,-6,6,League One,0.25,0.25,-6,1.12,0.75,4.0,4.0,11
Bolton,8,2,0,6,6,14,-8,6,League One,0.25,0.25,-8,0.75,0.75,4.0,4.0,11
Shrewsbury,8,0,2,6,4,16,-12,2,League One,0.0,0.25,-12,0.5,0.25,0.0,4.0,12
Bristol Rovers,8,0,1,7,4,15,-11,1,League One,0.0,0.12,-11,0.5,0.12,0.0,8.33,13
Doncaster,8,4,4,0,16,5,11,16,League Two,0.5,1.0,11,2.0,2.0,2.0,1.0,1
Port Vale,8,5,1,2,16,8,8,16,League Two,0.62,0.75,8,2.0,2.0,1.61,1.33,1
Salford City,8,4,3,1,15,10,5,15,League Two,0.5,0.88,5,1.88,1.88,2.0,1.14,2
Swindon Town,8,4,2,2,18,10,8,14,League Two,0.5,0.75,8,2.25,1.75,2.0,1.33,3
Carlisle Utd,8,4,2,2,14,13,1,14,League Two,0.5,0.75,1,1.75,1.75,2.0,1.33,3
Barrow,8,3,4,1,9,4,5,13,League Two,0.38,0.88,5,1.12,1.62,2.63,1.14,4
Chesterfield,8,3,4,1,10,9,1,13,League Two,0.38,0.88,1,1.25,1.62,2.63,1.14,4
Tranmere,8,3,3,2,12,9,3,12,League Two,0.38,0.75,3,1.5,1.5,2.63,1.33,5
Gillingham,8,2,6,0,8,6,2,12,League Two,0.25,1.0,2,1.0,1.5,4.0,1.0,5
Bromley,8,3,2,3,12,13,-1,11,League Two,0.38,0.62,-1,1.5,1.38,2.63,1.61,6
Colchester Utd,8,3,2,3,9,10,-1,11,League Two,0.38,0.62,-1,1.12,1.38,2.63,1.61,6
Grimsby,8,3,2,3,10,13,-3,11,League Two,0.38,0.62,-3,1.25,1.38,2.63,1.61,6
AFC Wimbledon,8,2,4,2,8,8,0,10,League Two,0.25,0.75,0,1.0,1.25,4.0,1.33,7
Harrogate,8,2,4,2,11,12,-1,10,League Two,0.25,0.75,-1,1.38,1.25,4.0,1.33,7
Bradford,8,2,3,3,14,13,1,9,League Two,0.25,0.62,1,1.75,1.12,4.0,1.61,8
Notts County,8,2,2,4,9,9,0,8,League Two,0.25,0.5,0,1.12,1.0,4.0,2.0,9
Cheltenham,8,2,2,4,9,14,-5,8,League Two,0.25,0.5,-5,1.12,1.0,4.0,2.0,9
Accrington,8,1,5,2,8,14,-6,8,League Two,0.12,0.75,-6,1.0,1.0,8.33,1.33,9
Fleetwood,8,2,2,4,9,16,-7,8,League Two,0.25,0.5,-7,1.12,1.0,4.0,2.0,9
Milton Keynes,8,2,2,4,6,13,-7,8,League Two,0.25,0.5,-7,0.75,1.0,4.0,2.0,9
Morecambe,8,2,1,5,7,12,-5,7,League Two,0.25,0.38,-5,0.88,0.88,4.0,2.63,10
Walsall,8,0,6,2,9,12,-3,6,League Two,0.0,0.75,-3,1.12,0.75,0.0,1.33,11
Newport,8,1,3,4,6,9,-3,6,League Two,0.12,0.5,-3,0.75,0.75,8.33,2.0,11
Crewe Alexandra,8,1,3,4,5,8,-3,6,League Two,0.12,0.5,-3,0.62,0.75,8.33,2.0,11
York City,8,6,1,1,23,7,16,19,England - National League,0.75,0.88,16,2.88,2.38,1.33,1.14,1
Barnet,8,5,2,1,12,6,6,17,England - National League,0.62,0.88,6,1.5,2.12,1.61,1.14,2
Hartlepool,8,4,3,1,15,10,5,15,England - National League,0.5,0.88,5,1.88,1.88,2.0,1.14,3
Woking,8,4,3,1,11,6,5,15,England - National League,0.5,0.88,5,1.38,1.88,2.0,1.14,3
Boston Utd,8,5,0,3,13,10,3,15,England - National League,0.62,0.62,3,1.62,1.88,1.61,1.61,3
Solihull Moors,8,4,2,2,10,10,0,14,England - National League,0.5,0.75,0,1.25,1.75,2.0,1.33,4
Tamworth,8,4,1,3,14,12,2,13,England - National League,0.5,0.62,2,1.75,1.62,2.0,1.61,5
Rochdale,8,3,3,2,12,8,4,12,England - National League,0.38,0.75,4,1.5,1.5,2.63,1.33,6
Maidenhead Utd,8,3,3,2,11,7,4,12,England - National League,0.38,0.75,4,1.38,1.5,2.63,1.33,6
Southend Utd,8,3,3,2,10,8,2,12,England - National League,0.38,0.75,2,1.25,1.5,2.63,1.33,6
Dagenham & R.,8,3,3,2,7,7,0,12,England - National League,0.38,0.75,0,0.88,1.5,2.63,1.33,6
Oldham,8,3,2,3,10,8,2,11,England - National League,0.38,0.62,2,1.25,1.38,2.63,1.61,7
Forest Green,8,3,2,3,12,12,0,11,England - National League,0.38,0.62,0,1.5,1.38,2.63,1.61,7
Braintree Town,8,3,2,3,10,10,0,11,England - National League,0.38,0.62,0,1.25,1.38,2.63,1.61,7
Wealdstone,8,3,2,3,7,11,-4,11,England - National League,0.38,0.62,-4,0.88,1.38,2.63,1.61,7
Yeovil Town,8,3,1,4,8,9,-1,10,England - National League,0.38,0.5,-1,1.0,1.25,2.63,2.0,8
Sutton Utd,8,2,3,3,9,13,-4,9,England - National League,0.25,0.62,-4,1.12,1.12,4.0,1.61,9
Altrincham,8,2,2,4,9,9,0,8,England - National League,0.25,0.5,0,1.12,1.0,4.0,2.0,10
Ebbsfleet Utd,8,2,2,4,13,16,-3,8,England - National League,0.25,0.5,-3,1.62,1.0,4.0,2.0,10
Aldershot Town,8,2,2,4,12,21,-9,8,England - National League,0.25,0.5,-9,1.5,1.0,4.0,2.0,10
Eastleigh,8,1,3,4,7,15,-8,6,England - National League,0.12,0.5,-8,0.88,0.75,8.33,2.0,11
Gateshead FC,8,2,0,6,10,19,-9,6,England - National League,0.25,0.25,-9,1.25,0.75,4.0,4.0,11
Halifax Town,8,1,2,5,2,10,-8,5,England - National League,0.12,0.38,-8,0.25,0.62,8.33,2.63,12
AFC Fylde,8,1,1,6,5,10,-5,4,England - National League,0.12,0.25,-5,0.62,0.5,8.33,4.0,13
Kidderminster,8,7,1,0,20,4,16,22,England - National L. North,0.88,1.0,16,2.5,2.75,1.14,1.0,1
Brackley Town,8,6,0,2,10,4,6,18,England - National L. North,0.75,0.75,6,1.25,2.25,1.33,1.33,2
Chester,8,5,2,1,13,9,4,17,England - National L. North,0.62,0.88,4,1.62,2.12,1.61,1.14,3
Kings Lynn,8,5,2,1,7,4,3,17,England - National L. North,0.62,0.88,3,0.88,2.12,1.61,1.14,3
Spennymoor,8,5,1,2,15,9,6,16,England - National L. North,0.62,0.75,6,1.88,2.0,1.61,1.33,4
Buxton,8,5,1,2,11,6,5,16,England - National L. North,0.62,0.75,5,1.38,2.0,1.61,1.33,4
Scunthorpe,8,5,0,3,14,4,10,15,England - National L. North,0.62,0.62,10,1.75,1.88,1.61,1.61,5
Oxford City,8,4,2,2,14,7,7,14,England - National L. North,0.5,0.75,7,1.75,1.75,2.0,1.33,6
Scarborough,8,4,2,2,8,7,1,14,England - National L. North,0.5,0.75,1,1.0,1.75,2.0,1.33,6
Marine,8,4,2,2,7,7,0,14,England - National L. North,0.5,0.75,0,0.88,1.75,2.0,1.33,6
Hereford Utd,8,4,1,3,15,11,4,13,England - National L. North,0.5,0.62,4,1.88,1.62,2.0,1.61,7
Alfreton Town,8,3,4,1,8,6,2,13,England - National L. North,0.38,0.88,2,1.0,1.62,2.63,1.14,7
Chorley,8,3,3,2,13,4,9,12,England - National L. North,0.38,0.75,9,1.62,1.5,2.63,1.33,8
Curzon,8,3,2,3,9,12,-3,11,England - National L. North,0.38,0.62,-3,1.12,1.38,2.63,1.61,9
Darlington,8,2,4,2,13,12,1,10,England - National L. North,0.25,0.75,1,1.62,1.25,4.0,1.33,10
Peterborough S.,8,3,0,5,9,15,-6,9,England - National L. North,0.38,0.38,-6,1.12,1.12,2.63,2.63,11
Rushall,8,2,2,4,8,12,-4,8,England - National L. North,0.25,0.5,-4,1.0,1.0,4.0,2.0,12
Radcliffe,8,2,2,4,7,13,-6,8,England - National L. North,0.25,0.5,-6,0.88,1.0,4.0,2.0,12
Southport,8,1,3,4,4,7,-3,6,England - National L. North,0.12,0.5,-3,0.5,0.75,8.33,2.0,13
Needham Market,8,2,0,6,7,14,-7,6,England - National L. North,0.25,0.25,-7,0.88,0.75,4.0,4.0,13
Leamington,8,1,1,6,2,10,-8,4,England - National L. North,0.12,0.25,-8,0.25,0.5,8.33,4.0,14
South Shields,8,0,2,6,3,15,-12,2,England - National L. North,0.0,0.25,-12,0.38,0.25,0.0,4.0,15
Warrington,8,0,1,7,3,14,-11,1,England - National L. North,0.0,0.12,-11,0.38,0.12,0.0,8.33,16
Farsley Celtic,8,0,0,8,5,25,-20,0,England - National L. North,0.0,0.0,-20,0.62,0.0,0.0,0.0,17
Eastbourne,8,6,1,1,18,6,12,19,England - National L. South,0.75,0.88,12,2.25,2.38,1.33,1.14,1
Torquay Utd,8,6,1,1,12,4,8,19,England - National L. South,0.75,0.88,8,1.5,2.38,1.33,1.14,1
Weston-s.-Mare,8,5,1,2,14,7,7,16,England - National L. South,0.62,0.75,7,1.75,2.0,1.61,1.33,2
Truro City,8,5,1,2,13,6,7,16,England - National L. South,0.62,0.75,7,1.62,2.0,1.61,1.33,2
Maidstone Utd,8,4,3,1,16,5,11,15,England - National L. South,0.5,0.88,11,2.0,1.88,2.0,1.14,3
Boreham Wood,8,5,0,3,17,10,7,15,England - National L. South,0.62,0.62,7,2.12,1.88,1.61,1.61,3
Bath City,8,4,2,2,13,4,9,14,England - National L. South,0.5,0.75,9,1.62,1.75,2.0,1.33,4
Dorking,8,3,4,1,13,9,4,13,England - National L. South,0.38,0.88,4,1.62,1.62,2.63,1.14,5
Chesham Utd,8,4,1,3,12,10,2,13,England - National L. South,0.5,0.62,2,1.5,1.62,2.0,1.61,5
Enfield Town,8,3,4,1,10,10,0,13,England - National L. South,0.38,0.88,0,1.25,1.62,2.63,1.14,5
St Albans,8,3,3,2,7,6,1,12,England - National L. South,0.38,0.75,1,0.88,1.5,2.63,1.33,6
Worthing,8,3,2,3,12,8,4,11,England - National L. South,0.38,0.62,4,1.5,1.38,2.63,1.61,7
Hornchurch,8,3,2,3,10,11,-1,11,England - National L. South,0.38,0.62,-1,1.25,1.38,2.63,1.61,7
Chelmsford City,8,3,1,4,10,8,2,10,England - National L. South,0.38,0.5,2,1.25,1.25,2.63,2.0,8
Slough Town,8,3,1,4,12,17,-5,10,England - National L. South,0.38,0.5,-5,1.5,1.25,2.63,2.0,8
Chippenham,8,3,1,4,5,11,-6,10,England - National L. South,0.38,0.5,-6,0.62,1.25,2.63,2.0,8
Farnborough,8,3,0,5,15,15,0,9,England - National L. South,0.38,0.38,0,1.88,1.12,2.63,2.63,9
Hemel Hempstead,8,2,3,3,6,10,-4,9,England - National L. South,0.25,0.62,-4,0.75,1.12,4.0,1.61,9
Weymouth,8,2,2,4,9,13,-4,8,England - National L. South,0.25,0.5,-4,1.12,1.0,4.0,2.0,10
Salisbury,8,2,2,4,8,12,-4,8,England - National L. South,0.25,0.5,-4,1.0,1.0,4.0,2.0,10
Aveley,8,2,1,5,5,11,-6,7,England - National L. South,0.25,0.38,-6,0.62,0.88,4.0,2.63,11
Tonbridge,8,2,1,5,5,14,-9,7,England - National L. South,0.25,0.38,-9,0.62,0.88,4.0,2.63,11
Welling Utd,8,1,1,6,6,22,-16,4,England - National L. South,0.12,0.25,-16,0.75,0.5,8.33,4.0,12
Hampton & R.,8,1,0,7,11,26,-15,3,England - National L. South,0.12,0.12,-15,1.38,0.38,8.33,8.33,13
Horsham,8,7,0,1,15,4,11,21,England - Isthmian league,0.88,0.88,11,1.88,2.62,1.14,1.14,1
Cray Valley PM,8,7,0,1,17,7,10,21,England - Isthmian league,0.88,0.88,10,2.12,2.62,1.14,1.14,1
Chichester City,8,6,0,2,16,5,11,18,England - Isthmian league,0.75,0.75,11,2.0,2.25,1.33,1.33,2
Dartford,8,5,2,1,16,8,8,17,England - Isthmian league,0.62,0.88,8,2.0,2.12,1.61,1.14,3
Billericay Town,8,5,0,3,18,9,9,15,England - Isthmian league,0.62,0.62,9,2.25,1.88,1.61,1.61,4
Carshalton,8,5,0,3,17,12,5,15,England - Isthmian league,0.62,0.62,5,2.12,1.88,1.61,1.61,4
Chatham Town,8,4,2,2,12,7,5,14,England - Isthmian league,0.5,0.75,5,1.5,1.75,2.0,1.33,5
Cray Wanderers,8,4,1,3,17,11,6,13,England - Isthmian league,0.5,0.62,6,2.12,1.62,2.0,1.61,6
Dover Athletic,8,4,1,3,12,11,1,13,England - Isthmian league,0.5,0.62,1,1.5,1.62,2.0,1.61,6
Wingate & F.,8,3,2,3,12,12,0,11,England - Isthmian league,0.38,0.62,0,1.5,1.38,2.63,1.61,7
Hashtag United,8,2,4,2,13,11,2,10,England - Isthmian league,0.25,0.75,2,1.62,1.25,4.0,1.33,8
Lewes,8,3,1,4,11,15,-4,10,England - Isthmian league,0.38,0.5,-4,1.38,1.25,2.63,2.0,8
Potters Bar,8,3,0,5,9,13,-4,9,England - Isthmian league,0.38,0.38,-4,1.12,1.12,2.63,2.63,9
Cheshunt,8,3,0,5,8,12,-4,9,England - Isthmian league,0.38,0.38,-4,1.0,1.12,2.63,2.63,9
Canvey Island,8,2,2,4,8,9,-1,8,England - Isthmian league,0.25,0.5,-1,1.0,1.0,4.0,2.0,10
Folkestone,8,2,1,5,7,14,-7,7,England - Isthmian league,0.25,0.38,-7,0.88,0.88,4.0,2.63,11
Bognor Regis,8,2,1,5,6,15,-9,7,England - Isthmian league,0.25,0.38,-9,0.75,0.88,4.0,2.63,11
Bowers & Pitsea,8,2,1,5,6,16,-10,7,England - Isthmian league,0.25,0.38,-10,0.75,0.88,4.0,2.63,11
Whitehawk,8,2,0,6,6,10,-4,6,England - Isthmian league,0.25,0.25,-4,0.75,0.75,4.0,4.0,12
Hastings Utd,8,1,3,4,5,12,-7,6,England - Isthmian league,0.12,0.5,-7,0.62,0.75,8.33,2.0,12
Dulwich Hamlet,8,2,0,6,5,15,-10,6,England - Isthmian league,0.25,0.25,-10,0.62,0.75,4.0,4.0,12
Hendon,8,1,2,5,10,21,-11,5,England - Isthmian league,0.12,0.38,-11,1.25,0.62,8.33,2.63,13
Macclesfield,8,8,0,0,24,4,20,24,England - Northern league,1.0,1.0,20,3.0,3.0,1.0,1.0,1
Worksop Town,8,6,0,2,22,7,15,18,England - Northern league,0.75,0.75,15,2.75,2.25,1.33,1.33,2
Stockton Town,8,5,2,1,9,4,5,17,England - Northern league,0.62,0.88,5,1.12,2.12,1.61,1.14,3
Prescot Cables,8,5,1,2,11,7,4,16,England - Northern league,0.62,0.75,4,1.38,2.0,1.61,1.33,4
Bamber Bridge,8,5,0,3,13,7,6,15,England - Northern league,0.62,0.62,6,1.62,1.88,1.61,1.61,5
Whitby Town,8,5,0,3,12,10,2,15,England - Northern league,0.62,0.62,2,1.5,1.88,1.61,1.61,5
Gainsborough,8,4,1,3,12,8,4,13,England - Northern league,0.5,0.62,4,1.5,1.62,2.0,1.61,6
Leek Town,8,4,1,3,12,8,4,13,England - Northern league,0.5,0.62,4,1.5,1.62,2.0,1.61,6
Morpeth Town,8,3,4,1,8,9,-1,13,England - Northern league,0.38,0.88,-1,1.0,1.62,2.63,1.14,6
Ilkeston Town,8,3,3,2,10,9,1,12,England - Northern league,0.38,0.75,1,1.25,1.5,2.63,1.33,7
Guiseley,8,3,3,2,8,7,1,12,England - Northern league,0.38,0.75,1,1.0,1.5,2.63,1.33,7
Workington,8,3,1,4,13,9,4,10,England - Northern league,0.38,0.5,4,1.62,1.25,2.63,2.0,8
Ashton Utd,8,3,1,4,12,11,1,10,England - Northern league,0.38,0.5,1,1.5,1.25,2.63,2.0,8
Lancaster City,8,3,1,4,11,15,-4,10,England - Northern league,0.38,0.5,-4,1.38,1.25,2.63,2.0,8
Hyde Utd,8,3,1,4,10,16,-6,10,England - Northern league,0.38,0.5,-6,1.25,1.25,2.63,2.0,8
Matlock,8,2,3,3,10,9,1,9,England - Northern league,0.25,0.62,1,1.25,1.12,4.0,1.61,9
Rylands,8,2,2,4,8,11,-3,8,England - Northern league,0.25,0.5,-3,1.0,1.0,4.0,2.0,10
FC United,8,2,2,4,8,14,-6,8,England - Northern league,0.25,0.5,-6,1.0,1.0,4.0,2.0,10
Mickleover,8,2,2,4,7,19,-12,8,England - Northern league,0.25,0.5,-12,0.88,1.0,4.0,2.0,10
Hebburn Town,8,1,2,5,7,14,-7,5,England - Northern league,0.12,0.38,-7,0.88,0.62,8.33,2.63,11
Basford Utd,8,1,1,6,6,17,-11,4,England - Northern league,0.12,0.25,-11,0.75,0.5,8.33,4.0,12
Blyth Spartans,8,0,0,8,6,21,-15,0,England - Northern league,0.0,0.0,-15,0.75,0.0,0.0,0.0,13
Bedford Town,8,6,2,0,16,6,10,20,England - Southern Central,0.75,1.0,10,2.0,2.5,1.33,1.0,1
AFC Sudbury,8,5,2,1,10,4,6,17,England - Southern Central,0.62,0.88,6,1.25,2.12,1.61,1.14,2
Halesowen Town,8,4,4,0,11,4,7,16,England - Southern Central,0.5,1.0,7,1.38,2.0,2.0,1.0,3
Kettering Town,8,4,4,0,9,4,5,16,England - Southern Central,0.5,1.0,5,1.12,2.0,2.0,1.0,3
Spalding United,8,4,3,1,18,8,10,15,England - Southern Central,0.5,0.88,10,2.25,1.88,2.0,1.14,4
Harborough Town,8,4,3,1,13,6,7,15,England - Southern Central,0.5,0.88,7,1.62,1.88,2.0,1.14,4
Stourbridge,8,4,3,1,12,8,4,15,England - Southern Central,0.5,0.88,4,1.5,1.88,2.0,1.14,4
Telford Utd,8,3,5,0,16,5,11,14,England - Southern Central,0.38,1.0,11,2.0,1.75,2.63,1.0,5
Banbury Utd,8,4,2,2,12,8,4,14,England - Southern Central,0.5,0.75,4,1.5,1.75,2.0,1.33,5
Stamford,8,4,2,2,7,11,-4,14,England - Southern Central,0.5,0.75,-4,0.88,1.75,2.0,1.33,5
Bromsgrove,8,3,1,4,14,13,1,10,England - Southern Central,0.38,0.5,1,1.75,1.25,2.63,2.0,6
Royston,8,2,4,2,9,8,1,10,England - Southern Central,0.25,0.75,1,1.12,1.25,4.0,1.33,6
Barwell,8,3,1,4,10,13,-3,10,England - Southern Central,0.38,0.5,-3,1.25,1.25,2.63,2.0,6
Stratford Town,8,2,3,3,8,9,-1,9,England - Southern Central,0.25,0.62,-1,1.0,1.12,4.0,1.61,7
St. Ives Town,8,2,3,3,11,13,-2,9,England - Southern Central,0.25,0.62,-2,1.38,1.12,4.0,1.61,7
B. Stortford,8,2,2,4,8,14,-6,8,England - Southern Central,0.25,0.5,-6,1.0,1.0,4.0,2.0,8
Alvechurch,8,1,3,4,6,10,-4,6,England - Southern Central,0.12,0.5,-4,0.75,0.75,8.33,2.0,9
Leiston,8,1,3,4,7,12,-5,6,England - Southern Central,0.12,0.5,-5,0.88,0.75,8.33,2.0,9
Redditch Utd,8,1,3,4,4,10,-6,6,England - Southern Central,0.12,0.5,-6,0.5,0.75,8.33,2.0,9
Biggleswade,8,1,2,5,5,12,-7,5,England - Southern Central,0.12,0.38,-7,0.62,0.62,8.33,2.63,10
Hitchin Town,8,0,2,6,11,19,-8,2,England - Southern Central,0.0,0.25,-8,1.38,0.25,0.0,4.0,11
Lowestoft,8,0,1,7,7,27,-20,1,England - Southern Central,0.0,0.12,-20,0.88,0.12,0.0,8.33,12
Levadia,8,7,1,0,24,5,19,22,Estonia - Meistriliiga,0.88,1.0,19,3.0,2.75,1.14,1.0,1
Paide,8,6,0,2,15,4,11,18,Estonia - Meistriliiga,0.75,0.75,11,1.88,2.25,1.33,1.33,2
Flora,8,5,2,1,16,5,11,17,Estonia - Meistriliiga,0.62,0.88,11,2.0,2.12,1.61,1.14,3
Nomme Kalju,8,4,1,3,14,11,3,13,Estonia - Meistriliiga,0.5,0.62,3,1.75,1.62,2.0,1.61,4
Narva Trans,8,4,1,3,10,8,2,13,Estonia - Meistriliiga,0.5,0.62,2,1.25,1.62,2.0,1.61,4
Harju JK,8,3,1,4,10,16,-6,10,Estonia - Meistriliiga,0.38,0.5,-6,1.25,1.25,2.63,2.0,5
Vaprus,8,2,2,4,10,10,0,8,Estonia - Meistriliiga,0.25,0.5,0,1.25,1.0,4.0,2.0,6
Kuressaare,8,2,0,6,7,17,-10,6,Estonia - Meistriliiga,0.25,0.25,-10,0.88,0.75,4.0,4.0,7
Tammeka,8,1,1,6,9,20,-11,4,Estonia - Meistriliiga,0.12,0.25,-11,1.12,0.5,8.33,4.0,8
Tallinna Kalev,8,1,1,6,7,26,-19,4,Estonia - Meistriliiga,0.12,0.25,-19,0.88,0.5,8.33,4.0,8
Nomme Utd,7,6,0,1,13,5,8,18,Estonia - Esiliiga,0.86,0.86,8,1.86,2.57,1.16,1.16,1
Viimsi,7,4,2,1,17,7,10,14,Estonia - Esiliiga,0.57,0.86,10,2.43,2.0,1.75,1.16,2
Tartu Welco,7,4,2,1,13,10,3,14,Estonia - Esiliiga,0.57,0.86,3,1.86,2.0,1.75,1.16,2
Elva,7,4,1,2,15,12,3,13,Estonia - Esiliiga,0.57,0.71,3,2.14,1.86,1.75,1.41,3
Levadia B,7,3,1,3,10,9,1,10,Estonia - Esiliiga,0.43,0.57,1,1.43,1.43,2.33,1.75,4
Flora B,7,2,3,2,11,10,1,9,Estonia - Esiliiga,0.29,0.71,1,1.57,1.29,3.45,1.41,5
Nomme Kalju B,7,3,0,4,10,16,-6,9,Estonia - Esiliiga,0.43,0.43,-6,1.43,1.29,2.33,2.33,5
FC Tallinn,7,2,1,4,11,14,-3,7,Estonia - Esiliiga,0.29,0.43,-3,1.57,1.0,3.45,2.33,6
Tammeka B,7,1,0,6,11,15,-4,3,Estonia - Esiliiga,0.14,0.14,-4,1.57,0.43,7.14,7.14,7
Tallinna K. B,7,0,2,5,6,19,-13,2,Estonia - Esiliiga,0.0,0.29,-13,0.86,0.29,0.0,3.45,8
NSI Runavik,6,6,0,0,28,5,23,18,FaroeIslands - Premier League,1.0,1.0,23,4.67,3.0,1.0,1.0,1
Klaksvik,6,6,0,0,16,3,13,18,FaroeIslands - Premier League,1.0,1.0,13,2.67,3.0,1.0,1.0,1
HB Torshavn,6,4,0,2,14,10,4,12,FaroeIslands - Premier League,0.67,0.67,4,2.33,2.0,1.49,1.49,2
B36 Torshavn,6,3,1,2,10,10,0,10,FaroeIslands - Premier League,0.5,0.67,0,1.67,1.67,2.0,1.49,3
Streymur,6,2,1,3,7,11,-4,7,FaroeIslands - Premier League,0.33,0.5,-4,1.17,1.17,3.03,2.0,4
Suduroy,6,2,0,4,3,10,-7,6,FaroeIslands - Premier League,0.33,0.33,-7,0.5,1.0,3.03,3.03,5
Vikingur,6,1,2,3,5,8,-3,5,FaroeIslands - Premier League,0.17,0.5,-3,0.83,0.83,5.88,2.0,6
TB Tvoroyri,6,1,2,3,6,11,-5,5,FaroeIslands - Premier League,0.17,0.5,-5,1.0,0.83,5.88,2.0,6
B68 Toftir,6,1,1,4,5,18,-13,4,FaroeIslands - Premier League,0.17,0.33,-13,0.83,0.67,5.88,3.03,7
07 Vestur,6,0,1,5,5,13,-8,1,FaroeIslands - Premier League,0.0,0.17,-8,0.83,0.17,0.0,5.88,8
Skala,6,5,1,0,16,2,14,16,FaroeIslands - 1. Deild,0.83,1.0,14,2.67,2.67,1.2,1.0,1
Vikingur B,6,4,0,2,14,8,6,12,FaroeIslands - 1. Deild,0.67,0.67,6,2.33,2.0,1.49,1.49,2
B71 Sandur,6,4,0,2,8,8,0,12,FaroeIslands - 1. Deild,0.67,0.67,0,1.33,2.0,1.49,1.49,2
AB Argir,5,3,2,0,10,3,7,11,FaroeIslands - 1. Deild,0.6,1.0,7,2.0,2.2,1.67,1.0,3
Klaksvik B,6,3,1,2,9,8,1,10,FaroeIslands - 1. Deild,0.5,0.67,1,1.5,1.67,2.0,1.49,4
Streymur B,5,3,0,2,7,5,2,9,FaroeIslands - 1. Deild,0.6,0.6,2,1.4,1.8,1.67,1.67,5
NSI Runavik B,6,2,1,3,12,12,0,7,FaroeIslands - 1. Deild,0.33,0.5,0,2.0,1.17,3.03,2.0,6
IF Fuglafjordur,6,1,2,3,8,11,-3,5,FaroeIslands - 1. Deild,0.17,0.5,-3,1.33,0.83,5.88,2.0,7
B36 Torshavn B,6,0,1,5,4,19,-15,1,FaroeIslands - 1. Deild,0.0,0.17,-15,0.67,0.17,0.0,5.88,8
07 Vestur B,6,0,0,6,6,18,-12,0,FaroeIslands - 1. Deild,0.0,0.0,-12,1.0,0.0,0.0,0.0,9
Ilves,3,3,0,0,10,3,7,9,Finland - Veikkausliiga,1.0,1.0,7,3.33,3.0,1.0,1.0,1
SJK,3,3,0,0,4,1,3,9,Finland - Veikkausliiga,1.0,1.0,3,1.33,3.0,1.0,1.0,1
Inter Turku,3,2,1,0,6,1,5,7,Finland - Veikkausliiga,0.67,1.0,5,2.0,2.33,1.49,1.0,2
KuPS,3,2,1,0,3,1,2,7,Finland - Veikkausliiga,0.67,1.0,2,1.0,2.33,1.49,1.0,2
Haka,3,2,0,1,5,4,1,6,Finland - Veikkausliiga,0.67,0.67,1,1.67,2.0,1.49,1.49,3
VPS,3,1,1,1,6,7,-1,4,Finland - Veikkausliiga,0.33,0.67,-1,2.0,1.33,3.03,1.49,4
Jaro,3,1,0,2,3,3,0,3,Finland - Veikkausliiga,0.33,0.33,0,1.0,1.0,3.03,3.03,5
Mariehamn,3,1,0,2,2,4,-2,3,Finland - Veikkausliiga,0.33,0.33,-2,0.67,1.0,3.03,3.03,5
KTP,3,0,1,2,2,8,-6,1,Finland - Veikkausliiga,0.0,0.33,-6,0.67,0.33,0.0,3.03,6
HJK Helsinki,2,0,0,2,2,4,-2,0,Finland - Veikkausliiga,0.0,0.0,-2,1.0,0.0,0.0,0.0,7
Oulu,3,0,0,3,4,7,-3,0,Finland - Veikkausliiga,0.0,0.0,-3,1.33,0.0,0.0,0.0,7
Gnistan,2,0,0,2,2,6,-4,0,Finland - Veikkausliiga,0.0,0.0,-4,1.0,0.0,0.0,0.0,7
JIPPO,1,1,0,0,2,0,2,3,Finland - Ykkosliga,1.0,1.0,2,2.0,3.0,1.0,1.0,1
Ekenas IF,0,0,0,0,0,0,0,0,Finland - Ykkosliga,0.0,0.0,0,0.0,0.0,0.0,0.0,2
JaPS,0,0,0,0,0,0,0,0,Finland - Ykkosliga,0.0,0.0,0,0.0,0.0,0.0,0.0,2
KaPa,0,0,0,0,0,0,0,0,Finland - Ykkosliga,0.0,0.0,0,0.0,0.0,0.0,0.0,2
Klubi-04,0,0,0,0,0,0,0,0,Finland - Ykkosliga,0.0,0.0,0,0.0,0.0,0.0,0.0,2
Lahti,0,0,0,0,0,0,0,0,Finland - Ykkosliga,0.0,0.0,0,0.0,0.0,0.0,0.0,2
PK-35,0,0,0,0,0,0,0,0,Finland - Ykkosliga,0.0,0.0,0,0.0,0.0,0.0,0.0,2
SJK Akatemia,0,0,0,0,0,0,0,0,Finland - Ykkosliga,0.0,0.0,0,0.0,0.0,0.0,0.0,2
TPS,0,0,0,0,0,0,0,0,Finland - Ykkosliga,0.0,0.0,0,0.0,0.0,0.0,0.0,2
SalPa,1,0,0,1,0,2,-2,0,Finland - Ykkosliga,0.0,0.0,-2,0.0,0.0,0.0,0.0,2
KuPS Ak.,2,2,0,0,4,2,2,6,Finland - Ykkonen,1.0,1.0,2,2.0,3.0,1.0,1.0,1
KPV Kokkola,2,1,1,0,3,2,1,4,Finland - Ykkonen,0.5,1.0,1,1.5,2.0,2.0,1.0,2
PKKU,2,1,0,1,5,1,4,3,Finland - Ykkonen,0.5,0.5,4,2.5,1.5,2.0,2.0,3
Inter Turku B,2,1,0,1,6,3,3,3,Finland - Ykkonen,0.5,0.5,3,3.0,1.5,2.0,2.0,3
EPS,2,1,0,1,2,1,1,3,Finland - Ykkonen,0.5,0.5,1,1.0,1.5,2.0,2.0,3
Atlantis,2,1,0,1,2,2,0,3,Finland - Ykkonen,0.5,0.5,0,1.0,1.5,2.0,2.0,3
Jazz Pori,2,1,0,1,2,2,0,3,Finland - Ykkonen,0.5,0.5,0,1.0,1.5,2.0,2.0,3
Tampere Utd,2,1,0,1,3,4,-1,3,Finland - Ykkonen,0.5,0.5,-1,1.5,1.5,2.0,2.0,3
Rovaniemi,2,1,0,1,1,5,-4,3,Finland - Ykkonen,0.5,0.5,-4,0.5,1.5,2.0,2.0,3
OLS Oulu,2,0,2,0,4,4,0,2,Finland - Ykkonen,0.0,1.0,0,2.0,1.0,0.0,1.0,4
JJK,2,0,1,1,3,4,-1,1,Finland - Ykkonen,0.0,0.5,-1,1.5,0.5,0.0,2.0,5
Mikkelin,2,0,0,2,0,5,-5,0,Finland - Ykkonen,0.0,0.0,-5,0.0,0.0,0.0,0.0,6
VJS,1,1,0,0,6,0,6,3,Finland - Kakkonen Group A,1.0,1.0,6,6.0,3.0,1.0,1.0,1
GrIFK,1,1,0,0,4,1,3,3,Finland - Kakkonen Group A,1.0,1.0,3,4.0,3.0,1.0,1.0,1
PuiU Helsinki,1,1,0,0,3,0,3,3,Finland - Kakkonen Group A,1.0,1.0,3,3.0,3.0,1.0,1.0,1
Honka,1,1,0,0,3,1,2,3,Finland - Kakkonen Group A,1.0,1.0,2,3.0,3.0,1.0,1.0,1
MYPA,1,0,1,0,3,3,0,1,Finland - Kakkonen Group A,0.0,1.0,0,3.0,1.0,0.0,1.0,2
Vaajakoski,1,0,1,0,3,3,0,1,Finland - Kakkonen Group A,0.0,1.0,0,3.0,1.0,0.0,1.0,2
Reipas,1,0,0,1,1,3,-2,0,Finland - Kakkonen Group A,0.0,0.0,-2,1.0,0.0,0.0,0.0,3
PEPO,1,0,0,1,1,4,-3,0,Finland - Kakkonen Group A,0.0,0.0,-3,1.0,0.0,0.0,0.0,3
HaPK,1,0,0,1,0,3,-3,0,Finland - Kakkonen Group A,0.0,0.0,-3,0.0,0.0,0.0,0.0,3
JPS,1,0,0,1,0,6,-6,0,Finland - Kakkonen Group A,0.0,0.0,-6,0.0,0.0,0.0,0.0,3
PPJ,1,1,0,0,3,2,1,3,Finland - Kakkonen Group B,1.0,1.0,1,3.0,3.0,1.0,1.0,1
TPV,1,1,0,0,3,2,1,3,Finland - Kakkonen Group B,1.0,1.0,1,3.0,3.0,1.0,1.0,1
Ilves B,1,1,0,0,2,1,1,3,Finland - Kakkonen Group B,1.0,1.0,1,2.0,3.0,1.0,1.0,1
HJS,1,1,0,0,1,0,1,3,Finland - Kakkonen Group B,1.0,1.0,1,1.0,3.0,1.0,1.0,1
Atlantis B,0,0,0,0,0,0,0,0,Finland - Kakkonen Group B,0.0,0.0,0,0.0,0.0,0.0,0.0,2
NJS,0,0,0,0,0,0,0,0,Finland - Kakkonen Group B,0.0,0.0,0,0.0,0.0,0.0,0.0,2
Kiffen,1,0,0,1,2,3,-1,0,Finland - Kakkonen Group B,0.0,0.0,-1,2.0,0.0,0.0,0.0,2
P-Iirot,1,0,0,1,2,3,-1,0,Finland - Kakkonen Group B,0.0,0.0,-1,2.0,0.0,0.0,0.0,2
MuSa,1,0,0,1,1,2,-1,0,Finland - Kakkonen Group B,0.0,0.0,-1,1.0,0.0,0.0,0.0,2
HPS,1,0,0,1,0,1,-1,0,Finland - Kakkonen Group B,0.0,0.0,-1,0.0,0.0,0.0,0.0,2
VPS B,1,1,0,0,3,0,3,3,Finland - Kakkonen Group C,1.0,1.0,3,3.0,3.0,1.0,1.0,1
JS Hercules,1,1,0,0,3,1,2,3,Finland - Kakkonen Group C,1.0,1.0,2,3.0,3.0,1.0,1.0,1
SJK Akatemia B,1,1,0,0,2,1,1,3,Finland - Kakkonen Group C,1.0,1.0,1,2.0,3.0,1.0,1.0,1
JBK,1,0,1,0,1,1,0,1,Finland - Kakkonen Group C,0.0,1.0,0,1.0,1.0,0.0,1.0,2
OsPa,1,0,1,0,1,1,0,1,Finland - Kakkonen Group C,0.0,1.0,0,1.0,1.0,0.0,1.0,2
TP-47,1,0,1,0,1,1,0,1,Finland - Kakkonen Group C,0.0,1.0,0,1.0,1.0,0.0,1.0,2
VIFK,1,0,1,0,1,1,0,1,Finland - Kakkonen Group C,0.0,1.0,0,1.0,1.0,0.0,1.0,2
Narpes Kraft,1,0,0,1,1,2,-1,0,Finland - Kakkonen Group C,0.0,0.0,-1,1.0,0.0,0.0,0.0,3
Kuopion Elo,1,0,0,1,1,3,-2,0,Finland - Kakkonen Group C,0.0,0.0,-2,1.0,0.0,0.0,0.0,3
GBK Kokkola,1,0,0,1,0,3,-3,0,Finland - Kakkonen Group C,0.0,0.0,-3,0.0,0.0,0.0,0.0,3
Paris SG,8,8,0,0,24,7,17,24,France - Ligue 1,1.0,1.0,17,3.0,3.0,1.0,1.0,1
Strasbourg,8,5,3,0,11,5,6,18,France - Ligue 1,0.62,1.0,6,1.38,2.25,1.61,1.0,2
Rennes,8,5,0,3,16,8,8,15,France - Ligue 1,0.62,0.62,8,2.0,1.88,1.61,1.61,3
Lyon,8,5,0,3,18,14,4,15,France - Ligue 1,0.62,0.62,4,2.25,1.88,1.61,1.61,3
Lille,8,5,0,3,11,10,1,15,France - Ligue 1,0.62,0.62,1,1.38,1.88,1.61,1.61,3
Monaco,8,4,2,2,13,6,7,14,France - Ligue 1,0.5,0.75,7,1.62,1.75,2.0,1.33,4
Auxerre,8,4,1,3,10,8,2,13,France - Ligue 1,0.5,0.62,2,1.25,1.62,2.0,1.61,5
Brest,8,3,3,2,13,11,2,12,France - Ligue 1,0.38,0.75,2,1.62,1.5,2.63,1.33,6
Lens,8,4,0,4,10,11,-1,12,France - Ligue 1,0.5,0.5,-1,1.25,1.5,2.0,2.0,6
Nice,8,3,2,3,12,11,1,11,France - Ligue 1,0.38,0.62,1,1.5,1.38,2.63,1.61,7
Reims,8,3,1,4,6,8,-2,10,France - Ligue 1,0.38,0.5,-2,0.75,1.25,2.63,2.0,8
Le Havre,8,3,1,4,15,21,-6,10,France - Ligue 1,0.38,0.5,-6,1.88,1.25,2.63,2.0,8
Marseille,8,3,0,5,12,16,-4,9,France - Ligue 1,0.38,0.38,-4,1.5,1.12,2.63,2.63,9
Saint-Etienne,8,2,3,3,13,18,-5,9,France - Ligue 1,0.25,0.62,-5,1.62,1.12,4.0,1.61,9
Nantes,8,3,0,5,10,17,-7,9,France - Ligue 1,0.38,0.38,-7,1.25,1.12,2.63,2.63,9
Toulouse,8,2,1,5,15,14,1,7,France - Ligue 1,0.25,0.38,1,1.88,0.88,4.0,2.63,10
Angers,8,1,1,6,6,17,-11,4,France - Ligue 1,0.12,0.25,-11,0.75,0.5,8.33,4.0,11
Montpellier,8,0,0,8,1,19,-18,0,France - Ligue 1,0.0,0.0,-18,0.12,0.0,0.0,0.0,12
Paris FC,8,7,0,1,16,10,6,21,France - Ligue 2,0.88,0.88,6,2.0,2.62,1.14,1.14,1
Metz,8,5,2,1,20,11,9,17,France - Ligue 2,0.62,0.88,9,2.5,2.12,1.61,1.14,2
Lorient,8,5,1,2,18,7,11,16,France - Ligue 2,0.62,0.75,11,2.25,2.0,1.61,1.33,3
Martigues,8,4,1,3,11,8,3,13,France - Ligue 2,0.5,0.62,3,1.38,1.62,2.0,1.61,4
SC Bastia,8,4,1,3,10,10,0,13,France - Ligue 2,0.5,0.62,0,1.25,1.62,2.0,1.61,4
USL Dunkerque,8,4,0,4,13,13,0,12,France - Ligue 2,0.5,0.5,0,1.62,1.5,2.0,2.0,5
AC Ajaccio,8,3,3,2,9,9,0,12,France - Ligue 2,0.38,0.75,0,1.12,1.5,2.63,1.33,5
Laval,8,4,0,4,10,11,-1,12,France - Ligue 2,0.5,0.5,-1,1.25,1.5,2.0,2.0,5
Troyes,8,3,2,3,9,6,3,11,France - Ligue 2,0.38,0.62,3,1.12,1.38,2.63,1.61,6
Amiens,8,3,2,3,10,11,-1,11,France - Ligue 2,0.38,0.62,-1,1.25,1.38,2.63,1.61,6
Rodez Aveyron,8,2,4,2,13,11,2,10,France - Ligue 2,0.25,0.75,2,1.62,1.25,4.0,1.33,7
Guingamp,8,3,1,4,12,13,-1,10,France - Ligue 2,0.38,0.5,-1,1.5,1.25,2.63,2.0,7
Pau FC,8,2,4,2,9,14,-5,10,France - Ligue 2,0.25,0.75,-5,1.12,1.25,4.0,1.33,7
Red Star,8,2,3,3,11,10,1,9,France - Ligue 2,0.25,0.62,1,1.38,1.12,4.0,1.61,8
Grenoble,8,1,3,4,7,11,-4,6,France - Ligue 2,0.12,0.5,-4,0.88,0.75,8.33,2.0,9
Caen,8,1,3,4,10,16,-6,6,France - Ligue 2,0.12,0.5,-6,1.25,0.75,8.33,2.0,9
Annecy,8,1,3,4,6,13,-7,6,France - Ligue 2,0.12,0.5,-7,0.75,0.75,8.33,2.0,9
Clermont,8,0,3,5,4,14,-10,3,France - Ligue 2,0.0,0.38,-10,0.5,0.38,0.0,2.63,10
Le Mans,8,6,1,1,13,5,8,19,France - National,0.75,0.88,8,1.62,2.38,1.33,1.14,1
Nancy,8,5,1,2,12,6,6,16,France - National,0.62,0.75,6,1.5,2.0,1.61,1.33,2
Boulogne,8,4,3,1,12,8,4,15,France - National,0.5,0.88,4,1.5,1.88,2.0,1.14,3
Dijon,8,4,3,1,11,7,4,15,France - National,0.5,0.88,4,1.38,1.88,2.0,1.14,3
Bourg-en-Bresse,8,4,2,2,7,4,3,14,France - National,0.5,0.75,3,0.88,1.75,2.0,1.33,4
Rouen,8,3,2,3,13,14,-1,11,France - National,0.38,0.62,-1,1.62,1.38,2.63,1.61,5
Chateauroux,8,3,2,3,9,10,-1,11,France - National,0.38,0.62,-1,1.12,1.38,2.63,1.61,5
Quevilly Rouen,8,3,2,3,6,8,-2,11,France - National,0.38,0.62,-2,0.75,1.38,2.63,1.61,5
Concarneau,8,2,4,2,11,10,1,10,France - National,0.25,0.75,1,1.38,1.25,4.0,1.33,6
Orleans,8,2,4,2,9,9,0,10,France - National,0.25,0.75,0,1.12,1.25,4.0,1.33,6
Valenciennes,8,2,3,3,7,7,0,9,France - National,0.25,0.62,0,0.88,1.12,4.0,1.61,7
Sochaux,8,2,3,3,7,9,-2,9,France - National,0.25,0.62,-2,0.88,1.12,4.0,1.61,7
Aubagne,8,2,3,3,6,8,-2,9,France - National,0.25,0.62,-2,0.75,1.12,4.0,1.61,7
Nimes,8,2,2,4,6,12,-6,8,France - National,0.25,0.5,-6,0.75,1.0,4.0,2.0,8
Villefranche,8,1,3,4,8,12,-4,6,France - National,0.12,0.5,-4,1.0,0.75,8.33,2.0,9
Versailles,8,0,5,3,8,12,-4,5,France - National,0.0,0.62,-4,1.0,0.62,0.0,1.61,10
Paris 13 A.,8,1,2,5,7,12,-5,5,France - National,0.12,0.38,-5,0.88,0.62,8.33,2.63,10
Iberia,8,6,2,0,13,3,10,20,Georgia - Erovnuli Liga,0.75,1.0,10,1.62,2.5,1.33,1.0,1
Dinamo Batumi,8,6,2,0,12,3,9,20,Georgia - Erovnuli Liga,0.75,1.0,9,1.5,2.5,1.33,1.0,1
Dila Gori,8,5,1,2,15,7,8,16,Georgia - Erovnuli Liga,0.62,0.75,8,1.88,2.0,1.61,1.33,2
Samgurali,8,3,2,3,13,6,7,11,Georgia - Erovnuli Liga,0.38,0.62,7,1.62,1.38,2.63,1.61,3
Dinamo Tbilisi,8,3,2,3,9,7,2,11,Georgia - Erovnuli Liga,0.38,0.62,2,1.12,1.38,2.63,1.61,3
Gagra,8,3,1,4,5,9,-4,10,Georgia - Erovnuli Liga,0.38,0.5,-4,0.62,1.25,2.63,2.0,4
Telavi,8,3,1,4,6,18,-12,10,Georgia - Erovnuli Liga,0.38,0.5,-12,0.75,1.25,2.63,2.0,4
Torpedo Kutaisi,8,1,3,4,8,11,-3,6,Georgia - Erovnuli Liga,0.12,0.5,-3,1.0,0.75,8.33,2.0,5
Kolkheti Poti,8,1,2,5,3,13,-10,5,Georgia - Erovnuli Liga,0.12,0.38,-10,0.38,0.62,8.33,2.63,6
Gareji Sagarejo,8,1,1,6,5,11,-6,4,Georgia - Erovnuli Liga,0.12,0.25,-6,0.62,0.5,8.33,4.0,7
Spaeri,7,5,2,0,18,9,9,17,Georgia - Erovnuli Liga 2,0.71,1.0,9,2.57,2.43,1.41,1.0,1
Rustavi,7,3,3,1,10,8,2,12,Georgia - Erovnuli Liga 2,0.43,0.86,2,1.43,1.71,2.33,1.16,2
Merani Martvili,7,3,1,3,12,14,-2,10,Georgia - Erovnuli Liga 2,0.43,0.57,-2,1.71,1.43,2.33,1.75,3
Gonio,7,2,3,2,9,8,1,9,Georgia - Erovnuli Liga 2,0.29,0.71,1,1.29,1.29,3.45,1.41,4
Bolnisi,7,2,2,3,6,7,-1,8,Georgia - Erovnuli Liga 2,0.29,0.57,-1,0.86,1.14,3.45,1.75,5
L. Tbilisi,7,1,4,2,10,10,0,7,Georgia - Erovnuli Liga 2,0.14,0.71,0,1.43,1.0,7.14,1.41,6
Samtredia,7,1,4,2,7,8,-1,7,Georgia - Erovnuli Liga 2,0.14,0.71,-1,1.0,1.0,7.14,1.41,6
D. Tbilisi B,7,1,4,2,8,10,-2,7,Georgia - Erovnuli Liga 2,0.14,0.71,-2,1.14,1.0,7.14,1.41,6
Meshakhte,7,1,4,2,5,8,-3,7,Georgia - Erovnuli Liga 2,0.14,0.71,-3,0.71,1.0,7.14,1.41,6
Iberia B,7,1,3,3,7,10,-3,6,Georgia - Erovnuli Liga 2,0.14,0.57,-3,1.0,0.86,7.14,1.75,7
Bayern Munich,8,5,2,1,22,10,12,17,Germany - Bundesliga,0.62,0.88,12,2.75,2.12,1.61,1.14,1
Leverkusen,8,5,2,1,15,8,7,17,Germany - Bundesliga,0.62,0.88,7,1.88,2.12,1.61,1.14,1
Dortmund,8,5,1,2,20,9,11,16,Germany - Bundesliga,0.62,0.75,11,2.5,2.0,1.61,1.33,2
FC Augsburg,8,4,3,1,9,5,4,15,Germany - Bundesliga,0.5,0.88,4,1.12,1.88,2.0,1.14,3
Werder Bremen,8,5,0,3,13,12,1,15,Germany - Bundesliga,0.62,0.62,1,1.62,1.88,1.61,1.61,3
Freiburg,8,3,3,2,14,11,3,12,Germany - Bundesliga,0.38,0.75,3,1.75,1.5,2.63,1.33,4
RB Leipzig,8,3,3,2,12,9,3,12,Germany - Bundesliga,0.38,0.75,3,1.5,1.5,2.63,1.33,4
FSV Mainz,8,3,3,2,13,12,1,12,Germany - Bundesliga,0.38,0.75,1,1.62,1.5,2.63,1.33,4
Union Berlin,8,3,3,2,10,14,-4,12,Germany - Bundesliga,0.38,0.75,-4,1.25,1.5,2.63,1.33,4
Monchengladbach,8,3,1,4,13,14,-1,10,Germany - Bundesliga,0.38,0.5,-1,1.62,1.25,2.63,2.0,5
E. Frankfurt,8,3,1,4,9,13,-4,10,Germany - Bundesliga,0.38,0.5,-4,1.12,1.25,2.63,2.0,5
Hoffenheim,8,2,3,3,9,10,-1,9,Germany - Bundesliga,0.25,0.62,-1,1.12,1.12,4.0,1.61,6
Sankt Pauli,8,2,3,3,8,11,-3,9,Germany - Bundesliga,0.25,0.62,-3,1.0,1.12,4.0,1.61,6
Heidenheim,8,2,2,4,7,15,-8,8,Germany - Bundesliga,0.25,0.5,-8,0.88,1.0,4.0,2.0,7
Stuttgart,8,1,3,4,16,17,-1,6,Germany - Bundesliga,0.12,0.5,-1,2.0,0.75,8.33,2.0,8
Wolfsburg,8,1,3,4,8,11,-3,6,Germany - Bundesliga,0.12,0.5,-3,1.0,0.75,8.33,2.0,8
Holstein Kiel,8,1,3,4,7,14,-7,6,Germany - Bundesliga,0.12,0.5,-7,0.88,0.75,8.33,2.0,8
Bochum,8,1,1,6,7,17,-10,4,Germany - Bundesliga,0.12,0.25,-10,0.88,0.5,8.33,4.0,9
Hamburger SV,8,4,2,2,17,9,8,14,Germany - 2. Bundesliga,0.5,0.75,8,2.12,1.75,2.0,1.33,1
Hertha Berlin,8,4,2,2,14,11,3,14,Germany - 2. Bundesliga,0.5,0.75,3,1.75,1.75,2.0,1.33,1
FC Koln,8,4,2,2,10,7,3,14,Germany - 2. Bundesliga,0.5,0.75,3,1.25,1.75,2.0,1.33,1
Karlsruher SC,8,4,2,2,8,8,0,14,Germany - 2. Bundesliga,0.5,0.75,0,1.0,1.75,2.0,1.33,1
Elversberg,8,3,4,1,15,4,11,13,Germany - 2. Bundesliga,0.38,0.88,11,1.88,1.62,2.63,1.14,2
Darmstadt,8,4,1,3,13,10,3,13,Germany - 2. Bundesliga,0.5,0.62,3,1.62,1.62,2.0,1.61,2
Braunschweig,8,3,3,2,13,15,-2,12,Germany - 2. Bundesliga,0.38,0.75,-2,1.62,1.5,2.63,1.33,3
Paderborn,8,3,2,3,15,13,2,11,Germany - 2. Bundesliga,0.38,0.62,2,1.88,1.38,2.63,1.61,4
Magdeburg,8,3,2,3,11,9,2,11,Germany - 2. Bundesliga,0.38,0.62,2,1.38,1.38,2.63,1.61,4
Schalke 04,8,3,2,3,11,13,-2,11,Germany - 2. Bundesliga,0.38,0.62,-2,1.38,1.38,2.63,1.61,4
Dusseldorf,8,3,2,3,9,12,-3,11,Germany - 2. Bundesliga,0.38,0.62,-3,1.12,1.38,2.63,1.61,4
FC Nurnberg,8,3,1,4,10,11,-1,10,Germany - 2. Bundesliga,0.38,0.5,-1,1.25,1.25,2.63,2.0,5
Greuther Furth,8,2,3,3,10,11,-1,9,Germany - 2. Bundesliga,0.25,0.62,-1,1.25,1.12,4.0,1.61,6
Ulm,8,2,3,3,7,8,-1,9,Germany - 2. Bundesliga,0.25,0.62,-1,0.88,1.12,4.0,1.61,6
Hannover 96,8,2,3,3,8,11,-3,9,Germany - 2. Bundesliga,0.25,0.62,-3,1.0,1.12,4.0,1.61,6
Preuss. Munster,8,2,2,4,6,8,-2,8,Germany - 2. Bundesliga,0.25,0.5,-2,0.75,1.0,4.0,2.0,7
Kaiserslautern,8,2,1,5,11,16,-5,7,Germany - 2. Bundesliga,0.25,0.38,-5,1.38,0.88,4.0,2.63,8
Regensburg,8,2,1,5,4,16,-12,7,Germany - 2. Bundesliga,0.25,0.38,-12,0.5,0.88,4.0,2.63,8
Bielefeld,8,6,1,1,18,7,11,19,Germany - 3. Liga,0.75,0.88,11,2.25,2.38,1.33,1.14,1
1860 Munchen,8,6,1,1,15,4,11,19,Germany - 3. Liga,0.75,0.88,11,1.88,2.38,1.33,1.14,1
RW Essen,8,5,1,2,11,8,3,16,Germany - 3. Liga,0.62,0.75,3,1.38,2.0,1.61,1.33,2
Dynamo Dresden,8,4,3,1,13,7,6,15,Germany - 3. Liga,0.5,0.88,6,1.62,1.88,2.0,1.14,3
Hansa Rostock,8,4,1,3,13,9,4,13,Germany - 3. Liga,0.5,0.62,4,1.62,1.62,2.0,1.61,4
Alemannia A.,8,4,1,3,11,7,4,13,Germany - 3. Liga,0.5,0.62,4,1.38,1.62,2.0,1.61,4
Osnabruck,8,4,1,3,6,5,1,13,Germany - 3. Liga,0.5,0.62,1,0.75,1.62,2.0,1.61,4
Verl,8,4,1,3,12,13,-1,13,Germany - 3. Liga,0.5,0.62,-1,1.5,1.62,2.0,1.61,4
VfB Stuttgart B,8,3,2,3,12,11,1,11,Germany - 3. Liga,0.38,0.62,1,1.5,1.38,2.63,1.61,5
Dortmund B,8,2,4,2,10,8,2,10,Germany - 3. Liga,0.25,0.75,2,1.25,1.25,4.0,1.33,6
Viktoria Koln,8,3,1,4,9,11,-2,10,Germany - 3. Liga,0.38,0.5,-2,1.12,1.25,2.63,2.0,6
Energie Cottbus,8,3,1,4,8,14,-6,10,Germany - 3. Liga,0.38,0.5,-6,1.0,1.25,2.63,2.0,6
FC Ingolstadt,8,2,3,3,15,16,-1,9,Germany - 3. Liga,0.25,0.62,-1,1.88,1.12,4.0,1.61,7
Wehen Wiesbaden,8,2,3,3,11,12,-1,9,Germany - 3. Liga,0.25,0.62,-1,1.38,1.12,4.0,1.61,7
Saarbrucken,8,2,3,3,8,12,-4,9,Germany - 3. Liga,0.25,0.62,-4,1.0,1.12,4.0,1.61,7
Mannheim,8,2,3,3,7,11,-4,9,Germany - 3. Liga,0.25,0.62,-4,0.88,1.12,4.0,1.61,7
Erzgebirge Aue,8,3,0,5,9,15,-6,9,Germany - 3. Liga,0.38,0.38,-6,1.12,1.12,2.63,2.63,7
Hannover 96 B,8,1,5,2,15,16,-1,8,Germany - 3. Liga,0.12,0.75,-1,1.88,1.0,8.33,1.33,8
Unterhaching,8,1,2,5,9,16,-7,5,Germany - 3. Liga,0.12,0.38,-7,1.12,0.62,8.33,2.63,9
Sandhausen,8,0,1,7,7,17,-10,1,Germany - 3. Liga,0.0,0.12,-10,0.88,0.12,0.0,8.33,10
Nations,8,6,1,1,10,2,8,19,Ghana - Premier League,0.75,0.88,8,1.25,2.38,1.33,1.14,1
Aduana Stars,8,5,1,2,11,6,5,16,Ghana - Premier League,0.62,0.75,5,1.38,2.0,1.61,1.33,2
Bibiani GS,8,5,1,2,8,6,2,16,Ghana - Premier League,0.62,0.75,2,1.0,2.0,1.61,1.33,2
Dreams,8,5,1,2,8,7,1,16,Ghana - Premier League,0.62,0.75,1,1.0,2.0,1.61,1.33,2
Samartex,8,4,3,1,12,6,6,15,Ghana - Premier League,0.5,0.88,6,1.5,1.88,2.0,1.14,3
Heart of Lions,8,4,1,3,11,7,4,13,Ghana - Premier League,0.5,0.62,4,1.38,1.62,2.0,1.61,4
Accra Lions,8,4,1,3,11,8,3,13,Ghana - Premier League,0.5,0.62,3,1.38,1.62,2.0,1.61,4
Holy Stars,8,4,0,4,9,7,2,12,Ghana - Premier League,0.5,0.5,2,1.12,1.5,2.0,2.0,5
Karela,8,3,2,3,6,5,1,11,Ghana - Premier League,0.38,0.62,1,0.75,1.38,2.63,1.61,6
Bechem Utd,8,3,1,4,9,8,1,10,Ghana - Premier League,0.38,0.5,1,1.12,1.25,2.63,2.0,7
Berekum Chelsea,8,3,1,4,9,8,1,10,Ghana - Premier League,0.38,0.5,1,1.12,1.25,2.63,2.0,7
Young Apostles,8,2,4,2,6,6,0,10,Ghana - Premier League,0.25,0.75,0,0.75,1.25,4.0,1.33,7
Asante Kotoko,8,2,4,2,5,8,-3,10,Ghana - Premier League,0.25,0.75,-3,0.62,1.25,4.0,1.33,7
Medeama,8,3,0,5,10,8,2,9,Ghana - Premier League,0.38,0.38,2,1.25,1.12,2.63,2.63,8
Legon Cities,8,2,2,4,7,9,-2,8,Ghana - Premier League,0.25,0.5,-2,0.88,1.0,4.0,2.0,9
Vision,8,1,4,3,6,9,-3,7,Ghana - Premier League,0.12,0.62,-3,0.75,0.88,8.33,1.61,10
Hearts of Oak,8,1,3,4,3,7,-4,6,Ghana - Premier League,0.12,0.5,-4,0.38,0.75,8.33,2.0,11
Nsoatreman,8,0,0,8,0,24,-24,0,Ghana - Premier League,0.0,0.0,-24,0.0,0.0,0.0,0.0,12
Manchester 62,8,6,1,1,21,5,16,19,Gibraltar - Premier Division,0.75,0.88,16,2.62,2.38,1.33,1.14,1
Lincoln RI,8,6,1,1,18,4,14,19,Gibraltar - Premier Division,0.75,0.88,14,2.25,2.38,1.33,1.14,1
St Josephs,8,6,1,1,18,5,13,19,Gibraltar - Premier Division,0.75,0.88,13,2.25,2.38,1.33,1.14,1
Magpies,8,4,0,4,16,13,3,12,Gibraltar - Premier Division,0.5,0.5,3,2.0,1.5,2.0,2.0,2
Europa FC,8,4,0,4,13,12,1,12,Gibraltar - Premier Division,0.5,0.5,1,1.62,1.5,2.0,2.0,2
College 1975,8,3,1,4,13,13,0,10,Gibraltar - Premier Division,0.38,0.5,0,1.62,1.25,2.63,2.0,3
Lynx,8,3,1,4,10,22,-12,10,Gibraltar - Premier Division,0.38,0.5,-12,1.25,1.25,2.63,2.0,3
Lions FC,8,2,1,5,6,14,-8,7,Gibraltar - Premier Division,0.25,0.38,-8,0.75,0.88,4.0,2.63,4
Glacis Utd,8,2,0,6,13,24,-11,6,Gibraltar - Premier Division,0.25,0.25,-11,1.62,0.75,4.0,4.0,5
Europa Point,8,0,2,6,7,28,-21,2,Gibraltar - Premier Division,0.0,0.25,-21,0.88,0.25,0.0,4.0,6
Mons Calpe,8,0,1,7,7,25,-18,1,Gibraltar - Premier Division,0.0,0.12,-18,0.88,0.12,0.0,8.33,7
Olympiakos,8,6,1,1,15,6,9,19,Greece - Super League,0.75,0.88,9,1.88,2.38,1.33,1.14,1
Levadiakos,8,5,1,2,14,6,8,16,Greece - Super League,0.62,0.75,8,1.75,2.0,1.61,1.33,2
PAOK,8,5,0,3,22,10,12,15,Greece - Super League,0.62,0.62,12,2.75,1.88,1.61,1.61,3
Aris,8,4,3,1,9,6,3,15,Greece - Super League,0.5,0.88,3,1.12,1.88,2.0,1.14,3
Panathinaikos,8,4,1,3,14,13,1,13,Greece - Super League,0.5,0.62,1,1.75,1.62,2.0,1.61,4
Atromitos,8,4,1,3,9,8,1,13,Greece - Super League,0.5,0.62,1,1.12,1.62,2.0,1.61,4
OFI Crete,8,4,0,4,13,14,-1,12,Greece - Super League,0.5,0.5,-1,1.62,1.5,2.0,2.0,5
Panaitolikos,8,3,2,3,6,6,0,11,Greece - Super League,0.38,0.62,0,0.75,1.38,2.63,1.61,6
AEK Athens,8,3,1,4,13,9,4,10,Greece - Super League,0.38,0.5,4,1.62,1.25,2.63,2.0,7
A. Kallithea,8,3,1,4,10,13,-3,10,Greece - Super League,0.38,0.5,-3,1.25,1.25,2.63,2.0,7
Asteras T.,8,3,1,4,7,11,-4,10,Greece - Super League,0.38,0.5,-4,0.88,1.25,2.63,2.0,7
Panserraikos,8,3,1,4,8,17,-9,10,Greece - Super League,0.38,0.5,-9,1.0,1.25,2.63,2.0,7
Lamia,8,2,1,5,5,17,-12,7,Greece - Super League,0.25,0.38,-12,0.62,0.88,4.0,2.63,8
Volos,8,1,3,4,5,8,-3,6,Greece - Super League,0.12,0.5,-3,0.62,0.75,8.33,2.0,9
Malacateco,8,6,0,2,15,5,10,18,Guatemala - Liga Nacional - Apertura,0.75,0.75,10,1.88,2.25,1.33,1.33,1
Xelaju,8,5,2,1,16,5,11,17,Guatemala - Liga Nacional - Apertura,0.62,0.88,11,2.0,2.12,1.61,1.14,2
Municipal,8,4,2,2,13,13,0,14,Guatemala - Liga Nacional - Apertura,0.5,0.75,0,1.62,1.75,2.0,1.33,3
Coban Imperial,8,4,1,3,13,9,4,13,Guatemala - Liga Nacional - Apertura,0.5,0.62,4,1.62,1.62,2.0,1.61,4
Antigua GFC,8,3,3,2,14,11,3,12,Guatemala - Liga Nacional - Apertura,0.38,0.75,3,1.75,1.5,2.63,1.33,5
Xinabajul,8,3,2,3,15,14,1,11,Guatemala - Liga Nacional - Apertura,0.38,0.62,1,1.88,1.38,2.63,1.61,6
Comunicaciones,8,3,2,3,12,13,-1,11,Guatemala - Liga Nacional - Apertura,0.38,0.62,-1,1.5,1.38,2.63,1.61,6
Guastatoya,8,2,4,2,12,10,2,10,Guatemala - Liga Nacional - Apertura,0.25,0.75,2,1.5,1.25,4.0,1.33,7
Mixco,8,3,1,4,7,11,-4,10,Guatemala - Liga Nacional - Apertura,0.38,0.5,-4,0.88,1.25,2.63,2.0,7
Achuapa,8,2,3,3,6,10,-4,9,Guatemala - Liga Nacional - Apertura,0.25,0.62,-4,0.75,1.12,4.0,1.61,8
Marquense,8,0,3,5,4,16,-12,3,Guatemala - Liga Nacional - Apertura,0.0,0.38,-12,0.5,0.38,0.0,2.63,9
Zacapa Tellioz,8,0,2,6,3,14,-11,2,Guatemala - Liga Nacional - Apertura,0.0,0.25,-11,0.38,0.25,0.0,4.0,10
Antigua GFC,8,3,3,2,7,7,0,12,guatemala2,0.38,0.75,0,0.88,1.5,2.63,1.33,1
Municipal,8,3,2,3,8,6,2,11,guatemala2,0.38,0.62,2,1.0,1.38,2.63,1.61,2
Guastatoya,8,3,1,4,8,11,-3,10,guatemala2,0.38,0.5,-3,1.0,1.25,2.63,2.0,3
Comunicaciones,8,2,3,3,8,9,-1,9,guatemala2,0.25,0.62,-1,1.0,1.12,4.0,1.61,4
Mixco,8,1,5,2,7,9,-2,8,guatemala2,0.12,0.75,-2,0.88,1.0,8.33,1.33,5
Malacateco,8,1,3,4,10,14,-4,6,guatemala2,0.12,0.5,-4,1.25,0.75,8.33,2.0,6
Coban Imperial,8,2,0,6,10,18,-8,6,guatemala2,0.25,0.25,-8,1.25,0.75,4.0,4.0,6
Marquense,8,1,2,5,4,10,-6,5,guatemala2,0.12,0.38,-6,0.5,0.62,8.33,2.63,7
Xinabajul,8,1,1,6,7,23,-16,4,guatemala2,0.12,0.25,-16,0.88,0.5,8.33,4.0,8
Achuapa,8,1,0,7,7,12,-5,3,guatemala2,0.12,0.12,-5,0.88,0.38,8.33,8.33,9
Xelaju,8,0,3,5,5,10,-5,3,guatemala2,0.0,0.38,-5,0.62,0.38,0.0,2.63,9
Olimpia,8,6,2,0,16,4,12,20,Honduras - Liga Nacional - Apertura,0.75,1.0,12,2.0,2.5,1.33,1.0,1
Genesis,8,4,3,1,16,8,8,15,Honduras - Liga Nacional - Apertura,0.5,0.88,8,2.0,1.88,2.0,1.14,2
Motagua,8,4,2,2,18,14,4,14,Honduras - Liga Nacional - Apertura,0.5,0.75,4,2.25,1.75,2.0,1.33,3
Olancho,8,3,4,1,15,10,5,13,Honduras - Liga Nacional - Apertura,0.38,0.88,5,1.88,1.62,2.63,1.14,4
Marathon,8,2,4,2,9,8,1,10,Honduras - Liga Nacional - Apertura,0.25,0.75,1,1.12,1.25,4.0,1.33,5
Juticalpa,8,2,2,4,7,14,-7,8,Honduras - Liga Nacional - Apertura,0.25,0.5,-7,0.88,1.0,4.0,2.0,6
UPNFM,8,2,2,4,6,16,-10,8,Honduras - Liga Nacional - Apertura,0.25,0.5,-10,0.75,1.0,4.0,2.0,6
Real Espana,8,1,4,3,6,7,-1,7,Honduras - Liga Nacional - Apertura,0.12,0.62,-1,0.75,0.88,8.33,1.61,7
Real Sociedad,8,1,3,4,10,17,-7,6,Honduras - Liga Nacional - Apertura,0.12,0.5,-7,1.25,0.75,8.33,2.0,8
Victoria,8,1,2,5,13,18,-5,5,Honduras - Liga Nacional - Apertura,0.12,0.38,-5,1.62,0.62,8.33,2.63,9
Marathon,8,4,3,1,12,6,6,15,honduras2,0.5,0.88,6,1.5,1.88,2.0,1.14,1
Olimpia,8,4,2,2,11,6,5,14,honduras2,0.5,0.75,5,1.38,1.75,2.0,1.33,2
Real Espana,8,4,2,2,12,8,4,14,honduras2,0.5,0.75,4,1.5,1.75,2.0,1.33,2
Victoria,8,3,3,2,12,10,2,12,honduras2,0.38,0.75,2,1.5,1.5,2.63,1.33,3
Motagua,8,2,3,3,9,9,0,9,honduras2,0.25,0.62,0,1.12,1.12,4.0,1.61,4
Olancho,8,1,4,3,9,12,-3,7,honduras2,0.12,0.62,-3,1.12,0.88,8.33,1.61,5
Genesis,8,1,4,3,5,9,-4,7,honduras2,0.12,0.62,-4,0.62,0.88,8.33,1.61,5
Juticalpa,8,1,2,5,3,17,-14,5,honduras2,0.12,0.38,-14,0.38,0.62,8.33,2.63,6
Real Sociedad,8,0,4,4,5,13,-8,4,honduras2,0.0,0.5,-8,0.62,0.5,0.0,2.0,7
UPNFM,8,0,3,5,5,18,-13,3,honduras2,0.0,0.38,-13,0.62,0.38,0.0,2.63,8
LM Warriors,8,6,1,1,20,13,7,19,Hong Kong - Premier League,0.75,0.88,7,2.5,2.38,1.33,1.14,1
Eastern,8,5,2,1,22,12,10,17,Hong Kong - Premier League,0.62,0.88,10,2.75,2.12,1.61,1.14,2
Tai Po,8,5,1,2,27,16,11,16,Hong Kong - Premier League,0.62,0.75,11,3.38,2.0,1.61,1.33,3
Kitchee,8,4,0,4,16,13,3,12,Hong Kong - Premier League,0.5,0.5,3,2.0,1.5,2.0,2.0,4
North District,8,4,0,4,16,22,-6,12,Hong Kong - Premier League,0.5,0.5,-6,2.0,1.5,2.0,2.0,4
HK Rangers,8,3,2,3,13,12,1,11,Hong Kong - Premier League,0.38,0.62,1,1.62,1.38,2.63,1.61,5
Southern D.,8,2,2,4,12,13,-1,8,Hong Kong - Premier League,0.25,0.5,-1,1.5,1.0,4.0,2.0,6
Kowloon City,8,2,1,5,15,24,-9,7,Hong Kong - Premier League,0.25,0.38,-9,1.88,0.88,4.0,2.63,7
Hong Kong FC,8,0,1,7,5,20,-15,1,Hong Kong - Premier League,0.0,0.12,-15,0.62,0.12,0.0,8.33,8
Ferencvaros,8,6,2,0,22,4,18,20,Hungary - NB I,0.75,1.0,18,2.75,2.5,1.33,1.0,1
Paks,8,5,3,0,21,10,11,18,Hungary - NB I,0.62,1.0,11,2.62,2.25,1.61,1.0,2
Gyor,8,5,3,0,14,6,8,18,Hungary - NB I,0.62,1.0,8,1.75,2.25,1.61,1.0,2
MTK Budapest,8,3,3,2,17,8,9,12,Hungary - NB I,0.38,0.75,9,2.12,1.5,2.63,1.33,3
Puskas A.,8,3,3,2,13,11,2,12,Hungary - NB I,0.38,0.75,2,1.62,1.5,2.63,1.33,3
Debrecen,8,3,1,4,16,14,2,10,Hungary - NB I,0.38,0.5,2,2.0,1.25,2.63,2.0,4
DVTK,8,2,2,4,8,17,-9,8,Hungary - NB I,0.25,0.5,-9,1.0,1.0,4.0,2.0,5
Fehervar,8,1,4,3,8,12,-4,7,Hungary - NB I,0.12,0.62,-4,1.0,0.88,8.33,1.61,6
Ujpest,8,1,4,3,7,17,-10,7,Hungary - NB I,0.12,0.62,-10,0.88,0.88,8.33,1.61,6
Zalaegerszegi,8,1,3,4,8,12,-4,6,Hungary - NB I,0.12,0.5,-4,1.0,0.75,8.33,2.0,7
Nyiregyhaza,8,1,2,5,1,15,-14,5,Hungary - NB I,0.12,0.38,-14,0.12,0.62,8.33,2.63,8
Kecskemeti TE,8,0,4,4,9,18,-9,4,Hungary - NB I,0.0,0.5,-9,1.12,0.5,0.0,2.0,9
Kisvarda,8,7,1,0,18,8,10,22,Hungary - NB II,0.88,1.0,10,2.25,2.75,1.14,1.0,1
Honved,8,5,1,2,14,9,5,16,Hungary - NB II,0.62,0.75,5,1.75,2.0,1.61,1.33,2
Vasas,8,5,0,3,14,9,5,15,Hungary - NB II,0.62,0.62,5,1.75,1.88,1.61,1.61,3
Szentlorinc,8,3,5,0,12,5,7,14,Hungary - NB II,0.38,1.0,7,1.5,1.75,2.63,1.0,4
Mezokovesd,8,4,1,3,12,8,4,13,Hungary - NB II,0.5,0.62,4,1.5,1.62,2.0,1.61,5
Kazincbarcika,8,3,4,1,9,6,3,13,Hungary - NB II,0.38,0.88,3,1.12,1.62,2.63,1.14,5
Kozarmisleny,8,4,0,4,11,15,-4,12,Hungary - NB II,0.5,0.5,-4,1.38,1.5,2.0,2.0,6
Ajka,8,3,2,3,9,10,-1,11,Hungary - NB II,0.38,0.62,-1,1.12,1.38,2.63,1.61,7
BVSC,8,2,3,3,9,10,-1,9,Hungary - NB II,0.25,0.62,-1,1.12,1.12,4.0,1.61,8
Szeged,8,2,3,3,8,12,-4,9,Hungary - NB II,0.25,0.62,-4,1.0,1.12,4.0,1.61,8
Bekescsaba,8,2,2,4,9,11,-2,8,Hungary - NB II,0.25,0.5,-2,1.12,1.0,4.0,2.0,9
Soroksar,8,2,2,4,12,15,-3,8,Hungary - NB II,0.25,0.5,-3,1.5,1.0,4.0,2.0,9
Tatabanya,8,2,2,4,8,13,-5,8,Hungary - NB II,0.25,0.5,-5,1.0,1.0,4.0,2.0,9
Csakvari,8,2,1,5,10,13,-3,7,Hungary - NB II,0.25,0.38,-3,1.25,0.88,4.0,2.63,10
Budafoki,8,2,0,6,10,15,-5,6,Hungary - NB II,0.25,0.25,-5,1.25,0.75,4.0,4.0,11
Gyirmot,8,0,5,3,5,11,-6,5,Hungary - NB II,0.0,0.62,-6,0.62,0.62,0.0,1.61,12
Vikingur R.,2,2,0,0,6,0,6,6,Iceland - Besta deild,1.0,1.0,6,3.0,3.0,1.0,1.0,1
Stjarnan,2,2,0,0,4,2,2,6,Iceland - Besta deild,1.0,1.0,2,2.0,3.0,1.0,1.0,1
Vestri,2,1,1,0,2,1,1,4,Iceland - Besta deild,0.5,1.0,1,1.0,2.0,2.0,1.0,2
Fram,2,1,0,1,4,3,1,3,Iceland - Besta deild,0.5,0.5,1,2.0,1.5,2.0,2.0,3
Breidablik,2,1,0,1,4,4,0,3,Iceland - Besta deild,0.5,0.5,0,2.0,1.5,2.0,2.0,3
IA Akranes,2,1,0,1,2,2,0,3,Iceland - Besta deild,0.5,0.5,0,1.0,1.5,2.0,2.0,3
KR Reykjavik,2,0,2,0,5,5,0,2,Iceland - Besta deild,0.0,1.0,0,2.5,1.0,0.0,1.0,4
Valur,2,0,2,0,4,4,0,2,Iceland - Besta deild,0.0,1.0,0,2.0,1.0,0.0,1.0,4
Afturelding,2,0,1,1,0,2,-2,1,Iceland - Besta deild,0.0,0.5,-2,0.0,0.5,0.0,2.0,5
IBV,2,0,1,1,0,2,-2,1,Iceland - Besta deild,0.0,0.5,-2,0.0,0.5,0.0,2.0,5
KA Akureyri,2,0,1,1,2,6,-4,1,Iceland - Besta deild,0.0,0.5,-4,1.0,0.5,0.0,2.0,5
Hafnarfjordur,2,0,0,2,1,3,-2,0,Iceland - Besta deild,0.0,0.0,-2,0.5,0.0,0.0,0.0,6
Afturelding,8,6,1,1,18,7,11,19,Iceland - 1. Deild,0.75,0.88,11,2.25,2.38,1.33,1.14,1
Keflavik,8,5,2,1,17,9,8,17,Iceland - 1. Deild,0.62,0.88,8,2.12,2.12,1.61,1.14,2
Leiknir R.,8,4,4,0,18,10,8,16,Iceland - 1. Deild,0.5,1.0,8,2.25,2.0,2.0,1.0,3
IBV,8,4,2,2,22,12,10,14,Iceland - 1. Deild,0.5,0.75,10,2.75,1.75,2.0,1.33,4
IR Reykjavik,8,3,4,1,10,10,0,13,Iceland - 1. Deild,0.38,0.88,0,1.25,1.62,2.63,1.14,5
Throttur R.,8,3,2,3,15,12,3,11,Iceland - 1. Deild,0.38,0.62,3,1.88,1.38,2.63,1.61,6
Grindavik,8,2,3,3,18,19,-1,9,Iceland - 1. Deild,0.25,0.62,-1,2.25,1.12,4.0,1.61,7
Thor Akureyri,8,2,3,3,11,16,-5,9,Iceland - 1. Deild,0.25,0.62,-5,1.38,1.12,4.0,1.61,7
Njardvik,8,1,5,2,8,11,-3,8,Iceland - 1. Deild,0.12,0.75,-3,1.0,1.0,8.33,1.33,8
Fjolnir,8,1,3,4,6,14,-8,6,Iceland - 1. Deild,0.12,0.5,-8,0.75,0.75,8.33,2.0,9
Dalvik / Reynir,8,1,1,6,10,25,-15,4,Iceland - 1. Deild,0.12,0.25,-15,1.25,0.5,8.33,4.0,10
Grotta,8,1,0,7,9,17,-8,3,Iceland - 1. Deild,0.12,0.12,-8,1.12,0.38,8.33,8.33,11
Throttur Vogar,8,6,2,0,29,7,22,20,Iceland - 2. Deild,0.75,1.0,22,3.62,2.5,1.33,1.0,1
Selfoss,8,6,1,1,22,12,10,19,Iceland - 2. Deild,0.75,0.88,10,2.75,2.38,1.33,1.14,2
Volsungur,8,5,3,0,21,7,14,18,Iceland - 2. Deild,0.62,1.0,14,2.62,2.25,1.61,1.0,3
V. Olafsvik,8,5,1,2,19,13,6,16,Iceland - 2. Deild,0.62,0.75,6,2.38,2.0,1.61,1.33,4
Haukar,8,3,1,4,16,14,2,10,Iceland - 2. Deild,0.38,0.5,2,2.0,1.25,2.63,2.0,5
Fjardabyggd/L.,8,3,1,4,23,24,-1,10,Iceland - 2. Deild,0.38,0.5,-1,2.88,1.25,2.63,2.0,5
AEggir,8,2,4,2,9,12,-3,10,Iceland - 2. Deild,0.25,0.75,-3,1.12,1.25,4.0,1.33,5
Hottur/Huginn,8,3,0,5,11,23,-12,9,Iceland - 2. Deild,0.38,0.38,-12,1.38,1.12,2.63,2.63,6
KFG,8,2,2,4,12,16,-4,8,Iceland - 2. Deild,0.25,0.5,-4,1.5,1.0,4.0,2.0,7
Reynir,8,2,1,5,11,16,-5,7,Iceland - 2. Deild,0.25,0.38,-5,1.38,0.88,4.0,2.63,8
Fjallabyggd,8,2,1,5,12,22,-10,7,Iceland - 2. Deild,0.25,0.38,-10,1.5,0.88,4.0,2.63,8
Kormakur/Hvot,8,0,1,7,5,24,-19,1,Iceland - 2. Deild,0.0,0.12,-19,0.62,0.12,0.0,8.33,9
Mohun Bagan,8,6,2,0,16,2,14,20,India - Super League,0.75,1.0,14,2.0,2.5,1.33,1.0,1
Goa,8,6,0,2,13,7,6,18,India - Super League,0.75,0.75,6,1.62,2.25,1.33,1.33,2
NorthEast Utd,8,4,2,2,15,7,8,14,India - Super League,0.5,0.75,8,1.88,1.75,2.0,1.33,3
East Bengal,8,4,2,2,11,11,0,14,India - Super League,0.5,0.75,0,1.38,1.75,2.0,1.33,3
Mumbai City,8,3,3,2,10,6,4,12,India - Super League,0.38,0.75,4,1.25,1.5,2.63,1.33,4
Odisha FC,8,3,3,2,13,11,2,12,India - Super League,0.38,0.75,2,1.62,1.5,2.63,1.33,4
Bengaluru,8,3,1,4,11,10,1,10,India - Super League,0.38,0.5,1,1.38,1.25,2.63,2.0,5
Chennaiyin,8,3,1,4,11,12,-1,10,India - Super League,0.38,0.5,-1,1.38,1.25,2.63,2.0,5
Jamshedpur,8,3,1,4,12,16,-4,10,India - Super League,0.38,0.5,-4,1.5,1.25,2.63,2.0,5
Kerala Blasters,8,2,3,3,7,10,-3,9,India - Super League,0.25,0.62,-3,0.88,1.12,4.0,1.61,6
Punjab,8,2,2,4,11,15,-4,8,India - Super League,0.25,0.5,-4,1.38,1.0,4.0,2.0,7
Hyderabad,8,2,2,4,10,16,-6,8,India - Super League,0.25,0.5,-6,1.25,1.0,4.0,2.0,7
Mohammedan,8,0,2,6,4,19,-15,2,India - Super League,0.0,0.25,-15,0.5,0.25,0.0,4.0,8
Gokulam,8,6,0,2,23,14,9,18,India - I-League,0.75,0.75,9,2.88,2.25,1.33,1.33,1
Inter Kashi,8,4,3,1,14,11,3,15,India - I-League,0.5,0.88,3,1.75,1.88,2.0,1.14,2
Churchill B.,8,3,5,0,18,9,9,14,India - I-League,0.38,1.0,9,2.25,1.75,2.63,1.0,3
Real Kashmir,8,4,2,2,12,12,0,14,India - I-League,0.5,0.75,0,1.5,1.75,2.0,1.33,3
Rajasthan,8,4,0,4,16,13,3,12,India - I-League,0.5,0.5,3,2.0,1.5,2.0,2.0,4
Sreenidi Deccan,8,3,3,2,11,10,1,12,India - I-League,0.38,0.75,1,1.38,1.5,2.63,1.33,4
Dempo,8,3,2,3,24,17,7,11,India - I-League,0.38,0.62,7,3.0,1.38,2.63,1.61,5
Aizawl,8,3,2,3,16,15,1,11,India - I-League,0.38,0.62,1,2.0,1.38,2.63,1.61,5
SC Bengaluru,8,2,2,4,11,18,-7,8,India - I-League,0.25,0.5,-7,1.38,1.0,4.0,2.0,6
Namdhari,8,2,1,5,8,14,-6,7,India - I-League,0.25,0.38,-6,1.0,0.88,4.0,2.63,7
Shillong Lajong,8,1,3,4,12,23,-11,6,India - I-League,0.12,0.5,-11,1.5,0.75,8.33,2.0,8
Delhi FC,8,1,1,6,7,16,-9,4,India - I-League,0.12,0.25,-9,0.88,0.5,8.33,4.0,9
Malut United,8,5,3,0,14,6,8,18,Indonesia - Liga 1,0.62,1.0,8,1.75,2.25,1.61,1.0,1
Dewa Utd,8,5,1,2,14,6,8,16,Indonesia - Liga 1,0.62,0.75,8,1.75,2.0,1.61,1.33,2
Persib,8,4,3,1,16,11,5,15,Indonesia - Liga 1,0.5,0.88,5,2.0,1.88,2.0,1.14,3
Persis Solo,8,4,3,1,12,8,4,15,Indonesia - Liga 1,0.5,0.88,4,1.5,1.88,2.0,1.14,3
Arema,8,4,2,2,20,13,7,14,Indonesia - Liga 1,0.5,0.75,7,2.5,1.75,2.0,1.33,4
Persebaya S.,8,4,2,2,10,7,3,14,Indonesia - Liga 1,0.5,0.75,3,1.25,1.75,2.0,1.33,4
Madura Utd,8,4,2,2,9,6,3,14,Indonesia - Liga 1,0.5,0.75,3,1.12,1.75,2.0,1.33,4
PSM,8,3,4,1,11,7,4,13,Indonesia - Liga 1,0.38,0.88,4,1.38,1.62,2.63,1.14,5
PSBS Biak N.,8,3,4,1,8,5,3,13,Indonesia - Liga 1,0.38,0.88,3,1.0,1.62,2.63,1.14,5
Borneo,8,3,2,3,8,10,-2,11,Indonesia - Liga 1,0.38,0.62,-2,1.0,1.38,2.63,1.61,6
Barito Putera,8,3,1,4,12,13,-1,10,Indonesia - Liga 1,0.38,0.5,-1,1.5,1.25,2.63,2.0,7
Persita,8,3,1,4,10,12,-2,10,Indonesia - Liga 1,0.38,0.5,-2,1.25,1.25,2.63,2.0,7
Persija,8,2,2,4,8,10,-2,8,Indonesia - Liga 1,0.25,0.5,-2,1.0,1.0,4.0,2.0,8
Semen Padang,8,2,2,4,9,18,-9,8,Indonesia - Liga 1,0.25,0.5,-9,1.12,1.0,4.0,2.0,8
Bali Utd,8,1,4,3,8,12,-4,7,Indonesia - Liga 1,0.12,0.62,-4,1.0,0.88,8.33,1.61,9
PSIS Semarang,8,0,4,4,7,12,-5,4,Indonesia - Liga 1,0.0,0.5,-5,0.88,0.5,0.0,2.0,10
Persik Kediri,8,0,4,4,5,11,-6,4,Indonesia - Liga 1,0.0,0.5,-6,0.62,0.5,0.0,2.0,10
PSS Sleman,8,1,0,7,8,19,-11,3,Indonesia - Liga 1,0.12,0.12,-11,1.0,0.38,8.33,8.33,11
Tractor Sazi,8,6,2,0,12,4,8,20,Iran - Pro League,0.75,1.0,8,1.5,2.5,1.33,1.0,1
Sepahan,8,4,4,0,12,4,8,16,Iran - Pro League,0.5,1.0,8,1.5,2.0,2.0,1.0,2
Malavan,8,5,0,3,10,8,2,15,Iran - Pro League,0.62,0.62,2,1.25,1.88,1.61,1.61,3
Persepolis,8,4,2,2,9,7,2,14,Iran - Pro League,0.5,0.75,2,1.12,1.75,2.0,1.33,4
Foolad,8,4,1,3,8,8,0,13,Iran - Pro League,0.5,0.62,0,1.0,1.62,2.0,1.61,5
Shams A. Qazvin,8,3,2,3,10,9,1,11,Iran - Pro League,0.38,0.62,1,1.25,1.38,2.63,1.61,6
Zob Ahan,8,3,2,3,9,9,0,11,Iran - Pro League,0.38,0.62,0,1.12,1.38,2.63,1.61,6
K. Khorramabad,8,3,2,3,5,7,-2,11,Iran - Pro League,0.38,0.62,-2,0.62,1.38,2.63,1.61,6
Gol Gohar,8,2,4,2,6,6,0,10,Iran - Pro League,0.25,0.75,0,0.75,1.25,4.0,1.33,7
Mes Rafsanjan,8,2,3,3,6,7,-1,9,Iran - Pro League,0.25,0.62,-1,0.75,1.12,4.0,1.61,8
Chadormalu,8,2,2,4,7,8,-1,8,Iran - Pro League,0.25,0.5,-1,0.88,1.0,4.0,2.0,9
Havadar,8,2,2,4,9,15,-6,8,Iran - Pro League,0.25,0.5,-6,1.12,1.0,4.0,2.0,9
Esteghlal,8,1,4,3,8,10,-2,7,Iran - Pro League,0.12,0.62,-2,1.0,0.88,8.33,1.61,10
Aluminium Arak,8,1,4,3,4,6,-2,7,Iran - Pro League,0.12,0.62,-2,0.5,0.88,8.33,1.61,10
E. Khuzestan,8,1,4,3,5,8,-3,7,Iran - Pro League,0.12,0.62,-3,0.62,0.88,8.33,1.61,10
N. Mazandaran,8,1,2,5,2,7,-5,5,Iran - Pro League,0.12,0.38,-5,0.25,0.62,8.33,2.63,11
Shamrock Rovers,8,5,2,1,14,7,7,17,Ireland - Premier Division,0.62,0.88,7,1.75,2.12,1.61,1.14,1
St. Patricks,8,4,3,1,11,4,7,15,Ireland - Premier Division,0.5,0.88,7,1.38,1.88,2.0,1.14,2
Drogheda Utd,8,4,3,1,11,6,5,15,Ireland - Premier Division,0.5,0.88,5,1.38,1.88,2.0,1.14,2
Galway Utd,8,3,3,2,11,9,2,12,Ireland - Premier Division,0.38,0.75,2,1.38,1.5,2.63,1.33,3
Bohemians,8,4,0,4,11,11,0,12,Ireland - Premier Division,0.5,0.5,0,1.38,1.5,2.0,2.0,3
Shelbourne,8,2,5,1,9,8,1,11,Ireland - Premier Division,0.25,0.88,1,1.12,1.38,4.0,1.14,4
Derry City,8,3,2,3,9,11,-2,11,Ireland - Premier Division,0.38,0.62,-2,1.12,1.38,2.63,1.61,4
Sligo Rovers,8,2,1,5,14,15,-1,7,Ireland - Premier Division,0.25,0.38,-1,1.75,0.88,4.0,2.63,5
Cork City,8,1,3,4,7,13,-6,6,Ireland - Premier Division,0.12,0.5,-6,0.88,0.75,8.33,2.0,6
Waterford,8,1,0,7,4,17,-13,3,Ireland - Premier Division,0.12,0.12,-13,0.5,0.38,8.33,8.33,7
Dundalk,8,5,3,0,14,6,8,18,Ireland - First Division,0.62,1.0,8,1.75,2.25,1.61,1.0,1
Bray Wanderers,8,6,0,2,13,10,3,18,Ireland - First Division,0.75,0.75,3,1.62,2.25,1.33,1.33,1
Cobh Ramblers,8,5,0,3,14,7,7,15,Ireland - First Division,0.62,0.62,7,1.75,1.88,1.61,1.61,2
Wexford,8,4,2,2,13,10,3,14,Ireland - First Division,0.5,0.75,3,1.62,1.75,2.0,1.33,3
Finn Harps,8,3,4,1,16,9,7,13,Ireland - First Division,0.38,0.88,7,2.0,1.62,2.63,1.14,4
Longford Town,8,2,2,4,9,14,-5,8,Ireland - First Division,0.25,0.5,-5,1.12,1.0,4.0,2.0,5
Athlone Town,8,2,2,4,5,10,-5,8,Ireland - First Division,0.25,0.5,-5,0.62,1.0,4.0,2.0,5
UC Dublin,8,2,1,5,3,7,-4,7,Ireland - First Division,0.25,0.38,-4,0.38,0.88,4.0,2.63,6
Treaty Utd,8,1,3,4,7,10,-3,6,Ireland - First Division,0.12,0.5,-3,0.88,0.75,8.33,2.0,7
Kerry,8,2,0,6,9,15,-6,6,Ireland - First Division,0.25,0.25,-6,1.12,0.75,4.0,4.0,7
H. Beer Sheva,8,5,2,1,17,10,7,17,Israel - Ligat HaAl,0.62,0.88,7,2.12,2.12,1.61,1.14,1
M. Tel Aviv,8,5,1,2,17,9,8,16,Israel - Ligat HaAl,0.62,0.75,8,2.12,2.0,1.61,1.33,2
Ashdod,8,4,3,1,15,8,7,15,Israel - Ligat HaAl,0.5,0.88,7,1.88,1.88,2.0,1.14,3
H. Jerusalem,8,3,4,1,14,8,6,13,Israel - Ligat HaAl,0.38,0.88,6,1.75,1.62,2.63,1.14,4
B. Jerusalem,8,3,3,2,12,11,1,12,Israel - Ligat HaAl,0.38,0.75,1,1.5,1.5,2.63,1.33,5
Maccabi Haifa,8,3,3,2,12,12,0,12,Israel - Ligat HaAl,0.38,0.75,0,1.5,1.5,2.63,1.33,5
Ironi Tiberias,8,3,2,3,9,11,-2,11,Israel - Ligat HaAl,0.38,0.62,-2,1.12,1.38,2.63,1.61,6
M. Bnei Raina,8,3,1,4,9,11,-2,10,Israel - Ligat HaAl,0.38,0.5,-2,1.12,1.25,2.63,2.0,7
Kiryat Shmona,8,3,1,4,9,12,-3,10,Israel - Ligat HaAl,0.38,0.5,-3,1.12,1.25,2.63,2.0,7
Hapoel Haifa,8,3,1,4,10,15,-5,10,Israel - Ligat HaAl,0.38,0.5,-5,1.25,1.25,2.63,2.0,7
Sakhnin,8,3,0,5,8,14,-6,9,Israel - Ligat HaAl,0.38,0.38,-6,1.0,1.12,2.63,2.63,8
Hapoel Hadera,8,2,1,5,8,16,-8,7,Israel - Ligat HaAl,0.25,0.38,-8,1.0,0.88,4.0,2.63,9
M. Petah Tikva,8,2,0,6,9,11,-2,6,Israel - Ligat HaAl,0.25,0.25,-2,1.12,0.75,4.0,4.0,10
Maccabi Netanya,8,0,3,5,5,13,-8,3,Israel - Ligat HaAl,0.0,0.38,-8,0.62,0.38,0.0,2.63,11
H. Petah Tikva,8,7,1,0,8,1,7,22,Israel - Leumit League,0.88,1.0,7,1.0,2.75,1.14,1.0,1
Hapoel Tel Aviv,8,6,1,1,17,3,14,19,Israel - Leumit League,0.75,0.88,14,2.12,2.38,1.33,1.14,2
H. Ironi Rishon,8,5,0,3,19,13,6,15,Israel - Leumit League,0.62,0.62,6,2.38,1.88,1.61,1.61,3
H. Ramat Gan,8,4,2,2,19,8,11,14,Israel - Leumit League,0.5,0.75,11,2.38,1.75,2.0,1.33,4
Maccabi Jaffa,8,3,4,1,10,9,1,13,Israel - Leumit League,0.38,0.88,1,1.25,1.62,2.63,1.14,5
Hapoel Akko,8,3,3,2,9,7,2,12,Israel - Leumit League,0.38,0.75,2,1.12,1.5,2.63,1.33,6
Hapoel Raanana,8,2,4,2,6,6,0,10,Israel - Leumit League,0.25,0.75,0,0.75,1.25,4.0,1.33,7
H. Kfar Saba,8,3,1,4,7,10,-3,10,Israel - Leumit League,0.38,0.5,-3,0.88,1.25,2.63,2.0,7
M. Herziliya,8,3,1,4,8,12,-4,10,Israel - Leumit League,0.38,0.5,-4,1.0,1.25,2.63,2.0,7
H. Kfar Shalem,8,3,0,5,8,9,-1,9,Israel - Leumit League,0.38,0.38,-1,1.0,1.12,2.63,2.63,8
Kafr Qasim,8,2,3,3,8,9,-1,9,Israel - Leumit League,0.25,0.62,-1,1.0,1.12,4.0,1.61,8
Hapoel Afula,8,1,4,3,5,7,-2,7,Israel - Leumit League,0.12,0.62,-2,0.62,0.88,8.33,1.61,9
H. Nof Hagalil,8,1,4,3,3,5,-2,7,Israel - Leumit League,0.12,0.62,-2,0.38,0.88,8.33,1.61,9
H. Umm al-Fahm,8,1,4,3,7,12,-5,7,Israel - Leumit League,0.12,0.62,-5,0.88,0.88,8.33,1.61,9
Bnei Yehuda,8,2,0,6,6,14,-8,6,Israel - Leumit League,0.25,0.25,-8,0.75,0.75,4.0,4.0,10
Ramat Hasharon,8,0,4,4,6,21,-15,4,Israel - Leumit League,0.0,0.5,-15,0.75,0.5,0.0,2.0,11
AS Roma,8,6,2,0,12,3,9,20,Italy - Serie A,0.75,1.0,9,1.5,2.5,1.33,1.0,1
Bologna,8,6,1,1,14,6,8,19,Italy - Serie A,0.75,0.88,8,1.75,2.38,1.33,1.14,2
Inter Milan,8,5,2,1,14,8,6,17,Italy - Serie A,0.62,0.88,6,1.75,2.12,1.61,1.14,3
Juventus,8,5,1,2,8,9,-1,16,Italy - Serie A,0.62,0.75,-1,1.0,2.0,1.61,1.33,4
Napoli,8,4,3,1,11,6,5,15,Italy - Serie A,0.5,0.88,5,1.38,1.88,2.0,1.14,5
Como,8,4,2,2,13,8,5,14,Italy - Serie A,0.5,0.75,5,1.62,1.75,2.0,1.33,6
Atalanta,8,4,1,3,12,4,8,13,Italy - Serie A,0.5,0.62,8,1.5,1.62,2.0,1.61,7
Torino,8,3,3,2,11,9,2,12,Italy - Serie A,0.38,0.75,2,1.38,1.5,2.63,1.33,8
Genoa,8,3,3,2,7,5,2,12,Italy - Serie A,0.38,0.75,2,0.88,1.5,2.63,1.33,8
Fiorentina,8,3,2,3,8,7,1,11,Italy - Serie A,0.38,0.62,1,1.0,1.38,2.63,1.61,9
Lazio,8,2,5,1,8,11,-3,11,Italy - Serie A,0.25,0.88,-3,1.0,1.38,4.0,1.14,9
AC Milan,8,3,1,4,14,12,2,10,Italy - Serie A,0.38,0.5,2,1.75,1.25,2.63,2.0,10
Udinese,8,3,1,4,7,9,-2,10,Italy - Serie A,0.38,0.5,-2,0.88,1.25,2.63,2.0,10
Venezia,8,1,6,1,5,5,0,9,Italy - Serie A,0.12,0.88,0,0.62,1.12,8.33,1.14,11
Hellas Verona,8,2,3,3,4,6,-2,9,Italy - Serie A,0.25,0.62,-2,0.5,1.12,4.0,1.61,11
Parma,8,1,5,2,7,7,0,8,Italy - Serie A,0.12,0.75,0,0.88,1.0,8.33,1.33,12
Cagliari,8,1,3,4,6,8,-2,6,Italy - Serie A,0.12,0.5,-2,0.75,0.75,8.33,2.0,13
Empoli,8,0,4,4,4,14,-10,4,Italy - Serie A,0.0,0.5,-10,0.5,0.5,0.0,2.0,14
Lecce,8,0,1,7,5,14,-9,1,Italy - Serie A,0.0,0.12,-9,0.62,0.12,0.0,8.33,15
Monza,8,0,1,7,4,18,-14,1,Italy - Serie A,0.0,0.12,-14,0.5,0.12,0.0,8.33,15
Sassuolo,8,5,2,1,17,9,8,17,Italy - Serie B,0.62,0.88,8,2.12,2.12,1.61,1.14,1
Frosinone,8,4,4,0,13,7,6,16,Italy - Serie B,0.5,1.0,6,1.62,2.0,2.0,1.0,2
Palermo,8,4,2,2,17,12,5,14,Italy - Serie B,0.5,0.75,5,2.12,1.75,2.0,1.33,3
Juve Stabia,8,4,2,2,11,8,3,14,Italy - Serie B,0.5,0.75,3,1.38,1.75,2.0,1.33,3
Pisa,8,4,1,3,15,9,6,13,Italy - Serie B,0.5,0.62,6,1.88,1.62,2.0,1.61,4
Cremonese,8,3,4,1,16,11,5,13,Italy - Serie B,0.38,0.88,5,2.0,1.62,2.63,1.14,4
Catanzaro,8,3,3,2,13,12,1,12,Italy - Serie B,0.38,0.75,1,1.62,1.5,2.63,1.33,5
Cesena,8,2,5,1,9,7,2,11,Italy - Serie B,0.25,0.88,2,1.12,1.38,4.0,1.14,6
Carrarese,8,2,5,1,13,12,1,11,Italy - Serie B,0.25,0.88,1,1.62,1.38,4.0,1.14,6
Bari,8,2,5,1,10,9,1,11,Italy - Serie B,0.25,0.88,1,1.25,1.38,4.0,1.14,6
Modena,8,3,2,3,10,10,0,11,Italy - Serie B,0.38,0.62,0,1.25,1.38,2.63,1.61,6
Sudtirol,8,2,4,2,12,10,2,10,Italy - Serie B,0.25,0.75,2,1.5,1.25,4.0,1.33,7
Spezia,8,2,4,2,9,8,1,10,Italy - Serie B,0.25,0.75,1,1.12,1.25,4.0,1.33,7
Mantova,8,2,3,3,11,12,-1,9,Italy - Serie B,0.25,0.62,-1,1.38,1.12,4.0,1.61,8
Salernitana,8,2,2,4,7,10,-3,8,Italy - Serie B,0.25,0.5,-3,0.88,1.0,4.0,2.0,9
Sampdoria,8,1,4,3,6,11,-5,7,Italy - Serie B,0.12,0.62,-5,0.75,0.88,8.33,1.61,10
Brescia,8,1,3,4,5,9,-4,6,Italy - Serie B,0.12,0.5,-4,0.62,0.75,8.33,2.0,11
Cosenza,8,1,3,4,5,17,-12,6,Italy - Serie B,0.12,0.5,-12,0.62,0.75,8.33,2.0,11
Cittadella,8,1,2,5,5,13,-8,5,Italy - Serie B,0.12,0.38,-8,0.62,0.62,8.33,2.63,12
Reggiana,8,0,4,4,8,16,-8,4,Italy - Serie B,0.0,0.5,-8,1.0,0.5,0.0,2.0,13
FeralpiSalo,8,5,2,1,14,7,7,17,Italy - Serie C - Group A,0.62,0.88,7,1.75,2.12,1.61,1.14,1
Renate,8,5,2,1,13,8,5,17,Italy - Serie C - Group A,0.62,0.88,5,1.62,2.12,1.61,1.14,1
Vicenza,8,5,2,1,11,7,4,17,Italy - Serie C - Group A,0.62,0.88,4,1.38,2.12,1.61,1.14,1
Giana Erminio,8,5,1,2,11,4,7,16,Italy - Serie C - Group A,0.62,0.75,7,1.38,2.0,1.61,1.33,2
Padova,8,5,1,2,14,9,5,16,Italy - Serie C - Group A,0.62,0.75,5,1.75,2.0,1.61,1.33,2
Arzignano,8,5,0,3,12,7,5,15,Italy - Serie C - Group A,0.62,0.62,5,1.5,1.88,1.61,1.61,3
AlbinoLeffe,8,5,0,3,13,12,1,15,Italy - Serie C - Group A,0.62,0.62,1,1.62,1.88,1.61,1.61,3
Atalanta B,8,3,4,1,14,10,4,13,Italy - Serie C - Group A,0.38,0.88,4,1.75,1.62,2.63,1.14,4
Pro Patria,8,3,3,2,9,6,3,12,Italy - Serie C - Group A,0.38,0.75,3,1.12,1.5,2.63,1.33,5
Virtus Verona,8,3,3,2,9,8,1,12,Italy - Serie C - Group A,0.38,0.75,1,1.12,1.5,2.63,1.33,5
Trento,8,3,2,3,8,9,-1,11,Italy - Serie C - Group A,0.38,0.62,-1,1.0,1.38,2.63,1.61,6
Novara,8,3,1,4,9,9,0,10,Italy - Serie C - Group A,0.38,0.5,0,1.12,1.25,2.63,2.0,7
Lecco,8,2,4,2,6,6,0,10,Italy - Serie C - Group A,0.25,0.75,0,0.75,1.25,4.0,1.33,7
Caldiero Terme,8,2,3,3,11,12,-1,9,Italy - Serie C - Group A,0.25,0.62,-1,1.38,1.12,4.0,1.61,8
Triestina,8,2,1,5,3,9,-6,7,Italy - Serie C - Group A,0.25,0.38,-6,0.38,0.88,4.0,2.63,9
Alcione,8,1,3,4,4,9,-5,6,Italy - Serie C - Group A,0.12,0.5,-5,0.5,0.75,8.33,2.0,10
Pro Vercelli,8,1,3,4,6,12,-6,6,Italy - Serie C - Group A,0.12,0.5,-6,0.75,0.75,8.33,2.0,10
Pergolettese,8,1,1,6,5,11,-6,4,Italy - Serie C - Group A,0.12,0.25,-6,0.62,0.5,8.33,4.0,11
Lumezzane,8,0,4,4,7,15,-8,4,Italy - Serie C - Group A,0.0,0.5,-8,0.88,0.5,0.0,2.0,11
Clodiense,8,1,0,7,9,18,-9,3,Italy - Serie C - Group A,0.12,0.12,-9,1.12,0.38,8.33,8.33,12
Entella,8,6,2,0,17,5,12,20,Italy - Serie C - Group B,0.75,1.0,12,2.12,2.5,1.33,1.0,1
Pineto,8,5,1,2,11,12,-1,16,Italy - Serie C - Group B,0.62,0.75,-1,1.38,2.0,1.61,1.33,2
Perugia,8,4,3,1,10,6,4,15,Italy - Serie C - Group B,0.5,0.88,4,1.25,1.88,2.0,1.14,3
Arezzo,8,5,0,3,8,4,4,15,Italy - Serie C - Group B,0.62,0.62,4,1.0,1.88,1.61,1.61,3
Rimini,8,4,1,3,11,9,2,13,Italy - Serie C - Group B,0.5,0.62,2,1.38,1.62,2.0,1.61,4
Ternana,8,4,1,3,9,7,2,13,Italy - Serie C - Group B,0.5,0.62,2,1.12,1.62,2.0,1.61,4
Pontedera,8,3,3,2,13,11,2,12,Italy - Serie C - Group B,0.38,0.75,2,1.62,1.5,2.63,1.33,5
Lucchese,8,3,3,2,14,14,0,12,Italy - Serie C - Group B,0.38,0.75,0,1.75,1.5,2.63,1.33,5
Athletic Carpi,8,3,3,2,8,8,0,12,Italy - Serie C - Group B,0.38,0.75,0,1.0,1.5,2.63,1.33,5
Pescara,8,3,2,3,13,9,4,11,Italy - Serie C - Group B,0.38,0.62,4,1.62,1.38,2.63,1.61,6
AC Milan B,8,3,2,3,9,9,0,11,Italy - Serie C - Group B,0.38,0.62,0,1.12,1.38,2.63,1.61,6
Gubbio,8,3,2,3,6,7,-1,11,Italy - Serie C - Group B,0.38,0.62,-1,0.75,1.38,2.63,1.61,6
Pianese,8,3,0,5,8,9,-1,9,Italy - Serie C - Group B,0.38,0.38,-1,1.0,1.12,2.63,2.63,7
Torres,8,2,3,3,7,8,-1,9,Italy - Serie C - Group B,0.25,0.62,-1,0.88,1.12,4.0,1.61,7
Legnago Salus,8,1,4,3,6,10,-4,7,Italy - Serie C - Group B,0.12,0.62,-4,0.75,0.88,8.33,1.61,8
Sestri Levante,8,2,1,5,10,15,-5,7,Italy - Serie C - Group B,0.25,0.38,-5,1.25,0.88,4.0,2.63,8
SPAL,8,1,4,3,6,11,-5,7,Italy - Serie C - Group B,0.12,0.62,-5,0.75,0.88,8.33,1.61,8
Campobasso,8,2,1,5,8,14,-6,7,Italy - Serie C - Group B,0.25,0.38,-6,1.0,0.88,4.0,2.63,8
Vis Pesaro,8,1,3,4,7,9,-2,6,Italy - Serie C - Group B,0.12,0.5,-2,0.88,0.75,8.33,2.0,9
Ascoli,8,1,3,4,4,8,-4,6,Italy - Serie C - Group B,0.12,0.5,-4,0.5,0.75,8.33,2.0,9
Avellino,8,8,0,0,13,4,9,24,Italy - Serie C - Group C,1.0,1.0,9,1.62,3.0,1.0,1.0,1
Catania,8,4,3,1,12,5,7,15,Italy - Serie C - Group C,0.5,0.88,7,1.5,1.88,2.0,1.14,2
Monopoli,8,4,2,2,9,6,3,14,Italy - Serie C - Group C,0.5,0.75,3,1.12,1.75,2.0,1.33,3
Crotone,8,4,2,2,14,12,2,14,Italy - Serie C - Group C,0.5,0.75,2,1.75,1.75,2.0,1.33,3
Juventus U23,8,4,1,3,14,9,5,13,Italy - Serie C - Group C,0.5,0.62,5,1.75,1.62,2.0,1.61,4
Picerno,8,3,4,1,11,7,4,13,Italy - Serie C - Group C,0.38,0.88,4,1.38,1.62,2.63,1.14,4
A. Cerignola,8,4,1,3,10,9,1,13,Italy - Serie C - Group C,0.5,0.62,1,1.25,1.62,2.0,1.61,4
Casertana,8,3,2,3,13,7,6,11,Italy - Serie C - Group C,0.38,0.62,6,1.62,1.38,2.63,1.61,5
Cavese,8,3,2,3,10,12,-2,11,Italy - Serie C - Group C,0.38,0.62,-2,1.25,1.38,2.63,1.61,5
Potenza,8,2,4,2,13,12,1,10,Italy - Serie C - Group C,0.25,0.75,1,1.62,1.25,4.0,1.33,6
ACR Messina,8,3,1,4,13,13,0,10,Italy - Serie C - Group C,0.38,0.5,0,1.62,1.25,2.63,2.0,6
Altamura,8,3,1,4,9,12,-3,10,Italy - Serie C - Group C,0.38,0.5,-3,1.12,1.25,2.63,2.0,6
Latina,8,3,1,4,8,16,-8,10,Italy - Serie C - Group C,0.38,0.5,-8,1.0,1.25,2.63,2.0,6
Trapani,8,3,0,5,7,10,-3,9,Italy - Serie C - Group C,0.38,0.38,-3,0.88,1.12,2.63,2.63,7
Giugliano,8,2,2,4,18,17,1,8,Italy - Serie C - Group C,0.25,0.5,1,2.25,1.0,4.0,2.0,8
Benevento,8,1,5,2,9,9,0,8,Italy - Serie C - Group C,0.12,0.75,0,1.12,1.0,8.33,1.33,8
Foggia,8,1,1,6,8,17,-9,4,Italy - Serie C - Group C,0.12,0.25,-9,1.0,0.5,8.33,4.0,9
Sorrento,8,1,1,6,5,18,-13,4,Italy - Serie C - Group C,0.12,0.25,-13,0.62,0.5,8.33,4.0,9
Taranto,0,0,0,0,0,0,0,0,Italy - Serie C - Group C,0.0,0.0,0,0.0,0.0,0.0,0.0,10
Turris,0,0,0,0,0,0,0,0,Italy - Serie C - Group C,0.0,0.0,0,0.0,0.0,0.0,0.0,10
Gozzano,8,6,2,0,15,6,9,20,Italy - Serie D - Group A,0.75,1.0,9,1.88,2.5,1.33,1.0,1
Lavagnese,8,6,1,1,12,6,6,19,Italy - Serie D - Group A,0.75,0.88,6,1.5,2.38,1.33,1.14,2
NovaRomentin,8,5,2,1,18,5,13,17,Italy - Serie D - Group A,0.62,0.88,13,2.25,2.12,1.61,1.14,3
Bra,8,5,2,1,12,6,6,17,Italy - Serie D - Group A,0.62,0.88,6,1.5,2.12,1.61,1.14,3
Oltrepo,8,5,1,2,9,5,4,16,Italy - Serie D - Group A,0.62,0.75,4,1.12,2.0,1.61,1.33,4
Vado,8,3,3,2,9,7,2,12,Italy - Serie D - Group A,0.38,0.75,2,1.12,1.5,2.63,1.33,5
Sanremese,8,3,3,2,6,5,1,12,Italy - Serie D - Group A,0.38,0.75,1,0.75,1.5,2.63,1.33,5
Ligorna,8,3,3,2,11,12,-1,12,Italy - Serie D - Group A,0.38,0.75,-1,1.38,1.5,2.63,1.33,5
Derthona,8,3,2,3,6,6,0,11,Italy - Serie D - Group A,0.38,0.62,0,0.75,1.38,2.63,1.61,6
Asti,8,2,4,2,7,5,2,10,Italy - Serie D - Group A,0.25,0.75,2,0.88,1.25,4.0,1.33,7
Saluzzo,8,2,4,2,9,8,1,10,Italy - Serie D - Group A,0.25,0.75,1,1.12,1.25,4.0,1.33,7
Chieri,8,1,5,2,8,8,0,8,Italy - Serie D - Group A,0.12,0.75,0,1.0,1.0,8.33,1.33,8
Citta di Varese,8,2,2,4,8,10,-2,8,Italy - Serie D - Group A,0.25,0.5,-2,1.0,1.0,4.0,2.0,8
Vogherese,8,1,5,2,5,7,-2,8,Italy - Serie D - Group A,0.12,0.75,-2,0.62,1.0,8.33,1.33,8
Borgaro Nobis,8,2,1,5,7,16,-9,7,Italy - Serie D - Group A,0.25,0.38,-9,0.88,0.88,4.0,2.63,9
Chisola,8,1,3,4,6,10,-4,6,Italy - Serie D - Group A,0.12,0.5,-4,0.75,0.75,8.33,2.0,10
Cairese,8,1,2,5,4,9,-5,5,Italy - Serie D - Group A,0.12,0.38,-5,0.5,0.62,8.33,2.63,11
Pro Imperia,8,1,1,6,6,16,-10,4,Italy - Serie D - Group A,0.12,0.25,-10,0.75,0.5,8.33,4.0,12
Fossano,8,1,0,7,5,16,-11,3,Italy - Serie D - Group A,0.12,0.12,-11,0.62,0.38,8.33,8.33,13
Albenga,0,0,0,0,0,0,0,0,Italy - Serie D - Group A,0.0,0.0,0,0.0,0.0,0.0,0.0,14
USD Casatese,8,6,1,1,17,5,12,19,Italy - Serie D - Group B,0.75,0.88,12,2.12,2.38,1.33,1.14,1
F. Caratese,8,5,1,2,18,8,10,16,Italy - Serie D - Group B,0.62,0.75,10,2.25,2.0,1.61,1.33,2
Pro Palazzolo,8,5,1,2,13,8,5,16,Italy - Serie D - Group B,0.62,0.75,5,1.62,2.0,1.61,1.33,2
Desenxano,8,5,1,2,10,5,5,16,Italy - Serie D - Group B,0.62,0.75,5,1.25,2.0,1.61,1.33,2
Ospitaletto,8,4,3,1,12,8,4,15,Italy - Serie D - Group B,0.5,0.88,4,1.5,1.88,2.0,1.14,3
Sondrio,8,5,0,3,10,6,4,15,Italy - Serie D - Group B,0.62,0.62,4,1.25,1.88,1.61,1.61,3
Varesina,8,4,2,2,16,12,4,14,Italy - Serie D - Group B,0.5,0.75,4,2.0,1.75,2.0,1.33,4
Club Milano,8,4,0,4,12,14,-2,12,Italy - Serie D - Group B,0.5,0.5,-2,1.5,1.5,2.0,2.0,5
Castellanzese,8,2,5,1,12,11,1,11,Italy - Serie D - Group B,0.25,0.88,1,1.5,1.38,4.0,1.14,6
Sangiuliano C.,8,3,2,3,10,10,0,11,Italy - Serie D - Group B,0.38,0.62,0,1.25,1.38,2.63,1.61,6
Pro Sesto,8,3,2,3,8,9,-1,11,Italy - Serie D - Group B,0.38,0.62,-1,1.0,1.38,2.63,1.61,6
Chievo,8,3,1,4,10,7,3,10,Italy - Serie D - Group B,0.38,0.5,3,1.25,1.25,2.63,2.0,7
Magenta,8,2,3,3,7,10,-3,9,Italy - Serie D - Group B,0.25,0.62,-3,0.88,1.12,4.0,1.61,8
Vigasio,8,3,0,5,7,10,-3,9,Italy - Serie D - Group B,0.38,0.38,-3,0.88,1.12,2.63,2.63,8
Breno,8,2,2,4,9,19,-10,8,Italy - Serie D - Group B,0.25,0.5,-10,1.12,1.0,4.0,2.0,9
Crema,8,2,1,5,12,14,-2,7,Italy - Serie D - Group B,0.25,0.38,-2,1.5,0.88,4.0,2.63,10
SantAngelo,8,1,4,3,8,10,-2,7,Italy - Serie D - Group B,0.12,0.62,-2,1.0,0.88,8.33,1.61,10
Ciliverghe,8,2,1,5,9,20,-11,7,Italy - Serie D - Group B,0.25,0.38,-11,1.12,0.88,4.0,2.63,10
Arconatese,8,1,3,4,9,15,-6,6,Italy - Serie D - Group B,0.12,0.5,-6,1.12,0.75,8.33,2.0,11
Fanfulla,8,0,3,5,5,13,-8,3,Italy - Serie D - Group B,0.0,0.38,-8,0.62,0.38,0.0,2.63,12
Real Calepina,8,5,3,0,12,5,7,18,Italy - Serie D - Group C,0.62,1.0,7,1.5,2.25,1.61,1.0,1
Brian Lignano,8,4,4,0,13,5,8,16,Italy - Serie D - Group C,0.5,1.0,8,1.62,2.0,2.0,1.0,2
Adriese,8,5,1,2,15,8,7,16,Italy - Serie D - Group C,0.62,0.75,7,1.88,2.0,1.61,1.33,2
Villa Alme,8,5,1,2,15,11,4,16,Italy - Serie D - Group C,0.62,0.75,4,1.88,2.0,1.61,1.33,2
Mestre,8,4,2,2,8,5,3,14,Italy - Serie D - Group C,0.5,0.75,3,1.0,1.75,2.0,1.33,3
Treviso,8,4,2,2,7,5,2,14,Italy - Serie D - Group C,0.5,0.75,2,0.88,1.75,2.0,1.33,3
Bassano Virtus,8,4,1,3,15,5,10,13,Italy - Serie D - Group C,0.5,0.62,10,1.88,1.62,2.0,1.61,4
D. Bellunesi,8,3,4,1,12,10,2,13,Italy - Serie D - Group C,0.38,0.88,2,1.5,1.62,2.63,1.14,4
Portogruaro,8,3,3,2,8,5,3,12,Italy - Serie D - Group C,0.38,0.75,3,1.0,1.5,2.63,1.33,5
Luparense,8,3,3,2,10,9,1,12,Italy - Serie D - Group C,0.38,0.75,1,1.25,1.5,2.63,1.33,5
Este,8,3,3,2,9,10,-1,12,Italy - Serie D - Group C,0.38,0.75,-1,1.12,1.5,2.63,1.33,5
Campodarsego,8,2,4,2,9,8,1,10,Italy - Serie D - Group C,0.25,0.75,1,1.12,1.25,4.0,1.33,6
Brusaporto,8,2,3,3,6,6,0,9,Italy - Serie D - Group C,0.25,0.62,0,0.75,1.12,4.0,1.61,7
Chions,8,2,3,3,8,10,-2,9,Italy - Serie D - Group C,0.25,0.62,-2,1.0,1.12,4.0,1.61,7
Cjarlins Muzane,8,2,3,3,10,15,-5,9,Italy - Serie D - Group C,0.25,0.62,-5,1.25,1.12,4.0,1.61,7
Ciserano,8,1,5,2,4,6,-2,8,Italy - Serie D - Group C,0.12,0.75,-2,0.5,1.0,8.33,1.33,8
Calvi Noale,8,2,1,5,9,13,-4,7,Italy - Serie D - Group C,0.25,0.38,-4,1.12,0.88,4.0,2.63,9
Caravaggio,8,0,3,5,6,13,-7,3,Italy - Serie D - Group C,0.0,0.38,-7,0.75,0.38,0.0,2.63,10
Lavis,8,1,0,7,5,20,-15,3,Italy - Serie D - Group C,0.12,0.12,-15,0.62,0.38,8.33,8.33,10
Montecchio M.,8,0,2,6,2,12,-10,2,Italy - Serie D - Group C,0.0,0.25,-10,0.25,0.25,0.0,4.0,11
Forli,8,8,0,0,19,5,14,24,Italy - Serie D - Group D,1.0,1.0,14,2.38,3.0,1.0,1.0,1
Ravenna,8,6,1,1,22,10,12,19,Italy - Serie D - Group D,0.75,0.88,12,2.75,2.38,1.33,1.14,2
Lentigione,8,6,1,1,16,4,12,19,Italy - Serie D - Group D,0.75,0.88,12,2.0,2.38,1.33,1.14,2
Zenith Prato,8,4,2,2,11,6,5,14,Italy - Serie D - Group D,0.5,0.75,5,1.38,1.75,2.0,1.33,3
Pistoiese,8,4,1,3,7,5,2,13,Italy - Serie D - Group D,0.5,0.62,2,0.88,1.62,2.0,1.61,4
Cittadella Vis,8,3,3,2,13,10,3,12,Italy - Serie D - Group D,0.38,0.75,3,1.62,1.5,2.63,1.33,5
Piacenza,8,3,3,2,10,7,3,12,Italy - Serie D - Group D,0.38,0.75,3,1.25,1.5,2.63,1.33,5
San Marino C.,8,3,3,2,14,12,2,12,Italy - Serie D - Group D,0.38,0.75,2,1.75,1.5,2.63,1.33,5
Imolese,8,3,3,2,10,8,2,12,Italy - Serie D - Group D,0.38,0.75,2,1.25,1.5,2.63,1.33,5
Tau Altopascio,8,2,5,1,10,7,3,11,Italy - Serie D - Group D,0.25,0.88,3,1.25,1.38,4.0,1.14,6
Prato,8,3,1,4,9,11,-2,10,Italy - Serie D - Group D,0.38,0.5,-2,1.12,1.25,2.63,2.0,7
Sasso Marconi,8,2,3,3,11,12,-1,9,Italy - Serie D - Group D,0.25,0.62,-1,1.38,1.12,4.0,1.61,8
Sammaurese,8,2,2,4,3,5,-2,8,Italy - Serie D - Group D,0.25,0.5,-2,0.38,1.0,4.0,2.0,9
Corticella,8,2,1,5,6,19,-13,7,Italy - Serie D - Group D,0.25,0.38,-13,0.75,0.88,4.0,2.63,10
Tuttocuoio,8,1,3,4,9,12,-3,6,Italy - Serie D - Group D,0.12,0.5,-3,1.12,0.75,8.33,2.0,11
Fiorenzuola,8,2,0,6,4,14,-10,6,Italy - Serie D - Group D,0.25,0.25,-10,0.5,0.75,4.0,4.0,11
Progresso,8,1,2,5,7,12,-5,5,Italy - Serie D - Group D,0.12,0.38,-5,0.88,0.62,8.33,2.63,12
United Riccione,8,0,0,8,1,23,-22,0,Italy - Serie D - Group D,0.0,0.0,-22,0.12,0.0,0.0,0.0,13
Flaminia,8,4,3,1,16,10,6,15,Italy - Serie D - Group E,0.5,0.88,6,2.0,1.88,2.0,1.14,1
S. Trestina,8,4,3,1,8,5,3,15,Italy - Serie D - Group E,0.5,0.88,3,1.0,1.88,2.0,1.14,1
Orvietana,8,4,2,2,13,10,3,14,Italy - Serie D - Group E,0.5,0.75,3,1.62,1.75,2.0,1.33,2
Ghiviborgo,8,4,1,3,18,8,10,13,Italy - Serie D - Group E,0.5,0.62,10,2.25,1.62,2.0,1.61,3
Fulgens Foligno,8,3,4,1,13,10,3,13,Italy - Serie D - Group E,0.38,0.88,3,1.62,1.62,2.63,1.14,3
Ostia Mare,8,3,4,1,12,10,2,13,Italy - Serie D - Group E,0.38,0.88,2,1.5,1.62,2.63,1.14,3
Livorno,8,3,3,2,16,17,-1,12,Italy - Serie D - Group E,0.38,0.75,-1,2.0,1.5,2.63,1.33,4
San Donato,8,3,2,3,9,7,2,11,Italy - Serie D - Group E,0.38,0.62,2,1.12,1.38,2.63,1.61,5
Seravezza,8,3,2,3,12,13,-1,11,Italy - Serie D - Group E,0.38,0.62,-1,1.5,1.38,2.63,1.61,5
Grosseto,8,2,4,2,7,6,1,10,Italy - Serie D - Group E,0.25,0.75,1,0.88,1.25,4.0,1.33,6
T. Traiana,8,2,4,2,6,7,-1,10,Italy - Serie D - Group E,0.25,0.75,-1,0.75,1.25,4.0,1.33,6
Poggibonsi,8,3,1,4,3,6,-3,10,Italy - Serie D - Group E,0.38,0.5,-3,0.38,1.25,2.63,2.0,6
FC Siena,8,2,3,3,9,11,-2,9,Italy - Serie D - Group E,0.25,0.62,-2,1.12,1.12,4.0,1.61,7
Montevarchi,8,1,5,2,7,8,-1,8,Italy - Serie D - Group E,0.12,0.75,-1,0.88,1.0,8.33,1.33,8
Fezzanese,8,2,2,4,9,14,-5,8,Italy - Serie D - Group E,0.25,0.5,-5,1.12,1.0,4.0,2.0,8
Gavorrano,8,1,4,3,7,13,-6,7,Italy - Serie D - Group E,0.12,0.62,-6,0.88,0.88,8.33,1.61,9
Sangiovannese,8,1,3,4,10,14,-4,6,Italy - Serie D - Group E,0.12,0.5,-4,1.25,0.75,8.33,2.0,10
Figline,8,1,2,5,2,8,-6,5,Italy - Serie D - Group E,0.12,0.38,-6,0.25,0.62,8.33,2.63,11
Teramo,8,5,1,2,11,6,5,16,Italy - Serie D - Group F,0.62,0.75,5,1.38,2.0,1.61,1.33,1
Sambenedettese,8,4,2,2,10,6,4,14,Italy - Serie D - Group F,0.5,0.75,4,1.25,1.75,2.0,1.33,2
Avezzano,8,4,2,2,11,9,2,14,Italy - Serie D - Group F,0.5,0.75,2,1.38,1.75,2.0,1.33,2
Termoli Calcio,8,3,4,1,10,10,0,13,Italy - Serie D - Group F,0.38,0.88,0,1.25,1.62,2.63,1.14,3
San Nicolo,8,4,1,3,9,10,-1,13,Italy - Serie D - Group F,0.5,0.62,-1,1.12,1.62,2.0,1.61,3
Sora,8,3,3,2,10,6,4,12,Italy - Serie D - Group F,0.38,0.75,4,1.25,1.5,2.63,1.33,4
Fossombrone,8,3,3,2,10,7,3,12,Italy - Serie D - Group F,0.38,0.75,3,1.25,1.5,2.63,1.33,4
LAquila,8,3,2,3,11,8,3,11,Italy - Serie D - Group F,0.38,0.62,3,1.38,1.38,2.63,1.61,5
Civitanovese,8,3,2,3,9,7,2,11,Italy - Serie D - Group F,0.38,0.62,2,1.12,1.38,2.63,1.61,5
Chieti,8,3,2,3,9,11,-2,11,Italy - Serie D - Group F,0.38,0.62,-2,1.12,1.38,2.63,1.61,5
Atletico Ascoli,8,2,4,2,7,7,0,10,Italy - Serie D - Group F,0.25,0.75,0,0.88,1.25,4.0,1.33,6
Isernia,8,3,1,4,8,9,-1,10,Italy - Serie D - Group F,0.38,0.5,-1,1.0,1.25,2.63,2.0,6
Recanatese,8,3,1,4,9,14,-5,10,Italy - Serie D - Group F,0.38,0.5,-5,1.12,1.25,2.63,2.0,6
Ancona 1905,8,2,3,3,10,11,-1,9,Italy - Serie D - Group F,0.25,0.62,-1,1.25,1.12,4.0,1.61,7
Roma City,8,2,3,3,9,10,-1,9,Italy - Serie D - Group F,0.25,0.62,-1,1.12,1.12,4.0,1.61,7
V. Senigallia,8,1,4,3,6,10,-4,7,Italy - Serie D - Group F,0.12,0.62,-4,0.75,0.88,8.33,1.61,8
Fermana,8,1,3,4,7,10,-3,6,Italy - Serie D - Group F,0.12,0.5,-3,0.88,0.75,8.33,2.0,9
Castelfidardo,8,1,3,4,4,9,-5,6,Italy - Serie D - Group F,0.12,0.5,-5,0.5,0.75,8.33,2.0,9
Guidonia,8,7,1,0,23,6,17,22,Italy - Serie D - Group G,0.88,1.0,17,2.88,2.75,1.14,1.0,1
Savoia,8,6,2,0,13,2,11,20,Italy - Serie D - Group G,0.75,1.0,11,1.62,2.5,1.33,1.0,2
Sarnese,8,5,3,0,12,6,6,18,Italy - Serie D - Group G,0.62,1.0,6,1.5,2.25,1.61,1.0,3
Olbia,8,4,2,2,13,7,6,14,Italy - Serie D - Group G,0.5,0.75,6,1.62,1.75,2.0,1.33,4
Gelbison,8,4,2,2,14,9,5,14,Italy - Serie D - Group G,0.5,0.75,5,1.75,1.75,2.0,1.33,4
Ilvamaddalena,8,4,1,3,13,8,5,13,Italy - Serie D - Group G,0.5,0.62,5,1.62,1.62,2.0,1.61,5
Paganese,8,4,1,3,11,7,4,13,Italy - Serie D - Group G,0.5,0.62,4,1.38,1.62,2.0,1.61,5
CynthiAlbalonga,8,4,1,3,9,11,-2,13,Italy - Serie D - Group G,0.5,0.62,-2,1.12,1.62,2.0,1.61,5
A. Lodigiani,8,3,3,2,13,11,2,12,Italy - Serie D - Group G,0.38,0.75,2,1.62,1.5,2.63,1.33,6
S. Ogliastra,8,3,3,2,13,14,-1,12,Italy - Serie D - Group G,0.38,0.75,-1,1.62,1.5,2.63,1.33,6
R. Monterotondo,8,3,1,4,7,12,-5,10,Italy - Serie D - Group G,0.38,0.5,-5,0.88,1.25,2.63,2.0,7
Trastevere,8,2,2,4,12,15,-3,8,Italy - Serie D - Group G,0.25,0.5,-3,1.5,1.0,4.0,2.0,8
Latte Dolce,8,2,2,4,10,14,-4,8,Italy - Serie D - Group G,0.25,0.5,-4,1.25,1.0,4.0,2.0,8
Cassino,8,2,1,5,7,11,-4,7,Italy - Serie D - Group G,0.25,0.38,-4,0.88,0.88,4.0,2.63,9
Anzio,8,1,3,4,6,14,-8,6,Italy - Serie D - Group G,0.12,0.5,-8,0.75,0.75,8.33,2.0,10
Atletico Uri,8,1,1,6,6,10,-4,4,Italy - Serie D - Group G,0.12,0.25,-4,0.75,0.5,8.33,4.0,11
Puteolana,8,0,3,5,6,18,-12,3,Italy - Serie D - Group G,0.0,0.38,-12,0.75,0.38,0.0,2.63,12
Terracina,8,0,2,6,7,20,-13,2,Italy - Serie D - Group G,0.0,0.25,-13,0.88,0.25,0.0,4.0,13
Casarano,8,6,2,0,20,7,13,20,Italy - Serie D - Group H,0.75,1.0,13,2.5,2.5,1.33,1.0,1
Citta di Fasano,8,5,2,1,17,8,9,17,Italy - Serie D - Group H,0.62,0.88,9,2.12,2.12,1.61,1.14,2
Nocerina,8,5,2,1,14,6,8,17,Italy - Serie D - Group H,0.62,0.88,8,1.75,2.12,1.61,1.14,2
Manfredonia,8,4,3,1,12,7,5,15,Italy - Serie D - Group H,0.5,0.88,5,1.5,1.88,2.0,1.14,3
Brindisi,8,4,2,2,15,11,4,14,Italy - Serie D - Group H,0.5,0.75,4,1.88,1.75,2.0,1.33,4
Ugento,8,4,1,3,11,10,1,13,Italy - Serie D - Group H,0.5,0.62,1,1.38,1.62,2.0,1.61,5
Francavilla,8,4,0,4,9,10,-1,12,Italy - Serie D - Group H,0.5,0.5,-1,1.12,1.5,2.0,2.0,6
V. Francavilla,8,2,5,1,14,10,4,11,Italy - Serie D - Group H,0.25,0.88,4,1.75,1.38,4.0,1.14,7
Ischia,8,2,4,2,5,6,-1,10,Italy - Serie D - Group H,0.25,0.75,-1,0.62,1.25,4.0,1.33,8
Gravina,8,2,3,3,8,8,0,9,Italy - Serie D - Group H,0.25,0.62,0,1.0,1.12,4.0,1.61,9
USD Palmese,8,2,3,3,10,11,-1,9,Italy - Serie D - Group H,0.25,0.62,-1,1.25,1.12,4.0,1.61,9
Martina Franca,8,2,3,3,7,8,-1,9,Italy - Serie D - Group H,0.25,0.62,-1,0.88,1.12,4.0,1.61,9
Matera,8,2,3,3,11,16,-5,9,Italy - Serie D - Group H,0.25,0.62,-5,1.38,1.12,4.0,1.61,9
Nardo,8,2,2,4,9,12,-3,8,Italy - Serie D - Group H,0.25,0.5,-3,1.12,1.0,4.0,2.0,10
Fidelis Andria,8,1,3,4,6,12,-6,6,Italy - Serie D - Group H,0.12,0.5,-6,0.75,0.75,8.33,2.0,11
Real Acerrana,8,1,2,5,5,12,-7,5,Italy - Serie D - Group H,0.12,0.38,-7,0.62,0.62,8.33,2.63,12
Costa DAmalfi,8,1,2,5,5,13,-8,5,Italy - Serie D - Group H,0.12,0.38,-8,0.62,0.62,8.33,2.63,12
Angri Calcio,8,1,2,5,7,18,-11,5,Italy - Serie D - Group H,0.12,0.38,-11,0.88,0.62,8.33,2.63,12
Reggina,8,8,0,0,19,5,14,24,Italy - Serie D - Group I,1.0,1.0,14,2.38,3.0,1.0,1.0,1
Siracusa,8,7,0,1,23,5,18,21,Italy - Serie D - Group I,0.88,0.88,18,2.88,2.62,1.14,1.14,2
Pompei,8,5,1,2,9,7,2,16,Italy - Serie D - Group I,0.62,0.75,2,1.12,2.0,1.61,1.33,3
Scafatese,8,5,0,3,16,9,7,15,Italy - Serie D - Group I,0.62,0.62,7,2.0,1.88,1.61,1.61,4
Sancataldese,8,4,2,2,10,9,1,14,Italy - Serie D - Group I,0.5,0.75,1,1.25,1.75,2.0,1.33,5
Acireale,8,3,4,1,12,9,3,13,Italy - Serie D - Group I,0.38,0.88,3,1.5,1.62,2.63,1.14,6
Nissa,8,3,2,3,13,14,-1,11,Italy - Serie D - Group I,0.38,0.62,-1,1.62,1.38,2.63,1.61,7
Paterno,8,3,2,3,7,10,-3,11,Italy - Serie D - Group I,0.38,0.62,-3,0.88,1.38,2.63,1.61,7
Ragusa,8,3,1,4,10,9,1,10,Italy - Serie D - Group I,0.38,0.5,1,1.25,1.25,2.63,2.0,8
Sambiase,8,3,1,4,7,8,-1,10,Italy - Serie D - Group I,0.38,0.5,-1,0.88,1.25,2.63,2.0,8
CD S. Agata,8,2,3,3,13,13,0,9,Italy - Serie D - Group I,0.25,0.62,0,1.62,1.12,4.0,1.61,9
Enna,8,2,2,4,5,10,-5,8,Italy - Serie D - Group I,0.25,0.5,-5,0.62,1.0,4.0,2.0,10
Vibonese,8,2,1,5,8,12,-4,7,Italy - Serie D - Group I,0.25,0.38,-4,1.0,0.88,4.0,2.63,11
Licata,8,2,1,5,6,13,-7,7,Italy - Serie D - Group I,0.25,0.38,-7,0.75,0.88,4.0,2.63,11
Igea Virtus,8,2,1,5,5,12,-7,7,Italy - Serie D - Group I,0.25,0.38,-7,0.62,0.88,4.0,2.63,11
CastrumFavara,8,1,3,4,7,12,-5,6,Italy - Serie D - Group I,0.12,0.5,-5,0.88,0.75,8.33,2.0,12
Locri 1909,8,1,0,7,8,15,-7,3,Italy - Serie D - Group I,0.12,0.12,-7,1.0,0.38,8.33,8.33,13
Akragas,0,0,0,0,0,0,0,0,Italy - Serie D - Group I,0.0,0.0,0,0.0,0.0,0.0,0.0,14
Roma U20,8,6,0,2,17,12,5,18,Italy - Primavera 1,0.75,0.75,5,2.12,2.25,1.33,1.33,1
Cesena U20,8,5,2,1,14,9,5,17,Italy - Primavera 1,0.62,0.88,5,1.75,2.12,1.61,1.14,2
H. Verona U20,8,5,1,2,14,4,10,16,Italy - Primavera 1,0.62,0.75,10,1.75,2.0,1.61,1.33,3
Cagliari U20,8,4,3,1,10,6,4,15,Italy - Primavera 1,0.5,0.88,4,1.25,1.88,2.0,1.14,4
Juventus U20,8,5,0,3,16,14,2,15,Italy - Primavera 1,0.62,0.62,2,2.0,1.88,1.61,1.61,4
Inter Milan U20,8,4,2,2,8,4,4,14,Italy - Primavera 1,0.5,0.75,4,1.0,1.75,2.0,1.33,5
Lecce U20,8,4,2,2,12,9,3,14,Italy - Primavera 1,0.5,0.75,3,1.5,1.75,2.0,1.33,5
Lazio U20,8,4,2,2,11,8,3,14,Italy - Primavera 1,0.5,0.75,3,1.38,1.75,2.0,1.33,5
Sassuolo U20,8,4,2,2,10,9,1,14,Italy - Primavera 1,0.5,0.75,1,1.25,1.75,2.0,1.33,5
Atalanta U20,8,4,1,3,12,7,5,13,Italy - Primavera 1,0.5,0.62,5,1.5,1.62,2.0,1.61,6
Genoa U20,8,3,1,4,10,11,-1,10,Italy - Primavera 1,0.38,0.5,-1,1.25,1.25,2.63,2.0,7
Bologna U20,8,3,1,4,9,10,-1,10,Italy - Primavera 1,0.38,0.5,-1,1.12,1.25,2.63,2.0,7
Cremonese U20,8,2,3,3,11,10,1,9,Italy - Primavera 1,0.25,0.62,1,1.38,1.12,4.0,1.61,8
Torino U20,8,2,2,4,12,14,-2,8,Italy - Primavera 1,0.25,0.5,-2,1.5,1.0,4.0,2.0,9
Milan U20,8,2,2,4,8,13,-5,8,Italy - Primavera 1,0.25,0.5,-5,1.0,1.0,4.0,2.0,9
Empoli U20,8,2,2,4,7,12,-5,8,Italy - Primavera 1,0.25,0.5,-5,0.88,1.0,4.0,2.0,9
Sampdoria U20,8,1,3,4,8,15,-7,6,Italy - Primavera 1,0.12,0.5,-7,1.0,0.75,8.33,2.0,10
Monza U20,8,1,2,5,12,21,-9,5,Italy - Primavera 1,0.12,0.38,-9,1.5,0.62,8.33,2.63,11
Fiorentina U20,8,1,1,6,13,16,-3,4,Italy - Primavera 1,0.12,0.25,-3,1.62,0.5,8.33,4.0,12
Udinese U20,8,1,1,6,5,21,-16,4,Italy - Primavera 1,0.12,0.25,-16,0.62,0.5,8.33,4.0,12
Mount Pleasant,8,6,1,1,14,2,12,19,Jamaica - Premier League,0.75,0.88,12,1.75,2.38,1.33,1.14,1
Tivoli Gardens,8,5,3,0,13,7,6,18,Jamaica - Premier League,0.62,1.0,6,1.62,2.25,1.61,1.0,2
Waterhouse,8,5,2,1,13,6,7,17,Jamaica - Premier League,0.62,0.88,7,1.62,2.12,1.61,1.14,3
Cavalier,8,4,3,1,15,9,6,15,Jamaica - Premier League,0.5,0.88,6,1.88,1.88,2.0,1.14,4
Montego Bay,8,3,4,1,15,5,10,13,Jamaica - Premier League,0.38,0.88,10,1.88,1.62,2.63,1.14,5
Portmore Utd,8,4,1,3,6,5,1,13,Jamaica - Premier League,0.5,0.62,1,0.75,1.62,2.0,1.61,5
Chapelton,8,3,2,3,6,10,-4,11,Jamaica - Premier League,0.38,0.62,-4,0.75,1.38,2.63,1.61,6
Arnett Gardens,8,2,3,3,13,12,1,9,Jamaica - Premier League,0.25,0.62,1,1.62,1.12,4.0,1.61,7
Humble Lions,8,2,3,3,9,8,1,9,Jamaica - Premier League,0.25,0.62,1,1.12,1.12,4.0,1.61,7
Molynes Utd,8,2,2,4,7,14,-7,8,Jamaica - Premier League,0.25,0.5,-7,0.88,1.0,4.0,2.0,8
Racing United,8,2,1,5,7,12,-5,7,Jamaica - Premier League,0.25,0.38,-5,0.88,0.88,4.0,2.63,9
Harbour View,8,1,2,5,4,13,-9,5,Jamaica - Premier League,0.12,0.38,-9,0.5,0.62,8.33,2.63,10
Dunbeholden,8,0,2,6,3,14,-11,2,Jamaica - Premier League,0.0,0.25,-11,0.38,0.25,0.0,4.0,11
Vere Utd,8,0,1,7,4,16,-12,1,Jamaica - Premier League,0.0,0.12,-12,0.5,0.12,0.0,8.33,12
Avispa Fukuoka,8,6,1,1,10,6,4,19,Japan - J1 League,0.75,0.88,4,1.25,2.38,1.33,1.14,1
Urawa RD,8,5,2,1,12,6,6,17,Japan - J1 League,0.62,0.88,6,1.5,2.12,1.61,1.14,2
Kyoto Sanga,8,5,1,2,13,9,4,16,Japan - J1 League,0.62,0.75,4,1.62,2.0,1.61,1.33,3
Vissel Kobe,8,5,0,3,7,5,2,15,Japan - J1 League,0.62,0.62,2,0.88,1.88,1.61,1.61,4
Machida Zelvia,8,4,2,2,10,8,2,14,Japan - J1 League,0.5,0.75,2,1.25,1.75,2.0,1.33,5
Kashima Antlers,8,4,1,3,12,9,3,13,Japan - J1 League,0.5,0.62,3,1.5,1.62,2.0,1.61,6
Kashiwa Reysol,8,3,4,1,8,6,2,13,Japan - J1 League,0.38,0.88,2,1.0,1.62,2.63,1.14,6
K. Frontale,8,2,5,1,12,8,4,11,Japan - J1 League,0.25,0.88,4,1.5,1.38,4.0,1.14,7
Gamba Osaka,8,3,2,3,8,8,0,11,Japan - J1 League,0.38,0.62,0,1.0,1.38,2.63,1.61,7
S. Hiroshima,8,3,2,3,7,7,0,11,Japan - J1 League,0.38,0.62,0,0.88,1.38,2.63,1.61,7
Fagiano Okayama,8,3,2,3,6,6,0,11,Japan - J1 League,0.38,0.62,0,0.75,1.38,2.63,1.61,7
Shimizu S-Pulse,8,3,1,4,12,11,1,10,Japan - J1 League,0.38,0.5,1,1.5,1.25,2.63,2.0,8
Nagoya G.,8,3,1,4,10,11,-1,10,Japan - J1 League,0.38,0.5,-1,1.25,1.25,2.63,2.0,8
Cerezo Osaka,8,2,4,2,9,10,-1,10,Japan - J1 League,0.25,0.75,-1,1.12,1.25,4.0,1.33,8
Tokyo Verdy,8,1,5,2,6,7,-1,8,Japan - J1 League,0.12,0.75,-1,0.75,1.0,8.33,1.33,9
Yokohama FC,8,2,2,4,6,7,-1,8,Japan - J1 League,0.25,0.5,-1,0.75,1.0,4.0,2.0,9
Albirex Niigata,8,1,4,3,9,11,-2,7,Japan - J1 League,0.12,0.62,-2,1.12,0.88,8.33,1.61,10
Yokohama M.,8,1,2,5,9,14,-5,5,Japan - J1 League,0.12,0.38,-5,1.12,0.62,8.33,2.63,11
Shonan Bellmare,8,1,2,5,4,12,-8,5,Japan - J1 League,0.12,0.38,-8,0.5,0.62,8.33,2.63,11
FC Tokyo,8,0,4,4,4,11,-7,4,Japan - J1 League,0.0,0.5,-7,0.5,0.5,0.0,2.0,12
JEF Utd Chiba,8,7,0,1,19,9,10,21,Japan - J2 League,0.88,0.88,10,2.38,2.62,1.14,1.14,1
FC Imabari,8,4,4,0,14,6,8,16,Japan - J2 League,0.5,1.0,8,1.75,2.0,2.0,1.0,2
Vegalta Sendai,8,4,3,1,10,6,4,15,Japan - J2 League,0.5,0.88,4,1.25,1.88,2.0,1.14,3
Omiya Ardija,8,4,2,2,12,6,6,14,Japan - J2 League,0.5,0.75,6,1.5,1.75,2.0,1.33,4
Sagan Tosu,8,4,2,2,10,10,0,14,Japan - J2 League,0.5,0.75,0,1.25,1.75,2.0,1.33,4
M. Yamagata,8,3,3,2,14,11,3,12,Japan - J2 League,0.38,0.75,3,1.75,1.5,2.63,1.33,5
Mito Hollyhock,8,3,3,2,12,9,3,12,Japan - J2 League,0.38,0.75,3,1.5,1.5,2.63,1.33,5
C. Sapporo,8,4,0,4,10,12,-2,12,Japan - J2 League,0.5,0.5,-2,1.25,1.5,2.0,2.0,5
Fujieda MYFC,8,3,2,3,14,13,1,11,Japan - J2 League,0.38,0.62,1,1.75,1.38,2.63,1.61,6
V-V. Nagasaki,8,3,2,3,12,12,0,11,Japan - J2 League,0.38,0.62,0,1.5,1.38,2.63,1.61,6
Jubilo Iwata,8,3,2,3,9,10,-1,11,Japan - J2 League,0.38,0.62,-1,1.12,1.38,2.63,1.61,6
Kataller Toyama,8,2,3,3,8,7,1,9,Japan - J2 League,0.25,0.62,1,1.0,1.12,4.0,1.61,7
Ventforet Kofu,8,2,3,3,8,10,-2,9,Japan - J2 League,0.25,0.62,-2,1.0,1.12,4.0,1.61,7
R. Kumamoto,8,2,3,3,6,10,-4,9,Japan - J2 League,0.25,0.62,-4,0.75,1.12,4.0,1.61,7
Oita Trinita,8,1,5,2,6,8,-2,8,Japan - J2 League,0.12,0.75,-2,0.75,1.0,8.33,1.33,8
R. Yamaguchi,8,1,4,3,9,10,-1,7,Japan - J2 League,0.12,0.62,-1,1.12,0.88,8.33,1.61,9
Tokushima V.,8,1,4,3,3,5,-2,7,Japan - J2 League,0.12,0.62,-2,0.38,0.88,8.33,1.61,9
Ehime FC,8,1,3,4,9,15,-6,6,Japan - J2 League,0.12,0.5,-6,1.12,0.75,8.33,2.0,10
Blaublitz Akita,8,2,0,6,9,18,-9,6,Japan - J2 League,0.25,0.25,-9,1.12,0.75,4.0,4.0,10
Iwaki,8,1,2,5,5,12,-7,5,Japan - J2 League,0.12,0.38,-7,0.62,0.62,8.33,2.63,11
Tochigi City,8,5,3,0,15,6,9,18,Japan - J3 League,0.62,1.0,9,1.88,2.25,1.61,1.0,1
Osaka,8,6,0,2,12,7,5,18,Japan - J3 League,0.75,0.75,5,1.5,2.25,1.33,1.33,1
Kagoshima Utd,8,4,4,0,15,7,8,16,Japan - J3 League,0.5,1.0,8,1.88,2.0,2.0,1.0,2
Nara Club,8,4,3,1,12,8,4,15,Japan - J3 League,0.5,0.88,4,1.5,1.88,2.0,1.14,3
Z. Kanazawa,8,4,2,2,11,8,3,14,Japan - J3 League,0.5,0.75,3,1.38,1.75,2.0,1.33,4
G. Kitakyushu,8,4,1,3,8,5,3,13,Japan - J3 League,0.5,0.62,3,1.0,1.62,2.0,1.61,5
T. Miyazaki,8,3,4,1,9,7,2,13,Japan - J3 League,0.38,0.88,2,1.12,1.62,2.63,1.14,5
Fukushima Utd,8,4,1,3,15,14,1,13,Japan - J3 League,0.5,0.62,1,1.88,1.62,2.0,1.61,5
Kochi United,8,3,2,3,17,17,0,11,Japan - J3 League,0.38,0.62,0,2.12,1.38,2.63,1.61,6
V. Hachinohe,8,3,2,3,8,8,0,11,Japan - J3 League,0.38,0.62,0,1.0,1.38,2.63,1.61,6
FC Ryukyu,8,2,3,3,8,8,0,9,Japan - J3 League,0.25,0.62,0,1.0,1.12,4.0,1.61,7
Matsumoto Y.,8,2,3,3,7,10,-3,9,Japan - J3 League,0.25,0.62,-3,0.88,1.12,4.0,1.61,7
Tochigi SC,8,2,2,4,5,7,-2,8,Japan - J3 League,0.25,0.5,-2,0.62,1.0,4.0,2.0,8
Gifu,8,2,2,4,9,13,-4,8,Japan - J3 League,0.25,0.5,-4,1.12,1.0,4.0,2.0,8
Nagano Parceiro,8,2,1,5,9,14,-5,7,Japan - J3 League,0.25,0.38,-5,1.12,0.88,4.0,2.63,9
SC Sagamihara,8,1,4,3,6,11,-5,7,Japan - J3 League,0.12,0.62,-5,0.75,0.88,8.33,1.61,9
Gainare Tottori,8,1,3,4,6,10,-4,6,Japan - J3 League,0.12,0.5,-4,0.75,0.75,8.33,2.0,10
Kamatamare S.,8,1,3,4,4,9,-5,6,Japan - J3 League,0.12,0.5,-5,0.5,0.75,8.33,2.0,10
AC Numazu,8,0,5,3,4,8,-4,5,Japan - J3 League,0.0,0.62,-4,0.5,0.62,0.0,1.61,11
Kusatsu,8,1,2,5,11,18,-7,5,Japan - J3 League,0.12,0.38,-7,1.38,0.62,8.33,2.63,11
Al Wihdat,8,6,1,1,16,5,11,19,Jordan - Premier League,0.75,0.88,11,2.0,2.38,1.33,1.14,1
Al Faysali,8,4,4,0,8,4,4,16,Jordan - Premier League,0.5,1.0,4,1.0,2.0,2.0,1.0,2
Al Hussein,8,4,3,1,21,7,14,15,Jordan - Premier League,0.5,0.88,14,2.62,1.88,2.0,1.14,3
Aqaba,8,4,2,2,9,10,-1,14,Jordan - Premier League,0.5,0.75,-1,1.12,1.75,2.0,1.33,4
Al Jazeera,8,4,1,3,10,6,4,13,Jordan - Premier League,0.5,0.62,4,1.25,1.62,2.0,1.61,5
Al Salt,8,3,3,2,8,6,2,12,Jordan - Premier League,0.38,0.75,2,1.0,1.5,2.63,1.33,6
Al Ramtha,8,3,2,3,7,7,0,11,Jordan - Premier League,0.38,0.62,0,0.88,1.38,2.63,1.61,7
Al Sareeh,8,3,1,4,7,11,-4,10,Jordan - Premier League,0.38,0.5,-4,0.88,1.25,2.63,2.0,8
Shabab Al Ordon,8,2,2,4,11,10,1,8,Jordan - Premier League,0.25,0.5,1,1.38,1.0,4.0,2.0,9
Maan,8,2,1,5,8,15,-7,7,Jordan - Premier League,0.25,0.38,-7,1.0,0.88,4.0,2.63,10
Moghayer Al S.,8,1,1,6,4,16,-12,4,Jordan - Premier League,0.12,0.25,-12,0.5,0.5,8.33,4.0,11
Al Ahli,8,1,1,6,2,14,-12,4,Jordan - Premier League,0.12,0.25,-12,0.25,0.5,8.33,4.0,11
Kairat Almaty,6,4,2,0,15,3,12,14,Kazakhstan - Premier League,0.67,1.0,12,2.5,2.33,1.49,1.0,1
FC Astana,5,3,2,0,9,3,6,11,Kazakhstan - Premier League,0.6,1.0,6,1.8,2.2,1.67,1.0,2
Tobol,5,3,2,0,6,1,5,11,Kazakhstan - Premier League,0.6,1.0,5,1.2,2.2,1.67,1.0,2
Aktobe,5,3,1,1,10,4,6,10,Kazakhstan - Premier League,0.6,0.8,6,2.0,2.0,1.67,1.25,3
Yelimay Semey,5,3,1,1,8,3,5,10,Kazakhstan - Premier League,0.6,0.8,5,1.6,2.0,1.67,1.25,3
Turan,5,2,1,2,8,7,1,7,Kazakhstan - Premier League,0.4,0.6,1,1.6,1.4,2.5,1.67,4
Okzhetpes,5,2,1,2,5,6,-1,7,Kazakhstan - Premier League,0.4,0.6,-1,1.0,1.4,2.5,1.67,4
Kyzylzhar,5,1,2,2,5,7,-2,5,Kazakhstan - Premier League,0.2,0.6,-2,1.0,1.0,5.0,1.67,5
Ordabasy,5,1,2,2,2,6,-4,5,Kazakhstan - Premier League,0.2,0.6,-4,0.4,1.0,5.0,1.67,5
Zhenys,5,0,4,1,1,2,-1,4,Kazakhstan - Premier League,0.0,0.8,-1,0.2,0.8,0.0,1.25,6
Zhetysu,5,0,3,2,1,5,-4,3,Kazakhstan - Premier League,0.0,0.6,-4,0.2,0.6,0.0,1.67,7
Kaisar K.,5,0,3,2,3,8,-5,3,Kazakhstan - Premier League,0.0,0.6,-5,0.6,0.6,0.0,1.67,7
Atyrau,6,1,0,5,5,17,-12,3,Kazakhstan - Premier League,0.17,0.17,-12,0.83,0.5,5.88,5.88,7
Ulytau,5,0,2,3,1,7,-6,2,Kazakhstan - Premier League,0.0,0.4,-6,0.2,0.4,0.0,2.5,8
Drita,8,5,2,1,14,6,8,17,Kosovo - Superliga,0.62,0.88,8,1.75,2.12,1.61,1.14,1
Ferizaj,8,5,0,3,14,11,3,15,Kosovo - Superliga,0.62,0.62,3,1.75,1.88,1.61,1.61,2
Gjilani,8,4,2,2,9,10,-1,14,Kosovo - Superliga,0.5,0.75,-1,1.12,1.75,2.0,1.33,3
Ballkani,8,4,1,3,11,9,2,13,Kosovo - Superliga,0.5,0.62,2,1.38,1.62,2.0,1.61,4
Llapi,8,3,3,2,7,3,4,12,Kosovo - Superliga,0.38,0.75,4,0.88,1.5,2.63,1.33,5
Malisheva,8,3,3,2,10,7,3,12,Kosovo - Superliga,0.38,0.75,3,1.25,1.5,2.63,1.33,5
Dukagjini,8,3,3,2,5,4,1,12,Kosovo - Superliga,0.38,0.75,1,0.62,1.5,2.63,1.33,5
Prishtina,8,0,6,2,7,9,-2,6,Kosovo - Superliga,0.0,0.75,-2,0.88,0.75,0.0,1.33,6
Suhareka,8,1,1,6,7,16,-9,4,Kosovo - Superliga,0.12,0.25,-9,0.88,0.5,8.33,4.0,7
Feronikeli,8,1,1,6,4,13,-9,4,Kosovo - Superliga,0.12,0.25,-9,0.5,0.5,8.33,4.0,7
Al Kuwait,8,5,3,0,24,5,19,18,Kuwait - Premier League,0.62,1.0,19,3.0,2.25,1.61,1.0,1
Al Qadsia,8,6,0,2,19,12,7,18,Kuwait - Premier League,0.75,0.75,7,2.38,2.25,1.33,1.33,1
Al Arabi SC,8,4,4,0,11,6,5,16,Kuwait - Premier League,0.5,1.0,5,1.38,2.0,2.0,1.0,2
Al Fahaheel,8,2,4,2,12,12,0,10,Kuwait - Premier League,0.25,0.75,0,1.5,1.25,4.0,1.33,3
Al Nasar,8,3,1,4,12,15,-3,10,Kuwait - Premier League,0.38,0.5,-3,1.5,1.25,2.63,2.0,3
Kazma,8,2,3,3,13,10,3,9,Kuwait - Premier League,0.25,0.62,3,1.62,1.12,4.0,1.61,4
Al Salmiyah,8,2,3,3,13,14,-1,9,Kuwait - Premier League,0.25,0.62,-1,1.62,1.12,4.0,1.61,4
Al Tadhamon,8,2,0,6,6,21,-15,6,Kuwait - Premier League,0.25,0.25,-15,0.75,0.75,4.0,4.0,5
Khaitan,8,1,2,5,5,9,-4,5,Kuwait - Premier League,0.12,0.38,-4,0.62,0.62,8.33,2.63,6
Yarmouk,8,1,2,5,5,20,-15,5,Kuwait - Premier League,0.12,0.38,-15,0.62,0.62,8.33,2.63,6
RFS,8,7,0,1,17,6,11,21,Latvia - Virsliga,0.88,0.88,11,2.12,2.62,1.14,1.14,1
Auda,8,5,1,2,13,6,7,16,Latvia - Virsliga,0.62,0.75,7,1.62,2.0,1.61,1.33,2
Riga FC,8,4,3,1,18,8,10,15,Latvia - Virsliga,0.5,0.88,10,2.25,1.88,2.0,1.14,3
Daugavpils,8,4,1,3,16,14,2,13,Latvia - Virsliga,0.5,0.62,2,2.0,1.62,2.0,1.61,4
Metta,8,3,2,3,9,14,-5,11,Latvia - Virsliga,0.38,0.62,-5,1.12,1.38,2.63,1.61,5
Liepaja,8,3,1,4,14,17,-3,10,Latvia - Virsliga,0.38,0.5,-3,1.75,1.25,2.63,2.0,6
FS Jelgava,8,2,3,3,8,8,0,9,Latvia - Virsliga,0.25,0.62,0,1.0,1.12,4.0,1.61,7
Super Nova,8,1,3,4,10,11,-1,6,Latvia - Virsliga,0.12,0.5,-1,1.25,0.75,8.33,2.0,8
Tukums,8,1,2,5,6,15,-9,5,Latvia - Virsliga,0.12,0.38,-9,0.75,0.62,8.33,2.63,9
Grobina,8,1,2,5,9,21,-12,5,Latvia - Virsliga,0.12,0.38,-12,1.12,0.62,8.33,2.63,9
Hegelmann L.,8,6,0,2,13,10,3,18,Lithuania - A Lyga,0.75,0.75,3,1.62,2.25,1.33,1.33,1
Kauno Zalgiris,8,4,3,1,12,6,6,15,Lithuania - A Lyga,0.5,0.88,6,1.5,1.88,2.0,1.14,2
Dziugas Telsiai,8,5,0,3,8,6,2,15,Lithuania - A Lyga,0.62,0.62,2,1.0,1.88,1.61,1.61,2
Suduva,8,4,2,2,8,9,-1,14,Lithuania - A Lyga,0.5,0.75,-1,1.0,1.75,2.0,1.33,3
Siauliai,8,3,3,2,14,11,3,12,Lithuania - A Lyga,0.38,0.75,3,1.75,1.5,2.63,1.33,4
Zalgiris,8,3,3,2,11,9,2,12,Lithuania - A Lyga,0.38,0.75,2,1.38,1.5,2.63,1.33,4
Riteriai,8,2,3,3,15,14,1,9,Lithuania - A Lyga,0.25,0.62,1,1.88,1.12,4.0,1.61,5
Banga,8,2,2,4,8,10,-2,8,Lithuania - A Lyga,0.25,0.5,-2,1.0,1.0,4.0,2.0,6
Panevezys,8,2,1,5,9,13,-4,7,Lithuania - A Lyga,0.25,0.38,-4,1.12,0.88,4.0,2.63,7
Dainava,8,0,1,7,7,17,-10,1,Lithuania - A Lyga,0.0,0.12,-10,0.88,0.12,0.0,8.33,8
Tauras,5,4,1,0,14,1,13,13,Lithuania - 1st League,0.8,1.0,13,2.8,2.6,1.25,1.0,1
BFA Vilnius,5,4,1,0,9,3,6,13,Lithuania - 1st League,0.8,1.0,6,1.8,2.6,1.25,1.0,1
TransINVEST,5,4,0,1,15,5,10,12,Lithuania - 1st League,0.8,0.8,10,3.0,2.4,1.25,1.25,2
Neptuna K.,5,4,0,1,14,4,10,12,Lithuania - 1st League,0.8,0.8,10,2.8,2.4,1.25,1.25,2
Babrungas,5,3,1,1,9,10,-1,10,Lithuania - 1st League,0.6,0.8,-1,1.8,2.0,1.67,1.25,3
Kauno Z. B,5,3,0,2,4,3,1,9,Lithuania - 1st League,0.6,0.6,1,0.8,1.8,1.67,1.67,4
Atmosfera,5,2,1,2,5,7,-2,7,Lithuania - 1st League,0.4,0.6,-2,1.0,1.4,2.5,1.67,5
Panevezys B,5,2,1,2,8,12,-4,7,Lithuania - 1st League,0.4,0.6,-4,1.6,1.4,2.5,1.67,5
Minija,5,2,0,3,3,9,-6,6,Lithuania - 1st League,0.4,0.4,-6,0.6,1.2,2.5,2.5,6
Zalgiris B,5,1,2,2,7,8,-1,5,Lithuania - 1st League,0.2,0.6,-1,1.4,1.0,5.0,1.67,7
Hegelmann B,5,1,2,2,5,7,-2,5,Lithuania - 1st League,0.2,0.6,-2,1.0,1.0,5.0,1.67,7
Nevezis,5,1,1,3,8,11,-3,4,Lithuania - 1st League,0.2,0.4,-3,1.6,0.8,5.0,2.5,8
Siauliai B,5,1,1,3,7,13,-6,4,Lithuania - 1st League,0.2,0.4,-6,1.4,0.8,5.0,2.5,8
Ekranas,5,1,0,4,5,8,-3,3,Lithuania - 1st League,0.2,0.2,-3,1.0,0.6,5.0,5.0,9
Be1 NFA,5,0,2,3,2,10,-8,2,Lithuania - 1st League,0.0,0.4,-8,0.4,0.4,0.0,2.5,10
Jonava,5,0,1,4,1,5,-4,1,Lithuania - 1st League,0.0,0.2,-4,0.2,0.2,0.0,5.0,11
Differdange,8,8,0,0,18,0,18,24,Luxembourg - National Division,1.0,1.0,18,2.25,3.0,1.0,1.0,1
Hostert,8,5,2,1,17,11,6,17,Luxembourg - National Division,0.62,0.88,6,2.12,2.12,1.61,1.14,2
Niedercorn,8,5,2,1,12,6,6,17,Luxembourg - National Division,0.62,0.88,6,1.5,2.12,1.61,1.14,2
UNA Strassen,8,5,1,2,16,8,8,16,Luxembourg - National Division,0.62,0.75,8,2.0,2.0,1.61,1.33,3
Dudelange,8,4,2,2,15,9,6,14,Luxembourg - National Division,0.5,0.75,6,1.88,1.75,2.0,1.33,4
Racing,8,4,1,3,13,7,6,13,Luxembourg - National Division,0.5,0.62,6,1.62,1.62,2.0,1.61,5
Petange,8,4,1,3,12,11,1,13,Luxembourg - National Division,0.5,0.62,1,1.5,1.62,2.0,1.61,5
Hesperange,8,3,2,3,12,12,0,11,Luxembourg - National Division,0.38,0.62,0,1.5,1.38,2.63,1.61,6
Rodange,8,3,2,3,9,11,-2,11,Luxembourg - National Division,0.38,0.62,-2,1.12,1.38,2.63,1.61,6
Mondorf,8,3,1,4,9,11,-2,10,Luxembourg - National Division,0.38,0.5,-2,1.12,1.25,2.63,2.0,7
V. Rosport,8,1,5,2,6,8,-2,8,Luxembourg - National Division,0.12,0.75,-2,0.75,1.0,8.33,1.33,8
Wiltz,8,2,1,5,10,16,-6,7,Luxembourg - National Division,0.25,0.38,-6,1.25,0.88,4.0,2.63,9
Jeunesse Esch,8,1,3,4,10,14,-4,6,Luxembourg - National Division,0.12,0.5,-4,1.25,0.75,8.33,2.0,10
Bettembourg,8,2,0,6,9,16,-7,6,Luxembourg - National Division,0.25,0.25,-7,1.12,0.75,4.0,4.0,10
Mondercange,8,1,1,6,5,19,-14,4,Luxembourg - National Division,0.12,0.25,-14,0.62,0.5,8.33,4.0,11
Fola Esch,8,1,0,7,6,20,-14,3,Luxembourg - National Division,0.12,0.12,-14,0.75,0.38,8.33,8.33,12
Johor Darul,8,8,0,0,31,1,30,24,Malaysia - Super League,1.0,1.0,30,3.88,3.0,1.0,1.0,1
Selangor,8,5,2,1,15,3,12,17,Malaysia - Super League,0.62,0.88,12,1.88,2.12,1.61,1.14,2
Kuching,8,5,2,1,16,7,9,17,Malaysia - Super League,0.62,0.88,9,2.0,2.12,1.61,1.14,2
Kuala Lumpur,8,4,2,2,15,11,4,14,Malaysia - Super League,0.5,0.75,4,1.88,1.75,2.0,1.33,3
Pahang,8,4,1,3,16,14,2,13,Malaysia - Super League,0.5,0.62,2,2.0,1.62,2.0,1.61,4
Perak,8,3,3,2,14,8,6,12,Malaysia - Super League,0.38,0.75,6,1.75,1.5,2.63,1.33,5
Pulau Pinang,8,3,3,2,16,12,4,12,Malaysia - Super League,0.38,0.75,4,2.0,1.5,2.63,1.33,5
Terengganu,8,3,2,3,15,9,6,11,Malaysia - Super League,0.38,0.62,6,1.88,1.38,2.63,1.61,6
Sabah,8,2,5,1,9,8,1,11,Malaysia - Super League,0.25,0.88,1,1.12,1.38,4.0,1.14,6
Negeri Sembilan,8,2,1,5,7,12,-5,7,Malaysia - Super League,0.25,0.38,-5,0.88,0.88,4.0,2.63,7
PDRM,8,2,0,6,5,15,-10,6,Malaysia - Super League,0.25,0.25,-10,0.62,0.75,4.0,4.0,8
Kedah,8,1,1,6,5,24,-19,4,Malaysia - Super League,0.12,0.25,-19,0.62,0.5,8.33,4.0,9
Kelantan United,8,0,0,8,4,40,-36,0,Malaysia - Super League,0.0,0.0,-36,0.5,0.0,0.0,0.0,10
Mosta,8,5,1,2,11,9,2,16,Malta - Premier League,0.62,0.75,2,1.38,2.0,1.61,1.33,1
Floriana,8,4,3,1,11,7,4,15,Malta - Premier League,0.5,0.88,4,1.38,1.88,2.0,1.14,2
Birkirkara,8,4,2,2,12,5,7,14,Malta - Premier League,0.5,0.75,7,1.5,1.75,2.0,1.33,3
Hibernians,8,4,2,2,13,12,1,14,Malta - Premier League,0.5,0.75,1,1.62,1.75,2.0,1.33,3
Marsaxlokk,8,4,1,3,13,6,7,13,Malta - Premier League,0.5,0.62,7,1.62,1.62,2.0,1.61,4
Sliema,8,4,0,4,13,12,1,12,Malta - Premier League,0.5,0.5,1,1.62,1.5,2.0,2.0,5
Hamrun Spartans,8,3,1,4,7,6,1,10,Malta - Premier League,0.38,0.5,1,0.88,1.25,2.63,2.0,6
Naxxar Lions,8,3,1,4,11,15,-4,10,Malta - Premier League,0.38,0.5,-4,1.38,1.25,2.63,2.0,6
Zabbar,8,2,2,4,10,9,1,8,Malta - Premier League,0.25,0.5,1,1.25,1.0,4.0,2.0,7
Gzira Utd,8,2,2,4,5,13,-8,8,Malta - Premier League,0.25,0.5,-8,0.62,1.0,4.0,2.0,7
Balzan,8,1,4,3,6,8,-2,7,Malta - Premier League,0.12,0.62,-2,0.75,0.88,8.33,1.61,8
Melita,8,1,3,4,10,20,-10,6,Malta - Premier League,0.12,0.5,-10,1.25,0.75,8.33,2.0,9
Cruz Azul,8,6,2,0,20,6,14,20,Mexico - Liga MX - Apertura,0.75,1.0,14,2.5,2.5,1.33,1.0,1
Toluca,8,5,2,1,21,7,14,17,Mexico - Liga MX - Apertura,0.62,0.88,14,2.62,2.12,1.61,1.14,2
A. San Luis,8,5,1,2,12,8,4,16,Mexico - Liga MX - Apertura,0.62,0.75,4,1.5,2.0,1.61,1.33,3
Pumas UNAM,8,4,3,1,8,3,5,15,Mexico - Liga MX - Apertura,0.5,0.88,5,1.0,1.88,2.0,1.14,4
Tijuana,8,4,3,1,10,9,1,15,Mexico - Liga MX - Apertura,0.5,0.88,1,1.25,1.88,2.0,1.14,4
CF America,8,4,2,2,15,10,5,14,Mexico - Liga MX - Apertura,0.5,0.75,5,1.88,1.75,2.0,1.33,5
Tigres,8,4,2,2,13,11,2,14,Mexico - Liga MX - Apertura,0.5,0.75,2,1.62,1.75,2.0,1.33,5
Juarez,8,4,1,3,13,15,-2,13,Mexico - Liga MX - Apertura,0.5,0.62,-2,1.62,1.62,2.0,1.61,6
Monterrey,8,3,3,2,12,7,5,12,Mexico - Liga MX - Apertura,0.38,0.75,5,1.5,1.5,2.63,1.33,7
Club Leon,8,2,5,1,13,9,4,11,Mexico - Liga MX - Apertura,0.25,0.88,4,1.62,1.38,4.0,1.14,8
Guadalajara,8,3,2,3,10,8,2,11,Mexico - Liga MX - Apertura,0.38,0.62,2,1.25,1.38,2.63,1.61,8
Queretaro,8,2,2,4,7,13,-6,8,Mexico - Liga MX - Apertura,0.25,0.5,-6,0.88,1.0,4.0,2.0,9
Atlas,8,1,5,2,6,12,-6,8,Mexico - Liga MX - Apertura,0.12,0.75,-6,0.75,1.0,8.33,1.33,9
Mazatlan,8,1,4,3,4,9,-5,7,Mexico - Liga MX - Apertura,0.12,0.62,-5,0.5,0.88,8.33,1.61,10
Pachuca,8,1,1,6,12,16,-4,4,Mexico - Liga MX - Apertura,0.12,0.25,-4,1.5,0.5,8.33,4.0,11
Necaxa,8,0,3,5,7,18,-11,3,Mexico - Liga MX - Apertura,0.0,0.38,-11,0.88,0.38,0.0,2.63,12
Puebla,8,1,0,7,7,18,-11,3,Mexico - Liga MX - Apertura,0.12,0.12,-11,0.88,0.38,8.33,8.33,12
Santos Laguna,8,0,2,6,4,16,-12,2,Mexico - Liga MX - Apertura,0.0,0.25,-12,0.5,0.25,0.0,4.0,13
Toluca,8,6,1,1,19,12,7,19,Mexico - Liga MX - Clausura,0.75,0.88,7,2.38,2.38,1.33,1.14,1
Tigres,8,5,2,1,10,6,4,17,Mexico - Liga MX - Clausura,0.62,0.88,4,1.25,2.12,1.61,1.14,2
Monterrey,8,5,1,2,16,9,7,16,Mexico - Liga MX - Clausura,0.62,0.75,7,2.0,2.0,1.61,1.33,3
Cruz Azul,8,4,4,0,13,7,6,16,Mexico - Liga MX - Clausura,0.5,1.0,6,1.62,2.0,2.0,1.0,3
CF America,8,4,2,2,14,3,11,14,Mexico - Liga MX - Clausura,0.5,0.75,11,1.75,1.75,2.0,1.33,4
Queretaro,8,4,1,3,9,7,2,13,Mexico - Liga MX - Clausura,0.5,0.62,2,1.12,1.62,2.0,1.61,5
Necaxa,8,4,1,3,15,16,-1,13,Mexico - Liga MX - Clausura,0.5,0.62,-1,1.88,1.62,2.0,1.61,5
Pachuca,8,3,3,2,16,12,4,12,Mexico - Liga MX - Clausura,0.38,0.75,4,2.0,1.5,2.63,1.33,6
Tijuana,8,4,0,4,16,14,2,12,Mexico - Liga MX - Clausura,0.5,0.5,2,2.0,1.5,2.0,2.0,6
A. San Luis,8,4,0,4,10,13,-3,12,Mexico - Liga MX - Clausura,0.5,0.5,-3,1.25,1.5,2.0,2.0,6
Atlas,8,3,2,3,16,16,0,11,Mexico - Liga MX - Clausura,0.38,0.62,0,2.0,1.38,2.63,1.61,7
Pumas UNAM,8,3,1,4,11,11,0,10,Mexico - Liga MX - Clausura,0.38,0.5,0,1.38,1.25,2.63,2.0,8
Guadalajara,8,2,4,2,6,7,-1,10,Mexico - Liga MX - Clausura,0.25,0.75,-1,0.75,1.25,4.0,1.33,8
Juarez,8,1,5,2,8,9,-1,8,Mexico - Liga MX - Clausura,0.12,0.75,-1,1.0,1.0,8.33,1.33,9
Club Leon,8,2,1,5,8,12,-4,7,Mexico - Liga MX - Clausura,0.25,0.38,-4,1.0,0.88,4.0,2.63,10
Mazatlan,8,1,3,4,7,15,-8,6,Mexico - Liga MX - Clausura,0.12,0.5,-8,0.88,0.75,8.33,2.0,11
Santos Laguna,8,1,0,7,8,21,-13,3,Mexico - Liga MX - Clausura,0.12,0.12,-13,1.0,0.38,8.33,8.33,12
Puebla,8,0,1,7,1,13,-12,1,Mexico - Liga MX - Clausura,0.0,0.12,-12,0.12,0.12,0.0,8.33,13
Buducnost,8,5,3,0,27,12,15,18,Montenegro - First League,0.62,1.0,15,3.38,2.25,1.61,1.0,1
Jezero,8,4,2,2,15,12,3,14,Montenegro - First League,0.5,0.75,3,1.88,1.75,2.0,1.33,2
Petrovac,8,3,4,1,12,7,5,13,Montenegro - First League,0.38,0.88,5,1.5,1.62,2.63,1.14,3
Sutjeska,8,4,1,3,10,9,1,13,Montenegro - First League,0.5,0.62,1,1.25,1.62,2.0,1.61,3
Arsenal Tivat,8,4,0,4,6,11,-5,12,Montenegro - First League,0.5,0.5,-5,0.75,1.5,2.0,2.0,4
Otrant,8,3,1,4,14,15,-1,10,Montenegro - First League,0.38,0.5,-1,1.75,1.25,2.63,2.0,5
Jedinstvo,8,2,3,3,11,12,-1,9,Montenegro - First League,0.25,0.62,-1,1.38,1.12,4.0,1.61,6
Decic,8,2,3,3,5,6,-1,9,Montenegro - First League,0.25,0.62,-1,0.62,1.12,4.0,1.61,6
Mornar Bar,8,2,2,4,8,14,-6,8,Montenegro - First League,0.25,0.5,-6,1.0,1.0,4.0,2.0,7
Bokelj,8,1,1,6,3,12,-9,4,Montenegro - First League,0.12,0.25,-9,0.38,0.5,8.33,4.0,8
Berkane,8,5,2,1,11,3,8,17,morocco,0.62,0.88,8,1.38,2.12,1.61,1.14,1
Difaa El Jadida,8,4,3,1,9,5,4,15,morocco,0.5,0.88,4,1.12,1.88,2.0,1.14,2
Wydad,8,3,5,0,13,5,8,14,morocco,0.38,1.0,8,1.62,1.75,2.63,1.0,3
FUS Rabat,8,4,2,2,13,8,5,14,morocco,0.5,0.75,5,1.62,1.75,2.0,1.33,3
Raja Casablanca,8,3,5,0,9,5,4,14,morocco,0.38,1.0,4,1.12,1.75,2.63,1.0,3
FAR Rabat,8,4,2,2,11,9,2,14,morocco,0.5,0.75,2,1.38,1.75,2.0,1.33,3
Meknes,8,3,3,2,9,7,2,12,morocco,0.38,0.75,2,1.12,1.5,2.63,1.33,4
Union Touarga,8,3,3,2,9,7,2,12,morocco,0.38,0.75,2,1.12,1.5,2.63,1.33,4
Olympic Safi,8,2,4,2,7,7,0,10,morocco,0.25,0.75,0,0.88,1.25,4.0,1.33,5
Maghreb de Fes,8,2,4,2,8,10,-2,10,morocco,0.25,0.75,-2,1.0,1.25,4.0,1.33,5
Hassania Agadir,8,2,3,3,11,9,2,9,morocco,0.25,0.62,2,1.38,1.12,4.0,1.61,6
Moghreb Tetouan,8,2,3,3,8,10,-2,9,morocco,0.25,0.62,-2,1.0,1.12,4.0,1.61,6
R. Zemamra,8,3,0,5,6,10,-4,9,morocco,0.38,0.38,-4,0.75,1.12,2.63,2.63,6
Ittihad Tanger,8,2,2,4,11,14,-3,8,morocco,0.25,0.5,-3,1.38,1.0,4.0,2.0,7
JS Sousalem,8,0,1,7,4,17,-13,1,morocco,0.0,0.12,-13,0.5,0.12,0.0,8.33,8
C. Mohammedia,8,0,1,7,3,17,-14,1,morocco,0.0,0.12,-14,0.38,0.12,0.0,8.33,8
Shan Utd,8,7,1,0,24,2,22,22,myanmar,0.88,1.0,22,3.0,2.75,1.14,1.0,1
Yangon Utd,8,5,2,1,21,6,15,17,myanmar,0.62,0.88,15,2.62,2.12,1.61,1.14,2
Sagaing Utd,8,4,2,2,16,13,3,14,myanmar,0.5,0.75,3,2.0,1.75,2.0,1.33,3
Thitsar Arman,8,4,1,3,15,12,3,13,myanmar,0.5,0.62,3,1.88,1.62,2.0,1.61,4
Yadanarbon,8,3,3,2,18,15,3,12,myanmar,0.38,0.75,3,2.25,1.5,2.63,1.33,5
Dagon,8,3,2,3,10,11,-1,11,myanmar,0.38,0.62,-1,1.25,1.38,2.63,1.61,6
Hantharwady,8,3,2,3,7,11,-4,11,myanmar,0.38,0.62,-4,0.88,1.38,2.63,1.61,6
Rakhine Utd,8,3,2,3,10,16,-6,11,myanmar,0.38,0.62,-6,1.25,1.38,2.63,1.61,6
Ayeyawady,8,2,0,6,9,16,-7,6,myanmar,0.25,0.25,-7,1.12,0.75,4.0,4.0,7
Ispe FC,8,1,3,4,4,14,-10,6,myanmar,0.12,0.5,-10,0.5,0.75,8.33,2.0,7
Dagon Port,8,1,2,5,12,21,-9,5,myanmar,0.12,0.38,-9,1.5,0.62,8.33,2.63,8
Myawady,8,1,2,5,11,20,-9,5,myanmar,0.12,0.38,-9,1.38,0.62,8.33,2.63,8
Feyenoord,8,6,2,0,18,6,12,20,netherlands,0.75,1.0,12,2.25,2.5,1.33,1.0,1
Ajax Amsterdam,8,6,1,1,13,8,5,19,netherlands,0.75,0.88,5,1.62,2.38,1.33,1.14,2
FC Utrecht,8,5,2,1,17,8,9,17,netherlands,0.62,0.88,9,2.12,2.12,1.61,1.14,3
PSV Eindhoven,8,4,2,2,18,10,8,14,netherlands,0.5,0.75,8,2.25,1.75,2.0,1.33,4
Sparta,8,4,2,2,14,7,7,14,netherlands,0.5,0.75,7,1.75,1.75,2.0,1.33,4
Go Ahead Eagles,8,4,2,2,13,12,1,14,netherlands,0.5,0.75,1,1.62,1.75,2.0,1.33,4
Heracles Almelo,8,4,2,2,12,11,1,14,netherlands,0.5,0.75,1,1.5,1.75,2.0,1.33,4
FC Twente,8,3,3,2,11,11,0,12,netherlands,0.38,0.75,0,1.38,1.5,2.63,1.33,5
Heerenveen,8,3,2,3,12,12,0,11,netherlands,0.38,0.62,0,1.5,1.38,2.63,1.61,6
FC Groningen,8,3,2,3,11,14,-3,11,netherlands,0.38,0.62,-3,1.38,1.38,2.63,1.61,6
AZ Alkmaar,8,2,3,3,11,12,-1,9,netherlands,0.25,0.62,-1,1.38,1.12,4.0,1.61,7
NEC Nijmegen,8,2,3,3,10,13,-3,9,netherlands,0.25,0.62,-3,1.25,1.12,4.0,1.61,7
PEC Zwolle,8,1,4,3,9,12,-3,7,netherlands,0.12,0.62,-3,1.12,0.88,8.33,1.61,8
Fortuna Sittard,8,2,1,5,4,11,-7,7,netherlands,0.25,0.38,-7,0.5,0.88,4.0,2.63,8
RKC Waalwijk,8,1,2,5,9,13,-4,5,netherlands,0.12,0.38,-4,1.12,0.62,8.33,2.63,9
Almere City,8,1,2,5,7,14,-7,5,netherlands,0.12,0.38,-7,0.88,0.62,8.33,2.63,9
NAC Breda,8,0,5,3,5,13,-8,5,netherlands,0.0,0.62,-8,0.62,0.62,0.0,1.61,9
Willem II,8,0,1,7,6,19,-13,1,netherlands,0.0,0.12,-13,0.75,0.12,0.0,8.33,10
FC Volendam,8,7,0,1,20,6,14,21,netherlands2,0.88,0.88,14,2.5,2.62,1.14,1.14,1
Excelsior,8,6,1,1,18,7,11,19,netherlands2,0.75,0.88,11,2.25,2.38,1.33,1.14,2
Telstar,8,5,2,1,18,8,10,17,netherlands2,0.62,0.88,10,2.25,2.12,1.61,1.14,3
ADO Den Haag,8,5,2,1,11,9,2,17,netherlands2,0.62,0.88,2,1.38,2.12,1.61,1.14,3
De Graafschap,8,5,1,2,12,6,6,16,netherlands2,0.62,0.75,6,1.5,2.0,1.61,1.33,4
Cambuur,8,5,1,2,16,11,5,16,netherlands2,0.62,0.75,5,2.0,2.0,1.61,1.33,4
Jong AZ,8,4,3,1,18,8,10,15,netherlands2,0.5,0.88,10,2.25,1.88,2.0,1.14,5
FC Dordrecht,8,4,0,4,15,10,5,12,netherlands2,0.5,0.5,5,1.88,1.5,2.0,2.0,6
Vitesse Arnhem,8,3,3,2,12,8,4,12,netherlands2,0.38,0.75,4,1.5,1.5,2.63,1.33,6
VVV,8,3,3,2,12,10,2,12,netherlands2,0.38,0.75,2,1.5,1.5,2.63,1.33,6
FC Emmen,8,4,0,4,10,10,0,12,netherlands2,0.5,0.5,0,1.25,1.5,2.0,2.0,6
FC Eindhoven,8,2,4,2,13,15,-2,10,netherlands2,0.25,0.75,-2,1.62,1.25,4.0,1.33,7
Roda JC,8,3,1,4,9,16,-7,10,netherlands2,0.38,0.5,-7,1.12,1.25,2.63,2.0,7
TOP Oss,8,2,3,3,8,11,-3,9,netherlands2,0.25,0.62,-3,1.0,1.12,4.0,1.61,8
FC Den Bosch,8,2,2,4,11,16,-5,8,netherlands2,0.25,0.5,-5,1.38,1.0,4.0,2.0,9
Helmond Sport,8,1,4,3,14,16,-2,7,netherlands2,0.12,0.62,-2,1.75,0.88,8.33,1.61,10
Jong PSV,8,1,3,4,13,20,-7,6,netherlands2,0.12,0.5,-7,1.62,0.75,8.33,2.0,11
MVV Maastricht,8,1,1,6,9,13,-4,4,netherlands2,0.12,0.25,-4,1.12,0.5,8.33,4.0,12
Jong Utrecht,8,0,2,6,3,21,-18,2,netherlands2,0.0,0.25,-18,0.38,0.25,0.0,4.0,13
Jong Ajax,8,0,1,7,2,16,-14,1,netherlands2,0.0,0.12,-14,0.25,0.12,0.0,8.33,14
Diriangen,8,7,1,0,29,1,28,22,nicaragua,0.88,1.0,28,3.62,2.75,1.14,1.0,1
Matagalpa,8,6,1,1,16,6,10,19,nicaragua,0.75,0.88,10,2.0,2.38,1.33,1.14,2
Real Esteli,8,4,3,1,13,9,4,15,nicaragua,0.5,0.88,4,1.62,1.88,2.0,1.14,3
Walter Ferreti,8,3,3,2,7,6,1,12,nicaragua,0.38,0.75,1,0.88,1.5,2.63,1.33,4
Managua FC,8,3,1,4,11,10,1,10,nicaragua,0.38,0.5,1,1.38,1.25,2.63,2.0,5
UNAN Managua,8,3,1,4,9,15,-6,10,nicaragua,0.38,0.5,-6,1.12,1.25,2.63,2.0,5
Jalapa,8,2,3,3,6,13,-7,9,nicaragua,0.25,0.62,-7,0.75,1.12,4.0,1.61,6
Export Sebaco,8,2,2,4,9,10,-1,8,nicaragua,0.25,0.5,-1,1.12,1.0,4.0,2.0,7
Rancho Santana,8,1,1,6,6,20,-14,4,nicaragua,0.12,0.25,-14,0.75,0.5,8.33,4.0,8
D. Ocotal,8,1,1,6,6,21,-15,4,nicaragua,0.12,0.25,-15,0.75,0.5,8.33,4.0,8
Real Esteli,8,8,0,0,23,7,16,24,nicaragua2,1.0,1.0,16,2.88,3.0,1.0,1.0,1
Managua FC,8,6,1,1,20,6,14,19,nicaragua2,0.75,0.88,14,2.5,2.38,1.33,1.14,2
Matagalpa,8,4,2,2,17,12,5,14,nicaragua2,0.5,0.75,5,2.12,1.75,2.0,1.33,3
Diriangen,8,3,2,3,14,15,-1,11,nicaragua2,0.38,0.62,-1,1.75,1.38,2.63,1.61,4
CS Sebaco,8,3,2,3,8,9,-1,11,nicaragua2,0.38,0.62,-1,1.0,1.38,2.63,1.61,4
UNAN Managua,8,3,1,4,10,15,-5,10,nicaragua2,0.38,0.5,-5,1.25,1.25,2.63,2.0,5
D. Ocotal,8,2,2,4,9,18,-9,8,nicaragua2,0.25,0.5,-9,1.12,1.0,4.0,2.0,6
Walter Ferreti,8,1,3,4,6,8,-2,6,nicaragua2,0.12,0.5,-2,0.75,0.75,8.33,2.0,7
Jalapa,8,1,3,4,9,13,-4,6,nicaragua2,0.12,0.5,-4,1.12,0.75,8.33,2.0,7
Rancho Santana,8,0,3,5,4,16,-12,3,nicaragua2,0.0,0.38,-12,0.5,0.38,0.0,2.63,8
Linfield,8,6,0,2,15,6,9,18,northernireland,0.75,0.75,9,1.88,2.25,1.33,1.33,1
Larne,8,4,4,0,13,9,4,16,northernireland,0.5,1.0,4,1.62,2.0,2.0,1.0,2
Cliftonville,8,4,1,3,15,8,7,13,northernireland,0.5,0.62,7,1.88,1.62,2.0,1.61,3
Portadown,8,3,2,3,9,10,-1,11,northernireland,0.38,0.62,-1,1.12,1.38,2.63,1.61,4
Coleraine,8,3,2,3,10,12,-2,11,northernireland,0.38,0.62,-2,1.25,1.38,2.63,1.61,4
Crusaders,8,3,2,3,9,12,-3,11,northernireland,0.38,0.62,-3,1.12,1.38,2.63,1.61,4
Ballymena Utd,8,3,1,4,12,14,-2,10,northernireland,0.38,0.5,-2,1.5,1.25,2.63,2.0,5
Glentoran,8,2,3,3,14,12,2,9,northernireland,0.25,0.62,2,1.75,1.12,4.0,1.61,6
Carrick Rangers,8,2,3,3,9,11,-2,9,northernireland,0.25,0.62,-2,1.12,1.12,4.0,1.61,6
Dungannon,8,2,2,4,9,15,-6,8,northernireland,0.25,0.5,-6,1.12,1.0,4.0,2.0,7
Loughgall,8,2,2,4,9,15,-6,8,northernireland,0.25,0.5,-6,1.12,1.0,4.0,2.0,7
Glenavon,8,1,2,5,6,11,-5,5,northernireland,0.12,0.38,-5,0.75,0.62,8.33,2.63,8
Annagh Utd,8,7,0,1,19,8,11,21,northernireland2,0.88,0.88,11,2.38,2.62,1.14,1.14,1
Newington,8,5,2,1,20,15,5,17,northernireland2,0.62,0.88,5,2.5,2.12,1.61,1.14,2
Ards,8,4,2,2,14,12,2,14,northernireland2,0.5,0.75,2,1.75,1.75,2.0,1.33,3
Limavady,8,3,4,1,11,8,3,13,northernireland2,0.38,0.88,3,1.38,1.62,2.63,1.14,4
Bangor,8,3,3,2,14,12,2,12,northernireland2,0.38,0.75,2,1.75,1.5,2.63,1.33,5
HW Welders,8,4,0,4,14,12,2,12,northernireland2,0.5,0.5,2,1.75,1.5,2.0,2.0,5
Institute,8,3,2,3,15,19,-4,11,northernireland2,0.38,0.62,-4,1.88,1.38,2.63,1.61,6
Newry City,8,2,3,3,13,14,-1,9,northernireland2,0.25,0.62,-1,1.62,1.12,4.0,1.61,7
Ballinamallard,8,2,2,4,8,10,-2,8,northernireland2,0.25,0.5,-2,1.0,1.0,4.0,2.0,8
Ballyclare,8,1,3,4,11,16,-5,6,northernireland2,0.12,0.5,-5,1.38,0.75,8.33,2.0,9
Dundela,8,1,2,5,5,12,-7,5,northernireland2,0.12,0.38,-7,0.62,0.62,8.33,2.63,10
Armagh City,8,1,1,6,14,25,-11,4,northernireland2,0.12,0.25,-11,1.75,0.5,8.33,4.0,11
Sileks,8,6,2,0,21,5,16,20,northmacedonia,0.75,1.0,16,2.62,2.5,1.33,1.0,1
Shkendija,8,6,1,1,13,7,6,19,northmacedonia,0.75,0.88,6,1.62,2.38,1.33,1.14,2
Vardar,8,3,5,0,12,6,6,14,northmacedonia,0.38,1.0,6,1.5,1.75,2.63,1.0,3
Struga,8,4,2,2,13,8,5,14,northmacedonia,0.5,0.75,5,1.62,1.75,2.0,1.33,3
Rabotnicki,8,3,3,2,5,5,0,12,northmacedonia,0.38,0.75,0,0.62,1.5,2.63,1.33,4
Tikves,8,3,2,3,8,8,0,11,northmacedonia,0.38,0.62,0,1.0,1.38,2.63,1.61,5
Besa,8,3,1,4,10,19,-9,10,northmacedonia,0.38,0.5,-9,1.25,1.25,2.63,2.0,6
Gostivar,8,2,3,3,9,10,-1,9,northmacedonia,0.25,0.62,-1,1.12,1.12,4.0,1.61,7
Voska Sport,8,2,2,4,8,11,-3,8,northmacedonia,0.25,0.5,-3,1.0,1.0,4.0,2.0,8
Pelister,8,2,0,6,7,15,-8,6,northmacedonia,0.25,0.25,-8,0.88,0.75,4.0,4.0,9
Shkupi,8,1,2,5,7,11,-4,5,northmacedonia,0.12,0.38,-4,0.88,0.62,8.33,2.63,10
Brera Strumica,8,1,1,6,7,15,-8,4,northmacedonia,0.12,0.25,-8,0.88,0.5,8.33,4.0,11
Fredrikstad,4,3,0,1,8,2,6,9,norway,0.75,0.75,6,2.0,2.25,1.33,1.33,1
Viking,4,3,0,1,12,7,5,9,norway,0.75,0.75,5,3.0,2.25,1.33,1.33,1
Rosenborg,3,3,0,0,5,1,4,9,norway,1.0,1.0,4,1.67,3.0,1.0,1.0,1
Brann,4,3,0,1,7,6,1,9,norway,0.75,0.75,1,1.75,2.25,1.33,1.33,1
Bodo.Glimt,3,2,1,0,6,2,4,7,norway,0.67,1.0,4,2.0,2.33,1.49,1.0,2
Sarpsborg 08,3,2,1,0,6,2,4,7,norway,0.67,1.0,4,2.0,2.33,1.49,1.0,2
Kristiansund,4,2,0,2,7,8,-1,6,norway,0.5,0.5,-1,1.75,1.5,2.0,2.0,3
Valerenga,4,1,1,2,4,6,-2,4,norway,0.25,0.5,-2,1.0,1.0,4.0,2.0,4
Stromsgodset,4,1,0,3,8,6,2,3,norway,0.25,0.25,2,2.0,0.75,4.0,4.0,5
Bryne,3,1,0,2,4,4,0,3,norway,0.33,0.33,0,1.33,1.0,3.03,3.03,5
Sandefjord,3,1,0,2,5,6,-1,3,norway,0.33,0.33,-1,1.67,1.0,3.03,3.03,5
KFUM Oslo,3,1,0,2,5,7,-2,3,norway,0.33,0.33,-2,1.67,1.0,3.03,3.03,5
Tromso,3,1,0,2,4,6,-2,3,norway,0.33,0.33,-2,1.33,1.0,3.03,3.03,5
HamKam,3,1,0,2,4,9,-5,3,norway,0.33,0.33,-5,1.33,1.0,3.03,3.03,5
Molde,3,0,1,2,2,7,-5,1,norway,0.0,0.33,-5,0.67,0.33,0.0,3.03,6
Haugesund,3,0,0,3,1,9,-8,0,norway,0.0,0.0,-8,0.33,0.0,0.0,0.0,7
Egersund,3,3,0,0,9,5,4,9,norway2,1.0,1.0,4,3.0,3.0,1.0,1.0,1
Kongsvinger,3,2,1,0,9,1,8,7,norway2,0.67,1.0,8,3.0,2.33,1.49,1.0,2
Lillestrom,3,2,1,0,6,2,4,7,norway2,0.67,1.0,4,2.0,2.33,1.49,1.0,2
Raufoss,3,2,1,0,7,5,2,7,norway2,0.67,1.0,2,2.33,2.33,1.49,1.0,2
Start,3,2,0,1,6,4,2,6,norway2,0.67,0.67,2,2.0,2.0,1.49,1.49,3
Odd,3,2,0,1,4,3,1,6,norway2,0.67,0.67,1,1.33,2.0,1.49,1.49,3
Aalesund,3,1,2,0,6,5,1,5,norway2,0.33,1.0,1,2.0,1.67,3.03,1.0,4
Hodd,3,1,1,1,3,4,-1,4,norway2,0.33,0.67,-1,1.0,1.33,3.03,1.49,5
Stabaek,3,1,1,1,2,4,-2,4,norway2,0.33,0.67,-2,0.67,1.33,3.03,1.49,5
Lyn,3,1,0,2,4,3,1,3,norway2,0.33,0.33,1,1.33,1.0,3.03,3.03,6
Sogndal,3,1,0,2,6,7,-1,3,norway2,0.33,0.33,-1,2.0,1.0,3.03,3.03,6
Moss,3,1,0,2,4,9,-5,3,norway2,0.33,0.33,-5,1.33,1.0,3.03,3.03,6
Mjondalen,3,0,2,1,3,4,-1,2,norway2,0.0,0.67,-1,1.0,0.67,0.0,1.49,7
Asane,3,0,1,2,3,6,-3,1,norway2,0.0,0.33,-3,1.0,0.33,0.0,3.03,8
Skeid,3,0,0,3,5,9,-4,0,norway2,0.0,0.0,-4,1.67,0.0,0.0,0.0,9
Ranheim,3,0,0,3,1,7,-6,0,norway2,0.0,0.0,-6,0.33,0.0,0.0,0.0,9
Sotra,3,2,1,0,8,1,7,7,norway3,0.67,1.0,7,2.67,2.33,1.49,1.0,1
Sandnes Ulf,3,2,1,0,8,5,3,7,norway3,0.67,1.0,3,2.67,2.33,1.49,1.0,1
Brann B,3,2,0,1,10,9,1,6,norway3,0.67,0.67,1,3.33,2.0,1.49,1.49,2
Sandviken,3,2,0,1,5,4,1,6,norway3,0.67,0.67,1,1.67,2.0,1.49,1.49,2
Notodden,3,1,2,0,4,3,1,5,norway3,0.33,1.0,1,1.33,1.67,3.03,1.0,3
Traef,3,1,1,1,5,5,0,4,norway3,0.33,0.67,0,1.67,1.33,3.03,1.49,4
Eik Tonsberg,3,1,1,1,4,4,0,4,norway3,0.33,0.67,0,1.33,1.33,3.03,1.49,4
Jerv,3,1,1,1,4,4,0,4,norway3,0.33,0.67,0,1.33,1.33,3.03,1.49,4
Lysekloster,3,1,1,1,4,4,0,4,norway3,0.33,0.67,0,1.33,1.33,3.03,1.49,4
Arendal,3,0,3,0,5,5,0,3,norway3,0.0,1.0,0,1.67,1.0,0.0,1.0,5
Brattvag,3,1,0,2,5,6,-1,3,norway3,0.33,0.33,-1,1.67,1.0,3.03,3.03,5
Pors Grenland,3,0,2,1,3,4,-1,2,norway3,0.0,0.67,-1,1.0,0.67,0.0,1.49,6
Flekkeroy,3,0,1,2,2,9,-7,1,norway3,0.0,0.33,-7,0.67,0.33,0.0,3.03,7
V. Haugesund,3,0,0,3,2,6,-4,0,norway3,0.0,0.0,-4,0.67,0.0,0.0,0.0,8
Strommen,3,3,0,0,8,3,5,9,norway4,1.0,1.0,5,2.67,3.0,1.0,1.0,1
Tromsdalen,3,2,1,0,7,3,4,7,norway4,0.67,1.0,4,2.33,2.33,1.49,1.0,2
Grorud,3,2,0,1,7,5,2,6,norway4,0.67,0.67,2,2.33,2.0,1.49,1.49,3
Kjelsas,3,2,0,1,5,4,1,6,norway4,0.67,0.67,1,1.67,2.0,1.49,1.49,3
Stjordals-Blink,3,2,0,1,4,5,-1,6,norway4,0.67,0.67,-1,1.33,2.0,1.49,1.49,3
Eidsvold,3,1,1,1,5,5,0,4,norway4,0.33,0.67,0,1.67,1.33,3.03,1.49,4
Follo,3,1,1,1,5,5,0,4,norway4,0.33,0.67,0,1.67,1.33,3.03,1.49,4
Asker,3,0,3,0,4,4,0,3,norway4,0.0,1.0,0,1.33,1.0,0.0,1.0,5
Levanger,3,1,0,2,6,7,-1,3,norway4,0.33,0.33,-1,2.0,1.0,3.03,3.03,5
Ull/Kisa,3,1,0,2,4,5,-1,3,norway4,0.33,0.33,-1,1.33,1.0,3.03,3.03,5
Alta,3,1,0,2,6,8,-2,3,norway4,0.33,0.33,-2,2.0,1.0,3.03,3.03,5
Honefoss,3,1,0,2,4,6,-2,3,norway4,0.33,0.33,-2,1.33,1.0,3.03,3.03,5
Rana,3,1,0,2,4,6,-2,3,norway4,0.33,0.33,-2,1.33,1.0,3.03,3.03,5
Strindheim,3,0,0,3,3,6,-3,0,norway4,0.0,0.0,-3,1.0,0.0,0.0,0.0,6
Junkeren,3,3,0,0,12,3,9,9,norway5,1.0,1.0,9,4.0,3.0,1.0,1.0,1
Floya,3,2,1,0,9,5,4,7,norway5,0.67,1.0,4,3.0,2.33,1.49,1.0,2
Frigg,3,2,1,0,9,6,3,7,norway5,0.67,1.0,3,3.0,2.33,1.49,1.0,2
Ulfstind,3,2,0,1,3,3,0,6,norway5,0.67,0.67,0,1.0,2.0,1.49,1.49,3
Gamle Oslo,3,1,2,0,8,3,5,5,norway5,0.33,1.0,5,2.67,1.67,3.03,1.0,4
Sortland,3,1,1,1,4,9,-5,4,norway5,0.33,0.67,-5,1.33,1.33,3.03,1.49,5
Ullern,3,1,0,2,6,5,1,3,norway5,0.33,0.33,1,2.0,1.0,3.03,3.03,6
Tromso B,3,1,0,2,9,10,-1,3,norway5,0.33,0.33,-1,3.0,1.0,3.03,3.03,6
Baerum,3,1,0,2,3,4,-1,3,norway5,0.33,0.33,-1,1.0,1.0,3.03,3.03,6
Harstad,3,1,0,2,6,9,-3,3,norway5,0.33,0.33,-3,2.0,1.0,3.03,3.03,6
Funnefoss/V,3,0,2,1,7,9,-2,2,norway5,0.0,0.67,-2,2.33,0.67,0.0,1.49,7
Skjervoy,3,0,2,1,5,8,-3,2,norway5,0.0,0.67,-3,1.67,0.67,0.0,1.49,7
Alta B,2,0,1,1,2,6,-4,1,norway5,0.0,0.5,-4,1.0,0.5,0.0,2.0,8
KFUM B,2,0,0,2,4,7,-3,0,norway5,0.0,0.0,-3,2.0,0.0,0.0,0.0,9
Melhus,3,3,0,0,15,0,15,9,norway6,1.0,1.0,15,5.0,3.0,1.0,1.0,1
Rosenborg B,3,3,0,0,6,0,6,9,norway6,1.0,1.0,6,2.0,3.0,1.0,1.0,1
Nardo,3,2,1,0,9,3,6,7,norway6,0.67,1.0,6,3.0,2.33,1.49,1.0,2
Trygg/Lade,3,2,0,1,11,1,10,6,norway6,0.67,0.67,10,3.67,2.0,1.49,1.49,3
Spjelkavik,3,2,0,1,9,5,4,6,norway6,0.67,0.67,4,3.0,2.0,1.49,1.49,3
Volda,2,1,1,0,3,1,2,4,norway6,0.5,1.0,2,1.5,2.0,2.0,1.0,4
Byasen,3,1,1,1,3,2,1,4,norway6,0.33,0.67,1,1.0,1.33,3.03,1.49,4
Aalesund B,2,1,0,1,5,5,0,3,norway6,0.5,0.5,0,2.5,1.5,2.0,2.0,5
Kvik Trondheim,3,1,0,2,4,8,-4,3,norway6,0.33,0.33,-4,1.33,1.0,3.03,3.03,5
Ranheim B,3,1,0,2,3,7,-4,3,norway6,0.33,0.33,-4,1.0,1.0,3.03,3.03,5
Tiller,3,0,2,1,2,3,-1,2,norway6,0.0,0.67,-1,0.67,0.67,0.0,1.49,6
Kristiansund B,3,0,1,2,1,9,-8,1,norway6,0.0,0.33,-8,0.33,0.33,0.0,3.03,7
Molde B,3,0,0,3,3,10,-7,0,norway6,0.0,0.0,-7,1.0,0.0,0.0,0.0,8
Surnadal,3,0,0,3,1,21,-20,0,norway6,0.0,0.0,-20,0.33,0.0,0.0,0.0,8
Elverum,3,3,0,0,13,3,10,9,norway7,1.0,1.0,10,4.33,3.0,1.0,1.0,1
Skjetten,3,2,1,0,7,1,6,7,norway7,0.67,1.0,6,2.33,2.33,1.49,1.0,2
Kongsvinger B,3,2,1,0,8,4,4,7,norway7,0.67,1.0,4,2.67,2.33,1.49,1.0,2
Lorenskog,3,2,0,1,10,5,5,6,norway7,0.67,0.67,5,3.33,2.0,1.49,1.49,3
Skedsmo,3,2,0,1,10,9,1,6,norway7,0.67,0.67,1,3.33,2.0,1.49,1.49,3
Gjovik-Lyn,3,1,2,0,4,2,2,5,norway7,0.33,1.0,2,1.33,1.67,3.03,1.0,4
Lillehammer,3,1,1,1,9,6,3,4,norway7,0.33,0.67,3,3.0,1.33,3.03,1.49,5
Nordstrand,3,1,1,1,5,7,-2,4,norway7,0.33,0.67,-2,1.67,1.33,3.03,1.49,5
Bjorkelangen,3,1,1,1,4,7,-3,4,norway7,0.33,0.67,-3,1.33,1.33,3.03,1.49,5
Stromsgodset B,3,1,0,2,4,7,-3,3,norway7,0.33,0.33,-3,1.33,1.0,3.03,3.03,6
Lillestrom B,3,1,0,2,6,10,-4,3,norway7,0.33,0.33,-4,2.0,1.0,3.03,3.03,6
Assiden IF,3,0,1,2,5,8,-3,1,norway7,0.0,0.33,-3,1.67,0.33,0.0,3.03,7
HamKam B,3,0,0,3,4,9,-5,0,norway7,0.0,0.0,-5,1.33,0.0,0.0,0.0,8
Ull/Kisa B,3,0,0,3,2,13,-11,0,norway7,0.0,0.0,-11,0.67,0.0,0.0,0.0,8
Bjarg,3,3,0,0,14,2,12,9,norway8,1.0,1.0,12,4.67,3.0,1.0,1.0,1
Forde,3,3,0,0,8,2,6,9,norway8,1.0,1.0,6,2.67,3.0,1.0,1.0,1
Fana,3,2,1,0,15,2,13,7,norway8,0.67,1.0,13,5.0,2.33,1.49,1.0,2
Lyn B,3,2,0,1,10,9,1,6,norway8,0.67,0.67,1,3.33,2.0,1.49,1.49,3
Askoy,3,2,0,1,4,6,-2,6,norway8,0.67,0.67,-2,1.33,2.0,1.49,1.49,3
Gneist,3,1,2,0,7,6,1,5,norway8,0.33,1.0,1,2.33,1.67,3.03,1.0,4
Sandefjord B,3,1,1,1,8,10,-2,4,norway8,0.33,0.67,-2,2.67,1.33,3.03,1.49,5
Lyngbo,3,1,0,2,6,4,2,3,norway8,0.33,0.33,2,2.0,1.0,3.03,3.03,6
Fyllingsdalen,3,1,0,2,6,8,-2,3,norway8,0.33,0.33,-2,2.0,1.0,3.03,3.03,6
Asane B,3,1,0,2,6,11,-5,3,norway8,0.33,0.33,-5,2.0,1.0,3.03,3.03,6
Fjora,3,1,0,2,5,11,-6,3,norway8,0.33,0.33,-6,1.67,1.0,3.03,3.03,6
Loddefjord,3,1,0,2,5,13,-8,3,norway8,0.33,0.33,-8,1.67,1.0,3.03,3.03,6
OS,3,0,0,3,4,8,-4,0,norway8,0.0,0.0,-4,1.33,0.0,0.0,0.0,7
Valerenga B,3,0,0,3,4,10,-6,0,norway8,0.0,0.0,-6,1.33,0.0,0.0,0.0,7
Vidar,3,3,0,0,8,2,6,9,norway9,1.0,1.0,6,2.67,3.0,1.0,1.0,1
Torvastad,3,2,1,0,9,3,6,7,norway9,0.67,1.0,6,3.0,2.33,1.49,1.0,2
Madla,3,1,2,0,5,4,1,5,norway9,0.33,1.0,1,1.67,1.67,3.03,1.0,3
Viking B,3,1,1,1,9,4,5,4,norway9,0.33,0.67,5,3.0,1.33,3.03,1.49,4
Staal Jorpeland,3,1,1,1,12,8,4,4,norway9,0.33,0.67,4,4.0,1.33,3.03,1.49,4
Vindbjart,2,1,1,0,3,2,1,4,norway9,0.5,1.0,1,1.5,2.0,2.0,1.0,4
Vag,3,1,0,2,11,10,1,3,norway9,0.33,0.33,1,3.67,1.0,3.03,3.03,5
Djerv,3,1,0,2,9,9,0,3,norway9,0.33,0.33,0,3.0,1.0,3.03,3.03,5
Hinna,3,1,0,2,9,10,-1,3,norway9,0.33,0.33,-1,3.0,1.0,3.03,3.03,5
Sandnes Ulf B,2,1,0,1,7,10,-3,3,norway9,0.5,0.5,-3,3.5,1.5,2.0,2.0,5
Haugesund B,3,1,0,2,6,9,-3,3,norway9,0.33,0.33,-3,2.0,1.0,3.03,3.03,5
Brodd,3,1,0,2,4,9,-5,3,norway9,0.33,0.33,-5,1.33,1.0,3.03,3.03,5
Sola,3,1,0,2,7,16,-9,3,norway9,0.33,0.33,-9,2.33,1.0,3.03,3.03,5
Stord,3,0,2,1,3,6,-3,2,norway9,0.0,0.67,-3,1.0,0.67,0.0,1.49,6
Sarpsborg 08 B,3,3,0,0,10,3,7,9,norway10,1.0,1.0,7,3.33,3.0,1.0,1.0,1
Stabaek B,3,2,0,1,6,3,3,6,norway10,0.67,0.67,3,2.0,2.0,1.49,1.49,2
Kvik Halden,3,2,0,1,7,6,1,6,norway10,0.67,0.67,1,2.33,2.0,1.49,1.49,2
Pors Grenland B,3,2,0,1,5,4,1,6,norway10,0.67,0.67,1,1.67,2.0,1.49,1.49,2
Fram,3,1,1,1,7,4,3,4,norway10,0.33,0.67,3,2.33,1.33,3.03,1.49,3
Grei,2,1,1,0,3,2,1,4,norway10,0.5,1.0,1,1.5,2.0,2.0,1.0,3
Drobak-Frogn,3,1,1,1,3,6,-3,4,norway10,0.33,0.67,-3,1.0,1.33,3.03,1.49,3
Orn Horten,3,1,0,2,7,7,0,3,norway10,0.33,0.33,0,2.33,1.0,3.03,3.03,4
Flint,3,1,0,2,6,6,0,3,norway10,0.33,0.33,0,2.0,1.0,3.03,3.03,4
Odd B,2,1,0,1,2,2,0,3,norway10,0.5,0.5,0,1.0,1.5,2.0,2.0,4
Oppsal,3,1,0,2,5,6,-1,3,norway10,0.33,0.33,-1,1.67,1.0,3.03,3.03,4
Fredrikstad B,3,1,0,2,5,9,-4,3,norway10,0.33,0.33,-4,1.67,1.0,3.03,3.03,4
Lokomotiv Oslo,3,1,0,2,3,7,-4,3,norway10,0.33,0.33,-4,1.0,1.0,3.03,3.03,4
IF Ready,3,0,1,2,1,5,-4,1,norway10,0.0,0.33,-4,0.33,0.33,0.0,3.03,5
Universitario,8,6,1,1,11,5,6,19,panama,0.75,0.88,6,1.38,2.38,1.33,1.14,1
Plaza Amador,8,4,3,1,13,8,5,15,panama,0.5,0.88,5,1.62,1.88,2.0,1.14,2
San Francisco,8,4,2,2,12,6,6,14,panama,0.5,0.75,6,1.5,1.75,2.0,1.33,3
Tauro,8,3,3,2,13,9,4,12,panama,0.38,0.75,4,1.62,1.5,2.63,1.33,4
Arabe Unido,8,3,2,3,7,5,2,11,panama,0.38,0.62,2,0.88,1.38,2.63,1.61,5
San Miguelito,8,3,2,3,6,8,-2,11,panama,0.38,0.62,-2,0.75,1.38,2.63,1.61,5
Veraguas,8,3,1,4,11,17,-6,10,panama,0.38,0.5,-6,1.38,1.25,2.63,2.0,6
Independiente,8,2,3,3,10,8,2,9,panama,0.25,0.62,2,1.25,1.12,4.0,1.61,7
Costa del Este,8,3,0,5,6,11,-5,9,panama,0.38,0.38,-5,0.75,1.12,2.63,2.63,7
Alianza,8,1,4,3,8,11,-3,7,panama,0.12,0.62,-3,1.0,0.88,8.33,1.61,8
Herrera,8,1,4,3,5,9,-4,7,panama,0.12,0.62,-4,0.62,0.88,8.33,1.61,8
UMECIT,8,1,3,4,6,11,-5,6,panama,0.12,0.5,-5,0.75,0.75,8.33,2.0,9
San Miguelito,8,5,2,1,8,4,4,17,panama2,0.62,0.88,4,1.0,2.12,1.61,1.14,1
Independiente,8,5,1,2,14,11,3,16,panama2,0.62,0.75,3,1.75,2.0,1.61,1.33,2
Plaza Amador,8,4,3,1,9,6,3,15,panama2,0.5,0.88,3,1.12,1.88,2.0,1.14,3
Tauro,8,4,3,1,9,6,3,15,panama2,0.5,0.88,3,1.12,1.88,2.0,1.14,3
Veraguas,8,3,3,2,11,7,4,12,panama2,0.38,0.75,4,1.38,1.5,2.63,1.33,4
Arabe Unido,8,2,5,1,7,6,1,11,panama2,0.25,0.88,1,0.88,1.38,4.0,1.14,5
Universitario,8,3,2,3,6,5,1,11,panama2,0.38,0.62,1,0.75,1.38,2.63,1.61,5
UMECIT,8,3,1,4,8,8,0,10,panama2,0.38,0.5,0,1.0,1.25,2.63,2.0,6
Costa del Este,8,2,3,3,10,15,-5,9,panama2,0.25,0.62,-5,1.25,1.12,4.0,1.61,7
Alianza,8,2,0,6,8,12,-4,6,panama2,0.25,0.25,-4,1.0,0.75,4.0,4.0,8
San Francisco,8,1,2,5,4,10,-6,5,panama2,0.12,0.38,-6,0.5,0.62,8.33,2.63,9
Herrera,8,1,1,6,4,8,-4,4,panama2,0.12,0.25,-4,0.5,0.5,8.33,4.0,10
Cerro Porteno,8,5,2,1,9,3,6,17,paraguay,0.62,0.88,6,1.12,2.12,1.61,1.14,1
Libertad,8,4,3,1,13,7,6,15,paraguay,0.5,0.88,6,1.62,1.88,2.0,1.14,2
D. Recoleta,8,3,4,1,14,8,6,13,paraguay,0.38,0.88,6,1.75,1.62,2.63,1.14,3
S. Luqueno,8,3,3,2,8,8,0,12,paraguay,0.38,0.75,0,1.0,1.5,2.63,1.33,4
Olimpia,8,3,2,3,9,8,1,11,paraguay,0.38,0.62,1,1.12,1.38,2.63,1.61,5
Guarani,8,3,2,3,7,8,-1,11,paraguay,0.38,0.62,-1,0.88,1.38,2.63,1.61,5
Nacional,8,3,2,3,7,8,-1,11,paraguay,0.38,0.62,-1,0.88,1.38,2.63,1.61,5
S. Trinidense,8,2,4,2,8,7,1,10,paraguay,0.25,0.75,1,1.0,1.25,4.0,1.33,6
A. Tembetary,8,2,3,3,6,7,-1,9,paraguay,0.25,0.62,-1,0.75,1.12,4.0,1.61,7
S. Ameliano,8,2,2,4,8,8,0,8,paraguay,0.25,0.5,0,1.0,1.0,4.0,2.0,8
G. Caballero,8,2,1,5,3,11,-8,7,paraguay,0.25,0.38,-8,0.38,0.88,4.0,2.63,9
2 de Mayo,8,1,2,5,5,14,-9,5,paraguay,0.12,0.38,-9,0.62,0.62,8.33,2.63,10
Olimpia,8,4,3,1,10,4,6,15,paraguay2,0.5,0.88,6,1.25,1.88,2.0,1.14,1
Guarani,8,3,5,0,10,7,3,14,paraguay2,0.38,1.0,3,1.25,1.75,2.63,1.0,2
S. Ameliano,8,4,1,3,7,6,1,13,paraguay2,0.5,0.62,1,0.88,1.62,2.0,1.61,3
Sol de America,8,3,3,2,12,9,3,12,paraguay2,0.38,0.75,3,1.5,1.5,2.63,1.33,4
S. Luqueno,8,3,3,2,10,8,2,12,paraguay2,0.38,0.75,2,1.25,1.5,2.63,1.33,4
S. Trinidense,8,3,3,2,10,9,1,12,paraguay2,0.38,0.75,1,1.25,1.5,2.63,1.33,4
2 de Mayo,8,2,4,2,7,5,2,10,paraguay2,0.25,0.75,2,0.88,1.25,4.0,1.33,5
G. Caballero,8,2,3,3,7,7,0,9,paraguay2,0.25,0.62,0,0.88,1.12,4.0,1.61,6
Nacional,8,1,5,2,8,9,-1,8,paraguay2,0.12,0.75,-1,1.0,1.0,8.33,1.33,7
Cerro Porteno,8,2,2,4,11,15,-4,8,paraguay2,0.25,0.5,-4,1.38,1.0,4.0,2.0,7
Libertad,8,2,1,5,8,12,-4,7,paraguay2,0.25,0.38,-4,1.0,0.88,4.0,2.63,8
Tacuary,8,1,3,4,5,14,-9,6,paraguay2,0.12,0.5,-9,0.62,0.75,8.33,2.0,9
Universitario,8,6,2,0,21,7,14,20,peru,0.75,1.0,14,2.62,2.5,1.33,1.0,1
D. Garcilaso,8,6,1,1,16,5,11,19,peru,0.75,0.88,11,2.0,2.38,1.33,1.14,2
FBC Melgar,8,6,0,2,16,9,7,18,peru,0.75,0.75,7,2.0,2.25,1.33,1.33,3
Alianza Lima,8,5,1,2,9,8,1,16,peru,0.62,0.75,1,1.12,2.0,1.61,1.33,4
ADT,8,4,2,2,15,14,1,14,peru,0.5,0.75,1,1.88,1.75,2.0,1.33,5
Cusco,8,4,1,3,14,11,3,13,peru,0.5,0.62,3,1.75,1.62,2.0,1.61,6
Sport Huancayo,8,4,1,3,12,12,0,13,peru,0.5,0.62,0,1.5,1.62,2.0,1.61,6
S. Cristal,8,4,0,4,11,9,2,12,peru,0.5,0.5,2,1.38,1.5,2.0,2.0,7
Alianza A.,8,3,1,4,12,11,1,10,peru,0.38,0.5,1,1.5,1.25,2.63,2.0,8
Atletico Grau,7,2,3,2,9,10,-1,9,peru,0.29,0.71,-1,1.29,1.29,3.45,1.41,9
Sport Boys,8,2,3,3,12,14,-2,9,peru,0.25,0.62,-2,1.5,1.12,4.0,1.61,9
Binacional,8,2,2,4,11,16,-5,8,peru,0.25,0.5,-5,1.38,1.0,4.0,2.0,10
Cajamarca,8,2,2,4,8,14,-6,8,peru,0.25,0.5,-6,1.0,1.0,4.0,2.0,10
Cienciano,8,1,4,3,12,14,-2,7,peru,0.12,0.62,-2,1.5,0.88,8.33,1.61,11
Los Chankas,8,1,4,3,9,11,-2,7,peru,0.12,0.62,-2,1.12,0.88,8.33,1.61,11
Juan Pablo II C,7,2,0,5,7,11,-4,6,peru,0.29,0.29,-4,1.0,0.86,3.45,3.45,12
Comerciantes U.,8,1,3,4,11,17,-6,6,peru,0.12,0.5,-6,1.38,0.75,8.33,2.0,12
Ayacucho,8,1,2,5,8,15,-7,5,peru,0.12,0.38,-7,1.0,0.62,8.33,2.63,13
A. Huanuco,8,1,2,5,6,15,-9,5,peru,0.12,0.38,-9,0.75,0.62,8.33,2.63,13
Manila Digger,8,6,1,1,20,4,16,19,philippines,0.75,0.88,16,2.5,2.38,1.33,1.14,1
Kaya FC,8,6,1,1,16,6,10,19,philippines,0.75,0.88,10,2.0,2.38,1.33,1.14,1
Davao Aguilas,8,4,3,1,12,3,9,15,philippines,0.5,0.88,9,1.5,1.88,2.0,1.14,2
One Taguig,8,4,2,2,16,6,10,14,philippines,0.5,0.75,10,2.0,1.75,2.0,1.33,3
Stallion,8,3,2,3,15,12,3,11,philippines,0.38,0.62,3,1.88,1.38,2.63,1.61,4
DH Cebu,8,3,2,3,11,9,2,11,philippines,0.38,0.62,2,1.38,1.38,2.63,1.61,4
Maharlika,8,3,0,5,9,14,-5,9,philippines,0.38,0.38,-5,1.12,1.12,2.63,2.63,5
PFF Development,8,1,3,4,9,20,-11,6,philippines,0.12,0.5,-11,1.12,0.75,8.33,2.0,6
Mendiola,8,1,1,6,5,37,-32,4,philippines,0.12,0.25,-32,0.62,0.5,8.33,4.0,7
Loyola,8,0,1,7,5,21,-16,1,philippines,0.0,0.12,-16,0.62,0.12,0.0,8.33,8
Rakow C.,8,6,1,1,15,6,9,19,poland,0.75,0.88,9,1.88,2.38,1.33,1.14,1
Lech Poznan,8,6,0,2,17,9,8,18,poland,0.75,0.75,8,2.12,2.25,1.33,1.33,2
Pogon Szczecin,8,4,2,2,16,8,8,14,poland,0.5,0.75,8,2.0,1.75,2.0,1.33,3
Radomiak Radom,8,4,2,2,14,10,4,14,poland,0.5,0.75,4,1.75,1.75,2.0,1.33,3
Motor Lublin,8,4,2,2,15,14,1,14,poland,0.5,0.75,1,1.88,1.75,2.0,1.33,3
Korona Kielce,8,4,2,2,10,9,1,14,poland,0.5,0.75,1,1.25,1.75,2.0,1.33,3
Jagiellonia,8,4,2,2,9,8,1,14,poland,0.5,0.75,1,1.12,1.75,2.0,1.33,3
Katowice,8,4,0,4,10,11,-1,12,poland,0.5,0.5,-1,1.25,1.5,2.0,2.0,4
Slask Wroclaw,8,3,2,3,14,13,1,11,poland,0.38,0.62,1,1.75,1.38,2.63,1.61,5
Legia Warsaw,8,3,2,3,13,13,0,11,poland,0.38,0.62,0,1.62,1.38,2.63,1.61,5
Widzew Lodz,8,3,1,4,8,10,-2,10,poland,0.38,0.5,-2,1.0,1.25,2.63,2.0,6
Zaglebie Lubin,8,3,1,4,8,10,-2,10,poland,0.38,0.5,-2,1.0,1.25,2.63,2.0,6
Gornik Zabrze,8,3,0,5,12,11,1,9,poland,0.38,0.38,1,1.5,1.12,2.63,2.63,7
Piast Gliwice,8,2,3,3,8,12,-4,9,poland,0.25,0.62,-4,1.0,1.12,4.0,1.61,7
Puszcza Niepolo,8,2,2,4,10,13,-3,8,poland,0.25,0.5,-3,1.25,1.0,4.0,2.0,8
Cracovia Krakow,8,2,2,4,13,17,-4,8,poland,0.25,0.5,-4,1.62,1.0,4.0,2.0,8
Lechia Gdansk,8,2,0,6,8,15,-7,6,poland,0.25,0.25,-7,1.0,0.75,4.0,4.0,9
Stal Mielec,8,0,2,6,9,20,-11,2,poland,0.0,0.25,-11,1.12,0.25,0.0,4.0,10
Tychy,8,7,0,1,16,5,11,21,poland2,0.88,0.88,11,2.0,2.62,1.14,1.14,1
Polonia Warszaw,8,6,2,0,17,8,9,20,poland2,0.75,1.0,9,2.12,2.5,1.33,1.0,2
Arka Gdynia,8,6,2,0,13,4,9,20,poland2,0.75,1.0,9,1.62,2.5,1.33,1.0,2
Wisla Krakow,8,6,1,1,12,7,5,19,poland2,0.75,0.88,5,1.5,2.38,1.33,1.14,3
Wisla Plock,8,5,2,1,13,4,9,17,poland2,0.62,0.88,9,1.62,2.12,1.61,1.14,4
T. Nieciecza,8,4,2,2,13,14,-1,14,poland2,0.5,0.75,-1,1.62,1.75,2.0,1.33,5
Gornik Leczna,8,4,1,3,8,4,4,13,poland2,0.5,0.62,4,1.0,1.62,2.0,1.61,6
Znicz Pruszkow,8,3,2,3,9,9,0,11,poland2,0.38,0.62,0,1.12,1.38,2.63,1.61,7
Miedz Legnica,8,3,1,4,10,13,-3,10,poland2,0.38,0.5,-3,1.25,1.25,2.63,2.0,8
Chrobry Glogow,8,2,2,4,11,13,-2,8,poland2,0.25,0.5,-2,1.38,1.0,4.0,2.0,9
Pogon Siedlce,8,2,2,4,9,12,-3,8,poland2,0.25,0.5,-3,1.12,1.0,4.0,2.0,9
LKS Lodz,8,2,2,4,9,13,-4,8,poland2,0.25,0.5,-4,1.12,1.0,4.0,2.0,9
Stal Rzeszow,8,2,2,4,7,11,-4,8,poland2,0.25,0.5,-4,0.88,1.0,4.0,2.0,9
Stalowa Wola,8,1,4,3,9,11,-2,7,poland2,0.12,0.62,-2,1.12,0.88,8.33,1.61,10
K. Kolobrzeg,8,0,5,3,3,6,-3,5,poland2,0.0,0.62,-3,0.38,0.62,0.0,1.61,11
Odra Opole,8,1,1,6,6,14,-8,4,poland2,0.12,0.25,-8,0.75,0.5,8.33,4.0,12
Ruch Chorzow,8,0,2,6,4,16,-12,2,poland2,0.0,0.25,-12,0.5,0.25,0.0,4.0,13
Warta Poznan,8,0,1,7,4,15,-11,1,poland2,0.0,0.12,-11,0.5,0.12,0.0,8.33,14
Polonia Bytom,8,5,2,1,14,9,5,17,poland3,0.62,0.88,5,1.75,2.12,1.61,1.14,1
Chojniczanka,8,5,1,2,11,6,5,16,poland3,0.62,0.75,5,1.38,2.0,1.61,1.33,2
Pogon Grodzisk,8,5,0,3,14,11,3,15,poland3,0.62,0.62,3,1.75,1.88,1.61,1.61,3
Rekord Bielsko,8,3,5,0,12,6,6,14,poland3,0.38,1.0,6,1.5,1.75,2.63,1.0,4
O. Grudziadz,8,4,2,2,11,11,0,14,poland3,0.5,0.75,0,1.38,1.75,2.0,1.33,4
Zaglebie L. B,8,4,1,3,12,7,5,13,poland3,0.5,0.62,5,1.5,1.62,2.0,1.61,5
Wieczysta K.,8,4,1,3,13,10,3,13,poland3,0.5,0.62,3,1.62,1.62,2.0,1.61,5
Podbeskidzie,8,3,3,2,8,7,1,12,poland3,0.38,0.75,1,1.0,1.5,2.63,1.33,6
Z. Sosnowiec,8,3,2,3,13,11,2,11,poland3,0.38,0.62,2,1.62,1.38,2.63,1.61,7
LKS Lodz B,8,3,2,3,11,12,-1,11,poland3,0.38,0.62,-1,1.38,1.38,2.63,1.61,7
Hutnik Krakow,8,3,2,3,10,13,-3,11,poland3,0.38,0.62,-3,1.25,1.38,2.63,1.61,7
Swit Skolwin,8,3,1,4,17,18,-1,10,poland3,0.38,0.5,-1,2.12,1.25,2.63,2.0,8
Wisla Pulawy,8,3,1,4,9,14,-5,10,poland3,0.38,0.5,-5,1.12,1.25,2.63,2.0,8
Resovia Rzeszow,8,2,3,3,10,10,0,9,poland3,0.25,0.62,0,1.25,1.12,4.0,1.61,9
Jastrzebie,8,2,1,5,6,9,-3,7,poland3,0.25,0.38,-3,0.75,0.88,4.0,2.63,10
Olimpia Elblag,8,2,1,5,6,12,-6,7,poland3,0.25,0.38,-6,0.75,0.88,4.0,2.63,10
Kalisz,8,2,0,6,7,12,-5,6,poland3,0.25,0.25,-5,0.88,0.75,4.0,4.0,11
SKRA Czestochow,8,2,0,6,7,15,-8,6,poland3,0.25,0.25,-8,0.88,0.75,4.0,4.0,11
Benfica,8,7,1,0,24,7,17,22,portugal,0.88,1.0,17,3.0,2.75,1.14,1.0,1
Sporting CP,8,6,2,0,19,7,12,20,portugal,0.75,1.0,12,2.38,2.5,1.33,1.0,2
Sporting Braga,8,6,1,1,13,5,8,19,portugal,0.75,0.88,8,1.62,2.38,1.33,1.14,3
Guimaraes,8,5,2,1,11,7,4,17,portugal,0.62,0.88,4,1.38,2.12,1.61,1.14,4
FC Porto,8,5,1,2,11,8,3,16,portugal,0.62,0.75,3,1.38,2.0,1.61,1.33,5
Famalicao,8,5,0,3,15,9,6,15,portugal,0.62,0.62,6,1.88,1.88,1.61,1.61,6
Arouca,8,2,3,3,9,11,-2,9,portugal,0.25,0.62,-2,1.12,1.12,4.0,1.61,7
Santa Clara,8,2,3,3,4,6,-2,9,portugal,0.25,0.62,-2,0.5,1.12,4.0,1.61,7
Moreirense,8,2,3,3,7,11,-4,9,portugal,0.25,0.62,-4,0.88,1.12,4.0,1.61,7
Boavista,8,3,0,5,6,10,-4,9,portugal,0.38,0.38,-4,0.75,1.12,2.63,2.63,7
Nacional,8,3,0,5,6,11,-5,9,portugal,0.38,0.38,-5,0.75,1.12,2.63,2.63,7
Estoril,8,2,2,4,10,14,-4,8,portugal,0.25,0.5,-4,1.25,1.0,4.0,2.0,8
Casa Pia,8,2,2,4,6,10,-4,8,portugal,0.25,0.5,-4,0.75,1.0,4.0,2.0,8
Gil Vicente,8,2,1,5,7,9,-2,7,portugal,0.25,0.38,-2,0.88,0.88,4.0,2.63,9
Rio Ave,8,2,1,5,9,12,-3,7,portugal,0.25,0.38,-3,1.12,0.88,4.0,2.63,9
Farense,8,1,3,4,7,10,-3,6,portugal,0.12,0.5,-3,0.88,0.75,8.33,2.0,10
Estrela Amadora,8,1,3,4,3,9,-6,6,portugal,0.12,0.5,-6,0.38,0.75,8.33,2.0,10
AVS,8,1,2,5,6,17,-11,5,portugal,0.12,0.38,-11,0.75,0.62,8.33,2.63,11
Vizela,8,7,1,0,19,6,13,22,portugal2,0.88,1.0,13,2.38,2.75,1.14,1.0,1
Tondela,8,5,2,1,12,7,5,17,portugal2,0.62,0.88,5,1.5,2.12,1.61,1.14,2
Chaves,8,5,0,3,13,8,5,15,portugal2,0.62,0.62,5,1.62,1.88,1.61,1.61,3
Maritimo,8,4,3,1,9,5,4,15,portugal2,0.5,0.88,4,1.12,1.88,2.0,1.14,3
Alverca,8,3,4,1,13,7,6,13,portugal2,0.38,0.88,6,1.62,1.62,2.63,1.14,4
Felgueiras,8,3,4,1,9,4,5,13,portugal2,0.38,0.88,5,1.12,1.62,2.63,1.14,4
Uniao de Leiria,8,4,1,3,12,12,0,13,portugal2,0.5,0.62,0,1.5,1.62,2.0,1.61,4
Torreense,8,3,3,2,16,13,3,12,portugal2,0.38,0.75,3,2.0,1.5,2.63,1.33,5
Benfica B,8,3,3,2,8,6,2,12,portugal2,0.38,0.75,2,1.0,1.5,2.63,1.33,5
Feirense,8,4,0,4,10,13,-3,12,portugal2,0.5,0.5,-3,1.25,1.5,2.0,2.0,5
Academico Viseu,8,2,4,2,8,7,1,10,portugal2,0.25,0.75,1,1.0,1.25,4.0,1.33,6
FC Porto B,8,2,2,4,7,8,-1,8,portugal2,0.25,0.5,-1,0.88,1.0,4.0,2.0,7
Portimonense,8,2,1,5,9,14,-5,7,portugal2,0.25,0.38,-5,1.12,0.88,4.0,2.63,8
Mafra,8,2,1,5,8,16,-8,7,portugal2,0.25,0.38,-8,1.0,0.88,4.0,2.63,8
Oliveirense,8,2,1,5,7,18,-11,7,portugal2,0.25,0.38,-11,0.88,0.88,4.0,2.63,8
Penafiel,8,2,0,6,9,12,-3,6,portugal2,0.25,0.25,-3,1.12,0.75,4.0,4.0,9
Leixoes,8,1,3,4,5,11,-6,6,portugal2,0.12,0.5,-6,0.62,0.75,8.33,2.0,9
Pacos Ferreira,8,1,1,6,3,10,-7,4,portugal2,0.12,0.25,-7,0.38,0.5,8.33,4.0,10
Al Sadd,8,8,0,0,25,1,24,24,qatar,1.0,1.0,24,3.12,3.0,1.0,1.0,1
Al Duhail,8,6,0,2,12,9,3,18,qatar,0.75,0.75,3,1.5,2.25,1.33,1.33,2
Al Rayyan,8,5,0,3,20,10,10,15,qatar,0.62,0.62,10,2.5,1.88,1.61,1.61,3
Al Shamal,8,4,1,3,15,9,6,13,qatar,0.5,0.62,6,1.88,1.62,2.0,1.61,4
Al Gharafa,8,4,1,3,12,13,-1,13,qatar,0.5,0.62,-1,1.5,1.62,2.0,1.61,4
Al Arabi,8,3,1,4,11,13,-2,10,qatar,0.38,0.5,-2,1.38,1.25,2.63,2.0,5
Al Shahaniya,8,3,1,4,11,18,-7,10,qatar,0.38,0.5,-7,1.38,1.25,2.63,2.0,5
Al Wakrah,8,2,2,4,6,13,-7,8,qatar,0.25,0.5,-7,0.75,1.0,4.0,2.0,6
Qatar SC,8,1,4,3,9,11,-2,7,qatar,0.12,0.62,-2,1.12,0.88,8.33,1.61,7
Umm Salal,8,2,1,5,7,11,-4,7,qatar,0.25,0.38,-4,0.88,0.88,4.0,2.63,7
Al Ahli Doha,8,2,1,5,9,20,-11,7,qatar,0.25,0.38,-11,1.12,0.88,4.0,2.63,7
Al Khor,8,2,0,6,9,18,-9,6,qatar,0.25,0.25,-9,1.12,0.75,4.0,4.0,8
CFR Cluj,8,5,3,0,19,5,14,18,romania,0.62,1.0,14,2.38,2.25,1.61,1.0,1
FCSB,8,5,3,0,10,2,8,18,romania,0.62,1.0,8,1.25,2.25,1.61,1.0,1
Univ. Craiova,8,5,1,2,11,6,5,16,romania,0.62,0.75,5,1.38,2.0,1.61,1.33,2
Din. Bucharest,8,4,2,2,10,6,4,14,romania,0.5,0.75,4,1.25,1.75,2.0,1.33,3
Rapid Bucharest,8,4,2,2,9,6,3,14,romania,0.5,0.75,3,1.12,1.75,2.0,1.33,3
Hermannstadt,8,4,2,2,9,7,2,14,romania,0.5,0.75,2,1.12,1.75,2.0,1.33,3
U. Cluj,8,3,3,2,9,8,1,12,romania,0.38,0.75,1,1.12,1.5,2.63,1.33,4
Botosani,8,3,3,2,8,7,1,12,romania,0.38,0.75,1,1.0,1.5,2.63,1.33,4
Sepsi OSK,8,3,2,3,8,9,-1,11,romania,0.38,0.62,-1,1.0,1.38,2.63,1.61,5
Farul Constanta,8,3,1,4,8,10,-2,10,romania,0.38,0.5,-2,1.0,1.25,2.63,2.0,6
P. Iasi,8,2,3,3,8,12,-4,9,romania,0.25,0.62,-4,1.0,1.12,4.0,1.61,7
Petrolul,8,2,2,4,6,8,-2,8,romania,0.25,0.5,-2,0.75,1.0,4.0,2.0,8
UTA Arad,8,2,2,4,5,10,-5,8,romania,0.25,0.5,-5,0.62,1.0,4.0,2.0,8
Otelul,8,2,1,5,7,11,-4,7,romania,0.25,0.38,-4,0.88,0.88,4.0,2.63,9
FC Buzau,8,1,1,6,6,16,-10,4,romania,0.12,0.25,-10,0.75,0.5,8.33,4.0,10
Unirea Slobozia,8,0,1,7,4,14,-10,1,romania,0.0,0.12,-10,0.5,0.12,0.0,8.33,11
CSKA Moscow,8,6,2,0,12,3,9,20,russia,0.75,1.0,9,1.5,2.5,1.33,1.0,1
FC Krasnodar,8,5,2,1,15,6,9,17,russia,0.62,0.88,9,1.88,2.12,1.61,1.14,2
Spartak Moscow,8,5,1,2,15,7,8,16,russia,0.62,0.75,8,1.88,2.0,1.61,1.33,3
Dinamo Moscow,8,4,2,2,20,10,10,14,russia,0.5,0.75,10,2.5,1.75,2.0,1.33,4
Zenit,8,4,2,2,14,6,8,14,russia,0.5,0.75,8,1.75,1.75,2.0,1.33,4
Rostov,8,4,1,3,12,11,1,13,russia,0.5,0.62,1,1.5,1.62,2.0,1.61,5
Akhmat Grozny,8,3,4,1,8,7,1,13,russia,0.38,0.88,1,1.0,1.62,2.63,1.14,5
Rubin Kazan,8,4,1,3,10,13,-3,13,russia,0.5,0.62,-3,1.25,1.62,2.0,1.61,5
Makhachkala,8,3,1,4,14,14,0,10,russia,0.38,0.5,0,1.75,1.25,2.63,2.0,6
Lokomotiv M.,8,2,4,2,9,10,-1,10,russia,0.25,0.75,-1,1.12,1.25,4.0,1.33,6
Akron,8,3,0,5,11,12,-1,9,russia,0.38,0.38,-1,1.38,1.12,2.63,2.63,7
Krylya Sovetov,8,2,3,3,12,14,-2,9,russia,0.25,0.62,-2,1.5,1.12,4.0,1.61,7
Orenburg,8,3,0,5,7,14,-7,9,russia,0.38,0.38,-7,0.88,1.12,2.63,2.63,7
Khimki,8,2,1,5,7,14,-7,7,russia,0.25,0.38,-7,0.88,0.88,4.0,2.63,8
Nizhny Novgorod,8,1,1,6,4,16,-12,4,russia,0.12,0.25,-12,0.5,0.5,8.33,4.0,9
Fakel Voronezh,8,0,1,7,0,13,-13,1,russia,0.0,0.12,-13,0.0,0.12,0.0,8.33,10
Baltika,8,5,3,0,16,2,14,18,russia2,0.62,1.0,14,2.0,2.25,1.61,1.0,1
Rodina Moskva,8,5,2,1,12,3,9,17,russia2,0.62,0.88,9,1.5,2.12,1.61,1.14,2
Chernomorets,8,4,3,1,12,5,7,15,russia2,0.5,0.88,7,1.5,1.88,2.0,1.14,3
SKA Khabarovsk,8,5,0,3,7,5,2,15,russia2,0.62,0.62,2,0.88,1.88,1.61,1.61,3
Shinnik,8,4,2,2,9,7,2,14,russia2,0.5,0.75,2,1.12,1.75,2.0,1.33,4
PFC Sochi,8,4,1,3,10,8,2,13,russia2,0.5,0.62,2,1.25,1.62,2.0,1.61,5
Ural,8,3,4,1,8,6,2,13,russia2,0.38,0.88,2,1.0,1.62,2.63,1.14,5
Yenisey,8,3,3,2,5,5,0,12,russia2,0.38,0.75,0,0.62,1.5,2.63,1.33,6
Kamaz,8,3,2,3,9,8,1,11,russia2,0.38,0.62,1,1.12,1.38,2.63,1.61,7
Tyumen,8,3,2,3,8,8,0,11,russia2,0.38,0.62,0,1.0,1.38,2.63,1.61,7
Rotor Volgograd,8,2,4,2,6,6,0,10,russia2,0.25,0.75,0,0.75,1.25,4.0,1.33,8
Torpedo Moscow,8,2,3,3,4,6,-2,9,russia2,0.25,0.62,-2,0.5,1.12,4.0,1.61,9
Neftekhimik,8,2,2,4,8,10,-2,8,russia2,0.25,0.5,-2,1.0,1.0,4.0,2.0,10
Arsenal Tula,8,1,3,4,3,6,-3,6,russia2,0.12,0.5,-3,0.38,0.75,8.33,2.0,11
Chayka,8,1,3,4,5,13,-8,6,russia2,0.12,0.5,-8,0.62,0.75,8.33,2.0,11
Ufa,8,1,3,4,4,13,-9,6,russia2,0.12,0.5,-9,0.5,0.75,8.33,2.0,11
A. Vladikavkaz,8,1,2,5,5,15,-10,5,russia2,0.12,0.38,-10,0.62,0.62,8.33,2.63,12
Sokol Saratov,8,0,4,4,6,11,-5,4,russia2,0.0,0.5,-5,0.75,0.5,0.0,2.0,13
Al Shabab,8,5,3,0,19,6,13,18,saudiarabia,0.62,1.0,13,2.38,2.25,1.61,1.0,1
Al Ahli Jeddah,8,5,2,1,21,9,12,17,saudiarabia,0.62,0.88,12,2.62,2.12,1.61,1.14,2
Al Fateh,8,5,1,2,17,8,9,16,saudiarabia,0.62,0.75,9,2.12,2.0,1.61,1.33,3
Al Hilal,8,4,2,2,18,10,8,14,saudiarabia,0.5,0.75,8,2.25,1.75,2.0,1.33,4
Al Nassr,8,4,1,3,16,12,4,13,saudiarabia,0.5,0.62,4,2.0,1.62,2.0,1.61,5
Al Ittihad,8,3,4,1,12,10,2,13,saudiarabia,0.38,0.88,2,1.5,1.62,2.63,1.14,5
Al Wahda,8,4,1,3,9,7,2,13,saudiarabia,0.5,0.62,2,1.12,1.62,2.0,1.61,5
Al Ittifaq,8,3,3,2,9,9,0,12,saudiarabia,0.38,0.75,0,1.12,1.5,2.63,1.33,6
Al Taawon,8,3,2,3,10,9,1,11,saudiarabia,0.38,0.62,1,1.25,1.38,2.63,1.61,7
Al Quadisiya,8,3,2,3,9,10,-1,11,saudiarabia,0.38,0.62,-1,1.12,1.38,2.63,1.61,7
Al Feiha,8,2,4,2,5,9,-4,10,saudiarabia,0.25,0.75,-4,0.62,1.25,4.0,1.33,8
Al Akhdoud,8,2,3,3,6,9,-3,9,saudiarabia,0.25,0.62,-3,0.75,1.12,4.0,1.61,9
Al Kholood,8,3,0,5,8,17,-9,9,saudiarabia,0.38,0.38,-9,1.0,1.12,2.63,2.63,9
Al Raed,8,2,1,5,12,14,-2,7,saudiarabia,0.25,0.38,-2,1.5,0.88,4.0,2.63,10
Damak,8,2,1,5,5,11,-6,7,saudiarabia,0.25,0.38,-6,0.62,0.88,4.0,2.63,10
Al Khaleej,8,1,3,4,7,16,-9,6,saudiarabia,0.12,0.5,-9,0.88,0.75,8.33,2.0,11
Al Orubah,8,2,0,6,5,18,-13,6,saudiarabia,0.25,0.25,-13,0.62,0.75,4.0,4.0,11
Al Riyadh,8,1,2,5,4,9,-5,5,saudiarabia,0.12,0.38,-5,0.5,0.62,8.33,2.63,12
Neom SC,8,7,1,0,23,5,18,22,saudiarabia2,0.88,1.0,18,2.88,2.75,1.14,1.0,1
Al Najma,8,7,1,0,16,5,11,22,saudiarabia2,0.88,1.0,11,2.0,2.75,1.14,1.0,1
Al Zulfi,8,5,2,1,11,4,7,17,saudiarabia2,0.62,0.88,7,1.38,2.12,1.61,1.14,2
Al Bukayriyah,8,4,3,1,9,4,5,15,saudiarabia2,0.5,0.88,5,1.12,1.88,2.0,1.14,3
Al Adalha,8,4,2,2,14,11,3,14,saudiarabia2,0.5,0.75,3,1.75,1.75,2.0,1.33,4
Abha,8,2,6,0,15,10,5,12,saudiarabia2,0.25,1.0,5,1.88,1.5,4.0,1.0,5
Al Faisaly,8,3,3,2,9,10,-1,12,saudiarabia2,0.38,0.75,-1,1.12,1.5,2.63,1.33,5
Al Jabalain,8,3,2,3,12,10,2,11,saudiarabia2,0.38,0.62,2,1.5,1.38,2.63,1.61,6
Al Hazm,8,3,2,3,10,12,-2,11,saudiarabia2,0.38,0.62,-2,1.25,1.38,2.63,1.61,6
Jeddah,8,2,3,3,5,7,-2,9,saudiarabia2,0.25,0.62,-2,0.62,1.12,4.0,1.61,7
Al Batin,8,2,3,3,10,16,-6,9,saudiarabia2,0.25,0.62,-6,1.25,1.12,4.0,1.61,7
Ohod,8,2,2,4,9,11,-2,8,saudiarabia2,0.25,0.5,-2,1.12,1.0,4.0,2.0,8
Al Tai,8,2,1,5,9,12,-3,7,saudiarabia2,0.25,0.38,-3,1.12,0.88,4.0,2.63,9
Al Ain,8,1,3,4,8,14,-6,6,saudiarabia2,0.12,0.5,-6,1.0,0.75,8.33,2.0,10
Al Jandal,8,1,2,5,4,10,-6,5,saudiarabia2,0.12,0.38,-6,0.5,0.62,8.33,2.63,11
Al Jubail,8,0,5,3,6,13,-7,5,saudiarabia2,0.0,0.62,-7,0.75,0.62,0.0,1.61,11
Al Arabi,8,1,1,6,10,16,-6,4,saudiarabia2,0.12,0.25,-6,1.25,0.5,8.33,4.0,12
Al Safa,8,0,2,6,6,19,-13,2,saudiarabia2,0.0,0.25,-13,0.75,0.25,0.0,4.0,13
Hibernian,8,6,2,0,17,4,13,20,scotland,0.75,1.0,13,2.12,2.5,1.33,1.0,1
Celtic,8,5,0,3,24,10,14,15,scotland,0.62,0.62,14,3.0,1.88,1.61,1.61,2
Aberdeen,8,4,3,1,13,11,2,15,scotland,0.5,0.88,2,1.62,1.88,2.0,1.14,2
Rangers,8,4,1,3,17,16,1,13,scotland,0.5,0.62,1,2.12,1.62,2.0,1.61,3
Dundee Utd,8,4,1,3,9,12,-3,13,scotland,0.5,0.62,-3,1.12,1.62,2.0,1.61,3
St. Mirren,8,3,2,3,15,15,0,11,scotland,0.38,0.62,0,1.88,1.38,2.63,1.61,4
Hearts,8,3,1,4,9,11,-2,10,scotland,0.38,0.5,-2,1.12,1.25,2.63,2.0,5
Ross County,8,3,0,5,9,9,0,9,scotland,0.38,0.38,0,1.12,1.12,2.63,2.63,6
St. Johnstone,8,2,2,4,5,10,-5,8,scotland,0.25,0.5,-5,0.62,1.0,4.0,2.0,7
Motherwell,8,2,2,4,7,14,-7,8,scotland,0.25,0.5,-7,0.88,1.0,4.0,2.0,7
Dundee FC,8,2,1,5,13,18,-5,7,scotland,0.25,0.38,-5,1.62,0.88,4.0,2.63,8
Kilmarnock,8,2,1,5,10,18,-8,7,scotland,0.25,0.38,-8,1.25,0.88,4.0,2.63,8
Falkirk,8,5,1,2,17,5,12,16,scotland2,0.62,0.75,12,2.12,2.0,1.61,1.33,1
Raith Rovers,8,4,4,0,13,5,8,16,scotland2,0.5,1.0,8,1.62,2.0,2.0,1.0,1
Livingston,8,4,3,1,15,6,9,15,scotland2,0.5,0.88,9,1.88,1.88,2.0,1.14,2
Greenock Morton,8,4,1,3,11,13,-2,13,scotland2,0.5,0.62,-2,1.38,1.62,2.0,1.61,3
Partick Thistle,8,3,3,2,8,5,3,12,scotland2,0.38,0.75,3,1.0,1.5,2.63,1.33,4
Airdrieonians,8,3,2,3,13,12,1,11,scotland2,0.38,0.62,1,1.62,1.38,2.63,1.61,5
Dunfermline,8,3,1,4,4,8,-4,10,scotland2,0.38,0.5,-4,0.5,1.25,2.63,2.0,6
Hamilton,8,2,3,3,7,11,-4,9,scotland2,0.25,0.62,-4,0.88,1.12,4.0,1.61,7
Ayr Utd,8,2,2,4,9,14,-5,8,scotland2,0.25,0.5,-5,1.12,1.0,4.0,2.0,8
Queens Park,8,0,1,7,3,20,-17,1,scotland2,0.0,0.12,-17,0.38,0.12,0.0,8.33,9
Arbroath,8,5,2,1,14,10,4,17,scotland3,0.62,0.88,4,1.75,2.12,1.61,1.14,1
Queen of South,8,5,1,2,15,9,6,16,scotland3,0.62,0.75,6,1.88,2.0,1.61,1.33,2
Cove Rangers,8,3,3,2,13,9,4,12,scotland3,0.38,0.75,4,1.62,1.5,2.63,1.33,3
Alloa Athletic,8,3,2,3,15,13,2,11,scotland3,0.38,0.62,2,1.88,1.38,2.63,1.61,4
Inverness,8,3,2,3,11,10,1,11,scotland3,0.38,0.62,1,1.38,1.38,2.63,1.61,4
Montrose,8,2,4,2,12,11,1,10,scotland3,0.25,0.75,1,1.5,1.25,4.0,1.33,5
Dumbarton,8,2,3,3,14,11,3,9,scotland3,0.25,0.62,3,1.75,1.12,4.0,1.61,6
Annan Athletic,8,3,0,5,9,13,-4,9,scotland3,0.38,0.38,-4,1.12,1.12,2.63,2.63,6
Stenhousemuir,8,1,3,4,7,16,-9,6,scotland3,0.12,0.5,-9,0.88,0.75,8.33,2.0,7
Kelty Hearts,8,1,3,4,5,16,-11,6,scotland3,0.12,0.5,-11,0.62,0.75,8.33,2.0,7
Peterhead,8,5,2,1,12,5,7,17,scotland4,0.62,0.88,7,1.5,2.12,1.61,1.14,1
Stirling Albion,8,4,2,2,10,7,3,14,scotland4,0.5,0.75,3,1.25,1.75,2.0,1.33,2
Forfar Athletic,8,4,2,2,6,6,0,14,scotland4,0.5,0.75,0,0.75,1.75,2.0,1.33,2
Spartans,8,4,1,3,11,8,3,13,scotland4,0.5,0.62,3,1.38,1.62,2.0,1.61,3
Edinburgh City,8,4,0,4,11,10,1,12,scotland4,0.5,0.5,1,1.38,1.5,2.0,2.0,4
Elgin City,8,4,0,4,9,8,1,12,scotland4,0.5,0.5,1,1.12,1.5,2.0,2.0,4
East Fife,8,4,0,4,12,13,-1,12,scotland4,0.5,0.5,-1,1.5,1.5,2.0,2.0,4
Clyde,8,3,1,4,9,11,-2,10,scotland4,0.38,0.5,-2,1.12,1.25,2.63,2.0,5
Stranraer,8,2,1,5,9,10,-1,7,scotland4,0.25,0.38,-1,1.12,0.88,4.0,2.63,6
Bonnyrigg Rose,8,1,1,6,5,16,-11,4,scotland4,0.12,0.25,-11,0.62,0.5,8.33,4.0,7
Red Star,8,7,1,0,27,9,18,22,serbia,0.88,1.0,18,3.38,2.75,1.14,1.0,1
Partizan,8,6,2,0,19,7,12,20,serbia,0.75,1.0,12,2.38,2.5,1.33,1.0,2
IMT N. Beograd,8,4,2,2,10,8,2,14,serbia,0.5,0.75,2,1.25,1.75,2.0,1.33,3
OFK Beograd,8,4,1,3,13,11,2,13,serbia,0.5,0.62,2,1.62,1.62,2.0,1.61,4
Backa Topola,8,4,1,3,13,12,1,13,serbia,0.5,0.62,1,1.62,1.62,2.0,1.61,4
Novi Pazar,8,3,3,2,13,11,2,12,serbia,0.38,0.75,2,1.62,1.5,2.63,1.33,5
S. Subotica,8,3,2,3,8,8,0,11,serbia,0.38,0.62,0,1.0,1.38,2.63,1.61,6
Radnicki 1923,8,3,2,3,8,9,-1,11,serbia,0.38,0.62,-1,1.0,1.38,2.63,1.61,6
Vojvodina,8,3,1,4,14,15,-1,10,serbia,0.38,0.5,-1,1.75,1.25,2.63,2.0,7
Tekstilac Odzac,8,3,1,4,9,13,-4,10,serbia,0.38,0.5,-4,1.12,1.25,2.63,2.0,7
Jedinstvo U.,8,2,2,4,10,10,0,8,serbia,0.25,0.5,0,1.25,1.0,4.0,2.0,8
Z. Pancevo,8,2,2,4,10,12,-2,8,serbia,0.25,0.5,-2,1.25,1.0,4.0,2.0,8
Cukaricki,8,2,2,4,7,10,-3,8,serbia,0.25,0.5,-3,0.88,1.0,4.0,2.0,8
Napredak,8,2,2,4,6,13,-7,8,serbia,0.25,0.5,-7,0.75,1.0,4.0,2.0,8
Mladost Lucani,8,1,3,4,4,11,-7,6,serbia,0.12,0.5,-7,0.5,0.75,8.33,2.0,9
Radnicki Nis,8,0,3,5,8,20,-12,3,serbia,0.0,0.38,-12,1.0,0.38,0.0,2.63,10
R. Surdulica,8,7,0,1,16,4,12,21,serbia2,0.88,0.88,12,2.0,2.62,1.14,1.14,1
Dubocica,8,5,1,2,16,8,8,16,serbia2,0.62,0.75,8,2.0,2.0,1.61,1.33,2
Zemun,8,4,2,2,10,8,2,14,serbia2,0.5,0.75,2,1.25,1.75,2.0,1.33,3
Sloven Ruma,8,3,4,1,13,10,3,13,serbia2,0.38,0.88,3,1.62,1.62,2.63,1.14,4
Vozdovac,8,3,4,1,8,5,3,13,serbia2,0.38,0.88,3,1.0,1.62,2.63,1.14,4
S. Mitrovica,8,3,4,1,7,4,3,13,serbia2,0.38,0.88,3,0.88,1.62,2.63,1.14,4
Graficar,8,3,4,1,9,7,2,13,serbia2,0.38,0.88,2,1.12,1.62,2.63,1.14,4
Borac Cacak,8,3,2,3,7,8,-1,11,serbia2,0.38,0.62,-1,0.88,1.38,2.63,1.61,5
Macva Sabac,8,2,4,2,6,7,-1,10,serbia2,0.25,0.75,-1,0.75,1.25,4.0,1.33,6
Mladost,8,2,4,2,6,8,-2,10,serbia2,0.25,0.75,-2,0.75,1.25,4.0,1.33,6
Trajal Krusevac,8,2,3,3,9,9,0,9,serbia2,0.25,0.62,0,1.12,1.12,4.0,1.61,7
Smederevo,8,1,4,3,6,8,-2,7,serbia2,0.12,0.62,-2,0.75,0.88,8.33,1.61,8
Javor Ivanjica,8,1,3,4,6,11,-5,6,serbia2,0.12,0.5,-5,0.75,0.75,8.33,2.0,9
Sloboda Uzice,8,1,2,5,5,13,-8,5,serbia2,0.12,0.38,-8,0.62,0.62,8.33,2.63,10
Indija,8,1,1,6,7,14,-7,4,serbia2,0.12,0.25,-7,0.88,0.5,8.33,4.0,11
Vrsac,8,0,4,4,1,8,-7,4,serbia2,0.0,0.5,-7,0.12,0.5,0.0,2.0,11
Lion City,8,6,2,0,27,4,23,20,singapore,0.75,1.0,23,3.38,2.5,1.33,1.0,1
Tampines Rovers,8,6,0,2,22,7,15,18,singapore,0.75,0.75,15,2.75,2.25,1.33,1.33,2
Geylang,8,4,1,3,20,15,5,13,singapore,0.5,0.62,5,2.5,1.62,2.0,1.61,3
Hougang,8,3,2,3,18,16,2,11,singapore,0.38,0.62,2,2.25,1.38,2.63,1.61,4
DPMM FC,8,2,2,4,8,11,-3,8,singapore,0.25,0.5,-3,1.0,1.0,4.0,2.0,5
A. Niigata (S),8,2,2,4,7,16,-9,8,singapore,0.25,0.5,-9,0.88,1.0,4.0,2.0,5
Khalsa,8,2,1,5,15,26,-11,7,singapore,0.25,0.38,-11,1.88,0.88,4.0,2.63,6
Young Lions,8,1,4,3,9,21,-12,7,singapore,0.12,0.62,-12,1.12,0.88,8.33,1.61,6
Tanjong Pagar,8,1,2,5,9,22,-13,5,singapore,0.12,0.38,-13,1.12,0.62,8.33,2.63,7
S. Bratislava,8,4,3,1,18,10,8,15,slovakia,0.5,0.88,8,2.25,1.88,2.0,1.14,1
Skalica,8,4,3,1,8,4,4,15,slovakia,0.5,0.88,4,1.0,1.88,2.0,1.14,1
DAC Streda,8,3,5,0,16,10,6,14,slovakia,0.38,1.0,6,2.0,1.75,2.63,1.0,2
Komarno,8,4,2,2,8,6,2,14,slovakia,0.5,0.75,2,1.0,1.75,2.0,1.33,2
FC Kosice,8,4,1,3,17,13,4,13,slovakia,0.5,0.62,4,2.12,1.62,2.0,1.61,3
Z. Michalovce,8,4,1,3,14,13,1,13,slovakia,0.5,0.62,1,1.75,1.62,2.0,1.61,3
Trencin,8,3,3,2,12,11,1,12,slovakia,0.38,0.75,1,1.5,1.5,2.63,1.33,4
Spartak Trnava,8,2,3,3,11,13,-2,9,slovakia,0.25,0.62,-2,1.38,1.12,4.0,1.61,5
Zilina,8,2,3,3,9,14,-5,9,slovakia,0.25,0.62,-5,1.12,1.12,4.0,1.61,5
Ruzomberok,8,2,1,5,9,14,-5,7,slovakia,0.25,0.38,-5,1.12,0.88,4.0,2.63,6
Podbrezova,8,0,5,3,7,11,-4,5,slovakia,0.0,0.62,-4,0.88,0.62,0.0,1.61,7
Banska Bystrica,8,1,1,6,9,15,-6,4,slovakia,0.12,0.25,-6,1.12,0.5,8.33,4.0,8
Zlate Moravce,8,6,2,0,14,3,11,20,slovakia2,0.75,1.0,11,1.75,2.5,1.33,1.0,1
Presov,8,6,1,1,12,3,9,19,slovakia2,0.75,0.88,9,1.5,2.38,1.33,1.14,2
Petrzalka,8,4,3,1,14,7,7,15,slovakia2,0.5,0.88,7,1.75,1.88,2.0,1.14,3
P. Bystrica,8,4,2,2,11,5,6,14,slovakia2,0.5,0.75,6,1.38,1.75,2.0,1.33,4
Zvolen,8,4,1,3,11,7,4,13,slovakia2,0.5,0.62,4,1.38,1.62,2.0,1.61,5
L. Mikulas,8,3,3,2,13,8,5,12,slovakia2,0.38,0.75,5,1.62,1.5,2.63,1.33,6
Zilina B,8,4,0,4,13,13,0,12,slovakia2,0.5,0.5,0,1.62,1.5,2.0,2.0,6
Puchov,8,3,2,3,15,13,2,11,slovakia2,0.38,0.62,2,1.88,1.38,2.63,1.61,7
S. Bratislava B,8,3,2,3,13,13,0,11,slovakia2,0.38,0.62,0,1.62,1.38,2.63,1.61,7
Samorin,8,3,1,4,6,10,-4,10,slovakia2,0.38,0.5,-4,0.75,1.25,2.63,2.0,8
Pohronie,8,3,0,5,11,16,-5,9,slovakia2,0.38,0.38,-5,1.38,1.12,2.63,2.63,9
S. Lubovna,8,2,1,5,8,10,-2,7,slovakia2,0.25,0.38,-2,1.0,0.88,4.0,2.63,10
Malzenice,8,1,1,6,5,15,-10,4,slovakia2,0.12,0.25,-10,0.62,0.5,8.33,4.0,11
Humenne,8,1,1,6,3,19,-16,4,slovakia2,0.12,0.25,-16,0.38,0.5,8.33,4.0,11
NK Celje,8,6,1,1,22,10,12,19,slovenia,0.75,0.88,12,2.75,2.38,1.33,1.14,1
NK Olimpija,8,5,2,1,14,4,10,17,slovenia,0.62,0.88,10,1.75,2.12,1.61,1.14,2
Koper,8,4,3,1,13,10,3,15,slovenia,0.5,0.88,3,1.62,1.88,2.0,1.14,3
Maribor,8,4,2,2,14,8,6,14,slovenia,0.5,0.75,6,1.75,1.75,2.0,1.33,4
Primorje,8,2,4,2,12,12,0,10,slovenia,0.25,0.75,0,1.5,1.25,4.0,1.33,5
Nafta,8,2,4,2,15,16,-1,10,slovenia,0.25,0.75,-1,1.88,1.25,4.0,1.33,5
Radomlje,8,3,1,4,11,14,-3,10,slovenia,0.38,0.5,-3,1.38,1.25,2.63,2.0,5
Domzale,8,2,1,5,11,14,-3,7,slovenia,0.25,0.38,-3,1.38,0.88,4.0,2.63,6
Mura,8,2,0,6,10,14,-4,6,slovenia,0.25,0.25,-4,1.25,0.75,4.0,4.0,7
Bravo,8,0,3,5,6,16,-10,3,slovenia,0.0,0.38,-10,0.75,0.38,0.0,2.63,8
Mamelodi S.,8,5,1,2,16,8,8,16,southafrica,0.62,0.75,8,2.0,2.0,1.61,1.33,1
Orlando Pirates,8,5,1,2,9,9,0,16,southafrica,0.62,0.75,0,1.12,2.0,1.61,1.33,1
Sekhukhune,8,5,0,3,15,12,3,15,southafrica,0.62,0.62,3,1.88,1.88,1.61,1.61,2
Stellenbosch,8,4,3,1,8,5,3,15,southafrica,0.5,0.88,3,1.0,1.88,2.0,1.14,2
Magesi,8,5,0,3,7,7,0,15,southafrica,0.62,0.62,0,0.88,1.88,1.61,1.61,2
Chippa Utd,8,3,3,2,6,3,3,12,southafrica,0.38,0.75,3,0.75,1.5,2.63,1.33,3
Marumo G.,8,3,3,2,8,6,2,12,southafrica,0.38,0.75,2,1.0,1.5,2.63,1.33,3
TS Galaxy,8,3,2,3,12,12,0,11,southafrica,0.38,0.62,0,1.5,1.38,2.63,1.61,4
Richards Bay,8,3,2,3,7,7,0,11,southafrica,0.38,0.62,0,0.88,1.38,2.63,1.61,4
AmaZulu,8,3,1,4,8,7,1,10,southafrica,0.38,0.5,1,1.0,1.25,2.63,2.0,5
Golden Arrows,8,2,4,2,6,7,-1,10,southafrica,0.25,0.75,-1,0.75,1.25,4.0,1.33,5
SuperSport Utd,8,1,4,3,7,10,-3,7,southafrica,0.12,0.62,-3,0.88,0.88,8.33,1.61,6
Kaizer Chiefs,8,1,3,4,4,10,-6,6,southafrica,0.12,0.5,-6,0.5,0.75,8.33,2.0,7
Royal AM,8,1,2,5,9,13,-4,5,southafrica,0.12,0.38,-4,1.12,0.62,8.33,2.63,8
Polokwane,8,1,2,5,4,9,-5,5,southafrica,0.12,0.38,-5,0.5,0.62,8.33,2.63,8
Cape Town City,8,0,3,5,3,9,-6,3,southafrica,0.0,0.38,-6,0.38,0.38,0.0,2.63,9
Kruger United,8,5,2,1,11,7,4,17,southafrica2,0.62,0.88,4,1.38,2.12,1.61,1.14,1
Black Leopards,8,4,3,1,15,8,7,15,southafrica2,0.5,0.88,7,1.88,1.88,2.0,1.14,2
Casric Stars,8,3,4,1,12,7,5,13,southafrica2,0.38,0.88,5,1.5,1.62,2.63,1.14,3
Highbury,8,3,3,2,9,5,4,12,southafrica2,0.38,0.75,4,1.12,1.5,2.63,1.33,4
Durban City,8,3,3,2,6,5,1,12,southafrica2,0.38,0.75,1,0.75,1.5,2.63,1.33,4
Orbit College,8,2,5,1,6,5,1,11,southafrica2,0.25,0.88,1,0.75,1.38,4.0,1.14,5
Leruma United,8,2,5,1,7,7,0,11,southafrica2,0.25,0.88,0,0.88,1.38,4.0,1.14,5
Cape Town Spurs,8,2,4,2,7,8,-1,10,southafrica2,0.25,0.75,-1,0.88,1.25,4.0,1.33,6
Baroka,8,2,4,2,9,11,-2,10,southafrica2,0.25,0.75,-2,1.12,1.25,4.0,1.33,6
Venda FC,8,2,3,3,5,4,1,9,southafrica2,0.25,0.62,1,0.62,1.12,4.0,1.61,7
Hungry Lions,8,2,2,4,6,7,-1,8,southafrica2,0.25,0.5,-1,0.75,1.0,4.0,2.0,8
JDR Stars,8,1,5,2,7,10,-3,8,southafrica2,0.12,0.75,-3,0.88,1.0,8.33,1.33,8
Milford,8,2,2,4,10,16,-6,8,southafrica2,0.25,0.5,-6,1.25,1.0,4.0,2.0,8
Pretoria U.,8,1,4,3,7,9,-2,7,southafrica2,0.12,0.62,-2,0.88,0.88,8.33,1.61,9
Upington City,8,2,1,5,3,7,-4,7,southafrica2,0.25,0.38,-4,0.38,0.88,4.0,2.63,9
Pretoria C.,8,2,1,5,5,10,-5,7,southafrica2,0.25,0.38,-5,0.62,0.88,4.0,2.63,9
Daejeon Citizen,8,5,2,1,14,9,5,17,southkorea,0.62,0.88,5,1.75,2.12,1.61,1.14,1
Gimcheon Sangmu,8,4,2,2,11,8,3,14,southkorea,0.5,0.75,3,1.38,1.75,2.0,1.33,2
Gwangju,8,4,2,2,10,8,2,14,southkorea,0.5,0.75,2,1.25,1.75,2.0,1.33,2
Seoul,8,3,4,1,9,7,2,13,southkorea,0.38,0.88,2,1.12,1.62,2.63,1.14,3
Gangwon,8,4,1,3,6,6,0,13,southkorea,0.5,0.62,0,0.75,1.62,2.0,1.61,3
Jeonbuk Motors,8,3,3,2,11,8,3,12,southkorea,0.38,0.75,3,1.38,1.5,2.63,1.33,4
Pohang Steelers,8,3,3,2,10,10,0,12,southkorea,0.38,0.75,0,1.25,1.5,2.63,1.33,4
Ulsan,8,3,2,3,8,7,1,11,southkorea,0.38,0.62,1,1.0,1.38,2.63,1.61,5
Anyang,8,3,0,5,10,11,-1,9,southkorea,0.38,0.38,-1,1.25,1.12,2.63,2.63,6
Jeju Utd,8,2,2,4,7,10,-3,8,southkorea,0.25,0.5,-3,0.88,1.0,4.0,2.0,7
Suwon City,8,1,3,4,7,12,-5,6,southkorea,0.12,0.5,-5,0.88,0.75,8.33,2.0,8
Daegu,8,0,1,7,5,14,-9,1,southkorea,0.0,0.12,-9,0.62,0.12,0.0,8.33,9
Incheon Utd,8,6,1,1,13,4,9,19,southkorea2,0.75,0.88,9,1.62,2.38,1.33,1.14,1
Seongnam,8,4,4,0,8,3,5,16,southkorea2,0.5,1.0,5,1.0,2.0,2.0,1.0,2
Jeonnam,8,4,3,1,10,6,4,15,southkorea2,0.5,0.88,4,1.25,1.88,2.0,1.14,3
Seoul E-Land,8,4,2,2,15,11,4,14,southkorea2,0.5,0.75,4,1.88,1.75,2.0,1.33,4
Suwon Bluewings,8,4,2,2,13,9,4,14,southkorea2,0.5,0.75,4,1.62,1.75,2.0,1.33,4
Bucheon FC,8,4,2,2,13,10,3,14,southkorea2,0.5,0.75,3,1.62,1.75,2.0,1.33,4
Busan IPark,8,3,3,2,10,7,3,12,southkorea2,0.38,0.75,3,1.25,1.5,2.63,1.33,5
Gyeongnam,8,3,2,3,9,11,-2,11,southkorea2,0.38,0.62,-2,1.12,1.38,2.63,1.61,6
Gimpo,8,2,3,3,9,8,1,9,southkorea2,0.25,0.62,1,1.12,1.12,4.0,1.61,7
Asan,8,1,5,2,7,7,0,8,southkorea2,0.12,0.75,0,0.88,1.0,8.33,1.33,8
Cheongju,8,2,1,5,10,16,-6,7,southkorea2,0.25,0.38,-6,1.25,0.88,4.0,2.63,9
Hwaseong,8,1,3,4,9,14,-5,6,southkorea2,0.12,0.5,-5,1.12,0.75,8.33,2.0,10
Ansan Greeners,8,1,1,6,6,14,-8,4,southkorea2,0.12,0.25,-8,0.75,0.5,8.33,4.0,11
Cheonan City,8,1,0,7,3,15,-12,3,southkorea2,0.12,0.12,-12,0.38,0.38,8.33,8.33,12
FC Barcelona,8,7,1,0,23,7,16,22,spain,0.88,1.0,16,2.88,2.75,1.14,1.0,1
Real Betis,8,6,1,1,15,9,6,19,spain,0.75,0.88,6,1.88,2.38,1.33,1.14,2
Real Madrid,8,6,0,2,13,8,5,18,spain,0.75,0.75,5,1.62,2.25,1.33,1.33,3
Espanyol,8,4,3,1,12,5,7,15,spain,0.5,0.88,7,1.5,1.88,2.0,1.14,4
Valencia,8,4,3,1,11,10,1,15,spain,0.5,0.88,1,1.38,1.88,2.0,1.14,4
Celta Vigo,8,4,2,2,12,11,1,14,spain,0.5,0.75,1,1.5,1.75,2.0,1.33,5
Atletico Madrid,8,4,1,3,14,11,3,13,spain,0.5,0.62,3,1.75,1.62,2.0,1.61,6
Athletic Bilbao,8,3,3,2,12,5,7,12,spain,0.38,0.75,7,1.5,1.5,2.63,1.33,7
Villarreal,8,3,3,2,9,8,1,12,spain,0.38,0.75,1,1.12,1.5,2.63,1.33,7
Real Sociedad,8,3,2,3,12,13,-1,11,spain,0.38,0.62,-1,1.5,1.38,2.63,1.61,8
Mallorca,8,2,4,2,8,7,1,10,spain,0.25,0.75,1,1.0,1.25,4.0,1.33,9
Getafe,8,3,0,5,11,11,0,9,spain,0.38,0.38,0,1.38,1.12,2.63,2.63,10
Las Palmas,8,2,3,3,9,11,-2,9,spain,0.25,0.62,-2,1.12,1.12,4.0,1.61,10
Alaves,8,2,3,3,6,8,-2,9,spain,0.25,0.62,-2,0.75,1.12,4.0,1.61,10
Osasuna,8,2,3,3,10,13,-3,9,spain,0.25,0.62,-3,1.25,1.12,4.0,1.61,10
Sevilla FC,8,1,3,4,6,9,-3,6,spain,0.12,0.5,-3,0.75,0.75,8.33,2.0,11
Rayo Vallecano,8,1,3,4,8,14,-6,6,spain,0.12,0.5,-6,1.0,0.75,8.33,2.0,11
Leganes,8,1,2,5,7,13,-6,5,spain,0.12,0.38,-6,0.88,0.62,8.33,2.63,12
Girona,8,0,3,5,7,16,-9,3,spain,0.0,0.38,-9,0.88,0.38,0.0,2.63,13
Valladolid,8,0,1,7,8,24,-16,1,spain,0.0,0.12,-16,1.0,0.12,0.0,8.33,14
Levante,8,6,1,1,20,10,10,19,spain2,0.75,0.88,10,2.5,2.38,1.33,1.14,1
Burgos,8,5,3,0,10,4,6,18,spain2,0.62,1.0,6,1.25,2.25,1.61,1.0,2
Elche,8,5,2,1,12,7,5,17,spain2,0.62,0.88,5,1.5,2.12,1.61,1.14,3
Granada,8,5,0,3,13,11,2,15,spain2,0.62,0.62,2,1.62,1.88,1.61,1.61,4
Albacete,8,4,2,2,14,9,5,14,spain2,0.5,0.75,5,1.75,1.75,2.0,1.33,5
Racing,8,4,2,2,13,9,4,14,spain2,0.5,0.75,4,1.62,1.75,2.0,1.33,5
Eibar,8,3,5,0,10,6,4,14,spain2,0.38,1.0,4,1.25,1.75,2.63,1.0,5
Deportivo,8,3,5,0,11,8,3,14,spain2,0.38,1.0,3,1.38,1.75,2.63,1.0,5
Tenerife,8,4,2,2,10,7,3,14,spain2,0.5,0.75,3,1.25,1.75,2.0,1.33,5
Cordoba,8,2,5,1,12,7,5,11,spain2,0.25,0.88,5,1.5,1.38,4.0,1.14,6
Mirandes,8,3,2,3,12,12,0,11,spain2,0.38,0.62,0,1.5,1.38,2.63,1.61,6
Castellon,8,2,4,2,16,15,1,10,spain2,0.25,0.75,1,2.0,1.25,4.0,1.33,7
Almeria,8,3,1,4,12,15,-3,10,spain2,0.38,0.5,-3,1.5,1.25,2.63,2.0,7
Real Oviedo,8,2,3,3,8,7,1,9,spain2,0.25,0.62,1,1.0,1.12,4.0,1.61,8
Sporting Gijon,8,2,3,3,11,13,-2,9,spain2,0.25,0.62,-2,1.38,1.12,4.0,1.61,8
Huesca,8,3,0,5,11,14,-3,9,spain2,0.38,0.38,-3,1.38,1.12,2.63,2.63,8
Eldense,8,2,2,4,9,11,-2,8,spain2,0.25,0.5,-2,1.12,1.0,4.0,2.0,9
Cadiz,8,2,2,4,6,9,-3,8,spain2,0.25,0.5,-3,0.75,1.0,4.0,2.0,9
Real Zaragoza,8,1,3,4,10,19,-9,6,spain2,0.12,0.5,-9,1.25,0.75,8.33,2.0,10
Malaga,8,1,2,5,7,12,-5,5,spain2,0.12,0.38,-5,0.88,0.62,8.33,2.63,11
Racing Ferrol,8,1,1,6,1,11,-10,4,spain2,0.12,0.25,-10,0.12,0.5,8.33,4.0,12
Cartagena,8,0,2,6,7,16,-9,2,spain2,0.0,0.25,-9,0.88,0.25,0.0,4.0,13
Ourense CF,8,5,1,2,9,5,4,16,spain3,0.62,0.75,4,1.12,2.0,1.61,1.33,1
Ponferradina,8,5,1,2,13,11,2,16,spain3,0.62,0.75,2,1.62,2.0,1.61,1.33,1
Gimnastic T.,8,4,2,2,17,9,8,14,spain3,0.5,0.75,8,2.12,1.75,2.0,1.33,2
Celta Vigo B,8,4,2,2,12,9,3,14,spain3,0.5,0.75,3,1.5,1.75,2.0,1.33,2
Zamora,8,4,2,2,9,6,3,14,spain3,0.5,0.75,3,1.12,1.75,2.0,1.33,2
Tarazona,8,3,4,1,8,5,3,13,spain3,0.38,0.88,3,1.0,1.62,2.63,1.14,3
Athletic B. B,8,3,4,1,11,9,2,13,spain3,0.38,0.88,2,1.38,1.62,2.63,1.14,3
FC Andorra,8,3,3,2,12,8,4,12,spain3,0.38,0.75,4,1.5,1.5,2.63,1.33,4
Sestao River,8,3,3,2,14,12,2,12,spain3,0.38,0.75,2,1.75,1.5,2.63,1.33,4
Osasuna B,8,3,3,2,13,13,0,12,spain3,0.38,0.75,0,1.62,1.5,2.63,1.33,4
Lugo,8,4,0,4,8,11,-3,12,spain3,0.5,0.5,-3,1.0,1.5,2.0,2.0,4
FC Barcelona B,8,3,2,3,13,12,1,11,spain3,0.38,0.62,1,1.62,1.38,2.63,1.61,5
Leonesa,8,2,4,2,7,8,-1,10,spain3,0.25,0.75,-1,0.88,1.25,4.0,1.33,6
Gimnastica,8,2,3,3,7,13,-6,9,spain3,0.25,0.62,-6,0.88,1.12,4.0,1.61,7
Real Union,8,2,2,4,7,9,-2,8,spain3,0.25,0.5,-2,0.88,1.0,4.0,2.0,8
Real Sociedad B,8,2,2,4,6,8,-2,8,spain3,0.25,0.5,-2,0.75,1.0,4.0,2.0,8
Unionistas,8,2,2,4,6,11,-5,8,spain3,0.25,0.5,-5,0.75,1.0,4.0,2.0,8
Amorebieta,8,1,3,4,5,9,-4,6,spain3,0.12,0.5,-4,0.62,0.75,8.33,2.0,9
Barakaldo,8,1,2,5,9,13,-4,5,spain3,0.12,0.38,-4,1.12,0.62,8.33,2.63,10
Arenteiro,8,0,4,4,5,9,-4,4,spain3,0.0,0.5,-4,0.62,0.5,0.0,2.0,11
Alcorcon,8,5,1,2,12,7,5,16,spain4,0.62,0.75,5,1.5,2.0,1.61,1.33,1
Ceuta,8,4,4,0,11,6,5,16,spain4,0.5,1.0,5,1.38,2.0,2.0,1.0,1
Algeciras,8,4,3,1,11,6,5,15,spain4,0.5,0.88,5,1.38,1.88,2.0,1.14,2
Merida,8,4,3,1,11,10,1,15,spain4,0.5,0.88,1,1.38,1.88,2.0,1.14,2
Atletico M. B,8,3,4,1,12,7,5,13,spain4,0.38,0.88,5,1.5,1.62,2.63,1.14,3
Real Betis B,8,3,3,2,10,8,2,12,spain4,0.38,0.75,2,1.25,1.5,2.63,1.33,4
Real Murcia,8,3,2,3,10,8,2,11,spain4,0.38,0.62,2,1.25,1.38,2.63,1.61,5
UD Ibiza,8,3,2,3,10,8,2,11,spain4,0.38,0.62,2,1.25,1.38,2.63,1.61,5
Antequera,8,3,2,3,13,15,-2,11,spain4,0.38,0.62,-2,1.62,1.38,2.63,1.61,5
Real Madrid B,8,1,7,0,9,6,3,10,spain4,0.12,1.0,3,1.12,1.25,8.33,1.0,6
Fuenlabrada,8,2,4,2,11,9,2,10,spain4,0.25,0.75,2,1.38,1.25,4.0,1.33,6
Sevilla FC B,8,3,1,4,7,8,-1,10,spain4,0.38,0.5,-1,0.88,1.25,2.63,2.0,6
Villarreal B,8,2,3,3,8,8,0,9,spain4,0.25,0.62,0,1.0,1.12,4.0,1.61,7
Yeclano,8,2,3,3,7,7,0,9,spain4,0.25,0.62,0,0.88,1.12,4.0,1.61,7
Hercules,8,2,3,3,12,13,-1,9,spain4,0.25,0.62,-1,1.5,1.12,4.0,1.61,7
Sanluqueno,8,1,5,2,10,11,-1,8,spain4,0.12,0.75,-1,1.25,1.0,8.33,1.33,8
Marbella,8,2,2,4,7,12,-5,8,spain4,0.25,0.5,-5,0.88,1.0,4.0,2.0,8
Recreativo H.,8,2,2,4,5,13,-8,8,spain4,0.25,0.5,-8,0.62,1.0,4.0,2.0,8
Intercity,8,1,3,4,7,13,-6,6,spain4,0.12,0.5,-6,0.88,0.75,8.33,2.0,9
Alcoyano,8,1,1,6,7,15,-8,4,spain4,0.12,0.25,-8,0.88,0.5,8.33,4.0,10
Rayo Cantabria,8,6,1,1,15,6,9,19,spain5,0.75,0.88,9,1.88,2.38,1.33,1.14,1
Pontevedra,8,6,1,1,13,5,8,19,spain5,0.75,0.88,8,1.62,2.38,1.33,1.14,1
Langreo,8,5,2,1,10,4,6,17,spain5,0.62,0.88,6,1.25,2.12,1.61,1.14,2
Real Aviles,8,4,3,1,11,8,3,15,spain5,0.5,0.88,3,1.38,1.88,2.0,1.14,3
Bergantinos,8,4,2,2,12,8,4,14,spain5,0.5,0.75,4,1.5,1.75,2.0,1.33,4
D. Fabril,8,3,2,3,9,8,1,11,spain5,0.38,0.62,1,1.12,1.38,2.63,1.61,5
Compostela,8,3,2,3,9,10,-1,11,spain5,0.38,0.62,-1,1.12,1.38,2.63,1.61,5
Numancia,8,3,1,4,11,7,4,10,spain5,0.38,0.5,4,1.38,1.25,2.63,2.0,6
Llanera,8,2,4,2,7,8,-1,10,spain5,0.25,0.75,-1,0.88,1.25,4.0,1.33,6
Coruxo,8,2,3,3,8,8,0,9,spain5,0.25,0.62,0,1.0,1.12,4.0,1.61,7
Escobedo,8,2,3,3,7,7,0,9,spain5,0.25,0.62,0,0.88,1.12,4.0,1.61,7
Marino de L.,8,2,3,3,6,8,-2,9,spain5,0.25,0.62,-2,0.75,1.12,4.0,1.61,7
Real Avila,8,2,3,3,6,8,-2,9,spain5,0.25,0.62,-2,0.75,1.12,4.0,1.61,7
Valladolid B,8,3,0,5,9,14,-5,9,spain5,0.38,0.38,-5,1.12,1.12,2.63,2.63,7
Torrelavega,8,2,2,4,11,12,-1,8,spain5,0.25,0.5,-1,1.38,1.0,4.0,2.0,8
Salamanca CF,8,2,1,5,7,12,-5,7,spain5,0.25,0.38,-5,0.88,0.88,4.0,2.63,9
Guijuelo,8,2,0,6,5,16,-11,6,spain5,0.25,0.25,-11,0.62,0.75,4.0,4.0,10
Laredo,8,1,2,5,5,16,-11,5,spain5,0.12,0.38,-11,0.62,0.62,8.33,2.63,11
SD Logrones,8,6,2,0,15,6,9,20,spain6,0.75,1.0,9,1.88,2.5,1.33,1.0,1
Alaves B,8,6,2,0,12,3,9,20,spain6,0.75,1.0,9,1.5,2.5,1.33,1.0,1
Arenas Club,8,5,2,1,13,4,9,17,spain6,0.62,0.88,9,1.62,2.12,1.61,1.14,2
Teruel,8,5,2,1,13,5,8,17,spain6,0.62,0.88,8,1.62,2.12,1.61,1.14,2
Utebo,8,4,3,1,12,8,4,15,spain6,0.5,0.88,4,1.5,1.88,2.0,1.14,3
Real Zaragoza B,8,4,1,3,12,9,3,13,spain6,0.5,0.62,3,1.5,1.62,2.0,1.61,4
Eibar B,8,3,3,2,10,6,4,12,spain6,0.38,0.75,4,1.25,1.5,2.63,1.33,5
Tudelano,8,3,2,3,10,8,2,11,spain6,0.38,0.62,2,1.25,1.38,2.63,1.61,6
Barbastro,8,3,1,4,7,7,0,10,spain6,0.38,0.5,0,0.88,1.25,2.63,2.0,7
Gernika,8,3,1,4,6,14,-8,10,spain6,0.38,0.5,-8,0.75,1.25,2.63,2.0,7
Subiza,8,3,0,5,9,12,-3,9,spain6,0.38,0.38,-3,1.12,1.12,2.63,2.63,8
Real Sociedad C,8,3,0,5,10,15,-5,9,spain6,0.38,0.38,-5,1.25,1.12,2.63,2.63,8
UD Logrones,8,2,2,4,8,6,2,8,spain6,0.25,0.5,2,1.0,1.0,4.0,2.0,9
Ejea,8,1,4,3,8,10,-2,7,spain6,0.12,0.62,-2,1.0,0.88,8.33,1.61,10
Anguiano,8,2,1,5,7,14,-7,7,spain6,0.25,0.38,-7,0.88,0.88,4.0,2.63,10
Calahorra,8,2,1,5,5,13,-8,7,spain6,0.25,0.38,-8,0.62,0.88,4.0,2.63,10
Alfaro,8,2,1,5,6,15,-9,7,spain6,0.25,0.38,-9,0.75,0.88,4.0,2.63,10
Izarra,8,1,0,7,5,13,-8,3,spain6,0.12,0.12,-8,0.62,0.38,8.33,8.33,11
Europa,8,6,1,1,13,5,8,19,spain7,0.75,0.88,8,1.62,2.38,1.33,1.14,1
Andratx,8,6,1,1,13,7,6,19,spain7,0.75,0.88,6,1.62,2.38,1.33,1.14,1
A. Baleares,8,5,3,0,12,5,7,18,spain7,0.62,1.0,7,1.5,2.25,1.61,1.0,2
Sant Andreu,8,5,2,1,19,8,11,17,spain7,0.62,0.88,11,2.38,2.12,1.61,1.14,3
SD Ibiza,8,5,1,2,13,8,5,16,spain7,0.62,0.75,5,1.62,2.0,1.61,1.33,4
Sabadell,8,5,0,3,14,7,7,15,spain7,0.62,0.62,7,1.75,1.88,1.61,1.61,5
Torrent,8,4,2,2,11,7,4,14,spain7,0.5,0.75,4,1.38,1.75,2.0,1.33,6
Valencia B,8,3,2,3,10,8,2,11,spain7,0.38,0.62,2,1.25,1.38,2.63,1.61,7
Ilicitano,8,3,2,3,10,11,-1,11,spain7,0.38,0.62,-1,1.25,1.38,2.63,1.61,7
Olot,8,3,2,3,6,8,-2,11,spain7,0.38,0.62,-2,0.75,1.38,2.63,1.61,7
Terrassa,8,3,1,4,7,7,0,10,spain7,0.38,0.5,0,0.88,1.25,2.63,2.0,8
Cornella,8,3,1,4,14,15,-1,10,spain7,0.38,0.5,-1,1.75,1.25,2.63,2.0,8
Espanyol B,8,2,3,3,8,8,0,9,spain7,0.25,0.62,0,1.0,1.12,4.0,1.61,9
Mallorca B,8,2,1,5,10,14,-4,7,spain7,0.25,0.38,-4,1.25,0.88,4.0,2.63,10
Lleida,8,1,4,3,4,8,-4,7,spain7,0.12,0.62,-4,0.5,0.88,8.33,1.61,10
Pena Deportiva,8,0,4,4,7,13,-6,4,spain7,0.0,0.5,-6,0.88,0.5,0.0,2.0,11
Badalona,8,0,1,7,4,19,-15,1,spain7,0.0,0.12,-15,0.5,0.12,0.0,8.33,12
Alzira,8,0,1,7,2,19,-17,1,spain7,0.0,0.12,-17,0.25,0.12,0.0,8.33,12
La Union,8,7,1,0,13,2,11,22,spain8,0.88,1.0,11,1.62,2.75,1.14,1.0,1
Torremolinos,8,6,0,2,14,6,8,18,spain8,0.75,0.75,8,1.75,2.25,1.33,1.33,2
Antoniano,8,5,2,1,12,8,4,17,spain8,0.62,0.88,4,1.5,2.12,1.61,1.14,3
CD Estepona,8,5,2,1,11,7,4,17,spain8,0.62,0.88,4,1.38,2.12,1.61,1.14,3
Orihuela,8,4,1,3,6,6,0,13,spain8,0.5,0.62,0,0.75,1.62,2.0,1.61,4
Villanovense,8,4,1,3,5,5,0,13,spain8,0.5,0.62,0,0.62,1.62,2.0,1.61,4
UCAM Murcia,8,3,3,2,8,6,2,12,spain8,0.38,0.75,2,1.0,1.5,2.63,1.33,5
Linares,8,3,2,3,11,8,3,11,spain8,0.38,0.62,3,1.38,1.38,2.63,1.61,6
Xerez CD,8,3,2,3,9,7,2,11,spain8,0.38,0.62,2,1.12,1.38,2.63,1.61,6
Aguilas CF,8,3,2,3,6,7,-1,11,spain8,0.38,0.62,-1,0.75,1.38,2.63,1.61,6
Xerez D. FC,8,3,1,4,7,12,-5,10,spain8,0.38,0.5,-5,0.88,1.25,2.63,2.0,7
D. Minera,8,3,0,5,13,13,0,9,spain8,0.38,0.38,0,1.62,1.12,2.63,2.63,8
Cadiz B,8,2,3,3,8,8,0,9,spain8,0.25,0.62,0,1.0,1.12,4.0,1.61,8
Don Benito,8,2,2,4,9,11,-2,8,spain8,0.25,0.5,-2,1.12,1.0,4.0,2.0,9
Almeria B,8,2,2,4,6,12,-6,8,spain8,0.25,0.5,-6,0.75,1.0,4.0,2.0,9
San Fernando,8,1,3,4,5,9,-4,6,spain8,0.12,0.5,-4,0.62,0.75,8.33,2.0,10
Granada B,8,1,1,6,4,12,-8,4,spain8,0.12,0.25,-8,0.5,0.5,8.33,4.0,11
Linense,8,0,2,6,1,9,-8,2,spain8,0.0,0.25,-8,0.12,0.25,0.0,4.0,12
Cacereno,8,6,2,0,17,6,11,20,spain9,0.75,1.0,11,2.12,2.5,1.33,1.0,1
S. Sebastian R.,8,6,1,1,13,5,8,19,spain9,0.75,0.88,8,1.62,2.38,1.33,1.14,2
Navalcarnero,8,6,0,2,13,7,6,18,spain9,0.75,0.75,6,1.62,2.25,1.33,1.33,3
Guadalajara,8,5,2,1,11,5,6,17,spain9,0.62,0.88,6,1.38,2.12,1.61,1.14,4
Talavera CF,8,3,3,2,10,5,5,12,spain9,0.38,0.75,5,1.25,1.5,2.63,1.33,5
CD Mostoles,8,4,0,4,17,13,4,12,spain9,0.5,0.5,4,2.12,1.5,2.0,2.0,5
CD Coria,8,3,3,2,10,9,1,12,spain9,0.38,0.75,1,1.25,1.5,2.63,1.33,5
Real Madrid C,8,3,2,3,7,6,1,11,spain9,0.38,0.62,1,0.88,1.38,2.63,1.61,6
Melilla,8,3,2,3,7,8,-1,11,spain9,0.38,0.62,-1,0.88,1.38,2.63,1.61,6
R. Majadahonda,8,2,4,2,3,5,-2,10,spain9,0.25,0.75,-2,0.38,1.25,4.0,1.33,7
Conquense,8,3,1,4,5,9,-4,10,spain9,0.38,0.5,-4,0.62,1.25,2.63,2.0,7
Getafe B,8,2,2,4,9,11,-2,8,spain9,0.25,0.5,-2,1.12,1.0,4.0,2.0,8
Colonia M.,8,2,2,4,5,11,-6,8,spain9,0.25,0.5,-6,0.62,1.0,4.0,2.0,8
Union Adarve,8,1,3,4,2,5,-3,6,spain9,0.12,0.5,-3,0.25,0.75,8.33,2.0,9
Illescas,8,1,3,4,7,12,-5,6,spain9,0.12,0.5,-5,0.88,0.75,8.33,2.0,9
Atletico Paso,8,1,3,4,6,11,-5,6,spain9,0.12,0.5,-5,0.75,0.75,8.33,2.0,9
Tenerife B,8,1,3,4,6,11,-5,6,spain9,0.12,0.5,-5,0.75,0.75,8.33,2.0,9
Yaiza,8,1,2,5,3,12,-9,5,spain9,0.12,0.38,-9,0.38,0.62,8.33,2.63,10
AIK,4,3,1,0,6,3,3,10,sweden,0.75,1.0,3,1.5,2.5,1.33,1.0,1
Hammarby,4,3,0,1,9,3,6,9,sweden,0.75,0.75,6,2.25,2.25,1.33,1.33,2
Mjallby,4,2,2,0,9,4,5,8,sweden,0.5,1.0,5,2.25,2.0,2.0,1.0,3
Malmo FF,4,2,2,0,4,2,2,8,sweden,0.5,1.0,2,1.0,2.0,2.0,1.0,3
Elfsborg,4,2,1,1,6,4,2,7,sweden,0.5,0.75,2,1.5,1.75,2.0,1.33,4
Degerfors,4,2,0,2,6,3,3,6,sweden,0.5,0.5,3,1.5,1.5,2.0,2.0,5
Norrkoping,4,2,0,2,10,9,1,6,sweden,0.5,0.5,1,2.5,1.5,2.0,2.0,5
Brommapojkarna,4,2,0,2,6,6,0,6,sweden,0.5,0.5,0,1.5,1.5,2.0,2.0,5
Hacken,4,2,0,2,5,7,-2,6,sweden,0.5,0.5,-2,1.25,1.5,2.0,2.0,5
IFK Goteborg,4,2,0,2,4,7,-3,6,sweden,0.5,0.5,-3,1.0,1.5,2.0,2.0,5
GAIS,4,1,2,1,3,2,1,5,sweden,0.25,0.75,1,0.75,1.25,4.0,1.33,6
Djurgarden,4,1,1,2,1,3,-2,4,sweden,0.25,0.5,-2,0.25,1.0,4.0,2.0,7
Sirius,4,1,1,2,3,6,-3,4,sweden,0.25,0.5,-3,0.75,1.0,4.0,2.0,7
Oster,4,1,0,3,5,6,-1,3,sweden,0.25,0.25,-1,1.25,0.75,4.0,4.0,8
Halmstad,4,1,0,3,1,9,-8,3,sweden,0.25,0.25,-8,0.25,0.75,4.0,4.0,8
Varnamo,4,0,0,4,3,7,-4,0,sweden,0.0,0.0,-4,0.75,0.0,0.0,0.0,9
Kalmar,4,3,1,0,6,1,5,10,sweden2,0.75,1.0,5,1.5,2.5,1.33,1.0,1
Varberg BoIS,4,2,2,0,9,4,5,8,sweden2,0.5,1.0,5,2.25,2.0,2.0,1.0,2
Orgryte,4,2,2,0,6,2,4,8,sweden2,0.5,1.0,4,1.5,2.0,2.0,1.0,2
Landskrona,4,2,2,0,9,7,2,8,sweden2,0.5,1.0,2,2.25,2.0,2.0,1.0,2
Vasteras,3,2,1,0,4,1,3,7,sweden2,0.67,1.0,3,1.33,2.33,1.49,1.0,3
Oddevold,4,2,1,1,6,5,1,7,sweden2,0.5,0.75,1,1.5,1.75,2.0,1.33,3
Sandviken,4,2,1,1,5,5,0,7,sweden2,0.5,0.75,0,1.25,1.75,2.0,1.33,3
Falkenberg,4,1,2,1,6,5,1,5,sweden2,0.25,0.75,1,1.5,1.25,4.0,1.33,4
Ostersunds,4,1,2,1,6,7,-1,5,sweden2,0.25,0.75,-1,1.5,1.25,4.0,1.33,4
Brage,4,1,2,1,4,5,-1,5,sweden2,0.25,0.75,-1,1.0,1.25,4.0,1.33,4
GIF Sundsvall,4,1,1,2,3,3,0,4,sweden2,0.25,0.5,0,0.75,1.0,4.0,2.0,5
Utsikten,4,1,0,3,6,7,-1,3,sweden2,0.25,0.25,-1,1.5,0.75,4.0,4.0,6
Helsingborg,3,1,0,2,3,4,-1,3,sweden2,0.33,0.33,-1,1.0,1.0,3.03,3.03,6
Trelleborg,4,1,0,3,1,4,-3,3,sweden2,0.25,0.25,-3,0.25,0.75,4.0,4.0,6
Umea,4,0,1,3,2,8,-6,1,sweden2,0.0,0.25,-6,0.5,0.25,0.0,4.0,7
Orebro,4,0,0,4,1,9,-8,0,sweden2,0.0,0.0,-8,0.25,0.0,0.0,0.0,8
FC Basel,8,6,1,1,19,4,15,19,switzerland,0.75,0.88,15,2.38,2.38,1.33,1.14,1
BSC Young Boys,8,5,1,2,10,9,1,16,switzerland,0.62,0.75,1,1.25,2.0,1.61,1.33,2
Servette,8,4,1,3,11,8,3,13,switzerland,0.5,0.62,3,1.38,1.62,2.0,1.61,3
Winterthur,8,4,1,3,10,7,3,13,switzerland,0.5,0.62,3,1.25,1.62,2.0,1.61,3
FC Zurich,8,3,2,3,12,14,-2,11,switzerland,0.38,0.62,-2,1.5,1.38,2.63,1.61,4
St. Gallen,8,3,2,3,7,10,-3,11,switzerland,0.38,0.62,-3,0.88,1.38,2.63,1.61,4
Grasshopper,8,3,1,4,10,11,-1,10,switzerland,0.38,0.5,-1,1.25,1.25,2.63,2.0,5
Lausanne Sport,8,3,1,4,9,11,-2,10,switzerland,0.38,0.5,-2,1.12,1.25,2.63,2.0,5
Luzern,8,2,3,3,17,13,4,9,switzerland,0.25,0.62,4,2.12,1.12,4.0,1.61,6
Yverdon,8,2,3,3,10,16,-6,9,switzerland,0.25,0.62,-6,1.25,1.12,4.0,1.61,6
Lugano,8,2,1,5,6,13,-7,7,switzerland,0.25,0.38,-7,0.75,0.88,4.0,2.63,7
Sion,8,1,3,4,6,11,-5,6,switzerland,0.12,0.5,-5,0.75,0.75,8.33,2.0,8
Thun,8,5,2,1,18,7,11,17,switzerland2,0.62,0.88,11,2.25,2.12,1.61,1.14,1
Etoile Carouge,8,4,3,1,19,9,10,15,switzerland2,0.5,0.88,10,2.38,1.88,2.0,1.14,2
Lausanne Ouchy,8,4,2,2,12,8,4,14,switzerland2,0.5,0.75,4,1.5,1.75,2.0,1.33,3
Aarau,8,2,6,0,15,10,5,12,switzerland2,0.25,1.0,5,1.88,1.5,4.0,1.0,4
Vaduz,8,3,2,3,14,12,2,11,switzerland2,0.38,0.62,2,1.75,1.38,2.63,1.61,5
Wil,8,3,2,3,13,17,-4,11,switzerland2,0.38,0.62,-4,1.62,1.38,2.63,1.61,5
Neuchatel Xamax,8,2,3,3,14,10,4,9,switzerland2,0.25,0.62,4,1.75,1.12,4.0,1.61,6
Bellinzona,8,2,2,4,8,20,-12,8,switzerland2,0.25,0.5,-12,1.0,1.0,4.0,2.0,7
Schaffhausen,8,2,1,5,9,19,-10,7,switzerland2,0.25,0.38,-10,1.12,0.88,4.0,2.63,8
Stade Nyonnais,8,1,1,6,7,17,-10,4,switzerland2,0.12,0.25,-10,0.88,0.5,8.33,4.0,9
Bangkok Utd,8,7,1,0,19,5,14,22,thailand,0.88,1.0,14,2.38,2.75,1.14,1.0,1
Pathum Utd,8,6,1,1,12,6,6,19,thailand,0.75,0.88,6,1.5,2.38,1.33,1.14,2
Ratchaburi,8,6,0,2,24,13,11,18,thailand,0.75,0.75,11,3.0,2.25,1.33,1.33,3
Buriram Utd,8,5,1,2,17,9,8,16,thailand,0.62,0.75,8,2.12,2.0,1.61,1.33,4
Prachuap,8,4,1,3,14,9,5,13,thailand,0.5,0.62,5,1.75,1.62,2.0,1.61,5
Chiangrai Utd,8,4,1,3,13,10,3,13,thailand,0.5,0.62,3,1.62,1.62,2.0,1.61,5
Port FC,8,3,3,2,13,12,1,12,thailand,0.38,0.75,1,1.62,1.5,2.63,1.33,6
Lamphun Warrior,8,3,2,3,10,10,0,11,thailand,0.38,0.62,0,1.25,1.38,2.63,1.61,7
Rayong,8,3,1,4,13,13,0,10,thailand,0.38,0.5,0,1.62,1.25,2.63,2.0,8
Uthai Thani,8,1,5,2,6,7,-1,8,thailand,0.12,0.75,-1,0.75,1.0,8.33,1.33,9
Sukhothai,8,1,4,3,11,14,-3,7,thailand,0.12,0.62,-3,1.38,0.88,8.33,1.61,10
Muang Thong Utd,8,2,1,5,10,16,-6,7,thailand,0.25,0.38,-6,1.25,0.88,4.0,2.63,10
Nakhon Pathom,8,1,3,4,8,14,-6,6,thailand,0.12,0.5,-6,1.0,0.75,8.33,2.0,11
N. Bua Pitchaya,8,1,3,4,6,12,-6,6,thailand,0.12,0.5,-6,0.75,0.75,8.33,2.0,11
N. Ratchasima,8,1,3,4,10,19,-9,6,thailand,0.12,0.5,-9,1.25,0.75,8.33,2.0,11
Khon Kaen Utd,8,1,2,5,7,21,-14,5,thailand,0.12,0.38,-14,0.88,0.62,8.33,2.63,12
Chonburi,8,7,0,1,20,7,13,21,thailand2,0.88,0.88,13,2.5,2.62,1.14,1.14,1
Kanchanaburi,8,4,3,1,19,11,8,15,thailand2,0.5,0.88,8,2.38,1.88,2.0,1.14,2
Ayutthaya Utd,8,4,2,2,16,8,8,14,thailand2,0.5,0.75,8,2.0,1.75,2.0,1.33,3
Chainat,8,4,2,2,12,8,4,14,thailand2,0.5,0.75,4,1.5,1.75,2.0,1.33,3
Police Tero,8,4,2,2,12,11,1,14,thailand2,0.5,0.75,1,1.5,1.75,2.0,1.33,3
Chanthaburi,8,4,2,2,12,12,0,14,thailand2,0.5,0.75,0,1.5,1.75,2.0,1.33,3
Lampang,8,4,1,3,11,10,1,13,thailand2,0.5,0.62,1,1.38,1.62,2.0,1.61,4
Phrae Utd,8,3,3,2,16,11,5,12,thailand2,0.38,0.75,5,2.0,1.5,2.63,1.33,5
Kasetsart,8,3,3,2,9,7,2,12,thailand2,0.38,0.75,2,1.12,1.5,2.63,1.33,5
Mahasarakham,8,2,5,1,9,7,2,11,thailand2,0.25,0.88,2,1.12,1.38,4.0,1.14,6
Chiangmai Utd,8,3,1,4,13,14,-1,10,thailand2,0.38,0.5,-1,1.62,1.25,2.63,2.0,7
Bangkok FC,8,2,3,3,12,13,-1,9,thailand2,0.25,0.62,-1,1.5,1.12,4.0,1.61,8
Nakhon Si,8,2,2,4,8,13,-5,8,thailand2,0.25,0.5,-5,1.0,1.0,4.0,2.0,9
Trat FC,8,2,1,5,10,14,-4,7,thailand2,0.25,0.38,-4,1.25,0.88,4.0,2.63,10
Sisaket Utd,8,2,1,5,7,15,-8,7,thailand2,0.25,0.38,-8,0.88,0.88,4.0,2.63,10
Suphanburi,8,0,4,4,12,21,-9,4,thailand2,0.0,0.5,-9,1.5,0.5,0.0,2.0,11
Pattaya United,8,1,1,6,5,20,-15,4,thailand2,0.12,0.25,-15,0.62,0.5,8.33,4.0,11
Samut Prakan,0,0,0,0,0,0,0,0,thailand2,0.0,0.0,0,0.0,0.0,0.0,0.0,12
Fenerbahce,8,5,3,0,20,8,12,18,turkey,0.62,1.0,12,2.5,2.25,1.61,1.0,1
Galatasaray,8,5,2,1,16,7,9,17,turkey,0.62,0.88,9,2.0,2.12,1.61,1.14,2
Kayserispor,8,5,1,2,15,7,8,16,turkey,0.62,0.75,8,1.88,2.0,1.61,1.33,3
Konyaspor,8,5,1,2,9,6,3,16,turkey,0.62,0.75,3,1.12,2.0,1.61,1.33,3
Basaksehir,8,5,0,3,10,9,1,15,turkey,0.62,0.62,1,1.25,1.88,1.61,1.61,4
Bodrumspor,8,4,2,2,7,6,1,14,turkey,0.5,0.75,1,0.88,1.75,2.0,1.33,5
Antalyaspor,8,4,2,2,9,12,-3,14,turkey,0.5,0.75,-3,1.12,1.75,2.0,1.33,5
Gaziantep,8,4,1,3,12,10,2,13,turkey,0.5,0.62,2,1.5,1.62,2.0,1.61,6
Trabzonspor,8,4,1,3,12,10,2,13,turkey,0.5,0.62,2,1.5,1.62,2.0,1.61,6
Kasimpasa,8,3,2,3,12,10,2,11,turkey,0.38,0.62,2,1.5,1.38,2.63,1.61,7
Besiktas,8,3,2,3,10,9,1,11,turkey,0.38,0.62,1,1.25,1.38,2.63,1.61,7
Eyupspor,8,3,1,4,13,12,1,10,turkey,0.38,0.5,1,1.62,1.25,2.63,2.0,8
Rizespor,8,3,1,4,10,12,-2,10,turkey,0.38,0.5,-2,1.25,1.25,2.63,2.0,8
Hatayspor,8,3,0,5,9,15,-6,9,turkey,0.38,0.38,-6,1.12,1.12,2.63,2.63,9
Sivasspor,8,2,2,4,14,14,0,8,turkey,0.25,0.5,0,1.75,1.0,4.0,2.0,10
Alanyaspor,8,2,0,6,8,13,-5,6,turkey,0.25,0.25,-5,1.0,0.75,4.0,4.0,11
Goztepe,8,0,5,3,7,11,-4,5,turkey,0.0,0.62,-4,0.88,0.62,0.0,1.61,12
Samsunspor,8,1,2,5,8,14,-6,5,turkey,0.12,0.38,-6,1.0,0.62,8.33,2.63,12
Adana Demirspor,8,0,2,6,6,21,-15,2,turkey,0.0,0.25,-15,0.75,0.25,0.0,4.0,13
Igdir,8,4,4,0,15,3,12,16,turkey2,0.5,1.0,12,1.88,2.0,2.0,1.0,1
Erokspor,8,4,4,0,17,10,7,16,turkey2,0.5,1.0,7,2.12,2.0,2.0,1.0,1
Istanbulspor,8,5,0,3,17,7,10,15,turkey2,0.62,0.62,10,2.12,1.88,1.61,1.61,2
Amed SK,8,4,3,1,9,6,3,15,turkey2,0.5,0.88,3,1.12,1.88,2.0,1.14,2
Bandirmaspor,8,3,5,0,12,8,4,14,turkey2,0.38,1.0,4,1.5,1.75,2.63,1.0,3
Boluspor,8,4,2,2,11,7,4,14,turkey2,0.5,0.75,4,1.38,1.75,2.0,1.33,3
Kocaelispor,8,3,4,1,20,11,9,13,turkey2,0.38,0.88,9,2.5,1.62,2.63,1.14,4
Umraniyespor,8,3,4,1,10,4,6,13,turkey2,0.38,0.88,6,1.25,1.62,2.63,1.14,4
Erzurum BB,8,4,1,3,13,10,3,13,turkey2,0.5,0.62,3,1.62,1.62,2.0,1.61,4
Corum,8,3,3,2,14,14,0,12,turkey2,0.38,0.75,0,1.75,1.5,2.63,1.33,5
Genclerbirligi,8,3,3,2,9,10,-1,12,turkey2,0.38,0.75,-1,1.12,1.5,2.63,1.33,5
F. Karagumruk,8,3,2,3,8,7,1,11,turkey2,0.38,0.62,1,1.0,1.38,2.63,1.61,6
Keciorengucu,8,3,1,4,14,13,1,10,turkey2,0.38,0.5,1,1.75,1.25,2.63,2.0,7
Sakaryaspor,8,3,1,4,12,16,-4,10,turkey2,0.38,0.5,-4,1.5,1.25,2.63,2.0,7
Manisa BB,8,2,2,4,10,11,-1,8,turkey2,0.25,0.5,-1,1.25,1.0,4.0,2.0,8
Pendikspor,8,2,2,4,8,11,-3,8,turkey2,0.25,0.5,-3,1.0,1.0,4.0,2.0,8
Sanliurfaspor,8,2,1,5,9,14,-5,7,turkey2,0.25,0.38,-5,1.12,0.88,4.0,2.63,9
Adanaspor,8,2,0,6,9,15,-6,6,turkey2,0.25,0.25,-6,1.12,0.75,4.0,4.0,10
Ankaragucu,8,1,2,5,9,17,-8,5,turkey2,0.12,0.38,-8,1.12,0.62,8.33,2.63,11
Y. Malatyaspor,8,0,0,8,2,34,-32,0,turkey2,0.0,0.0,-32,0.25,0.0,0.0,0.0,12
Sariyer,8,6,1,1,20,7,13,19,turkey3,0.75,0.88,13,2.5,2.38,1.33,1.14,1
B. Petrolspor,8,6,1,1,15,3,12,19,turkey3,0.75,0.88,12,1.88,2.38,1.33,1.14,1
Ankaraspor,8,5,1,2,19,5,14,16,turkey3,0.62,0.75,14,2.38,2.0,1.61,1.33,2
Trabzon FK,8,5,1,2,12,5,7,16,turkey3,0.62,0.75,7,1.5,2.0,1.61,1.33,2
B. Anadolu,8,5,1,2,15,15,0,16,turkey3,0.62,0.75,0,1.88,2.0,1.61,1.33,2
Kastamonuspor,8,4,3,1,13,8,5,15,turkey3,0.5,0.88,5,1.62,1.88,2.0,1.14,3
Adana,8,4,2,2,12,7,5,14,turkey3,0.5,0.75,5,1.5,1.75,2.0,1.33,4
Fethiyespor,8,4,1,3,7,10,-3,13,turkey3,0.5,0.62,-3,0.88,1.62,2.0,1.61,5
Kirklarelispor,8,3,1,4,11,12,-1,10,turkey3,0.38,0.5,-1,1.38,1.25,2.63,2.0,6
Iskenderun,8,2,3,3,12,13,-1,9,turkey3,0.25,0.62,-1,1.5,1.12,4.0,1.61,7
Kepez Belediyes,8,2,2,4,9,11,-2,8,turkey3,0.25,0.5,-2,1.12,1.0,4.0,2.0,8
Altinordu,8,2,2,4,7,11,-4,8,turkey3,0.25,0.5,-4,0.88,1.0,4.0,2.0,8
Inegolspor,8,2,2,4,10,16,-6,8,turkey3,0.25,0.5,-6,1.25,1.0,4.0,2.0,8
Altay,8,2,1,5,8,15,-7,7,turkey3,0.25,0.38,-7,1.0,0.88,4.0,2.63,9
Isparta Davrazs,8,2,1,5,10,18,-8,7,turkey3,0.25,0.38,-8,1.25,0.88,4.0,2.63,9
Karakopru,8,2,0,6,7,11,-4,6,turkey3,0.25,0.25,-4,0.88,0.75,4.0,4.0,10
24 Erzincanspor,8,1,3,4,10,15,-5,6,turkey3,0.12,0.5,-5,1.25,0.75,8.33,2.0,10
Afyonspor,8,0,0,8,0,24,-24,0,turkey3,0.0,0.0,-24,0.0,0.0,0.0,0.0,11
Elazigspor,8,6,0,2,16,6,10,18,turkey4,0.75,0.75,10,2.0,2.25,1.33,1.33,1
Yeni Mersin,8,5,2,1,20,4,16,17,turkey4,0.62,0.88,16,2.5,2.12,1.61,1.14,2
Beyoglu Yeni C.,8,5,1,2,18,8,10,16,turkey4,0.62,0.75,10,2.25,2.0,1.61,1.33,3
Menemen B.,8,5,1,2,13,7,6,16,turkey4,0.62,0.75,6,1.62,2.0,1.61,1.33,3
Karacabey,8,5,1,2,12,6,6,16,turkey4,0.62,0.75,6,1.5,2.0,1.61,1.33,3
Erbaaspor,8,5,0,3,21,15,6,15,turkey4,0.62,0.62,6,2.62,1.88,1.61,1.61,4
Serik Belediyes,8,4,2,2,24,13,11,14,turkey4,0.5,0.75,11,3.0,1.75,2.0,1.33,5
Karaman,8,3,5,0,11,7,4,14,turkey4,0.38,1.0,4,1.38,1.75,2.63,1.0,5
Aksaray B.,8,4,2,2,15,12,3,14,turkey4,0.5,0.75,3,1.88,1.75,2.0,1.33,5
Van Spor,8,4,2,2,12,10,2,14,turkey4,0.5,0.75,2,1.5,1.75,2.0,1.33,5
A. Demirspor,8,3,3,2,15,12,3,12,turkey4,0.38,0.75,3,1.88,1.5,2.63,1.33,6
Somaspor,8,3,1,4,12,13,-1,10,turkey4,0.38,0.5,-1,1.5,1.25,2.63,2.0,7
Diyarbekirspor,8,3,1,4,7,11,-4,10,turkey4,0.38,0.5,-4,0.88,1.25,2.63,2.0,7
Arnavutkoy B.,8,2,1,5,13,17,-4,7,turkey4,0.25,0.38,-4,1.62,0.88,4.0,2.63,8
Bucaspor,8,2,1,5,8,16,-8,7,turkey4,0.25,0.38,-8,1.0,0.88,4.0,2.63,8
Derince,8,1,1,6,8,21,-13,4,turkey4,0.12,0.25,-13,1.0,0.5,8.33,4.0,9
Giresunspor,8,0,0,8,5,25,-20,0,turkey4,0.0,0.0,-20,0.62,0.0,0.0,0.0,10
Nazillispor,8,0,0,8,4,31,-27,0,turkey4,0.0,0.0,-27,0.5,0.0,0.0,0.0,10
Musspor,8,7,1,0,21,6,15,22,turkey5,0.88,1.0,15,2.62,2.75,1.14,1.0,1
Bursaspor,8,6,1,1,20,7,13,19,turkey5,0.75,0.88,13,2.5,2.38,1.33,1.14,2
Anadolu U.,8,5,2,1,11,6,5,17,turkey5,0.62,0.88,5,1.38,2.12,1.61,1.14,3
Karsiyaka,8,5,1,2,20,9,11,16,turkey5,0.62,0.75,11,2.5,2.0,1.61,1.33,4
Kutahyaspor,8,5,1,2,17,14,3,16,turkey5,0.62,0.75,3,2.12,2.0,1.61,1.33,4
Silifke,8,5,0,3,13,9,4,15,turkey5,0.62,0.62,4,1.62,1.88,1.61,1.61,5
Duzcespor,8,5,0,3,8,9,-1,15,turkey5,0.62,0.62,-1,1.0,1.88,1.61,1.61,5
K. Bulvarspor,8,3,2,3,12,16,-4,11,turkey5,0.38,0.62,-4,1.5,1.38,2.63,1.61,6
Artvin Hopaspor,8,3,1,4,5,7,-2,10,turkey5,0.38,0.5,-2,0.62,1.25,2.63,2.0,7
Ergene Velimese,8,3,1,4,7,15,-8,10,turkey5,0.38,0.5,-8,0.88,1.25,2.63,2.0,7
Tokat,8,2,2,4,9,9,0,8,turkey5,0.25,0.5,0,1.12,1.0,4.0,2.0,8
Kusadasispor,8,2,1,5,6,14,-8,7,turkey5,0.25,0.38,-8,0.75,0.88,4.0,2.63,9
Kirsehir B.,8,1,3,4,5,12,-7,6,turkey5,0.12,0.5,-7,0.62,0.75,8.33,2.0,10
Kahramanmar.,8,1,2,5,6,10,-4,5,turkey5,0.12,0.38,-4,0.75,0.62,8.33,2.63,11
Elaziz K.,8,0,3,5,4,10,-6,3,turkey5,0.0,0.38,-6,0.5,0.38,0.0,2.63,12
Viven Bornova,8,0,1,7,7,18,-11,1,turkey5,0.0,0.12,-11,0.88,0.12,0.0,8.33,13
Tire 2021 FK,8,7,1,0,20,3,17,22,turkey6,0.88,1.0,17,2.5,2.75,1.14,1.0,1
Muglaspor,8,6,1,1,17,3,14,19,turkey6,0.75,0.88,14,2.12,2.38,1.33,1.14,2
Beykoz Ishaklis,8,5,1,2,19,8,11,16,turkey6,0.62,0.75,11,2.38,2.0,1.61,1.33,3
Mazidagi,8,4,3,1,17,6,11,15,turkey6,0.5,0.88,11,2.12,1.88,2.0,1.14,4
Turk Metal 1963,8,4,2,2,17,14,3,14,turkey6,0.5,0.75,3,2.12,1.75,2.0,1.33,5
Balikesirspor,8,4,1,3,15,10,5,13,turkey6,0.5,0.62,5,1.88,1.62,2.0,1.61,6
Cayelispor,8,3,4,1,7,3,4,13,turkey6,0.38,0.88,4,0.88,1.62,2.63,1.14,6
Inegol Kafkas,8,3,2,3,14,9,5,11,turkey6,0.38,0.62,5,1.75,1.38,2.63,1.61,7
Usakspor,8,2,5,1,8,6,2,11,turkey6,0.25,0.88,2,1.0,1.38,4.0,1.14,7
Silivrispor,8,3,2,3,12,11,1,11,turkey6,0.38,0.62,1,1.5,1.38,2.63,1.61,7
Amasyaspor,8,2,3,3,13,12,1,9,turkey6,0.25,0.62,1,1.62,1.12,4.0,1.61,8
Kelkit,8,2,2,4,9,11,-2,8,turkey6,0.25,0.5,-2,1.12,1.0,4.0,2.0,9
Etimesgut,8,1,3,4,7,15,-8,6,turkey6,0.12,0.5,-8,0.88,0.75,8.33,2.0,10
Fatsa B.,8,1,2,5,4,15,-11,5,turkey6,0.12,0.38,-11,0.5,0.62,8.33,2.63,11
Nevsehirspor,8,0,2,6,3,32,-29,2,turkey6,0.0,0.25,-29,0.38,0.25,0.0,4.0,12
Adiyaman,8,0,0,8,0,24,-24,0,turkey6,0.0,0.0,-24,0.0,0.0,0.0,0.0,13
Aliaga FAS,8,7,1,0,19,5,14,22,turkey7,0.88,1.0,14,2.38,2.75,1.14,1.0,1
Ayvalikgucu,8,6,2,0,14,6,8,20,turkey7,0.75,1.0,8,1.75,2.5,1.33,1.0,2
Orduspor,8,4,2,2,16,6,10,14,turkey7,0.5,0.75,10,2.0,1.75,2.0,1.33,3
Alanya 1221,8,4,2,2,15,10,5,14,turkey7,0.5,0.75,5,1.88,1.75,2.0,1.33,3
1923 M.,8,3,3,2,13,9,4,12,turkey7,0.38,0.75,4,1.62,1.5,2.63,1.33,4
Corluspor,8,3,3,2,11,7,4,12,turkey7,0.38,0.75,4,1.38,1.5,2.63,1.33,4
Kucukcekmece,8,3,3,2,10,8,2,12,turkey7,0.38,0.75,2,1.25,1.5,2.63,1.33,4
Pazarspor,8,3,1,4,12,11,1,10,turkey7,0.38,0.5,1,1.5,1.25,2.63,2.0,5
Yozgat Bld Bozo,8,3,1,4,15,18,-3,10,turkey7,0.38,0.5,-3,1.88,1.25,2.63,2.0,5
Cankaya FK,8,3,1,4,12,21,-9,10,turkey7,0.38,0.5,-9,1.5,1.25,2.63,2.0,5
Osmaniyespor,8,3,0,5,10,18,-8,9,turkey7,0.38,0.38,-8,1.25,1.12,2.63,2.63,6
Efeler 09,8,1,5,2,5,6,-1,8,turkey7,0.12,0.75,-1,0.62,1.0,8.33,1.33,7
K. Idmanyurdu,8,1,3,4,7,11,-4,6,turkey7,0.12,0.5,-4,0.88,0.75,8.33,2.0,8
Viransehir,8,2,0,6,5,11,-6,6,turkey7,0.25,0.25,-6,0.62,0.75,4.0,4.0,8
Bayburt,8,1,3,4,4,15,-11,6,turkey7,0.12,0.5,-11,0.5,0.75,8.33,2.0,8
1922 Konyaspor,8,1,2,5,8,14,-6,5,turkey7,0.12,0.38,-6,1.0,0.62,8.33,2.63,9
Sebat G.,8,6,1,1,24,11,13,19,turkey8,0.75,0.88,13,3.0,2.38,1.33,1.14,1
Mardin BB,8,5,3,0,19,8,11,18,turkey8,0.62,1.0,11,2.38,2.25,1.61,1.0,2
Z. Komurspor,8,5,2,1,12,7,5,17,turkey8,0.62,0.88,5,1.5,2.12,1.61,1.14,3
Agri 1970,8,4,4,0,9,5,4,16,turkey8,0.5,1.0,4,1.12,2.0,2.0,1.0,4
Kirikkale B.,8,5,1,2,14,13,1,16,turkey8,0.62,0.75,1,1.75,2.0,1.61,1.33,4
K. Istiklalspor,8,4,1,3,17,12,5,13,turkey8,0.5,0.62,5,2.12,1.62,2.0,1.61,5
Erciyes,8,3,2,3,13,15,-2,11,turkey8,0.38,0.62,-2,1.62,1.38,2.63,1.61,6
Tepecik,8,2,3,3,10,13,-3,9,turkey8,0.25,0.62,-3,1.25,1.12,4.0,1.61,7
Denizlispor,8,1,5,2,10,9,1,8,turkey8,0.12,0.75,1,1.25,1.0,8.33,1.33,8
Nilufer B.,8,2,2,4,8,8,0,8,turkey8,0.25,0.5,0,1.0,1.0,4.0,2.0,8
Nigde Belediyes,8,2,2,4,7,10,-3,8,turkey8,0.25,0.5,-3,0.88,1.0,4.0,2.0,8
Turgutluspor,8,2,2,4,11,15,-4,8,turkey8,0.25,0.5,-4,1.38,1.0,4.0,2.0,8
Orduspor 1967,8,2,2,4,8,12,-4,8,turkey8,0.25,0.5,-4,1.0,1.0,4.0,2.0,8
Edirnespor,8,2,2,4,12,20,-8,8,turkey8,0.25,0.5,-8,1.5,1.0,4.0,2.0,8
Polatli B.,8,2,1,5,10,14,-4,7,turkey8,0.25,0.38,-4,1.25,0.88,4.0,2.63,9
Coruhlu,8,0,1,7,9,21,-12,1,turkey8,0.0,0.12,-12,1.12,0.12,0.0,8.33,10
Shabab Al Ahli,8,6,2,0,15,3,12,20,uae,0.75,1.0,12,1.88,2.5,1.33,1.0,1
Al Wasl,8,5,2,1,16,7,9,17,uae,0.62,0.88,9,2.0,2.12,1.61,1.14,2
Khorfakkan,8,5,2,1,12,7,5,17,uae,0.62,0.88,5,1.5,2.12,1.61,1.14,2
Al Wahda,8,4,2,2,16,12,4,14,uae,0.5,0.75,4,2.0,1.75,2.0,1.33,3
Al Sharjah,8,4,1,3,6,5,1,13,uae,0.5,0.62,1,0.75,1.62,2.0,1.61,4
Bani Yas,8,4,1,3,9,12,-3,13,uae,0.5,0.62,-3,1.12,1.62,2.0,1.61,4
Al Ain,8,3,2,3,13,10,3,11,uae,0.38,0.62,3,1.62,1.38,2.63,1.61,5
Ajman,8,3,2,3,12,14,-2,11,uae,0.38,0.62,-2,1.5,1.38,2.63,1.61,5
Al Bataeh,8,2,4,2,8,9,-1,10,uae,0.25,0.75,-1,1.0,1.25,4.0,1.33,6
Al Jazira,8,3,1,4,11,16,-5,10,uae,0.38,0.5,-5,1.38,1.25,2.63,2.0,6
Al Nasr,8,2,2,4,9,11,-2,8,uae,0.25,0.5,-2,1.12,1.0,4.0,2.0,7
Dibba Al Hisn,8,2,1,5,11,15,-4,7,uae,0.25,0.38,-4,1.38,0.88,4.0,2.63,8
Ittihad Kalba,8,1,2,5,6,11,-5,5,uae,0.12,0.38,-5,0.75,0.62,8.33,2.63,9
Al Urooba,8,1,0,7,8,19,-11,3,uae,0.12,0.12,-11,1.0,0.38,8.33,8.33,10
Dynamo Kyiv,8,6,2,0,16,4,12,20,ukraine,0.75,1.0,12,2.0,2.5,1.33,1.0,1
Oleksandria,8,6,1,1,13,6,7,19,ukraine,0.75,0.88,7,1.62,2.38,1.33,1.14,2
Shakhtar,8,5,2,1,17,7,10,17,ukraine,0.62,0.88,10,2.12,2.12,1.61,1.14,3
Veres,8,5,1,2,14,9,5,16,ukraine,0.62,0.75,5,1.75,2.0,1.61,1.33,4
Karpaty Lviv,8,4,3,1,11,5,6,15,ukraine,0.5,0.88,6,1.38,1.88,2.0,1.14,5
Polessya,8,4,3,1,10,8,2,15,ukraine,0.5,0.88,2,1.25,1.88,2.0,1.14,5
Livyi Bereh,8,3,1,4,5,7,-2,10,ukraine,0.38,0.5,-2,0.62,1.25,2.63,2.0,6
Zorya Luhansk,8,3,1,4,10,14,-4,10,ukraine,0.38,0.5,-4,1.25,1.25,2.63,2.0,6
Obolon,8,3,1,4,4,11,-7,10,ukraine,0.38,0.5,-7,0.5,1.25,2.63,2.0,6
Kolos Kovalivka,8,3,0,5,11,10,1,9,ukraine,0.38,0.38,1,1.38,1.12,2.63,2.63,7
Inhulets,8,2,2,4,4,5,-1,8,ukraine,0.25,0.5,-1,0.5,1.0,4.0,2.0,8
LNZ Cherkasy,8,2,1,5,5,9,-4,7,ukraine,0.25,0.38,-4,0.62,0.88,4.0,2.63,9
Kryvbas KR,8,2,1,5,6,11,-5,7,ukraine,0.25,0.38,-5,0.75,0.88,4.0,2.63,9
Rukh Lviv,8,2,1,5,4,10,-6,7,ukraine,0.25,0.38,-6,0.5,0.88,4.0,2.63,9
Chornomorets,8,2,0,6,5,13,-8,6,ukraine,0.25,0.25,-8,0.62,0.75,4.0,4.0,10
Vorskla Poltava,8,1,2,5,4,10,-6,5,ukraine,0.12,0.38,-6,0.5,0.62,8.33,2.63,11
Dnipro-1,0,0,0,0,0,0,0,0,ukraine,0.0,0.0,0,0.0,0.0,0.0,0.0,12
Liverpool M.,8,5,3,0,13,4,9,18,uruguay,0.62,1.0,9,1.62,2.25,1.61,1.0,1
Racing CM,8,5,1,2,9,4,5,16,uruguay,0.62,0.75,5,1.12,2.0,1.61,1.33,2
Nacional,8,4,3,1,17,9,8,15,uruguay,0.5,0.88,8,2.12,1.88,2.0,1.14,3
Juventud,8,5,0,3,14,10,4,15,uruguay,0.62,0.62,4,1.75,1.88,1.61,1.61,3
Boston River,8,4,1,3,10,11,-1,13,uruguay,0.5,0.62,-1,1.25,1.62,2.0,1.61,4
Penarol,8,4,0,4,9,11,-2,12,uruguay,0.5,0.5,-2,1.12,1.5,2.0,2.0,5
Progreso,8,2,5,1,9,8,1,11,uruguay,0.25,0.88,1,1.12,1.38,4.0,1.14,6
Cerro,8,2,4,2,9,9,0,10,uruguay,0.25,0.75,0,1.12,1.25,4.0,1.33,7
Montevideo City,8,2,4,2,9,12,-3,10,uruguay,0.25,0.75,-3,1.12,1.25,4.0,1.33,7
Defensor S.,8,2,3,3,8,8,0,9,uruguay,0.25,0.62,0,1.0,1.12,4.0,1.61,8
Plaza Colonia,8,2,3,3,6,7,-1,9,uruguay,0.25,0.62,-1,0.75,1.12,4.0,1.61,8
Cerro Largo,8,2,3,3,4,9,-5,9,uruguay,0.25,0.62,-5,0.5,1.12,4.0,1.61,8
Miramar Misione,8,2,2,4,8,13,-5,8,uruguay,0.25,0.5,-5,1.0,1.0,4.0,2.0,9
Wanderers,8,1,4,3,9,9,0,7,uruguay,0.12,0.62,0,1.12,0.88,8.33,1.61,10
River Plate,8,1,2,5,6,11,-5,5,uruguay,0.12,0.38,-5,0.75,0.62,8.33,2.63,11
Danubio,8,0,4,4,6,11,-5,4,uruguay,0.0,0.5,-5,0.75,0.5,0.0,2.0,12
Nacional,7,5,1,1,18,5,13,16,uruguay2,0.71,0.86,13,2.57,2.29,1.41,1.16,1
Penarol,7,4,2,1,10,5,5,14,uruguay2,0.57,0.86,5,1.43,2.0,1.75,1.16,2
Danubio,7,4,2,1,11,11,0,14,uruguay2,0.57,0.86,0,1.57,2.0,1.75,1.16,2
Wanderers,7,4,1,2,11,9,2,13,uruguay2,0.57,0.71,2,1.57,1.86,1.75,1.41,3
Defensor S.,7,3,2,2,7,5,2,11,uruguay2,0.43,0.71,2,1.0,1.57,2.33,1.41,4
Cerro Largo,7,3,2,2,6,7,-1,11,uruguay2,0.43,0.71,-1,0.86,1.57,2.33,1.41,4
Cerro,7,3,1,3,8,5,3,10,uruguay2,0.43,0.57,3,1.14,1.43,2.33,1.75,5
Fenix,7,3,1,3,10,9,1,10,uruguay2,0.43,0.57,1,1.43,1.43,2.33,1.75,5
Miramar Misione,7,3,1,3,7,10,-3,10,uruguay2,0.43,0.57,-3,1.0,1.43,2.33,1.75,5
River Plate,7,2,2,3,8,9,-1,8,uruguay2,0.29,0.57,-1,1.14,1.14,3.45,1.75,6
Progreso,7,2,2,3,8,11,-3,8,uruguay2,0.29,0.57,-3,1.14,1.14,3.45,1.75,6
Rampla Juniors,7,2,2,3,8,12,-4,8,uruguay2,0.29,0.57,-4,1.14,1.14,3.45,1.75,6
Boston River,7,2,1,4,6,8,-2,7,uruguay2,0.29,0.43,-2,0.86,1.0,3.45,2.33,7
Racing CM,7,1,3,3,8,10,-2,6,uruguay2,0.14,0.57,-2,1.14,0.86,7.14,1.75,8
D. Maldonado,7,1,3,3,5,9,-4,6,uruguay2,0.14,0.57,-4,0.71,0.86,7.14,1.75,8
Liverpool M.,7,1,0,6,4,10,-6,3,uruguay2,0.14,0.14,-6,0.57,0.43,7.14,7.14,9
Charlotte,8,6,0,2,14,5,9,18,usa,0.75,0.75,9,1.75,2.25,1.33,1.33,1
Inter Miami,8,5,3,0,13,6,7,18,usa,0.62,1.0,7,1.62,2.25,1.61,1.0,1
Vancouver,8,5,2,1,13,5,8,17,usa,0.62,0.88,8,1.62,2.12,1.61,1.14,2
Minnesota Utd,8,4,4,0,11,6,5,16,usa,0.5,1.0,5,1.38,2.0,2.0,1.0,3
Cincinnati,8,5,1,2,12,11,1,16,usa,0.62,0.75,1,1.5,2.0,1.61,1.33,3
Portland,8,4,3,1,15,9,6,15,usa,0.5,0.88,6,1.88,1.88,2.0,1.14,4
Columbus Crew,8,4,3,1,8,5,3,15,usa,0.5,0.88,3,1.0,1.88,2.0,1.14,4
Colorado Rapids,8,4,2,2,13,13,0,14,usa,0.5,0.75,0,1.62,1.75,2.0,1.33,5
Orlando City,8,3,4,1,13,8,5,13,usa,0.38,0.88,5,1.62,1.62,2.63,1.14,6
Philadelphia,8,4,1,3,12,7,5,13,usa,0.5,0.62,5,1.5,1.62,2.0,1.61,6
Austin,8,4,1,3,6,8,-2,13,usa,0.5,0.62,-2,0.75,1.62,2.0,1.61,6
Chicago Fire,8,3,3,2,14,11,3,12,usa,0.38,0.75,3,1.75,1.5,2.63,1.33,7
New York RB,8,3,3,2,10,8,2,12,usa,0.38,0.75,2,1.25,1.5,2.63,1.33,7
Nashville SC,8,4,0,4,12,11,1,12,usa,0.5,0.5,1,1.5,1.5,2.0,2.0,7
San Diego,8,3,2,3,13,12,1,11,usa,0.38,0.62,1,1.62,1.38,2.63,1.61,8
Seattle,8,3,2,3,10,9,1,11,usa,0.38,0.62,1,1.25,1.38,2.63,1.61,8
New England,8,3,1,4,6,7,-1,10,usa,0.38,0.5,-1,0.75,1.25,2.63,2.0,9
Los Angeles FC,8,3,1,4,12,14,-2,10,usa,0.38,0.5,-2,1.5,1.25,2.63,2.0,9
New York City,8,3,1,4,9,11,-2,10,usa,0.38,0.5,-2,1.12,1.25,2.63,2.0,9
Dallas,8,2,3,3,8,10,-2,9,usa,0.25,0.62,-2,1.0,1.12,4.0,1.61,10
Real Salt Lake,8,3,0,5,8,10,-2,9,usa,0.38,0.38,-2,1.0,1.12,2.63,2.63,10
St. Louis City,8,2,2,4,5,6,-1,8,usa,0.25,0.5,-1,0.62,1.0,4.0,2.0,11
DC United,8,2,2,4,9,17,-8,8,usa,0.25,0.5,-8,1.12,1.0,4.0,2.0,11
SJ Earthquakes,8,2,1,5,15,17,-2,7,usa,0.25,0.38,-2,1.88,0.88,4.0,2.63,12
Sporting KC,8,2,1,5,15,18,-3,7,usa,0.25,0.38,-3,1.88,0.88,4.0,2.63,12
Houston Dynamo,8,1,4,3,7,12,-5,7,usa,0.12,0.62,-5,0.88,0.88,8.33,1.61,12
Toronto,8,1,3,4,6,11,-5,6,usa,0.12,0.5,-5,0.75,0.75,8.33,2.0,13
Atlanta Utd,8,1,3,4,8,14,-6,6,usa,0.12,0.5,-6,1.0,0.75,8.33,2.0,13
LA Galaxy,8,0,3,5,6,14,-8,3,usa,0.0,0.38,-8,0.75,0.38,0.0,2.63,14
Loudoun Utd,7,6,0,1,13,6,7,18,usa2,0.86,0.86,7,1.86,2.57,1.16,1.16,1
Monterey Bay,7,4,2,1,11,5,6,14,usa2,0.57,0.86,6,1.57,2.0,1.75,1.16,2
Louisville City,6,4,2,0,10,4,6,14,usa2,0.67,1.0,6,1.67,2.33,1.49,1.0,2
Detroit City,7,4,2,1,11,7,4,14,usa2,0.57,0.86,4,1.57,2.0,1.75,1.16,2
Charleston,6,4,0,2,11,7,4,12,usa2,0.67,0.67,4,1.83,2.0,1.49,1.49,3
FC Tulsa,6,4,0,2,8,4,4,12,usa2,0.67,0.67,4,1.33,2.0,1.49,1.49,3
San Antonio,6,4,0,2,10,7,3,12,usa2,0.67,0.67,3,1.67,2.0,1.49,1.49,3
New Mexico,5,4,0,1,7,4,3,12,usa2,0.8,0.8,3,1.4,2.4,1.25,1.25,3
El Paso,7,2,3,2,12,13,-1,9,usa2,0.29,0.71,-1,1.71,1.29,3.45,1.41,4
North Carolina,7,2,2,3,8,9,-1,8,usa2,0.29,0.57,-1,1.14,1.14,3.45,1.75,5
Las Vegas L.,6,2,2,2,5,7,-2,8,usa2,0.33,0.67,-2,0.83,1.33,3.03,1.49,5
Lexington,7,1,4,2,8,8,0,7,usa2,0.14,0.71,0,1.14,1.0,7.14,1.41,6
Pittsburgh,6,2,1,3,6,7,-1,7,usa2,0.33,0.5,-1,1.0,1.17,3.03,2.0,6
Orange County,6,2,1,3,8,11,-3,7,usa2,0.33,0.5,-3,1.33,1.17,3.03,2.0,6
Oakland Roots,7,2,1,4,9,13,-4,7,usa2,0.29,0.43,-4,1.29,1.0,3.45,2.33,6
Colorado S.,6,1,3,2,10,11,-1,6,usa2,0.17,0.67,-1,1.67,1.0,5.88,1.49,7
Sacramento R.,6,1,3,2,8,9,-1,6,usa2,0.17,0.67,-1,1.33,1.0,5.88,1.49,7
Phoenix Rising,7,1,3,3,13,16,-3,6,usa2,0.14,0.57,-3,1.86,0.86,7.14,1.75,7
Miami FC,6,2,0,4,6,10,-4,6,usa2,0.33,0.33,-4,1.0,1.0,3.03,3.03,7
Indy Eleven,5,1,2,2,9,10,-1,5,usa2,0.2,0.6,-1,1.8,1.0,5.0,1.67,8
Birmingham L.,6,1,2,3,7,10,-3,5,usa2,0.17,0.5,-3,1.17,0.83,5.88,2.0,8
Rhode Island,5,1,1,3,5,8,-3,4,usa2,0.2,0.4,-3,1.0,0.8,5.0,2.5,9
Tampa Bay,6,1,0,5,5,9,-4,3,usa2,0.17,0.17,-4,0.83,0.5,5.88,5.88,10
Hartford A.,5,1,0,4,2,7,-5,3,usa2,0.2,0.2,-5,0.4,0.6,5.0,5.0,10
Naples,7,4,2,1,9,3,6,14,usa3,0.57,0.86,6,1.29,2.0,1.75,1.16,1
Spokane V.,6,3,2,1,12,5,7,11,usa3,0.5,0.83,7,2.0,1.83,2.0,1.2,2
One Knoxville,4,3,1,0,6,2,4,10,usa3,0.75,1.0,4,1.5,2.5,1.33,1.0,3
Richmond K.,7,3,1,3,14,12,2,10,usa3,0.43,0.57,2,2.0,1.43,2.33,1.75,3
Charlotte I.,5,2,2,1,5,4,1,8,usa3,0.4,0.8,1,1.0,1.6,2.5,1.25,4
Tormenta,6,2,1,3,11,13,-2,7,usa3,0.33,0.5,-2,1.83,1.17,3.03,2.0,5
Greenville,6,2,1,3,5,7,-2,7,usa3,0.33,0.5,-2,0.83,1.17,3.03,2.0,5
Chattanooga RW,5,1,3,1,6,6,0,6,usa3,0.2,0.8,0,1.2,1.2,5.0,1.25,6
Alta,5,2,0,3,7,9,-2,6,usa3,0.4,0.4,-2,1.4,1.2,2.5,2.5,6
Westchester SC,4,1,2,1,8,8,0,5,usa3,0.25,0.75,0,2.0,1.25,4.0,1.33,7
Forward Madison,4,1,2,1,4,5,-1,5,usa3,0.25,0.75,-1,1.0,1.25,4.0,1.33,7
Union Omaha,3,1,0,2,3,5,-2,3,usa3,0.33,0.33,-2,1.0,1.0,3.03,3.03,8
Portland Hearts,3,0,2,1,1,2,-1,2,usa3,0.0,0.67,-1,0.33,0.67,0.0,1.49,9
Texoma,5,0,1,4,3,13,-10,1,usa3,0.0,0.2,-10,0.6,0.2,0.0,5.0,10
UCV,8,6,2,0,9,1,8,20,venezuela,0.75,1.0,8,1.12,2.5,1.33,1.0,1
D. La Guaira,8,5,2,1,13,6,7,17,venezuela,0.62,0.88,7,1.62,2.12,1.61,1.14,2
Carabobo,8,5,2,1,6,4,2,17,venezuela,0.62,0.88,2,0.75,2.12,1.61,1.14,2
D. Tachira,8,4,3,1,14,8,6,15,venezuela,0.5,0.88,6,1.75,1.88,2.0,1.14,3
Monagas,8,4,2,2,13,9,4,14,venezuela,0.5,0.75,4,1.62,1.75,2.0,1.33,4
Puerto Cabello,8,3,3,2,5,4,1,12,venezuela,0.38,0.75,1,0.62,1.5,2.63,1.33,5
A. Anzoategui,8,2,4,2,7,6,1,10,venezuela,0.25,0.75,1,0.88,1.25,4.0,1.33,6
Metropolitanos,8,2,3,3,10,11,-1,9,venezuela,0.25,0.62,-1,1.25,1.12,4.0,1.61,7
Rayo Zuliano,8,3,0,5,7,8,-1,9,venezuela,0.38,0.38,-1,0.88,1.12,2.63,2.63,7
Portuguesa,8,2,2,4,8,11,-3,8,venezuela,0.25,0.5,-3,1.0,1.0,4.0,2.0,8
E. Merida,8,2,1,5,11,15,-4,7,venezuela,0.25,0.38,-4,1.38,0.88,4.0,2.63,9
Caracas,8,1,3,4,6,12,-6,6,venezuela,0.12,0.5,-6,0.75,0.75,8.33,2.0,10
Zamora,8,1,2,5,6,10,-4,5,venezuela,0.12,0.38,-4,0.75,0.62,8.33,2.63,11
Yaracuyanos,8,0,3,5,8,18,-10,3,venezuela,0.0,0.38,-10,1.0,0.38,0.0,2.63,12
AGMK,6,5,1,0,11,4,7,16,uzbekistan,0.83,1.0,7,1.83,2.67,1.2,1.0,1
Nasaf Qarshi,6,4,2,0,10,3,7,14,uzbekistan,0.67,1.0,7,1.67,2.33,1.49,1.0,2
Bunyodkor,6,3,3,0,9,3,6,12,uzbekistan,0.5,1.0,6,1.5,2.0,2.0,1.0,3
D. Samarqand,6,3,3,0,5,2,3,12,uzbekistan,0.5,1.0,3,0.83,2.0,2.0,1.0,3
Andijan,6,2,3,1,9,8,1,9,uzbekistan,0.33,0.83,1,1.5,1.5,3.03,1.2,4
Neftchi,6,2,3,1,9,9,0,9,uzbekistan,0.33,0.83,0,1.5,1.5,3.03,1.2,4
Navbahor,6,2,2,2,9,8,1,8,uzbekistan,0.33,0.67,1,1.5,1.33,3.03,1.49,5
Xorazm,5,2,1,2,5,5,0,7,uzbekistan,0.4,0.6,0,1.0,1.4,2.5,1.67,6
Qizilqum,5,2,1,2,4,5,-1,7,uzbekistan,0.4,0.6,-1,0.8,1.4,2.5,1.67,6
Pakhtakor,6,2,0,4,11,8,3,6,uzbekistan,0.33,0.33,3,1.83,1.0,3.03,3.03,7
Buxoro,6,2,0,4,8,9,-1,6,uzbekistan,0.33,0.33,-1,1.33,1.0,3.03,3.03,7
Kokand-1912,6,1,3,2,3,5,-2,6,uzbekistan,0.17,0.67,-2,0.5,1.0,5.88,1.49,7
Termez Surkhon,6,2,0,4,5,9,-4,6,uzbekistan,0.33,0.33,-4,0.83,1.0,3.03,3.03,7
Mashal,6,2,0,4,3,11,-8,6,uzbekistan,0.33,0.33,-8,0.5,1.0,3.03,3.03,7
Sogdiana,6,1,1,4,7,9,-2,4,uzbekistan,0.17,0.33,-2,1.17,0.67,5.88,3.03,8
Shurtan,6,0,1,5,1,11,-10,1,uzbekistan,0.0,0.17,-10,0.17,0.17,0.0,5.88,9
Ha Noi,8,5,2,1,17,6,11,17,vietnam,0.62,0.88,11,2.12,2.12,1.61,1.14,1
Nam Dinh,8,4,4,0,11,4,7,16,vietnam,0.5,1.0,7,1.38,2.0,2.0,1.0,2
Hai Phong,8,5,1,2,8,4,4,16,vietnam,0.62,0.75,4,1.0,2.0,1.61,1.33,2
Cong An Nhan,8,3,4,1,14,11,3,13,vietnam,0.38,0.88,3,1.75,1.62,2.63,1.14,3
Hong Linh Ha T.,8,2,5,1,7,6,1,11,vietnam,0.25,0.88,1,0.88,1.38,4.0,1.14,4
Binh Duong,8,3,2,3,9,14,-5,11,vietnam,0.38,0.62,-5,1.12,1.38,2.63,1.61,4
Quang Nam,8,2,4,2,14,13,1,10,vietnam,0.25,0.75,1,1.75,1.25,4.0,1.33,5
Song Lam Nghe,8,2,4,2,7,9,-2,10,vietnam,0.25,0.75,-2,0.88,1.25,4.0,1.33,5
Viettel,8,2,3,3,11,14,-3,9,vietnam,0.25,0.62,-3,1.38,1.12,4.0,1.61,6
Thanh Hoa,8,1,5,2,10,11,-1,8,vietnam,0.12,0.75,-1,1.25,1.0,8.33,1.33,7
Ho Chi Minh,8,1,5,2,7,10,-3,8,vietnam,0.12,0.75,-3,0.88,1.0,8.33,1.33,7
Da Nang,8,1,4,3,8,10,-2,7,vietnam,0.12,0.62,-2,1.0,0.88,8.33,1.61,8
Gia Lai,8,1,2,5,9,13,-4,5,vietnam,0.12,0.38,-4,1.12,0.62,8.33,2.63,9
Binh Dinh,8,1,1,6,5,12,-7,4,vietnam,0.12,0.25,-7,0.62,0.5,8.33,4.0,10
Phu Dong,8,8,0,0,17,0,17,24,vietnam2,1.0,1.0,17,2.12,3.0,1.0,1.0,1
PVF-CAND,8,6,1,1,17,7,10,19,vietnam2,0.75,0.88,10,2.12,2.38,1.33,1.14,2
Binh Phuoc,8,6,1,1,14,5,9,19,vietnam2,0.75,0.88,9,1.75,2.38,1.33,1.14,2
Ba Ria Vung Tau,8,3,1,4,6,16,-10,10,vietnam2,0.38,0.5,-10,0.75,1.25,2.63,2.0,3
Dong Nai,8,2,3,3,5,3,2,9,vietnam2,0.25,0.62,2,0.62,1.12,4.0,1.61,4
Ho Chi Minh B,8,2,3,3,7,10,-3,9,vietnam2,0.25,0.62,-3,0.88,1.12,4.0,1.61,4
Dong Thap,8,2,2,4,7,6,1,8,vietnam2,0.25,0.5,1,0.88,1.0,4.0,2.0,5
S. Khanh Hoa,8,2,2,4,7,11,-4,8,vietnam2,0.25,0.5,-4,0.88,1.0,4.0,2.0,5
Long An,8,1,2,5,3,11,-8,5,vietnam2,0.12,0.38,-8,0.38,0.62,8.33,2.63,6
Hoa Binh,8,0,4,4,4,10,-6,4,vietnam2,0.0,0.5,-6,0.5,0.5,0.0,2.0,7
Hue,8,1,1,6,6,17,-11,4,vietnam2,0.12,0.25,-11,0.75,0.5,8.33,4.0,7
The New Saints,8,7,0,1,21,4,17,21,wales,0.88,0.88,17,2.62,2.62,1.14,1.14,1
Flint,8,6,1,1,18,11,7,19,wales,0.75,0.88,7,2.25,2.38,1.33,1.14,2
Barry,8,5,1,2,18,11,7,16,wales,0.62,0.75,7,2.25,2.0,1.61,1.33,3
Connahs Quay,8,4,1,3,13,7,6,13,wales,0.5,0.62,6,1.62,1.62,2.0,1.61,4
Penybont,8,4,1,3,13,14,-1,13,wales,0.5,0.62,-1,1.62,1.62,2.0,1.61,4
Caernarfon,8,3,1,4,14,14,0,10,wales,0.38,0.5,0,1.75,1.25,2.63,2.0,5
Briton Ferry,8,3,1,4,9,15,-6,10,wales,0.38,0.5,-6,1.12,1.25,2.63,2.0,5
Cardiff MU,8,2,3,3,8,13,-5,9,wales,0.25,0.62,-5,1.0,1.12,4.0,1.61,6
Haverfordwest,8,1,4,3,7,13,-6,7,wales,0.12,0.62,-6,0.88,0.88,8.33,1.61,7
Newtown,8,1,3,4,10,16,-6,6,wales,0.12,0.5,-6,1.25,0.75,8.33,2.0,8
Bala Town,8,1,2,5,7,16,-9,5,wales,0.12,0.38,-9,0.88,0.62,8.33,2.63,9
Aberystwyth,8,1,1,6,6,14,-8,4,wales,0.12,0.25,-8,0.75,0.5,8.33,4.0,10
