Equipe,GP,W,D,L,GF,GA,GD,Pts_Overall,Liga,PIO,PIO_HA,GD_Overall,GF_AVG_Overall,Odd_Justa_MO,Odd_Justa_HA,Rank_Overall
Vllaznia S.,8,4,3,1,15,6,9,15,Albania - Abissnet Superiore,0.5,0.88,9,1.88,2.0,1.14,1
Dinamo Tirana,8,3,4,1,11,6,5,13,Albania - Abissnet Superiore,0.38,0.88,5,1.38,2.63,1.14,2
KF Tirana,8,3,2,3,12,13,-1,11,Albania - Abissnet Superiore,0.38,0.62,-1,1.5,2.63,1.61,3
Laci,8,3,2,3,10,12,-2,11,Albania - Abissnet Superiore,0.38,0.62,-2,1.25,2.63,1.61,3
Skenderbeu K.,8,3,2,3,7,9,-2,11,Albania - Abissnet Superiore,0.38,0.62,-2,0.88,2.63,1.61,3
Bylis,8,3,1,4,9,14,-5,10,Albania - Abissnet Superiore,0.38,0.5,-5,1.12,2.63,2.0,4
AF Elbasani,8,1,4,3,8,10,-2,7,Albania - Abissnet Superiore,0.12,0.62,-2,1.0,8.33,1.61,5
Partizani T.,8,1,3,4,6,11,-5,6,Albania - Abissnet Superiore,0.12,0.5,-5,0.75,8.33,2.0,6
Teuta Durres,8,1,2,5,5,13,-8,5,Albania - Abissnet Superiore,0.12,0.38,-8,0.62,8.33,2.63,7
MC Alger,8,7,1,0,17,6,11,22,Algeria - Ligue 1,0.88,1.0,11,2.12,1.14,1.0,1
ASO Chlef,8,4,3,1,11,6,5,15,Algeria - Ligue 1,0.5,0.88,5,1.38,2.0,1.14,2
CR Belouizdad,8,4,2,2,10,6,4,14,Algeria - Ligue 1,0.5,0.75,4,1.25,2.0,1.33,3
El Bayadh,8,4,2,2,6,6,0,14,Algeria - Ligue 1,0.5,0.75,0,0.75,2.0,1.33,3
JS Kabylie,8,3,3,2,11,8,3,12,Algeria - Ligue 1,0.38,0.75,3,1.38,2.63,1.33,4
USM Alger,8,3,3,2,8,6,2,12,Algeria - Ligue 1,0.38,0.75,2,1.0,2.63,1.33,4
JS Saoura,8,4,0,4,9,9,0,12,Algeria - Ligue 1,0.5,0.5,0,1.12,2.0,2.0,4
ES Setif,8,2,4,2,6,6,0,10,Algeria - Ligue 1,0.25,0.75,0,0.75,4.0,1.33,5
Paradou AC,8,3,1,4,10,12,-2,10,Algeria - Ligue 1,0.38,0.5,-2,1.25,2.63,2.0,5
CS Constantine,8,1,4,3,6,8,-2,7,Algeria - Ligue 1,0.12,0.62,-2,0.75,8.33,1.61,6
Biskra,8,1,4,3,2,5,-3,7,Algeria - Ligue 1,0.12,0.62,-3,0.25,8.33,1.61,6
Khenchela,8,2,1,5,8,17,-9,7,Algeria - Ligue 1,0.25,0.38,-9,1.0,4.0,2.63,6
O. Akbou,8,1,3,4,4,7,-3,6,Algeria - Ligue 1,0.12,0.5,-3,0.5,8.33,2.0,7
MC Oran,8,2,0,6,3,11,-8,6,Algeria - Ligue 1,0.25,0.25,-8,0.38,4.0,4.0,7
Mostaganem,8,1,2,5,4,9,-5,5,Algeria - Ligue 1,0.12,0.38,-5,0.5,8.33,2.63,8
NC Magra,8,0,4,4,4,9,-5,4,Algeria - Ligue 1,0.0,0.5,-5,0.5,0.0,2.0,9
Argentinos Jrs,8,6,2,0,11,4,7,20,Argentina - Liga Profesional,0.75,1.0,7,1.38,1.33,1.0,1
Boca Juniors,8,6,1,1,12,5,7,19,Argentina - Liga Profesional,0.75,0.88,7,1.5,1.33,1.14,2
Estudiantes,8,5,3,0,15,7,8,18,Argentina - Liga Profesional,0.62,1.0,8,1.88,1.61,1.0,3
Tigre,8,6,0,2,12,5,7,18,Argentina - Liga Profesional,0.75,0.75,7,1.5,1.33,1.33,3
Independiente,8,5,2,1,13,6,7,17,Argentina - Liga Profesional,0.62,0.88,7,1.62,1.61,1.14,4
Rosario Central,8,5,2,1,11,4,7,17,Argentina - Liga Profesional,0.62,0.88,7,1.38,1.61,1.14,4
Huracan,8,5,2,1,10,3,7,17,Argentina - Liga Profesional,0.62,0.88,7,1.25,1.61,1.14,4
River Plate,8,4,3,1,7,3,4,15,Argentina - Liga Profesional,0.5,0.88,4,0.88,2.0,1.14,5
Defensa y J.,8,4,2,2,11,6,5,14,Argentina - Liga Profesional,0.5,0.75,5,1.38,2.0,1.33,6
San Lorenzo,8,4,2,2,9,7,2,14,Argentina - Liga Profesional,0.5,0.75,2,1.12,2.0,1.33,6
Barracas C.,8,3,4,1,12,8,4,13,Argentina - Liga Profesional,0.38,0.88,4,1.5,2.63,1.14,7
D. Riestra,8,2,5,1,7,3,4,11,Argentina - Liga Profesional,0.25,0.88,4,0.88,4.0,1.14,8
Central Cordoba,8,3,2,3,14,11,3,11,Argentina - Liga Profesional,0.38,0.62,3,1.75,2.63,1.61,8
Lanus,8,2,4,2,5,4,1,10,Argentina - Liga Profesional,0.25,0.75,1,0.62,4.0,1.33,9
I. Rivadavia,8,2,4,2,8,9,-1,10,Argentina - Liga Profesional,0.25,0.75,-1,1.0,4.0,1.33,9
Gimnasia,8,3,1,4,5,8,-3,10,Argentina - Liga Profesional,0.38,0.5,-3,0.62,2.63,2.0,9
Racing Club,8,3,0,5,13,11,2,9,Argentina - Liga Profesional,0.38,0.38,2,1.62,2.63,2.63,10
Platense,8,2,3,3,5,6,-1,9,Argentina - Liga Profesional,0.25,0.62,-1,0.62,4.0,1.61,10
Godoy Cruz,7,2,3,2,5,8,-3,9,Argentina - Liga Profesional,0.29,0.71,-3,0.71,3.45,1.41,10
Belgrano,8,2,2,4,7,16,-9,8,Argentina - Liga Profesional,0.25,0.5,-9,0.88,4.0,2.0,11
Instituto,8,2,1,5,5,7,-2,7,Argentina - Liga Profesional,0.25,0.38,-2,0.62,4.0,2.63,12
A. Tucuman,8,2,1,5,9,12,-3,7,Argentina - Liga Profesional,0.25,0.38,-3,1.12,4.0,2.63,12
Sarmiento,8,1,4,3,6,13,-7,7,Argentina - Liga Profesional,0.12,0.62,-7,0.75,8.33,1.61,12
SM San Juan,8,1,3,4,4,7,-3,6,Argentina - Liga Profesional,0.12,0.5,-3,0.5,8.33,2.0,13
Newells,8,2,0,6,4,12,-8,6,Argentina - Liga Profesional,0.25,0.25,-8,0.5,4.0,4.0,13
Banfield,8,1,2,5,5,7,-2,5,Argentina - Liga Profesional,0.12,0.38,-2,0.62,8.33,2.63,14
T. de Cordoba,7,1,2,4,5,8,-3,5,Argentina - Liga Profesional,0.14,0.43,-3,0.71,7.14,2.33,14
Union Santa Fe,7,1,2,4,3,7,-4,5,Argentina - Liga Profesional,0.14,0.43,-4,0.43,7.14,2.33,14
Velez Sarsfield,8,1,2,5,1,10,-9,5,Argentina - Liga Profesional,0.12,0.38,-9,0.12,8.33,2.63,14
Tristan Suarez,5,3,1,1,6,3,3,10,Argentina - Primera Nacional,0.6,0.8,3,1.2,1.67,1.25,1
Colon Santa Fe,4,3,1,0,5,2,3,10,Argentina - Primera Nacional,0.75,1.0,3,1.25,1.33,1.0,1
SM Tucuman,5,2,3,0,4,2,2,9,Argentina - Primera Nacional,0.4,1.0,2,0.8,2.5,1.0,2
Deportivo Maipu,5,3,0,2,6,5,1,9,Argentina - Primera Nacional,0.6,0.6,1,1.2,1.67,1.67,2
CA Estudiantes,4,2,2,0,7,3,4,8,Argentina - Primera Nacional,0.5,1.0,4,1.75,2.0,1.0,3
D. de Belgrano,4,2,2,0,5,1,4,8,Argentina - Primera Nacional,0.5,1.0,4,1.25,2.0,1.0,3
Ferro Carril,5,2,2,1,4,2,2,8,Argentina - Primera Nacional,0.4,0.8,2,0.8,2.5,1.25,3
G. Mendoza,4,2,2,0,3,1,2,8,Argentina - Primera Nacional,0.5,1.0,2,0.75,2.0,1.0,3
Los Andes,5,2,2,1,6,5,1,8,Argentina - Primera Nacional,0.4,0.8,1,1.2,2.5,1.25,3
Temperley,4,2,1,1,4,2,2,7,Argentina - Primera Nacional,0.5,0.75,2,1.0,2.0,1.33,4
Gimnasia y Tiro,4,2,1,1,4,3,1,7,Argentina - Primera Nacional,0.5,0.75,1,1.0,2.0,1.33,4
All Boys,5,1,3,1,5,3,2,6,Argentina - Primera Nacional,0.2,0.8,2,1.0,5.0,1.25,5
Chaco For Ever,5,2,0,3,5,4,1,6,Argentina - Primera Nacional,0.4,0.4,1,1.0,2.5,2.5,5
San Miguel,4,2,0,2,5,4,1,6,Argentina - Primera Nacional,0.5,0.5,1,1.25,2.0,2.0,5
Atlanta,4,1,3,0,2,1,1,6,Argentina - Primera Nacional,0.25,1.0,1,0.5,4.0,1.0,5
Gimnasia Jujuy,4,1,3,0,2,1,1,6,Argentina - Primera Nacional,0.25,1.0,1,0.5,4.0,1.0,5
Quilmes,5,1,3,1,5,5,0,6,Argentina - Primera Nacional,0.2,0.8,0,1.0,5.0,1.25,5
Racing Cordoba,4,2,0,2,4,7,-3,6,Argentina - Primera Nacional,0.5,0.5,-3,1.0,2.0,2.0,5
Deportivo Moron,4,1,2,1,3,2,1,5,Argentina - Primera Nacional,0.25,0.75,1,0.75,4.0,1.33,6
E. Rio Cuarto,4,1,2,1,4,4,0,5,Argentina - Primera Nacional,0.25,0.75,0,1.0,4.0,1.33,6
Chacarita J.,4,1,2,1,3,3,0,5,Argentina - Primera Nacional,0.25,0.75,0,0.75,4.0,1.33,6
Central Norte,4,1,2,1,3,4,-1,5,Argentina - Primera Nacional,0.25,0.75,-1,0.75,4.0,1.33,6
Defensores U.,4,1,2,1,3,4,-1,5,Argentina - Primera Nacional,0.25,0.75,-1,0.75,4.0,1.33,6
Arsenal Sarandi,4,0,4,0,3,3,0,4,Argentina - Primera Nacional,0.0,1.0,0,0.75,0.0,1.0,7
Patronato,4,1,1,2,4,5,-1,4,Argentina - Primera Nacional,0.25,0.5,-1,1.0,4.0,2.0,7
D. Madryn,5,1,1,3,4,6,-2,4,Argentina - Primera Nacional,0.2,0.4,-2,0.8,5.0,2.5,7
Agropecuario,4,1,1,2,3,5,-2,4,Argentina - Primera Nacional,0.25,0.5,-2,0.75,4.0,2.0,7
Nueva Chicago,4,1,1,2,3,5,-2,4,Argentina - Primera Nacional,0.25,0.5,-2,0.75,4.0,2.0,7
San Telmo,4,1,1,2,3,5,-2,4,Argentina - Primera Nacional,0.25,0.5,-2,0.75,4.0,2.0,7
Argentino Merlo,8,6,1,1,15,6,9,19,Argentina - Primera B,0.75,0.88,9,1.88,1.33,1.14,1
A. Quilmes,8,5,2,1,12,4,8,17,Argentina - Primera B,0.62,0.88,8,1.5,1.61,1.14,2
Comunicaciones,8,5,2,1,12,6,6,17,Argentina - Primera B,0.62,0.88,6,1.5,1.61,1.14,2
Villa Dalmine,8,5,2,1,7,2,5,17,Argentina - Primera B,0.62,0.88,5,0.88,1.61,1.14,2
Deportivo Merlo,8,4,3,1,8,4,4,15,Argentina - Primera B,0.5,0.88,4,1.0,2.0,1.14,3
Excursionistas,8,4,2,2,16,9,7,14,Argentina - Primera B,0.5,0.75,7,2.0,2.0,1.33,4
D. Armenio,8,4,1,3,13,8,5,13,Argentina - Primera B,0.5,0.62,5,1.62,2.0,1.61,5
Colegiales,8,4,1,3,9,7,2,13,Argentina - Primera B,0.5,0.62,2,1.12,2.0,1.61,5
Midland,8,3,3,2,10,7,3,12,Argentina - Primera B,0.38,0.75,3,1.25,2.63,1.33,6
Sacachispas,8,3,2,3,4,6,-2,11,Argentina - Primera B,0.38,0.62,-2,0.5,2.63,1.61,7
Liniers,8,2,4,2,5,5,0,10,Argentina - Primera B,0.25,0.75,0,0.62,4.0,1.33,8
S. Italiano,8,2,3,3,9,9,0,9,Argentina - Primera B,0.25,0.62,0,1.12,4.0,1.61,9
Flandria,8,2,3,3,7,9,-2,9,Argentina - Primera B,0.25,0.62,-2,0.88,4.0,1.61,9
SM Burzaco,8,3,0,5,5,9,-4,9,Argentina - Primera B,0.38,0.38,-4,0.62,2.63,2.63,9
Dock Sud,8,2,2,4,5,8,-3,8,Argentina - Primera B,0.25,0.5,-3,0.62,4.0,2.0,10
Los Andes,8,2,2,4,5,9,-4,8,Argentina - Primera B,0.25,0.5,-4,0.62,4.0,2.0,10
Acassuso,8,2,2,4,5,12,-7,8,Argentina - Primera B,0.25,0.5,-7,0.62,4.0,2.0,10
UAI Urquiza,8,2,2,4,10,18,-8,8,Argentina - Primera B,0.25,0.5,-8,1.25,4.0,2.0,10
V. San Carlos,8,2,1,5,5,9,-4,7,Argentina - Primera B,0.25,0.38,-4,0.62,4.0,2.63,11
D. Laferrere,8,1,4,3,4,9,-5,7,Argentina - Primera B,0.12,0.62,-5,0.5,8.33,1.61,11
Canuelas,8,2,0,6,6,11,-5,6,Argentina - Primera B,0.25,0.25,-5,0.75,4.0,4.0,12
Fenix,8,1,1,6,5,12,-7,4,Argentina - Primera B,0.12,0.25,-7,0.62,8.33,4.0,13
Gutierrez,8,6,2,0,10,4,6,20,Argentina - Torneo Federal,0.75,1.0,6,1.25,1.33,1.0,1
Central Norte,8,6,1,1,15,5,10,19,Argentina - Torneo Federal,0.75,0.88,10,1.88,1.33,1.14,2
Sol de America,8,5,3,0,11,5,6,18,Argentina - Torneo Federal,0.62,1.0,6,1.38,1.61,1.0,3
Santamarina,8,5,2,1,14,6,8,17,Argentina - Torneo Federal,0.62,0.88,8,1.75,1.61,1.14,4
Villa Mitre,8,5,2,1,11,3,8,17,Argentina - Torneo Federal,0.62,0.88,8,1.38,1.61,1.14,4
Camioneros,8,5,2,1,14,7,7,17,Argentina - Torneo Federal,0.62,0.88,7,1.75,1.61,1.14,4
Olimpo Bahia B.,8,4,4,0,10,4,6,16,Argentina - Torneo Federal,0.5,1.0,6,1.25,2.0,1.0,5
S. Belgrano,8,4,4,0,7,1,6,16,Argentina - Torneo Federal,0.5,1.0,6,0.88,2.0,1.0,5
Sarmiento DLB,8,5,1,2,10,6,4,16,Argentina - Torneo Federal,0.62,0.75,4,1.25,1.61,1.33,5
9 Julio Rafaela,8,4,3,1,13,6,7,15,Argentina - Torneo Federal,0.5,0.88,7,1.62,2.0,1.14,6
Germinal,8,3,4,1,8,4,4,13,Argentina - Torneo Federal,0.38,0.88,4,1.0,2.63,1.14,7
Kimberley,8,3,4,1,7,4,3,13,Argentina - Torneo Federal,0.38,0.88,3,0.88,2.63,1.14,7
Atenas,8,4,1,3,11,9,2,13,Argentina - Torneo Federal,0.5,0.62,2,1.38,2.0,1.61,7
Argentino MM,8,4,1,3,6,4,2,13,Argentina - Torneo Federal,0.5,0.62,2,0.75,2.0,1.61,7
D. Belgrano VR,8,2,6,0,10,5,5,12,Argentina - Torneo Federal,0.25,1.0,5,1.25,4.0,1.0,8
Ciudad Bolivar,8,4,0,4,9,6,3,12,Argentina - Torneo Federal,0.5,0.5,3,1.12,2.0,2.0,8
SM Formosa,8,3,3,2,8,7,1,12,Argentina - Torneo Federal,0.38,0.75,1,1.0,2.63,1.33,8
Juventud U. U.,8,4,0,4,6,8,-2,12,Argentina - Torneo Federal,0.5,0.5,-2,0.75,2.0,2.0,8
Douglas Haig,8,3,2,3,7,8,-1,11,Argentina - Torneo Federal,0.38,0.62,-1,0.88,2.63,1.61,9
J. Antoniana,8,3,1,4,9,10,-1,10,Argentina - Torneo Federal,0.38,0.5,-1,1.12,2.63,2.0,10
El Linqueno,8,3,1,4,6,8,-2,10,Argentina - Torneo Federal,0.38,0.5,-2,0.75,2.63,2.0,10
SM Mendoza,8,3,1,4,5,7,-2,10,Argentina - Torneo Federal,0.38,0.5,-2,0.62,2.63,2.0,10
Union Sunchales,8,2,4,2,6,9,-3,10,Argentina - Torneo Federal,0.25,0.75,-3,0.75,4.0,1.33,10
Sol de Mayo,8,3,1,4,8,14,-6,10,Argentina - Torneo Federal,0.38,0.5,-6,1.0,2.63,2.0,10
S. Las Parejas,8,2,3,3,5,6,-1,9,Argentina - Torneo Federal,0.25,0.62,-1,0.62,4.0,1.61,11
Gimnasia E.,8,2,3,3,5,7,-2,9,Argentina - Torneo Federal,0.25,0.62,-2,0.62,4.0,1.61,11
Huracan Las H.,8,2,2,4,6,8,-2,8,Argentina - Torneo Federal,0.25,0.5,-2,0.75,4.0,2.0,12
D. Rincon,8,2,2,4,6,9,-3,8,Argentina - Torneo Federal,0.25,0.5,-3,0.75,4.0,2.0,12
I. Chivilcoy,8,1,4,3,3,5,-2,7,Argentina - Torneo Federal,0.12,0.62,-2,0.38,8.33,1.61,13
Noah,8,8,0,0,35,3,32,24,Armenia - Premier League,1.0,1.0,32,4.38,1.0,1.0,1
Pyunik,8,5,0,3,15,6,9,15,Armenia - Premier League,0.62,0.62,9,1.88,1.61,1.61,2
Urartu,8,5,0,3,15,10,5,15,Armenia - Premier League,0.62,0.62,5,1.88,1.61,1.61,2
Ararat-Armenia,8,4,2,2,16,9,7,14,Armenia - Premier League,0.5,0.75,7,2.0,2.0,1.33,3
Van,8,4,1,3,13,11,2,13,Armenia - Premier League,0.5,0.62,2,1.62,2.0,1.61,4
Shirak,8,3,3,2,6,7,-1,12,Armenia - Premier League,0.38,0.75,-1,0.75,2.63,1.33,5
BKMA,8,2,2,4,10,15,-5,8,Armenia - Premier League,0.25,0.5,-5,1.25,4.0,2.0,6
West Armenia,8,2,1,5,5,21,-16,7,Armenia - Premier League,0.25,0.38,-16,0.62,4.0,2.63,7
Ararat Yerevan,8,1,2,5,4,15,-11,5,Armenia - Premier League,0.12,0.38,-11,0.5,8.33,2.63,8
Alashkert,8,0,2,6,4,16,-12,2,Armenia - Premier League,0.0,0.25,-12,0.5,0.0,4.0,9
Gandzasar,8,0,1,7,1,23,-22,1,Armenia - Premier League,0.0,0.12,-22,0.12,0.0,8.33,10
Auckland,8,5,2,1,20,9,11,17,Australia - A-League,0.62,0.88,11,2.5,1.61,1.14,1
Western United,8,5,2,1,21,12,9,17,Australia - A-League,0.62,0.88,9,2.62,1.61,1.14,1
WS Wanderers,8,5,1,2,17,10,7,16,Australia - A-League,0.62,0.75,7,2.12,1.61,1.33,2
Melbourne V.,8,4,2,2,13,9,4,14,Australia - A-League,0.5,0.75,4,1.62,2.0,1.33,3
Newcastle Jets,8,4,2,2,15,12,3,14,Australia - A-League,0.5,0.75,3,1.88,2.0,1.33,3
Melbourne City,8,4,1,3,7,7,0,13,Australia - A-League,0.5,0.62,0,0.88,2.0,1.61,4
Sydney FC,8,3,3,2,16,11,5,12,Australia - A-League,0.38,0.75,5,2.0,2.63,1.33,5
Adelaide Utd,8,2,3,3,13,18,-5,9,Australia - A-League,0.25,0.62,-5,1.62,4.0,1.61,6
Macarthur FC,8,2,1,5,9,13,-4,7,Australia - A-League,0.25,0.38,-4,1.12,4.0,2.63,7
Central Coast,8,1,4,3,9,16,-7,7,Australia - A-League,0.12,0.62,-7,1.12,8.33,1.61,7
Brisbane Roar,8,1,3,4,8,12,-4,6,Australia - A-League,0.12,0.5,-4,1.0,8.33,2.0,8
Perth Glory,8,1,3,4,6,12,-6,6,Australia - A-League,0.12,0.5,-6,0.75,8.33,2.0,8
Wellington,8,1,3,4,5,14,-9,6,Australia - A-League,0.12,0.5,-9,0.62,8.33,2.0,8
Avondale,5,5,0,0,17,5,12,15,Australia - NPL Victoria,1.0,1.0,12,3.4,1.0,1.0,1
Preston Lions,5,3,2,0,8,4,4,11,Australia - NPL Victoria,0.6,1.0,4,1.6,1.67,1.0,2
Hume City,5,3,1,1,9,5,4,10,Australia - NPL Victoria,0.6,0.8,4,1.8,1.67,1.25,3
Dandenong T.,5,3,1,1,9,7,2,10,Australia - NPL Victoria,0.6,0.8,2,1.8,1.67,1.25,3
Oakleigh C.,4,2,1,1,7,3,4,7,Australia - NPL Victoria,0.5,0.75,4,1.75,2.0,1.33,4
Heidelberg Utd,5,2,1,2,8,8,0,7,Australia - NPL Victoria,0.4,0.6,0,1.6,2.5,1.67,4
South Melbourne,5,2,1,2,7,9,-2,7,Australia - NPL Victoria,0.4,0.6,-2,1.4,2.5,1.67,4
Dandenong City,5,1,3,1,13,10,3,6,Australia - NPL Victoria,0.2,0.8,3,2.6,5.0,1.25,5
St. Albans,5,1,1,3,9,11,-2,4,Australia - NPL Victoria,0.2,0.4,-2,1.8,5.0,2.5,6
Altona Magic,5,1,1,3,3,6,-3,4,Australia - NPL Victoria,0.2,0.4,-3,0.6,5.0,2.5,6
Port Melbourne,4,1,0,3,2,7,-5,3,Australia - NPL Victoria,0.25,0.25,-5,0.5,4.0,4.0,7
Melbourne K.,4,1,0,3,5,11,-6,3,Australia - NPL Victoria,0.25,0.25,-6,1.25,4.0,4.0,7
M. Victory B,4,0,2,2,5,9,-4,2,Australia - NPL Victoria,0.0,0.5,-4,1.25,0.0,2.0,8
Green Gully,5,0,2,3,3,10,-7,2,Australia - NPL Victoria,0.0,0.4,-7,0.6,0.0,2.5,8
Peninsula,2,2,0,0,7,1,6,6,Australia - NPL Queensland,1.0,1.0,6,3.5,1.0,1.0,1
Gold C. Knights,2,2,0,0,5,1,4,6,Australia - NPL Queensland,1.0,1.0,4,2.5,1.0,1.0,1
Gold C. Utd,2,2,0,0,5,1,4,6,Australia - NPL Queensland,1.0,1.0,4,2.5,1.0,1.0,1
Moreton City E.,2,2,0,0,5,2,3,6,Australia - NPL Queensland,1.0,1.0,3,2.5,1.0,1.0,1
Eastern Suburbs,2,1,1,0,5,3,2,4,Australia - NPL Queensland,0.5,1.0,2,2.5,2.0,1.0,2
Q. Lions,2,1,0,1,4,3,1,3,Australia - NPL Queensland,0.5,0.5,1,2.0,2.0,2.0,3
Olympic FC,2,1,0,1,3,2,1,3,Australia - NPL Queensland,0.5,0.5,1,1.5,2.0,2.0,3
St George W.,2,0,1,1,1,3,-2,1,Australia - NPL Queensland,0.0,0.5,-2,0.5,0.0,2.0,4
Brisbane City,2,0,0,2,3,7,-4,0,Australia - NPL Queensland,0.0,0.0,-4,1.5,0.0,0.0,5
SC Wanderers,2,0,0,2,1,5,-4,0,Australia - NPL Queensland,0.0,0.0,-4,0.5,0.0,0.0,5
Wynnum Wolves,2,0,0,2,1,5,-4,0,Australia - NPL Queensland,0.0,0.0,-4,0.5,0.0,0.0,5
Brisbane Roar B,2,0,0,2,0,7,-7,0,Australia - NPL Queensland,0.0,0.0,-7,0.0,0.0,0.0,5
Wolfsberger AC,8,6,1,1,20,9,11,19,Austria - Bundesliga,0.75,0.88,11,2.5,1.33,1.14,1
Austria Wien,8,6,1,1,14,6,8,19,Austria - Bundesliga,0.75,0.88,8,1.75,1.33,1.14,1
Salzburg,8,4,4,0,15,5,10,16,Austria - Bundesliga,0.5,1.0,10,1.88,2.0,1.0,2
Sturm Graz,8,4,2,2,18,11,7,14,Austria - Bundesliga,0.5,0.75,7,2.25,2.0,1.33,3
LASK Linz,8,4,2,2,10,9,1,14,Austria - Bundesliga,0.5,0.75,1,1.25,2.0,1.33,3
BW Linz,8,4,1,3,10,9,1,13,Austria - Bundesliga,0.5,0.62,1,1.25,2.0,1.61,4
Grazer AK,8,3,1,4,12,16,-4,10,Austria - Bundesliga,0.38,0.5,-4,1.5,2.63,2.0,5
Rapid Wien,8,2,2,4,12,10,2,8,Austria - Bundesliga,0.25,0.5,2,1.5,4.0,2.0,6
Tirol,8,1,4,3,9,11,-2,7,Austria - Bundesliga,0.12,0.62,-2,1.12,8.33,1.61,7
Hartberg,8,1,4,3,5,10,-5,7,Austria - Bundesliga,0.12,0.62,-5,0.62,8.33,1.61,7
Altach,8,1,2,5,6,16,-10,5,Austria - Bundesliga,0.12,0.38,-10,0.75,8.33,2.63,8
A. Klagenfurt,8,1,2,5,7,20,-13,5,Austria - Bundesliga,0.12,0.38,-13,0.88,8.33,2.63,8
Ried,8,7,0,1,15,2,13,21,Austria - 2. Liga,0.88,0.88,13,1.88,1.14,1.14,1
Admira Wacker,8,6,2,0,18,8,10,20,Austria - 2. Liga,0.75,1.0,10,2.25,1.33,1.0,2
St. Polten,8,6,1,1,15,5,10,19,Austria - 2. Liga,0.75,0.88,10,1.88,1.33,1.14,3
First Vienna,8,6,0,2,16,8,8,18,Austria - 2. Liga,0.75,0.75,8,2.0,1.33,1.33,4
Voitsberg,8,5,0,3,15,6,9,15,Austria - 2. Liga,0.62,0.62,9,1.88,1.61,1.61,5
Sturm Graz B,8,4,2,2,12,8,4,14,Austria - 2. Liga,0.5,0.75,4,1.5,2.0,1.33,6
Rapid Wien B,8,3,2,3,12,10,2,11,Austria - 2. Liga,0.38,0.62,2,1.5,2.63,1.61,7
Amstetten,8,3,1,4,11,11,0,10,Austria - 2. Liga,0.38,0.5,0,1.38,2.63,2.0,8
Bregenz,8,3,1,4,13,15,-2,10,Austria - 2. Liga,0.38,0.5,-2,1.62,2.63,2.0,8
Liefering,8,3,1,4,9,14,-5,10,Austria - 2. Liga,0.38,0.5,-5,1.12,2.63,2.0,8
Stripfing,8,1,4,3,9,11,-2,7,Austria - 2. Liga,0.12,0.62,-2,1.12,8.33,1.61,9
Kapfenberger,8,1,3,4,10,16,-6,6,Austria - 2. Liga,0.12,0.5,-6,1.25,8.33,2.0,10
Floridsdorfer,8,1,3,4,5,11,-6,6,Austria - 2. Liga,0.12,0.5,-6,0.62,8.33,2.0,10
Lafnitz,8,1,3,4,10,21,-11,6,Austria - 2. Liga,0.12,0.5,-11,1.25,8.33,2.0,10
A. Lustenau,8,1,2,5,4,11,-7,5,Austria - 2. Liga,0.12,0.38,-7,0.5,8.33,2.63,11
SV Horn,8,1,1,6,4,17,-13,4,Austria - 2. Liga,0.12,0.25,-13,0.5,8.33,4.0,12
Zira,8,7,0,1,15,5,10,21,Azerbaijan - Premier League,0.88,0.88,10,1.88,1.14,1.14,1
Qarabag,8,5,1,2,18,9,9,16,Azerbaijan - Premier League,0.62,0.75,9,2.25,1.61,1.33,2
Kapaz,8,3,3,2,10,8,2,12,Azerbaijan - Premier League,0.38,0.75,2,1.25,2.63,1.33,3
Neftci,8,3,2,3,7,7,0,11,Azerbaijan - Premier League,0.38,0.62,0,0.88,2.63,1.61,4
Turan,8,3,2,3,9,12,-3,11,Azerbaijan - Premier League,0.38,0.62,-3,1.12,2.63,1.61,4
Shamakhi,8,3,1,4,10,9,1,10,Azerbaijan - Premier League,0.38,0.5,1,1.25,2.63,2.0,5
Sebail,8,2,3,3,4,9,-5,9,Azerbaijan - Premier League,0.25,0.62,-5,0.5,4.0,1.61,6
Sabah,8,1,5,2,9,11,-2,8,Azerbaijan - Premier League,0.12,0.75,-2,1.12,8.33,1.33,7
Araz,8,1,4,3,5,8,-3,7,Azerbaijan - Premier League,0.12,0.62,-3,0.62,8.33,1.61,8
Sumqayit,8,0,3,5,0,9,-9,3,Azerbaijan - Premier League,0.0,0.38,-9,0.0,0.0,2.63,9
Al-Muharraq,8,7,0,1,20,6,14,21,Bahrain - Premier League,0.88,0.88,14,2.5,1.14,1.14,1
Khalidiya,8,6,0,2,17,9,8,18,Bahrain - Premier League,0.75,0.75,8,2.12,1.33,1.33,2
Al Riffa,8,5,1,2,12,6,6,16,Bahrain - Premier League,0.62,0.75,6,1.5,1.61,1.33,3
Al-Najma,8,4,1,3,15,11,4,13,Bahrain - Premier League,0.5,0.62,4,1.88,2.0,1.61,4
Malkiya,8,3,4,1,7,7,0,13,Bahrain - Premier League,0.38,0.88,0,0.88,2.63,1.14,4
Al Shabbab,8,3,2,3,11,10,1,11,Bahrain - Premier League,0.38,0.62,1,1.38,2.63,1.61,5
Al Ahli M.,8,3,1,4,15,14,1,10,Bahrain - Premier League,0.38,0.5,1,1.88,2.63,2.0,6
Bahrain SC,8,2,3,3,8,11,-3,9,Bahrain - Premier League,0.25,0.62,-3,1.0,4.0,1.61,7
Manama,8,2,2,4,6,12,-6,8,Bahrain - Premier League,0.25,0.5,-6,0.75,4.0,2.0,8
Sitra,8,1,4,3,6,9,-3,7,Bahrain - Premier League,0.12,0.62,-3,0.75,8.33,1.61,9
East Riffa,8,0,4,4,4,11,-7,4,Bahrain - Premier League,0.0,0.5,-7,0.5,0.0,2.0,10
AAli FC,8,0,2,6,4,19,-15,2,Bahrain - Premier League,0.0,0.25,-15,0.5,0.0,4.0,11
Mohammedan,8,7,0,1,17,4,13,21,Bangladesh - Premier League,0.88,0.88,13,2.12,1.14,1.14,1
Bashundhara K.,8,5,2,1,22,5,17,17,Bangladesh - Premier League,0.62,0.88,17,2.75,1.61,1.14,2
Abahani,8,5,2,1,14,2,12,17,Bangladesh - Premier League,0.62,0.88,12,1.75,1.61,1.14,2
Fortis,8,3,4,1,10,5,5,13,Bangladesh - Premier League,0.38,0.88,5,1.25,2.63,1.14,3
Brothers Union,8,3,2,3,11,7,4,11,Bangladesh - Premier League,0.38,0.62,4,1.38,2.63,1.61,4
B. Police,8,3,1,4,9,13,-4,10,Bangladesh - Premier League,0.38,0.5,-4,1.12,2.63,2.0,5
Rahmatgonj,8,3,0,5,19,16,3,9,Bangladesh - Premier League,0.38,0.38,3,2.38,2.63,2.63,6
Fakirerpool,8,3,0,5,10,23,-13,9,Bangladesh - Premier League,0.38,0.38,-13,1.25,2.63,2.63,6
Dhaka Wanderers,8,1,1,6,5,27,-22,4,Bangladesh - Premier League,0.12,0.25,-22,0.62,8.33,4.0,7
Chittagong,8,1,0,7,2,17,-15,3,Bangladesh - Premier League,0.12,0.12,-15,0.25,8.33,8.33,8
Arsenal D.,0,0,0,0,0,0,0,0,Belarus - Vysshaya Liga,0.0,0.0,0,0.0,0.0,0.0,1
BATE Borisov,0,0,0,0,0,0,0,0,Belarus - Vysshaya Liga,0.0,0.0,0,0.0,0.0,0.0,1
Dinamo Brest,0,0,0,0,0,0,0,0,Belarus - Vysshaya Liga,0.0,0.0,0,0.0,0.0,0.0,1
Dinamo Minsk,0,0,0,0,0,0,0,0,Belarus - Vysshaya Liga,0.0,0.0,0,0.0,0.0,0.0,1
FC Minsk,0,0,0,0,0,0,0,0,Belarus - Vysshaya Liga,0.0,0.0,0,0.0,0.0,0.0,1
Gomel,0,0,0,0,0,0,0,0,Belarus - Vysshaya Liga,0.0,0.0,0,0.0,0.0,0.0,1
Isloch,0,0,0,0,0,0,0,0,Belarus - Vysshaya Liga,0.0,0.0,0,0.0,0.0,0.0,1
Maxline,0,0,0,0,0,0,0,0,Belarus - Vysshaya Liga,0.0,0.0,0,0.0,0.0,0.0,1
Molodechno,0,0,0,0,0,0,0,0,Belarus - Vysshaya Liga,0.0,0.0,0,0.0,0.0,0.0,1
Naftan,0,0,0,0,0,0,0,0,Belarus - Vysshaya Liga,0.0,0.0,0,0.0,0.0,0.0,1
Neman Grodno,0,0,0,0,0,0,0,0,Belarus - Vysshaya Liga,0.0,0.0,0,0.0,0.0,0.0,1
Slavia Mozyr,0,0,0,0,0,0,0,0,Belarus - Vysshaya Liga,0.0,0.0,0,0.0,0.0,0.0,1
Slutsk,0,0,0,0,0,0,0,0,Belarus - Vysshaya Liga,0.0,0.0,0,0.0,0.0,0.0,1
Smorgon,0,0,0,0,0,0,0,0,Belarus - Vysshaya Liga,0.0,0.0,0,0.0,0.0,0.0,1
T. Zhodino,0,0,0,0,0,0,0,0,Belarus - Vysshaya Liga,0.0,0.0,0,0.0,0.0,0.0,1
Vitebsk,0,0,0,0,0,0,0,0,Belarus - Vysshaya Liga,0.0,0.0,0,0.0,0.0,0.0,1
Maxline,8,7,0,1,22,6,16,21,Belarus - First League,0.88,0.88,16,2.75,1.14,1.14,1
Belshina,8,5,2,1,16,9,7,17,Belarus - First League,0.62,0.88,7,2.0,1.61,1.14,2
Baranovichi,8,5,1,2,14,11,3,16,Belarus - First League,0.62,0.75,3,1.75,1.61,1.33,3
Niva,8,5,0,3,12,8,4,15,Belarus - First League,0.62,0.62,4,1.5,1.61,1.61,4
Lokomotiv Gomel,8,4,2,2,14,7,7,14,Belarus - First League,0.5,0.75,7,1.75,2.0,1.33,5
Lida,8,3,4,1,15,7,8,13,Belarus - First League,0.38,0.88,8,1.88,2.63,1.14,6
Molodechno,8,4,1,3,12,9,3,13,Belarus - First League,0.5,0.62,3,1.5,2.0,1.61,6
Volna Pinsk,8,4,0,4,15,12,3,12,Belarus - First League,0.5,0.5,3,1.88,2.0,2.0,7
Bumprom,8,3,2,3,13,10,3,11,Belarus - First League,0.38,0.62,3,1.62,2.63,1.61,8
ABFF U17,8,3,2,3,5,9,-4,11,Belarus - First League,0.38,0.62,-4,0.62,2.63,1.61,8
BATE B,8,3,1,4,11,21,-10,10,Belarus - First League,0.38,0.5,-10,1.38,2.63,2.0,9
Dinamo Minsk B,8,2,3,3,11,9,2,9,Belarus - First League,0.25,0.62,2,1.38,4.0,1.61,10
Orsha,8,2,3,3,13,16,-3,9,Belarus - First League,0.25,0.62,-3,1.62,4.0,1.61,10
S. Soligorsk B,8,3,0,5,4,13,-9,9,Belarus - First League,0.38,0.38,-9,0.5,2.63,2.63,10
Slonim,8,2,2,4,4,13,-9,8,Belarus - First League,0.25,0.5,-9,0.5,4.0,2.0,11
Ostrovets,8,2,1,5,10,14,-4,7,Belarus - First League,0.25,0.38,-4,1.25,4.0,2.63,12
Energetik-BGU,8,1,2,5,8,8,0,5,Belarus - First League,0.12,0.38,0,1.0,8.33,2.63,13
T. Zhodhino B,8,1,0,7,8,25,-17,3,Belarus - First League,0.12,0.12,-17,1.0,8.33,8.33,14
Royale Union SG,8,7,0,1,17,5,12,21,Belgium - Pro League,0.88,0.88,12,2.12,1.14,1.14,1
KRC Genk,8,6,2,0,11,5,6,20,Belgium - Pro League,0.75,1.0,6,1.38,1.33,1.0,2
Anderlecht,8,5,0,3,11,7,4,15,Belgium - Pro League,0.62,0.62,4,1.38,1.61,1.61,3
Antwerp,8,3,4,1,11,10,1,13,Belgium - Pro League,0.38,0.88,1,1.38,2.63,1.14,4
Standard Liege,8,4,1,3,10,11,-1,13,Belgium - Pro League,0.5,0.62,-1,1.25,2.0,1.61,4
Club Brugge,8,3,3,2,14,10,4,12,Belgium - Pro League,0.38,0.75,4,1.75,2.63,1.33,5
Gent,8,2,6,0,9,7,2,12,Belgium - Pro League,0.25,1.0,2,1.12,4.0,1.0,5
Cercle Brugge,8,2,5,1,7,6,1,11,Belgium - Pro League,0.25,0.88,1,0.88,4.0,1.14,6
Charleroi,8,2,4,2,12,7,5,10,Belgium - Pro League,0.25,0.75,5,1.5,4.0,1.33,7
Sint-Truiden,8,2,3,3,13,12,1,9,Belgium - Pro League,0.25,0.62,1,1.62,4.0,1.61,8
OH Leuven,8,2,3,3,6,8,-2,9,Belgium - Pro League,0.25,0.62,-2,0.75,4.0,1.61,8
Westerlo,8,2,2,4,12,14,-2,8,Belgium - Pro League,0.25,0.5,-2,1.5,4.0,2.0,9
KV Mechelen,8,2,2,4,8,12,-4,8,Belgium - Pro League,0.25,0.5,-4,1.0,4.0,2.0,9
Kortrijk,8,1,2,5,9,14,-5,5,Belgium - Pro League,0.12,0.38,-5,1.12,8.33,2.63,10
Beerschot,8,1,2,5,6,15,-9,5,Belgium - Pro League,0.12,0.38,-9,0.75,8.33,2.63,10
Dender,8,1,1,6,5,16,-11,4,Belgium - Pro League,0.12,0.25,-11,0.62,8.33,4.0,11
RWDM,8,6,2,0,7,1,6,20,Belgium - Challenger Pro League,0.75,1.0,6,0.88,1.33,1.0,1
Beveren,8,5,3,0,14,7,7,18,Belgium - Challenger Pro League,0.62,1.0,7,1.75,1.61,1.0,2
Club Brugge B,8,5,0,3,14,10,4,15,Belgium - Challenger Pro League,0.62,0.62,4,1.75,1.61,1.61,3
Patro Eisden,8,4,2,2,15,10,5,14,Belgium - Challenger Pro League,0.5,0.75,5,1.88,2.0,1.33,4
La Louviere,8,3,4,1,15,6,9,13,Belgium - Challenger Pro League,0.38,0.88,9,1.88,2.63,1.14,5
RFC Liege,8,4,1,3,13,11,2,13,Belgium - Challenger Pro League,0.5,0.62,2,1.62,2.0,1.61,5
Lierse K.,8,3,3,2,10,6,4,12,Belgium - Challenger Pro League,0.38,0.75,4,1.25,2.63,1.33,6
Zulte-Waregem,8,3,3,2,12,10,2,12,Belgium - Challenger Pro League,0.38,0.75,2,1.5,2.63,1.33,6
Lokeren-Temse,8,3,2,3,8,14,-6,11,Belgium - Challenger Pro League,0.38,0.62,-6,1.0,2.63,1.61,7
Francs Borains,8,3,1,4,8,11,-3,10,Belgium - Challenger Pro League,0.38,0.5,-3,1.0,2.63,2.0,8
Eupen,8,2,3,3,11,13,-2,9,Belgium - Challenger Pro League,0.25,0.62,-2,1.38,4.0,1.61,9
Anderlecht B,8,2,2,4,17,15,2,8,Belgium - Challenger Pro League,0.25,0.5,2,2.12,4.0,2.0,10
Lommel SK,8,1,1,6,7,18,-11,4,Belgium - Challenger Pro League,0.12,0.25,-11,0.88,8.33,4.0,11
KRC Genk B,8,0,3,5,8,16,-8,3,Belgium - Challenger Pro League,0.0,0.38,-8,1.0,0.0,2.63,12
Seraing,8,0,3,5,9,18,-9,3,Belgium - Challenger Pro League,0.0,0.38,-9,1.12,0.0,2.63,12
Deinze,0,0,0,0,0,0,0,0,Belgium - Challenger Pro League,0.0,0.0,0,0.0,0.0,0.0,13
Bolivar,8,5,1,2,19,13,6,16,Bolivia - Primera Div. - Apertura,0.62,0.75,6,2.38,1.61,1.33,1
The Strongest,8,5,1,2,17,15,2,16,Bolivia - Primera Div. - Apertura,0.62,0.75,2,2.12,1.61,1.33,1
SA Bulo Bulo,8,4,2,2,15,7,8,14,Bolivia - Primera Div. - Apertura,0.5,0.75,8,1.88,2.0,1.33,2
Aurora,8,4,2,2,14,7,7,14,Bolivia - Primera Div. - Apertura,0.5,0.75,7,1.75,2.0,1.33,2
Nacional Potosi,8,4,2,2,13,11,2,14,Bolivia - Primera Div. - Apertura,0.5,0.75,2,1.62,2.0,1.33,2
U. de Vinto,8,4,2,2,8,7,1,14,Bolivia - Primera Div. - Apertura,0.5,0.75,1,1.0,2.0,1.33,2
Blooming,8,4,2,2,12,12,0,14,Bolivia - Primera Div. - Apertura,0.5,0.75,0,1.5,2.0,1.33,2
I. Petrolero,8,3,2,3,10,11,-1,11,Bolivia - Primera Div. - Apertura,0.38,0.62,-1,1.25,2.63,1.61,3
Gualberto V. SJ,8,3,2,3,12,14,-2,11,Bolivia - Primera Div. - Apertura,0.38,0.62,-2,1.5,2.63,1.61,3
Real Tomayapo,8,3,2,3,10,12,-2,11,Bolivia - Primera Div. - Apertura,0.38,0.62,-2,1.25,2.63,1.61,3
Guabira,8,3,1,4,12,11,1,10,Bolivia - Primera Div. - Apertura,0.38,0.5,1,1.5,2.63,2.0,4
Oriente P.,8,3,1,4,9,13,-4,10,Bolivia - Primera Div. - Apertura,0.38,0.5,-4,1.12,2.63,2.0,4
Royal Pari,8,2,2,4,7,10,-3,8,Bolivia - Primera Div. - Apertura,0.25,0.5,-3,0.88,4.0,2.0,5
Always Ready,8,1,3,4,6,10,-4,6,Bolivia - Primera Div. - Apertura,0.12,0.5,-4,0.75,8.33,2.0,6
Wilstermann,8,1,2,5,12,14,-2,5,Bolivia - Primera Div. - Apertura,0.12,0.38,-2,1.5,8.33,2.63,7
Santa Cruz,8,1,1,6,8,17,-9,4,Bolivia - Primera Div. - Apertura,0.12,0.25,-9,1.0,8.33,4.0,8
Bolivar,8,6,1,1,28,11,17,19,Bolivia - Primera Div. - Clausura,0.75,0.88,17,3.5,1.33,1.14,1
The Strongest,8,6,0,2,26,11,15,18,Bolivia - Primera Div. - Clausura,0.75,0.75,15,3.25,1.33,1.33,2
Always Ready,8,4,1,3,20,13,7,13,Bolivia - Primera Div. - Clausura,0.5,0.62,7,2.5,2.0,1.61,3
Gualberto V. SJ,8,4,1,3,18,12,6,13,Bolivia - Primera Div. - Clausura,0.5,0.62,6,2.25,2.0,1.61,3
Nacional Potosi,8,4,1,3,16,12,4,13,Bolivia - Primera Div. - Clausura,0.5,0.62,4,2.0,2.0,1.61,3
Royal Pari,8,4,1,3,11,10,1,13,Bolivia - Primera Div. - Clausura,0.5,0.62,1,1.38,2.0,1.61,3
Aurora,8,3,3,2,19,14,5,12,Bolivia - Primera Div. - Clausura,0.38,0.75,5,2.38,2.63,1.33,4
Real Tomayapo,8,4,0,4,14,12,2,12,Bolivia - Primera Div. - Clausura,0.5,0.5,2,1.75,2.0,2.0,4
Blooming,8,3,3,2,10,13,-3,12,Bolivia - Primera Div. - Clausura,0.38,0.75,-3,1.25,2.63,1.33,4
Guabira,8,3,2,3,10,10,0,11,Bolivia - Primera Div. - Clausura,0.38,0.62,0,1.25,2.63,1.61,5
Wilstermann,8,2,4,2,11,13,-2,10,Bolivia - Primera Div. - Clausura,0.25,0.75,-2,1.38,4.0,1.33,6
I. Petrolero,8,3,0,5,13,20,-7,9,Bolivia - Primera Div. - Clausura,0.38,0.38,-7,1.62,2.63,2.63,7
SA Bulo Bulo,8,2,2,4,14,22,-8,8,Bolivia - Primera Div. - Clausura,0.25,0.5,-8,1.75,4.0,2.0,8
Oriente P.,8,2,1,5,14,23,-9,7,Bolivia - Primera Div. - Clausura,0.25,0.38,-9,1.75,4.0,2.63,9
U. de Vinto,8,2,1,5,8,17,-9,7,Bolivia - Primera Div. - Clausura,0.25,0.38,-9,1.0,4.0,2.63,9
Santa Cruz,8,1,0,7,7,27,-20,3,Bolivia - Primera Div. - Clausura,0.12,0.12,-20,0.88,8.33,8.33,10
Corinthians,8,8,0,0,20,5,15,24,Brazil - Serie A,1.0,1.0,15,2.5,1.0,1.0,1
Botafogo,8,5,3,0,11,3,8,18,Brazil - Serie A,0.62,1.0,8,1.38,1.61,1.0,2
Flamengo,8,4,4,0,12,6,6,16,Brazil - Serie A,0.5,1.0,6,1.5,2.0,1.0,3
Vitoria,8,4,3,1,12,8,4,15,Brazil - Serie A,0.5,0.88,4,1.5,2.0,1.14,4
Internacional,8,4,1,3,12,9,3,13,Brazil - Serie A,0.5,0.62,3,1.5,2.0,1.61,5
Palmeiras,8,4,1,3,9,10,-1,13,Brazil - Serie A,0.5,0.62,-1,1.12,2.0,1.61,5
Fortaleza,8,3,3,2,14,9,5,12,Brazil - Serie A,0.38,0.75,5,1.75,2.63,1.33,6
Juventude,8,3,2,3,12,15,-3,11,Brazil - Serie A,0.38,0.62,-3,1.5,2.63,1.61,7
Bragantino,8,2,4,2,10,9,1,10,Brazil - Serie A,0.25,0.75,1,1.25,4.0,1.33,8
Gremio,8,2,4,2,11,12,-1,10,Brazil - Serie A,0.25,0.75,-1,1.38,4.0,1.33,8
Fluminense,8,2,4,2,8,9,-1,10,Brazil - Serie A,0.25,0.75,-1,1.0,4.0,1.33,8
Vasco da Gama,8,3,1,4,10,15,-5,10,Brazil - Serie A,0.38,0.5,-5,1.25,2.63,2.0,8
Sao Paulo,8,2,3,3,12,11,1,9,Brazil - Serie A,0.25,0.62,1,1.5,4.0,1.61,9
Athletico PR,8,2,2,4,8,9,-1,8,Brazil - Serie A,0.25,0.5,-1,1.0,4.0,2.0,10
Atletico GO,8,2,2,4,7,11,-4,8,Brazil - Serie A,0.25,0.5,-4,0.88,4.0,2.0,10
Cruzeiro,8,2,2,4,7,11,-4,8,Brazil - Serie A,0.25,0.5,-4,0.88,4.0,2.0,10
Bahia,8,2,1,5,9,15,-6,7,Brazil - Serie A,0.25,0.38,-6,1.12,4.0,2.63,11
Atletico MG,8,1,3,4,5,9,-4,6,Brazil - Serie A,0.12,0.5,-4,0.62,8.33,2.0,12
Cuiaba,8,0,3,5,4,9,-5,3,Brazil - Serie A,0.0,0.38,-5,0.5,0.0,2.63,13
Criciuma,8,0,2,6,5,18,-13,2,Brazil - Serie A,0.0,0.25,-13,0.62,0.0,4.0,14
Goias,8,7,1,0,17,2,15,22,Brazil - Serie B,0.88,1.0,15,2.12,1.14,1.0,1
Ceara,8,6,1,1,12,4,8,19,Brazil - Serie B,0.75,0.88,8,1.5,1.33,1.14,2
Mirassol,8,5,2,1,13,5,8,17,Brazil - Serie B,0.62,0.88,8,1.62,1.61,1.14,3
Paysandu,8,5,2,1,12,7,5,17,Brazil - Serie B,0.62,0.88,5,1.5,1.61,1.14,3
Santos,8,5,0,3,14,9,5,15,Brazil - Serie B,0.62,0.62,5,1.75,1.61,1.61,4
Operario PR,8,4,3,1,9,8,1,15,Brazil - Serie B,0.5,0.88,1,1.12,2.0,1.14,4
Sport Recife,8,4,1,3,17,9,8,13,Brazil - Serie B,0.5,0.62,8,2.12,2.0,1.61,5
America MG,8,3,2,3,12,10,2,11,Brazil - Serie B,0.38,0.62,2,1.5,2.63,1.61,6
Avai,8,3,2,3,11,10,1,11,Brazil - Serie B,0.38,0.62,1,1.38,2.63,1.61,6
Novorizontino,8,3,1,4,8,7,1,10,Brazil - Serie B,0.38,0.5,1,1.0,2.63,2.0,7
CRB,8,3,1,4,9,9,0,10,Brazil - Serie B,0.38,0.5,0,1.12,2.63,2.0,7
Botafogo SP,8,3,1,4,8,12,-4,10,Brazil - Serie B,0.38,0.5,-4,1.0,2.63,2.0,7
Amazonas,8,3,1,4,4,8,-4,10,Brazil - Serie B,0.38,0.5,-4,0.5,2.63,2.0,7
Chapecoense,8,3,1,4,7,13,-6,10,Brazil - Serie B,0.38,0.5,-6,0.88,2.63,2.0,7
Coritiba,8,3,0,5,12,15,-3,9,Brazil - Serie B,0.38,0.38,-3,1.5,2.63,2.63,8
Vila Nova,8,3,0,5,8,16,-8,9,Brazil - Serie B,0.38,0.38,-8,1.0,2.63,2.63,8
Guarani,8,2,2,4,4,10,-6,8,Brazil - Serie B,0.25,0.5,-6,0.5,4.0,2.0,9
Ituano,8,2,0,6,9,14,-5,6,Brazil - Serie B,0.25,0.25,-5,1.12,4.0,4.0,10
Brusque,8,2,0,6,4,11,-7,6,Brazil - Serie B,0.25,0.25,-7,0.5,4.0,4.0,10
Ponte Preta,8,1,0,7,5,15,-10,3,Brazil - Serie B,0.12,0.12,-10,0.62,8.33,8.33,11
Botafogo PB,8,5,2,1,15,11,4,17,Brazil - Serie C,0.62,0.88,4,1.88,1.61,1.14,1
Athletic Club,8,4,4,0,15,7,8,16,Brazil - Serie C,0.5,1.0,8,1.88,2.0,1.0,2
Ferroviaria,8,4,3,1,11,5,6,15,Brazil - Serie C,0.5,0.88,6,1.38,2.0,1.14,3
CSA,8,4,2,2,11,8,3,14,Brazil - Serie C,0.5,0.75,3,1.38,2.0,1.33,4
Sao Bernardo,8,4,2,2,9,7,2,14,Brazil - Serie C,0.5,0.75,2,1.12,2.0,1.33,4
Remo,8,4,1,3,11,7,4,13,Brazil - Serie C,0.5,0.62,4,1.38,2.0,1.61,5
Nautico,8,3,3,2,18,11,7,12,Brazil - Serie C,0.38,0.75,7,2.25,2.63,1.33,6
Ypiranga,8,3,3,2,9,9,0,12,Brazil - Serie C,0.38,0.75,0,1.12,2.63,1.33,6
Londrina,8,3,3,2,8,8,0,12,Brazil - Serie C,0.38,0.75,0,1.0,2.63,1.33,6
Caxias,8,4,0,4,7,8,-1,12,Brazil - Serie C,0.5,0.5,-1,0.88,2.0,2.0,6
Confianca,8,3,2,3,11,10,1,11,Brazil - Serie C,0.38,0.62,1,1.38,2.63,1.61,7
Volta Redonda,8,3,2,3,11,14,-3,11,Brazil - Serie C,0.38,0.62,-3,1.38,2.63,1.61,7
Floresta,8,2,4,2,7,9,-2,10,Brazil - Serie C,0.25,0.75,-2,0.88,4.0,1.33,8
Sampaio Correa,8,2,3,3,7,8,-1,9,Brazil - Serie C,0.25,0.62,-1,0.88,4.0,1.61,9
ABC,8,2,3,3,7,9,-2,9,Brazil - Serie C,0.25,0.62,-2,0.88,4.0,1.61,9
Figueirense,8,1,4,3,5,10,-5,7,Brazil - Serie C,0.12,0.62,-5,0.62,8.33,1.61,10
EC Sao Jose,8,1,3,4,5,7,-2,6,Brazil - Serie C,0.12,0.5,-2,0.62,8.33,2.0,11
Aparecidense,8,1,3,4,4,10,-6,6,Brazil - Serie C,0.12,0.5,-6,0.5,8.33,2.0,11
Tombense,8,0,5,3,7,10,-3,5,Brazil - Serie C,0.0,0.62,-3,0.88,0.0,1.61,12
Ferroviario,8,0,4,4,8,16,-8,4,Brazil - Serie C,0.0,0.5,-8,1.0,0.0,2.0,13
Nova Iguacu,8,7,1,0,11,2,9,22,Brazil - Serie D,0.88,1.0,9,1.38,1.14,1.0,1
Brasiliense,8,6,1,1,17,5,12,19,Brazil - Serie D,0.75,0.88,12,2.12,1.33,1.14,2
Maringa,8,6,1,1,16,5,11,19,Brazil - Serie D,0.75,0.88,11,2.0,1.33,1.14,2
Retro,8,6,0,2,15,6,9,18,Brazil - Serie D,0.75,0.75,9,1.88,1.33,1.33,3
Juazeirense,8,6,0,2,10,6,4,18,Brazil - Serie D,0.75,0.75,4,1.25,1.33,1.33,3
P. do Solimoes,8,5,2,1,13,8,5,17,Brazil - Serie D,0.62,0.88,5,1.62,1.61,1.14,4
America RN,8,5,2,1,9,4,5,17,Brazil - Serie D,0.62,0.88,5,1.12,1.61,1.14,4
Manauara,8,4,4,0,17,4,13,16,Brazil - Serie D,0.5,1.0,13,2.12,2.0,1.0,5
Porto Velho,8,5,1,2,21,9,12,16,Brazil - Serie D,0.62,0.75,12,2.62,1.61,1.33,5
Manaus,8,5,1,2,15,8,7,16,Brazil - Serie D,0.62,0.75,7,1.88,1.61,1.33,5
Costa Rica MS,8,5,1,2,11,5,6,16,Brazil - Serie D,0.62,0.75,6,1.38,1.61,1.33,5
Altos,8,5,1,2,12,7,5,16,Brazil - Serie D,0.62,0.75,5,1.5,1.61,1.33,5
CSE,8,5,1,2,13,9,4,16,Brazil - Serie D,0.62,0.75,4,1.62,1.61,1.33,5
Iguatu,8,5,1,2,7,3,4,16,Brazil - Serie D,0.62,0.75,4,0.88,1.61,1.33,5
Portuguesa RJ,8,4,3,1,11,3,8,15,Brazil - Serie D,0.5,0.88,8,1.38,2.0,1.14,6
Maranhao,8,4,3,1,12,5,7,15,Brazil - Serie D,0.5,0.88,7,1.5,2.0,1.14,6
Treze,8,4,3,1,12,5,7,15,Brazil - Serie D,0.5,0.88,7,1.5,2.0,1.14,6
Itabaiana,8,5,0,3,13,7,6,15,Brazil - Serie D,0.62,0.62,6,1.62,1.61,1.61,6
Mixto,8,4,3,1,11,6,5,15,Brazil - Serie D,0.5,0.88,5,1.38,2.0,1.14,6
Santo Andre,8,4,2,2,8,5,3,14,Brazil - Serie D,0.5,0.75,3,1.0,2.0,1.33,7
Brasil de P.,8,4,1,3,14,10,4,13,Brazil - Serie D,0.5,0.62,4,1.75,2.0,1.61,8
CRAC,8,3,4,1,8,4,4,13,Brazil - Serie D,0.38,0.88,4,1.0,2.63,1.14,8
Cianorte,8,4,1,3,9,7,2,13,Brazil - Serie D,0.5,0.62,2,1.12,2.0,1.61,8
Sousa,8,4,1,3,9,7,2,13,Brazil - Serie D,0.5,0.62,2,1.12,2.0,1.61,8
Real Noroeste,8,4,1,3,11,10,1,13,Brazil - Serie D,0.5,0.62,1,1.38,2.0,1.61,8
Agua Santa,8,4,1,3,6,6,0,13,Brazil - Serie D,0.5,0.62,0,0.75,2.0,1.61,8
Atletico CE,8,3,3,2,9,6,3,12,Brazil - Serie D,0.38,0.75,3,1.12,2.63,1.33,9
Itabuna,8,3,3,2,8,5,3,12,Brazil - Serie D,0.38,0.75,3,1.0,2.63,1.33,9
Cameta,8,3,3,2,12,10,2,12,Brazil - Serie D,0.38,0.75,2,1.5,2.63,1.33,9
Flamengo,8,7,1,0,22,0,22,22,Brazil - Carioca,0.88,1.0,22,2.75,1.14,1.0,1
Fluminense,8,4,3,1,12,7,5,15,Brazil - Carioca,0.5,0.88,5,1.5,2.0,1.14,2
Vasco da Gama,8,4,2,2,11,7,4,14,Brazil - Carioca,0.5,0.75,4,1.38,2.0,1.33,3
Volta Redonda,8,4,2,2,11,10,1,14,Brazil - Carioca,0.5,0.75,1,1.38,2.0,1.33,3
Sampaio Correa,8,3,3,2,11,9,2,12,Brazil - Carioca,0.38,0.75,2,1.38,2.63,1.33,4
Madureira,8,3,2,3,7,5,2,11,Brazil - Carioca,0.38,0.62,2,0.88,2.63,1.61,5
Boavista,8,1,7,0,7,5,2,10,Brazil - Carioca,0.12,1.0,2,0.88,8.33,1.0,6
Botafogo,8,3,1,4,7,8,-1,10,Brazil - Carioca,0.38,0.5,-1,0.88,2.63,2.0,6
Nova Iguacu,8,2,3,3,4,7,-3,9,Brazil - Carioca,0.25,0.62,-3,0.5,4.0,1.61,7
CFRJ . Marica,8,1,2,5,7,15,-8,5,Brazil - Carioca,0.12,0.38,-8,0.88,8.33,2.63,8
Portuguesa RJ,8,1,1,6,9,21,-12,4,Brazil - Carioca,0.12,0.25,-12,1.12,8.33,4.0,9
Bangu,8,0,3,5,4,18,-14,3,Brazil - Carioca,0.0,0.38,-14,0.5,0.0,2.63,10
Atletico MG,8,4,4,0,9,2,7,16,Brazil - Mineiro,0.5,1.0,7,1.12,2.0,1.0,1
Tombense,8,5,1,2,8,5,3,16,Brazil - Mineiro,0.62,0.75,3,1.0,1.61,1.33,1
Betim,8,4,3,1,12,5,7,15,Brazil - Mineiro,0.5,0.88,7,1.5,2.0,1.14,2
America MG,8,3,4,1,14,5,9,13,Brazil - Mineiro,0.38,0.88,9,1.75,2.63,1.14,3
Athletic Club,8,4,0,4,12,12,0,12,Brazil - Mineiro,0.5,0.5,0,1.5,2.0,2.0,4
Cruzeiro,8,3,2,3,11,9,2,11,Brazil - Mineiro,0.38,0.62,2,1.38,2.63,1.61,5
Democrata GV,8,3,2,3,8,9,-1,11,Brazil - Mineiro,0.38,0.62,-1,1.0,2.63,1.61,5
Uberlandia,8,2,3,3,10,10,0,9,Brazil - Mineiro,0.25,0.62,0,1.25,4.0,1.61,6
Itabirito,8,2,2,4,7,11,-4,8,Brazil - Mineiro,0.25,0.5,-4,0.88,4.0,2.0,7
Pouso Alegre,8,2,2,4,7,15,-8,8,Brazil - Mineiro,0.25,0.5,-8,0.88,4.0,2.0,7
Aymores,8,1,4,3,3,5,-2,7,Brazil - Mineiro,0.12,0.62,-2,0.38,8.33,1.61,8
Villa Nova,8,1,1,6,4,17,-13,4,Brazil - Mineiro,0.12,0.25,-13,0.5,8.33,4.0,9
Anapolis,8,6,0,2,13,6,7,18,Brazil - Goiano,0.75,0.75,7,1.62,1.33,1.33,1
Vila Nova,8,4,3,1,8,5,3,15,Brazil - Goiano,0.5,0.88,3,1.0,2.0,1.14,2
Atletico GO,8,4,2,2,10,6,4,14,Brazil - Goiano,0.5,0.75,4,1.25,2.0,1.33,3
CRAC,8,4,2,2,7,4,3,14,Brazil - Goiano,0.5,0.75,3,0.88,2.0,1.33,3
Goias,8,4,2,2,7,5,2,14,Brazil - Goiano,0.5,0.75,2,0.88,2.0,1.33,3
Goianesia,8,2,4,2,11,9,2,10,Brazil - Goiano,0.25,0.75,2,1.38,4.0,1.33,4
ABECAT Ouvidore,8,3,1,4,8,10,-2,10,Brazil - Goiano,0.38,0.5,-2,1.0,2.63,2.0,4
Goiatuba EC,8,2,4,2,4,6,-2,10,Brazil - Goiano,0.25,0.75,-2,0.5,4.0,1.33,4
Jataiense,8,3,0,5,10,10,0,9,Brazil - Goiano,0.38,0.38,0,1.25,2.63,2.63,5
Goiania,8,2,1,5,8,14,-6,7,Brazil - Goiano,0.25,0.38,-6,1.0,4.0,2.63,6
Aparecidense,8,1,3,4,4,7,-3,6,Brazil - Goiano,0.12,0.5,-3,0.5,8.33,2.0,7
Inhumas,8,1,2,5,5,13,-8,5,Brazil - Goiano,0.12,0.38,-8,0.62,8.33,2.63,8
Santa Cruz,8,6,1,1,13,3,10,19,Brazil - Pernambucano,0.75,0.88,10,1.62,1.33,1.14,1
Nautico,8,5,0,3,14,8,6,15,Brazil - Pernambucano,0.62,0.62,6,1.75,1.61,1.61,2
Sport Recife,8,4,2,2,16,7,9,14,Brazil - Pernambucano,0.5,0.75,9,2.0,2.0,1.33,3
Maguary PE,8,4,2,2,10,9,1,14,Brazil - Pernambucano,0.5,0.75,1,1.25,2.0,1.33,3
Retro,8,3,3,2,7,7,0,12,Brazil - Pernambucano,0.38,0.75,0,0.88,2.63,1.33,4
Decisao,8,3,3,2,10,11,-1,12,Brazil - Pernambucano,0.38,0.75,-1,1.25,2.63,1.33,4
Jaguar,8,3,1,4,10,16,-6,10,Brazil - Pernambucano,0.38,0.5,-6,1.25,2.63,2.0,5
Central,8,2,2,4,8,9,-1,8,Brazil - Pernambucano,0.25,0.5,-1,1.0,4.0,2.0,6
Afogados,8,0,4,4,4,12,-8,4,Brazil - Pernambucano,0.0,0.5,-8,0.5,0.0,2.0,7
Petrolina,8,0,2,6,3,13,-10,2,Brazil - Pernambucano,0.0,0.25,-10,0.38,0.0,4.0,8
Corinthians,8,5,3,0,13,7,6,18,Brazil - Paulista,0.62,1.0,6,1.62,1.61,1.0,1
Palmeiras,8,4,4,0,15,6,9,16,Brazil - Paulista,0.5,1.0,9,1.88,2.0,1.0,2
Ponte Preta,8,5,1,2,9,6,3,16,Brazil - Paulista,0.62,0.75,3,1.12,1.61,1.33,2
Santos,8,4,2,2,15,8,7,14,Brazil - Paulista,0.5,0.75,7,1.88,2.0,1.33,3
Bragantino,8,4,2,2,10,5,5,14,Brazil - Paulista,0.5,0.75,5,1.25,2.0,1.33,3
Sao Bernardo,8,4,2,2,12,11,1,14,Brazil - Paulista,0.5,0.75,1,1.5,2.0,1.33,3
Novorizontino,8,3,4,1,8,6,2,13,Brazil - Paulista,0.38,0.88,2,1.0,2.63,1.14,4
Portuguesa,8,2,5,1,12,10,2,11,Brazil - Paulista,0.25,0.88,2,1.5,4.0,1.14,5
Velo Clube,8,2,4,2,10,10,0,10,Brazil - Paulista,0.25,0.75,0,1.25,4.0,1.33,6
Sao Paulo,8,2,3,3,12,11,1,9,Brazil - Paulista,0.25,0.62,1,1.5,4.0,1.61,7
Botafogo SP,8,2,3,3,8,10,-2,9,Brazil - Paulista,0.25,0.62,-2,1.0,4.0,1.61,7
Mirassol,8,2,1,5,10,17,-7,7,Brazil - Paulista,0.25,0.38,-7,1.25,4.0,2.63,8
Guarani,8,1,3,4,10,13,-3,6,Brazil - Paulista,0.12,0.5,-3,1.25,8.33,2.0,9
Agua Santa,8,0,4,4,5,13,-8,4,Brazil - Paulista,0.0,0.5,-8,0.62,0.0,2.0,10
Noroeste,8,0,3,5,9,16,-7,3,Brazil - Paulista,0.0,0.38,-7,1.12,0.0,2.63,11
Inter Limeira,8,0,3,5,5,15,-10,3,Brazil - Paulista,0.0,0.38,-10,0.62,0.0,2.63,11
Treze,8,5,2,1,17,7,10,17,Brazil - Paraibano,0.62,0.88,10,2.12,1.61,1.14,1
Sousa,8,5,2,1,12,3,9,17,Brazil - Paraibano,0.62,0.88,9,1.5,1.61,1.14,1
Botafogo PB,8,5,1,2,15,6,9,16,Brazil - Paraibano,0.62,0.75,9,1.88,1.61,1.33,2
Serra Branca,8,4,2,2,20,8,12,14,Brazil - Paraibano,0.5,0.75,12,2.5,2.0,1.33,3
Campinense,8,4,2,2,14,9,5,14,Brazil - Paraibano,0.5,0.75,5,1.75,2.0,1.33,3
Pombal,8,2,3,3,7,8,-1,9,Brazil - Paraibano,0.25,0.62,-1,0.88,4.0,1.61,4
Nacional Patos,8,2,3,3,13,17,-4,9,Brazil - Paraibano,0.25,0.62,-4,1.62,4.0,1.61,4
EC de Patos,8,2,1,5,11,16,-5,7,Brazil - Paraibano,0.25,0.38,-5,1.38,4.0,2.63,5
Auto Esporte,8,1,3,4,8,15,-7,6,Brazil - Paraibano,0.12,0.5,-7,1.0,8.33,2.0,6
Picuiense,8,0,1,7,5,33,-28,1,Brazil - Paraibano,0.0,0.12,-28,0.62,0.0,8.33,7
Santa Catarina,8,4,3,1,14,9,5,15,Brazil - Catarinense,0.5,0.88,5,1.75,2.0,1.14,1
Brusque,8,4,2,2,12,6,6,14,Brazil - Catarinense,0.5,0.75,6,1.5,2.0,1.33,2
Avai,8,4,1,3,12,6,6,13,Brazil - Catarinense,0.5,0.62,6,1.5,2.0,1.61,3
Criciuma,8,3,4,1,10,4,6,13,Brazil - Catarinense,0.38,0.88,6,1.25,2.63,1.14,3
Figueirense,8,4,1,3,16,11,5,13,Brazil - Catarinense,0.5,0.62,5,2.0,2.0,1.61,3
Barra FC,8,3,3,2,6,7,-1,12,Brazil - Catarinense,0.38,0.75,-1,0.75,2.63,1.33,4
Marcilio Dias,8,2,4,2,7,8,-1,10,Brazil - Catarinense,0.25,0.75,-1,0.88,4.0,1.33,5
Concordia,8,3,1,4,8,15,-7,10,Brazil - Catarinense,0.38,0.5,-7,1.0,2.63,2.0,5
Chapecoense,8,1,6,1,10,9,1,9,Brazil - Catarinense,0.12,0.88,1,1.25,8.33,1.14,6
Joinville,8,2,3,3,9,14,-5,9,Brazil - Catarinense,0.25,0.62,-5,1.12,4.0,1.61,6
Caravaggio,8,2,1,5,5,12,-7,7,Brazil - Catarinense,0.25,0.38,-7,0.62,4.0,2.63,7
Hercilio Luz,8,1,2,5,6,13,-7,5,Brazil - Catarinense,0.12,0.38,-7,0.75,8.33,2.63,8
Internacional,8,6,2,0,16,4,12,20,Brazil - Gaucho,0.75,1.0,12,2.0,1.33,1.0,1
Juventude,8,6,1,1,14,6,8,19,Brazil - Gaucho,0.75,0.88,8,1.75,1.33,1.14,2
Gremio,8,5,2,1,19,3,16,17,Brazil - Gaucho,0.62,0.88,16,2.38,1.61,1.14,3
Caxias,8,4,2,2,8,9,-1,14,Brazil - Gaucho,0.5,0.75,-1,1.0,2.0,1.33,4
Ypiranga,8,3,3,2,6,6,0,12,Brazil - Gaucho,0.38,0.75,0,0.75,2.63,1.33,5
Guarany de Bage,8,2,3,3,6,6,0,9,Brazil - Gaucho,0.25,0.62,0,0.75,4.0,1.61,6
Sao Luiz,8,2,3,3,7,13,-6,9,Brazil - Gaucho,0.25,0.62,-6,0.88,4.0,1.61,6
Brasil de P.,8,1,4,3,5,10,-5,7,Brazil - Gaucho,0.12,0.62,-5,0.62,8.33,1.61,7
Monsoon,8,2,1,5,7,14,-7,7,Brazil - Gaucho,0.25,0.38,-7,0.88,4.0,2.63,7
Pelotas,8,1,3,4,6,13,-7,6,Brazil - Gaucho,0.12,0.5,-7,0.75,8.33,2.0,8
EC Sao Jose,8,0,5,3,5,10,-5,5,Brazil - Gaucho,0.0,0.62,-5,0.62,0.0,1.61,9
Avenida,8,0,3,5,4,9,-5,3,Brazil - Gaucho,0.0,0.38,-5,0.5,0.0,2.63,10
Levski Sofia,8,7,1,0,18,5,13,22,Bulgaria - Parva Liga,0.88,1.0,13,2.25,1.14,1.0,1
Ludogorets,8,5,2,1,17,6,11,17,Bulgaria - Parva Liga,0.62,0.88,11,2.12,1.61,1.14,2
CSKA Sofia,8,5,2,1,15,6,9,17,Bulgaria - Parva Liga,0.62,0.88,9,1.88,1.61,1.14,2
Cherno More,8,4,3,1,14,8,6,15,Bulgaria - Parva Liga,0.5,0.88,6,1.75,2.0,1.14,3
Slavia Sofia,8,4,2,2,12,10,2,14,Bulgaria - Parva Liga,0.5,0.75,2,1.5,2.0,1.33,4
Beroe,8,4,1,3,14,9,5,13,Bulgaria - Parva Liga,0.5,0.62,5,1.75,2.0,1.61,5
Lokomotiv Sofia,8,4,0,4,12,11,1,12,Bulgaria - Parva Liga,0.5,0.5,1,1.5,2.0,2.0,6
CSKA 1948 Sofia,8,3,3,2,10,10,0,12,Bulgaria - Parva Liga,0.38,0.75,0,1.25,2.63,1.33,6
Arda,8,3,3,2,10,11,-1,12,Bulgaria - Parva Liga,0.38,0.75,-1,1.25,2.63,1.33,6
Septemvri Sofia,8,3,2,3,7,9,-2,11,Bulgaria - Parva Liga,0.38,0.62,-2,0.88,2.63,1.61,7
Lok. Plovdiv,8,3,0,5,7,9,-2,9,Bulgaria - Parva Liga,0.38,0.38,-2,0.88,2.63,2.63,8
Botev Plovdiv,8,2,1,5,7,15,-8,7,Bulgaria - Parva Liga,0.25,0.38,-8,0.88,4.0,2.63,9
Spartak Varna,8,1,3,4,7,15,-8,6,Bulgaria - Parva Liga,0.12,0.5,-8,0.88,8.33,2.0,10
L. Krumovgrad,8,0,4,4,1,7,-6,4,Bulgaria - Parva Liga,0.0,0.5,-6,0.12,0.0,2.0,11
Botev Vratsa,8,0,2,6,5,17,-12,2,Bulgaria - Parva Liga,0.0,0.25,-12,0.62,0.0,4.0,12
Hebar,8,0,1,7,5,18,-13,1,Bulgaria - Parva Liga,0.0,0.12,-13,0.62,0.0,8.33,13
Coquimbo Unido,3,3,0,0,6,1,5,9,Chile - Primera Division,1.0,1.0,5,2.0,1.0,1.0,1
Palestino,4,3,0,1,8,4,4,9,Chile - Primera Division,0.75,0.75,4,2.0,1.33,1.33,1
Union La Calera,4,2,1,1,7,3,4,7,Chile - Primera Division,0.5,0.75,4,1.75,2.0,1.33,2
Huachipato,4,2,1,1,6,2,4,7,Chile - Primera Division,0.5,0.75,4,1.5,2.0,1.33,2
U. Catolica,4,2,1,1,5,3,2,7,Chile - Primera Division,0.5,0.75,2,1.25,2.0,1.33,2
U. de Chile,3,2,0,1,7,2,5,6,Chile - Primera Division,0.67,0.67,5,2.33,1.49,1.49,3
Audax Italiano,3,2,0,1,7,5,2,6,Chile - Primera Division,0.67,0.67,2,2.33,1.49,1.49,3
Cobresal,3,2,0,1,6,4,2,6,Chile - Primera Division,0.67,0.67,2,2.0,1.49,1.49,3
OHiggins,3,1,2,0,3,2,1,5,Chile - Primera Division,0.33,1.0,1,1.0,3.03,1.0,4
Nublense,4,1,2,1,4,8,-4,5,Chile - Primera Division,0.25,0.75,-4,1.0,4.0,1.33,4
Colo-Colo,3,1,0,2,4,4,0,3,Chile - Primera Division,0.33,0.33,0,1.33,3.03,3.03,5
La Serena,3,1,0,2,3,6,-3,3,Chile - Primera Division,0.33,0.33,-3,1.0,3.03,3.03,5
D. Limache,3,0,2,1,3,4,-1,2,Chile - Primera Division,0.0,0.67,-1,1.0,0.0,1.49,6
Everton,3,0,1,2,2,7,-5,1,Chile - Primera Division,0.0,0.33,-5,0.67,0.0,3.03,7
D. Iquique,4,0,0,4,3,11,-8,0,Chile - Primera Division,0.0,0.0,-8,0.75,0.0,0.0,8
Union Espanola,3,0,0,3,0,8,-8,0,Chile - Primera Division,0.0,0.0,-8,0.0,0.0,0.0,8
U. Concepcion,3,2,1,0,4,1,3,7,Chile - Primera B,0.67,1.0,3,1.33,1.49,1.0,1
Copiapo,3,1,2,0,6,3,3,5,Chile - Primera B,0.33,1.0,3,2.0,3.03,1.0,2
Antofagasta,2,1,1,0,3,1,2,4,Chile - Primera B,0.5,1.0,2,1.5,2.0,1.0,3
S. Morning,2,1,1,0,4,3,1,4,Chile - Primera B,0.5,1.0,1,2.0,2.0,1.0,3
Curico Unido,2,1,1,0,3,2,1,4,Chile - Primera B,0.5,1.0,1,1.5,2.0,1.0,3
S. Wanderers,2,1,1,0,1,0,1,4,Chile - Primera B,0.5,1.0,1,0.5,2.0,1.0,3
Deportes Temuco,3,1,1,1,5,5,0,4,Chile - Primera B,0.33,0.67,0,1.67,3.03,1.49,3
Rangers,3,1,1,1,5,5,0,4,Chile - Primera B,0.33,0.67,0,1.67,3.03,1.49,3
San Marcos,3,1,1,1,3,3,0,4,Chile - Primera B,0.33,0.67,0,1.0,3.03,1.49,3
Magallanes,3,1,0,2,4,3,1,3,Chile - Primera B,0.33,0.33,1,1.33,3.03,3.03,4
Recoleta,2,1,0,1,3,5,-2,3,Chile - Primera B,0.5,0.5,-2,1.5,2.0,2.0,4
San Luis,2,0,2,0,2,2,0,2,Chile - Primera B,0.0,1.0,0,1.0,0.0,1.0,5
Cobreloa,3,0,2,1,2,4,-2,2,Chile - Primera B,0.0,0.67,-2,0.67,0.0,1.49,5
Concepcion,2,0,1,1,3,5,-2,1,Chile - Primera B,0.0,0.5,-2,1.5,0.0,2.0,6
U. San Felipe,3,0,1,2,2,4,-2,1,Chile - Primera B,0.0,0.33,-2,0.67,0.0,3.03,6
CD Santa Cruz,2,0,0,2,2,6,-4,0,Chile - Primera B,0.0,0.0,-4,1.0,0.0,0.0,7
Shanghai Port,2,2,0,0,5,1,4,6,China - Super League,1.0,1.0,4,2.5,1.0,1.0,1
Shandong T.,2,1,1,0,4,1,3,4,China - Super League,0.5,1.0,3,2.0,2.0,1.0,2
Beijing Guoan,2,1,1,0,4,2,2,4,China - Super League,0.5,1.0,2,2.0,2.0,1.0,2
Qingdao West C.,2,1,1,0,4,2,2,4,China - Super League,0.5,1.0,2,2.0,2.0,1.0,2
Meizhou Hakka,2,1,1,0,4,3,1,4,China - Super League,0.5,1.0,1,2.0,2.0,1.0,2
S. Shenhua,2,1,1,0,4,3,1,4,China - Super League,0.5,1.0,1,2.0,2.0,1.0,2
Tianjin T.,2,1,1,0,4,3,1,4,China - Super League,0.5,1.0,1,2.0,2.0,1.0,2
Chengdu,2,1,0,1,2,2,0,3,China - Super League,0.5,0.5,0,1.0,2.0,2.0,3
Sichuan Jiuniu,2,1,0,1,2,3,-1,3,China - Super League,0.5,0.5,-1,1.0,2.0,2.0,3
Zhejiang,2,0,2,0,2,2,0,2,China - Super League,0.0,1.0,0,1.0,0.0,1.0,4
Qingdao Hainiu,2,0,1,1,2,3,-1,1,China - Super League,0.0,0.5,-1,1.0,0.0,2.0,5
Henan SL,2,0,1,1,1,2,-1,1,China - Super League,0.0,0.5,-1,0.5,0.0,2.0,5
Yunnan Yukun,2,0,1,1,1,3,-2,1,China - Super League,0.0,0.5,-2,0.5,0.0,2.0,5
Dalian Yingbo,2,0,1,1,2,5,-3,1,China - Super League,0.0,0.5,-3,1.0,0.0,2.0,5
Changchun Yatai,2,0,0,2,1,4,-3,0,China - Super League,0.0,0.0,-3,0.5,0.0,0.0,6
Wuhan Three T.,2,0,0,2,0,3,-3,0,China - Super League,0.0,0.0,-3,0.0,0.0,0.0,6
Liaoning Tieren,8,7,0,1,13,5,8,21,China - League One,0.88,0.88,8,1.62,1.14,1.14,1
Yunnan Yukun,8,5,0,3,20,9,11,15,China - League One,0.62,0.62,11,2.5,1.61,1.61,2
S. Gongfu,8,4,3,1,10,6,4,15,China - League One,0.5,0.88,4,1.25,2.0,1.14,2
Chongqing T.,8,4,2,2,10,6,4,14,China - League One,0.5,0.75,4,1.25,2.0,1.33,3
Guangzhou FC,8,3,4,1,11,6,5,13,China - League One,0.38,0.88,5,1.38,2.63,1.14,4
Dalian Yingbo,8,4,1,3,10,10,0,13,China - League One,0.5,0.62,0,1.25,2.0,1.61,4
Foshan Nanshi,8,3,3,2,10,9,1,12,China - League One,0.38,0.75,1,1.25,2.63,1.33,5
Suzhou Dongwu,8,3,3,2,9,9,0,12,China - League One,0.38,0.75,0,1.12,2.63,1.33,5
Guangxi Baoyun,8,2,5,1,11,12,-1,11,China - League One,0.25,0.88,-1,1.38,4.0,1.14,6
Jiangxi Lushan,8,3,1,4,7,11,-4,10,China - League One,0.38,0.5,-4,0.88,2.63,2.0,7
Nanjing City,8,2,2,4,10,11,-1,8,China - League One,0.25,0.5,-1,1.25,4.0,2.0,8
Shanghai Jiadin,8,1,4,3,6,8,-2,7,China - League One,0.12,0.62,-2,0.75,8.33,1.61,9
Wuxi Wugou,8,2,1,5,8,11,-3,7,China - League One,0.25,0.38,-3,1.0,4.0,2.63,9
Yanbian Longdin,8,2,1,5,7,12,-5,7,China - League One,0.25,0.38,-5,0.88,4.0,2.63,9
Qingdao RL,8,1,2,5,6,14,-8,5,China - League One,0.12,0.38,-8,0.75,8.33,2.63,10
Heilongjiang IC,8,1,2,5,3,12,-9,5,China - League One,0.12,0.38,-9,0.38,8.33,2.63,10
Dalian Kuncheng,8,6,0,2,10,3,7,18,China - League Two,0.75,0.75,7,1.25,1.33,1.33,1
Shenzhen J.,8,5,1,2,9,5,4,16,China - League Two,0.62,0.75,4,1.12,1.61,1.33,2
Langfang Glory,8,4,2,2,10,4,6,14,China - League Two,0.5,0.75,6,1.25,2.0,1.33,3
Xian Ronghai,8,4,2,2,13,8,5,14,China - League Two,0.5,0.75,5,1.62,2.0,1.33,3
Shaanxi Union,8,4,2,2,10,7,3,14,China - League Two,0.5,0.75,3,1.25,2.0,1.33,3
Jiangxi DH,8,4,1,3,11,5,6,13,China - League Two,0.5,0.62,6,1.38,2.0,1.61,4
Ganzhou Ruishi,8,3,4,1,14,11,3,13,China - League Two,0.38,0.88,3,1.75,2.63,1.14,4
Guangxi Lanhang,8,3,4,1,14,13,1,13,China - League Two,0.38,0.88,1,1.75,2.63,1.14,4
Haikou M.,8,4,1,3,12,13,-1,13,China - League Two,0.5,0.62,-1,1.5,2.0,1.61,4
Guangdong GZP,8,3,3,2,9,6,3,12,China - League Two,0.38,0.75,3,1.12,2.63,1.33,5
Rizhao Yuqi,8,3,3,2,12,10,2,12,China - League Two,0.38,0.75,2,1.5,2.63,1.33,5
Shandong T. B,8,4,0,4,12,11,1,12,China - League Two,0.5,0.5,1,1.5,2.0,2.0,5
Guangxi H.,8,3,0,5,8,12,-4,9,China - League Two,0.38,0.38,-4,1.0,2.63,2.63,6
Hunan Billows,8,2,3,3,8,14,-6,9,China - League Two,0.25,0.62,-6,1.0,4.0,1.61,6
Beijing IT,8,2,2,4,8,11,-3,8,China - League Two,0.25,0.5,-3,1.0,4.0,2.0,7
Taian Tiankuang,8,2,2,4,10,14,-4,8,China - League Two,0.25,0.5,-4,1.25,4.0,2.0,7
Quanzhou Yassin,8,2,2,4,6,12,-6,8,China - League Two,0.25,0.5,-6,0.75,4.0,2.0,7
Hubei Istar,8,1,3,4,11,14,-3,6,China - League Two,0.12,0.5,-3,1.38,8.33,2.0,8
Shanghai Port B,8,2,0,6,7,13,-6,6,China - League Two,0.25,0.25,-6,0.88,4.0,4.0,8
Nantong Haimen,8,0,3,5,8,16,-8,3,China - League Two,0.0,0.38,-8,1.0,0.0,2.63,9
I. Medelin,8,5,3,0,11,2,9,18,Colombia - Primera A - Apertura,0.62,1.0,9,1.38,1.61,1.0,1
America de Cali,6,4,2,0,13,4,9,14,Colombia - Primera A - Apertura,0.67,1.0,9,2.17,1.49,1.0,2
A. Nacional,6,4,1,1,17,6,11,13,Colombia - Primera A - Apertura,0.67,0.83,11,2.83,1.49,1.2,3
Millonarios,7,4,1,2,11,8,3,13,Colombia - Primera A - Apertura,0.57,0.71,3,1.57,1.75,1.41,3
Deportivo Pasto,8,4,1,3,8,6,2,13,Colombia - Primera A - Apertura,0.5,0.62,2,1.0,2.0,1.61,3
Deportivo Cali,7,3,3,1,7,4,3,12,Colombia - Primera A - Apertura,0.43,0.86,3,1.0,2.33,1.16,4
A. Petrolera,7,3,3,1,8,7,1,12,Colombia - Primera A - Apertura,0.43,0.86,1,1.14,2.33,1.16,4
Once Caldas,7,4,0,3,9,11,-2,12,Colombia - Primera A - Apertura,0.57,0.57,-2,1.29,1.75,1.75,4
Junior,7,2,4,1,8,5,3,10,Colombia - Primera A - Apertura,0.29,0.86,3,1.14,3.45,1.16,5
Santa Fe,6,2,3,1,11,6,5,9,Colombia - Primera A - Apertura,0.33,0.83,5,1.83,3.03,1.2,6
Deportes Tolima,6,2,3,1,5,3,2,9,Colombia - Primera A - Apertura,0.33,0.83,2,0.83,3.03,1.2,6
Llaneros,8,2,2,4,10,13,-3,8,Colombia - Primera A - Apertura,0.25,0.5,-3,1.25,4.0,2.0,7
D. Pereira,8,2,2,4,6,10,-4,8,Colombia - Primera A - Apertura,0.25,0.5,-4,0.75,4.0,2.0,7
Boyaca Chico,7,2,2,3,5,11,-6,8,Colombia - Primera A - Apertura,0.29,0.57,-6,0.71,3.45,1.75,7
Fortaleza CEIF,6,2,1,3,5,10,-5,7,Colombia - Primera A - Apertura,0.33,0.5,-5,0.83,3.03,2.0,8
Envigado,8,2,1,5,6,15,-9,7,Colombia - Primera A - Apertura,0.25,0.38,-9,0.75,4.0,2.63,8
A. Bucaramanga,7,1,3,3,3,8,-5,6,Colombia - Primera A - Apertura,0.14,0.57,-5,0.43,7.14,1.75,9
R. Aguilas,7,0,4,3,5,8,-3,4,Colombia - Primera A - Apertura,0.0,0.57,-3,0.71,0.0,1.75,10
Union Magdalena,8,0,4,4,5,11,-6,4,Colombia - Primera A - Apertura,0.0,0.5,-6,0.62,0.0,2.0,10
La Equidad,8,0,3,5,4,9,-5,3,Colombia - Primera A - Apertura,0.0,0.38,-5,0.5,0.0,2.63,11
I. Medelin,8,5,2,1,15,6,9,17,Colombia - Primera A - Clausura,0.62,0.88,9,1.88,1.61,1.14,1
Millonarios,8,5,2,1,11,4,7,17,Colombia - Primera A - Clausura,0.62,0.88,7,1.38,1.61,1.14,1
Junior,8,4,3,1,11,4,7,15,Colombia - Primera A - Clausura,0.5,0.88,7,1.38,2.0,1.14,2
Santa Fe,8,4,3,1,12,6,6,15,Colombia - Primera A - Clausura,0.5,0.88,6,1.5,2.0,1.14,2
D. Pereira,8,4,3,1,12,9,3,15,Colombia - Primera A - Clausura,0.5,0.88,3,1.5,2.0,1.14,2
Deportes Tolima,8,4,2,2,9,4,5,14,Colombia - Primera A - Clausura,0.5,0.75,5,1.12,2.0,1.33,3
Deportivo Pasto,8,4,1,3,14,11,3,13,Colombia - Primera A - Clausura,0.5,0.62,3,1.75,2.0,1.61,4
A. Nacional,8,3,4,1,9,7,2,13,Colombia - Primera A - Clausura,0.38,0.88,2,1.12,2.63,1.14,4
A. Bucaramanga,8,3,3,2,12,7,5,12,Colombia - Primera A - Clausura,0.38,0.75,5,1.5,2.63,1.33,5
America de Cali,8,3,2,3,10,10,0,11,Colombia - Primera A - Clausura,0.38,0.62,0,1.25,2.63,1.61,6
Fortaleza CEIF,8,3,1,4,9,8,1,10,Colombia - Primera A - Clausura,0.38,0.5,1,1.12,2.63,2.0,7
La Equidad,8,2,3,3,12,13,-1,9,Colombia - Primera A - Clausura,0.25,0.62,-1,1.5,4.0,1.61,8
Patriotas,8,2,2,4,12,14,-2,8,Colombia - Primera A - Clausura,0.25,0.5,-2,1.5,4.0,2.0,9
Deportivo Cali,8,2,2,4,5,9,-4,8,Colombia - Primera A - Clausura,0.25,0.5,-4,0.62,4.0,2.0,9
A. Petrolera,8,2,2,4,7,12,-5,8,Colombia - Primera A - Clausura,0.25,0.5,-5,0.88,4.0,2.0,9
Jaguares de C.,8,2,2,4,7,14,-7,8,Colombia - Primera A - Clausura,0.25,0.5,-7,0.88,4.0,2.0,9
Envigado,8,2,1,5,5,9,-4,7,Colombia - Primera A - Clausura,0.25,0.38,-4,0.62,4.0,2.63,10
Boyaca Chico,8,2,1,5,5,15,-10,7,Colombia - Primera A - Clausura,0.25,0.38,-10,0.62,4.0,2.63,10
Once Caldas,8,1,2,5,4,12,-8,5,Colombia - Primera A - Clausura,0.12,0.38,-8,0.5,8.33,2.63,11
R. Aguilas,8,1,1,6,4,15,-11,4,Colombia - Primera A - Clausura,0.12,0.25,-11,0.5,8.33,4.0,12
Saprissa,8,5,2,1,13,7,6,17,Costa Rica - Primera Div. - Apertura,0.62,0.88,6,1.62,1.61,1.14,1
Alajuelense,8,5,1,2,13,6,7,16,Costa Rica - Primera Div. - Apertura,0.62,0.75,7,1.62,1.61,1.33,2
Santos Guapiles,8,5,1,2,14,8,6,16,Costa Rica - Primera Div. - Apertura,0.62,0.75,6,1.75,1.61,1.33,2
Guanacasteca,8,4,1,3,11,11,0,13,Costa Rica - Primera Div. - Apertura,0.5,0.62,0,1.38,2.0,1.61,3
Herediano,8,3,3,2,11,9,2,12,Costa Rica - Primera Div. - Apertura,0.38,0.75,2,1.38,2.63,1.33,4
San Carlos,8,2,5,1,11,11,0,11,Costa Rica - Primera Div. - Apertura,0.25,0.88,0,1.38,4.0,1.14,5
Cartagines,8,3,1,4,15,18,-3,10,Costa Rica - Primera Div. - Apertura,0.38,0.5,-3,1.88,2.63,2.0,6
Zeledon,8,3,1,4,9,12,-3,10,Costa Rica - Primera Div. - Apertura,0.38,0.5,-3,1.12,2.63,2.0,6
M. Liberia,8,2,2,4,9,11,-2,8,Costa Rica - Primera Div. - Apertura,0.25,0.5,-2,1.12,4.0,2.0,7
Sporting SJ,8,2,1,5,10,11,-1,7,Costa Rica - Primera Div. - Apertura,0.25,0.38,-1,1.25,4.0,2.63,8
Santa Ana,8,2,1,5,7,11,-4,7,Costa Rica - Primera Div. - Apertura,0.25,0.38,-4,0.88,4.0,2.63,8
Puntarenas,8,2,1,5,8,16,-8,7,Costa Rica - Primera Div. - Apertura,0.25,0.38,-8,1.0,4.0,2.63,8
Sparta Prague,8,8,0,0,17,5,12,24,CzechRepublic - 1. Liga,1.0,1.0,12,2.12,1.0,1.0,1
Banik Ostrava,8,6,0,2,12,3,9,18,CzechRepublic - 1. Liga,0.75,0.75,9,1.5,1.33,1.33,2
Slavia Prague,8,6,0,2,11,5,6,18,CzechRepublic - 1. Liga,0.75,0.75,6,1.38,1.33,1.33,2
Viktoria Plzen,8,5,1,2,19,11,8,16,CzechRepublic - 1. Liga,0.62,0.75,8,2.38,1.61,1.33,3
Jablonec,8,4,2,2,16,9,7,14,CzechRepublic - 1. Liga,0.5,0.75,7,2.0,2.0,1.33,4
Sigma Olomouc,8,4,1,3,16,10,6,13,CzechRepublic - 1. Liga,0.5,0.62,6,2.0,2.0,1.61,5
Mlada Boleslav,8,4,0,4,12,10,2,12,CzechRepublic - 1. Liga,0.5,0.5,2,1.5,2.0,2.0,6
Hradec Kralove,8,3,2,3,11,11,0,11,CzechRepublic - 1. Liga,0.38,0.62,0,1.38,2.63,1.61,7
Slovan Liberec,8,2,4,2,10,7,3,10,CzechRepublic - 1. Liga,0.25,0.75,3,1.25,4.0,1.33,8
Bohemians,8,2,3,3,7,11,-4,9,CzechRepublic - 1. Liga,0.25,0.62,-4,0.88,4.0,1.61,9
Teplice,8,2,2,4,6,11,-5,8,CzechRepublic - 1. Liga,0.25,0.5,-5,0.75,4.0,2.0,10
Slovacko,8,2,2,4,8,14,-6,8,CzechRepublic - 1. Liga,0.25,0.5,-6,1.0,4.0,2.0,10
Karvina,8,1,2,5,11,20,-9,5,CzechRepublic - 1. Liga,0.12,0.38,-9,1.38,8.33,2.63,11
Dukla Praha,8,0,4,4,6,11,-5,4,CzechRepublic - 1. Liga,0.0,0.5,-5,0.75,0.0,2.0,12
Pardubice,8,0,3,5,4,18,-14,3,CzechRepublic - 1. Liga,0.0,0.38,-14,0.5,0.0,2.63,13
C. Budejovice,8,0,1,7,6,23,-17,1,CzechRepublic - 1. Liga,0.0,0.12,-17,0.75,0.0,8.33,14
FC Kobenhavn,8,4,4,0,11,6,5,16,Denmark - Superligaen,0.5,1.0,5,1.38,2.0,1.0,1
Nordsjaelland,8,5,1,2,14,11,3,16,Denmark - Superligaen,0.62,0.75,3,1.75,1.61,1.33,1
FC Midtjylland,8,5,0,3,10,8,2,15,Denmark - Superligaen,0.62,0.62,2,1.25,1.61,1.61,2
Brondby IF,8,3,5,0,16,8,8,14,Denmark - Superligaen,0.38,1.0,8,2.0,2.63,1.0,3
Randers FC,8,4,2,2,14,6,8,14,Denmark - Superligaen,0.5,0.75,8,1.75,2.0,1.33,3
AGF Aarhus,8,3,3,2,13,8,5,12,Denmark - Superligaen,0.38,0.75,5,1.62,2.63,1.33,4
Silkeborg,8,3,3,2,12,8,4,12,Denmark - Superligaen,0.38,0.75,4,1.5,2.63,1.33,4
Viborg,8,3,1,4,12,15,-3,10,Denmark - Superligaen,0.38,0.5,-3,1.5,2.63,2.0,5
Vejle BK,8,1,3,4,9,17,-8,6,Denmark - Superligaen,0.12,0.5,-8,1.12,8.33,2.0,6
Aalborg BK,8,0,5,3,7,13,-6,5,Denmark - Superligaen,0.0,0.62,-6,0.88,0.0,1.61,7
SonderjyskE,8,1,2,5,12,21,-9,5,Denmark - Superligaen,0.12,0.38,-9,1.5,8.33,2.63,7
Lyngby,8,0,3,5,5,12,-7,3,Denmark - Superligaen,0.0,0.38,-7,0.62,0.0,2.63,8
Hillerod,8,5,2,1,16,7,9,17,Denmark - 1st Division,0.62,0.88,9,2.0,1.61,1.14,1
Odense BK,8,3,5,0,16,11,5,14,Denmark - 1st Division,0.38,1.0,5,2.0,2.63,1.0,2
Kolding IF,8,4,2,2,8,4,4,14,Denmark - 1st Division,0.5,0.75,4,1.0,2.0,1.33,2
AC Horsens,8,4,1,3,15,12,3,13,Denmark - 1st Division,0.5,0.62,3,1.88,2.0,1.61,3
Fredericia,8,4,0,4,14,10,4,12,Denmark - 1st Division,0.5,0.5,4,1.75,2.0,2.0,4
Hvidovre,8,4,0,4,10,9,1,12,Denmark - 1st Division,0.5,0.5,1,1.25,2.0,2.0,4
Esbjerg,8,4,0,4,10,11,-1,12,Denmark - 1st Division,0.5,0.5,-1,1.25,2.0,2.0,4
HB Koge,8,2,3,3,6,11,-5,9,Denmark - 1st Division,0.25,0.62,-5,0.75,4.0,1.61,5
Hobro,8,2,2,4,10,15,-5,8,Denmark - 1st Division,0.25,0.5,-5,1.25,4.0,2.0,6
Vendsyssel,8,1,3,4,9,12,-3,6,Denmark - 1st Division,0.12,0.5,-3,1.12,8.33,2.0,7
Roskilde,8,2,0,6,5,15,-10,6,Denmark - 1st Division,0.25,0.25,-10,0.62,4.0,4.0,7
B 93,8,1,2,5,9,20,-11,5,Denmark - 1st Division,0.12,0.38,-11,1.12,8.33,2.63,8
Aarhus Fremad,8,5,1,2,13,5,8,16,Denmark - 2nd Division,0.62,0.75,8,1.62,1.61,1.33,1
Naestved,8,5,1,2,8,5,3,16,Denmark - 2nd Division,0.62,0.75,3,1.0,1.61,1.33,1
Fremad Amager,8,4,1,3,8,7,1,13,Denmark - 2nd Division,0.5,0.62,1,1.0,2.0,1.61,2
Middelfart,8,3,3,2,12,10,2,12,Denmark - 2nd Division,0.38,0.75,2,1.5,2.63,1.33,3
Ishoj,8,2,4,2,7,8,-1,10,Denmark - 2nd Division,0.25,0.75,-1,0.88,4.0,1.33,4
Skive,8,2,4,2,10,13,-3,10,Denmark - 2nd Division,0.25,0.75,-3,1.25,4.0,1.33,4
Thisted,8,2,3,3,11,11,0,9,Denmark - 2nd Division,0.25,0.62,0,1.38,4.0,1.61,5
AB Copenhagen,8,2,3,3,9,9,0,9,Denmark - 2nd Division,0.25,0.62,0,1.12,4.0,1.61,5
BK Frem,8,2,3,3,9,10,-1,9,Denmark - 2nd Division,0.25,0.62,-1,1.12,4.0,1.61,5
Nykobing,8,2,2,4,10,10,0,8,Denmark - 2nd Division,0.25,0.5,0,1.25,4.0,2.0,6
Helsingor,8,1,5,2,7,9,-2,8,Denmark - 2nd Division,0.12,0.75,-2,0.88,8.33,1.33,6
Hellerup IK,8,2,2,4,4,11,-7,8,Denmark - 2nd Division,0.25,0.5,-7,0.5,4.0,2.0,6
Barcelona SC,4,3,0,1,8,7,1,9,Ecuador - Liga Pro 1st Stage,0.75,0.75,1,2.0,1.33,1.33,1
LDU Quito,4,2,2,0,8,1,7,8,Ecuador - Liga Pro 1st Stage,0.5,1.0,7,2.0,2.0,1.0,2
Macara,3,2,1,0,3,1,2,7,Ecuador - Liga Pro 1st Stage,0.67,1.0,2,1.0,1.49,1.0,3
Libertad,4,2,1,1,6,6,0,7,Ecuador - Liga Pro 1st Stage,0.5,0.75,0,1.5,2.0,1.33,3
Mushuc Runa,3,2,0,1,5,2,3,6,Ecuador - Liga Pro 1st Stage,0.67,0.67,3,1.67,1.49,1.49,4
D. Cuenca,4,2,0,2,4,4,0,6,Ecuador - Liga Pro 1st Stage,0.5,0.5,0,1.0,2.0,2.0,4
U. Catolica,3,1,2,0,6,2,4,5,Ecuador - Liga Pro 1st Stage,0.33,1.0,4,2.0,3.03,1.0,5
I. del Valle,4,1,2,1,6,4,2,5,Ecuador - Liga Pro 1st Stage,0.25,0.75,2,1.5,4.0,1.33,5
Aucas,3,1,1,1,6,5,1,4,Ecuador - Liga Pro 1st Stage,0.33,0.67,1,2.0,3.03,1.49,6
Manta,4,1,1,2,9,10,-1,4,Ecuador - Liga Pro 1st Stage,0.25,0.5,-1,2.25,4.0,2.0,6
Delfin,4,1,1,2,4,7,-3,4,Ecuador - Liga Pro 1st Stage,0.25,0.5,-3,1.0,4.0,2.0,6
Orense,3,1,0,2,2,6,-4,3,Ecuador - Liga Pro 1st Stage,0.33,0.33,-4,0.67,3.03,3.03,7
Cuniburo,3,0,2,1,3,4,-1,2,Ecuador - Liga Pro 1st Stage,0.0,0.67,-1,1.0,0.0,1.49,8
El Nacional,4,0,2,2,4,6,-2,2,Ecuador - Liga Pro 1st Stage,0.0,0.5,-2,1.0,0.0,2.0,8
Tecnico U.,3,0,2,1,3,6,-3,2,Ecuador - Liga Pro 1st Stage,0.0,0.67,-3,1.0,0.0,1.49,8
Emelec,3,0,1,2,0,6,-6,1,Ecuador - Liga Pro 1st Stage,0.0,0.33,-6,0.0,0.0,3.03,9
Manta,8,6,1,1,16,9,7,19,Ecuador - Serie B,0.75,0.88,7,2.0,1.33,1.14,1
Guayaquil City,8,4,3,1,9,3,6,15,Ecuador - Serie B,0.5,0.88,6,1.12,2.0,1.14,2
Cuniburo,8,4,2,2,20,10,10,14,Ecuador - Serie B,0.5,0.75,10,2.5,2.0,1.33,3
Leones Norte,8,3,4,1,10,7,3,13,Ecuador - Serie B,0.38,0.88,3,1.25,2.63,1.14,4
San Antonio,8,3,2,3,8,7,1,11,Ecuador - Serie B,0.38,0.62,1,1.0,2.63,1.61,5
Gualaceo,8,2,2,4,5,9,-4,8,Ecuador - Serie B,0.25,0.5,-4,0.62,4.0,2.0,6
Nueve Octubre,8,1,4,3,8,13,-5,7,Ecuador - Serie B,0.12,0.62,-5,1.0,8.33,1.61,7
Vargas Torres,8,1,4,3,9,18,-9,7,Ecuador - Serie B,0.12,0.62,-9,1.12,8.33,1.61,7
I. Juniors,8,1,3,4,9,11,-2,6,Ecuador - Serie B,0.12,0.5,-2,1.12,8.33,2.0,8
Chacaritas,8,0,4,4,7,16,-9,4,Ecuador - Serie B,0.0,0.5,-9,0.88,0.0,2.0,9
Pyramids FC,8,7,1,0,17,5,12,22,Egypt - Premier League,0.88,1.0,12,2.12,1.14,1.0,1
Al Ahly,8,6,2,0,16,5,11,20,Egypt - Premier League,0.75,1.0,11,2.0,1.33,1.0,2
Zamalek,8,4,3,1,13,7,6,15,Egypt - Premier League,0.5,0.88,6,1.62,2.0,1.14,3
Al Masry,8,4,3,1,12,6,6,15,Egypt - Premier League,0.5,0.88,6,1.5,2.0,1.14,3
National Bank,8,4,3,1,13,9,4,15,Egypt - Premier League,0.5,0.88,4,1.62,2.0,1.14,3
Haras El Hodood,8,4,1,3,8,8,0,13,Egypt - Premier League,0.5,0.62,0,1.0,2.0,1.61,4
Pharco,8,3,3,2,7,6,1,12,Egypt - Premier League,0.38,0.75,1,0.88,2.63,1.33,5
Smouha,8,4,0,4,6,10,-4,12,Egypt - Premier League,0.5,0.5,-4,0.75,2.0,2.0,5
El Gouna,8,3,2,3,8,8,0,11,Egypt - Premier League,0.38,0.62,0,1.0,2.63,1.61,6
El Geish,8,2,4,2,6,7,-1,10,Egypt - Premier League,0.25,0.75,-1,0.75,4.0,1.33,7
Ghazl El M.,8,3,0,5,9,10,-1,9,Egypt - Premier League,0.38,0.38,-1,1.12,2.63,2.63,8
Petrojet,8,2,3,3,9,11,-2,9,Egypt - Premier League,0.25,0.62,-2,1.12,4.0,1.61,8
ZED FC,8,1,5,2,9,9,0,8,Egypt - Premier League,0.12,0.75,0,1.12,8.33,1.33,9
Ceramica C.,8,2,2,4,10,11,-1,8,Egypt - Premier League,0.25,0.5,-1,1.25,4.0,2.0,9
Al Ittihad,8,2,2,4,7,10,-3,8,Egypt - Premier League,0.25,0.5,-3,0.88,4.0,2.0,9
ENPPI,8,1,2,5,5,13,-8,5,Egypt - Premier League,0.12,0.38,-8,0.62,8.33,2.63,10
Modern Sport,8,0,2,6,6,14,-8,2,Egypt - Premier League,0.0,0.25,-8,0.75,0.0,4.0,11
Ismaily,8,0,2,6,3,15,-12,2,Egypt - Premier League,0.0,0.25,-12,0.38,0.0,4.0,11
Liverpool,8,6,2,0,19,7,12,20,Premier League,0.75,1.0,12,2.38,1.33,1.0,2
Crystal Palace,8,6,0,2,15,5,10,18,Premier League,0.75,0.75,10,1.88,1.33,1.33,3
Brighton,8,6,0,2,16,11,5,18,Premier League,0.75,0.75,5,2.0,1.33,1.33,3
Everton,8,4,4,0,16,9,7,16,Premier League,0.5,1.0,7,2.0,2.0,1.0,4
Arsenal,8,4,3,1,13,6,7,15,Premier League,0.5,0.88,7,1.62,2.0,1.14,5
Bournemouth,8,4,1,3,16,9,7,13,Premier League,0.5,0.62,7,2.0,2.0,1.61,7
Manchester City,8,4,1,3,17,11,6,13,Premier League,0.5,0.62,6,2.12,2.0,1.61,7
Fulham,8,4,0,4,11,11,0,12,Premier League,0.5,0.5,0,1.38,2.0,2.0,8
Newcastle Utd,8,4,0,4,14,17,-3,12,Premier League,0.5,0.5,-3,1.75,2.0,2.0,8
Nottm Forest,8,3,2,3,16,14,2,11,Premier League,0.38,0.62,2,2.0,2.63,1.61,9
Chelsea,8,3,2,3,14,13,1,11,Premier League,0.38,0.62,1,1.75,2.63,1.61,9
Brentford,8,3,2,3,10,9,1,11,Premier League,0.38,0.62,1,1.25,2.63,1.61,9
Manchester Utd,8,3,2,3,12,13,-1,11,Premier League,0.38,0.62,-1,1.5,2.63,1.61,9
Aston Villa,8,2,4,2,10,13,-3,10,Premier League,0.25,0.75,-3,1.25,4.0,1.33,10
West Ham Utd,8,3,1,4,9,12,-3,10,Premier League,0.38,0.5,-3,1.12,2.63,2.0,10
Tottenham,8,3,0,5,12,11,1,9,Premier League,0.38,0.38,1,1.5,2.63,2.63,11
Wolverhampton,8,2,1,5,7,12,-5,7,Premier League,0.25,0.38,-5,0.88,4.0,2.63,13
Southampton,8,1,0,7,8,24,-16,3,Premier League,0.12,0.12,-16,1.0,8.33,8.33,17
Leicester City,8,1,0,7,3,19,-16,3,Premier League,0.12,0.12,-16,0.38,8.33,8.33,17
Ipswich Town,8,0,1,7,6,23,-17,1,Premier League,0.0,0.12,-17,0.75,0.0,8.33,18
Coventry City,8,7,0,1,15,9,6,21,Premier League,0.88,0.88,6,1.88,1.14,1.14,1
Leeds Utd,8,6,2,0,21,3,18,20,Premier League,0.75,1.0,18,2.62,1.33,1.0,2
Burnley,8,5,3,0,13,1,12,18,Premier League,0.62,1.0,12,1.62,1.61,1.0,3
Sheffield Utd,8,6,0,2,11,9,2,18,Premier League,0.75,0.75,2,1.38,1.33,1.33,3
Bristol City,8,4,3,1,11,6,5,15,Premier League,0.5,0.88,5,1.38,2.0,1.14,5
West Brom,8,4,2,2,13,8,5,14,Premier League,0.5,0.75,5,1.62,2.0,1.33,6
Sunderland,8,4,2,2,14,11,3,14,Premier League,0.5,0.75,3,1.75,2.0,1.33,6
Millwall,8,4,2,2,9,11,-2,14,Premier League,0.5,0.75,-2,1.12,2.0,1.33,6
Norwich City,8,3,4,1,14,8,6,13,Premier League,0.38,0.88,6,1.75,2.63,1.14,7
Hull City,8,3,2,3,9,7,2,11,Premier League,0.38,0.62,2,1.12,2.63,1.61,9
Blackburn,8,3,1,4,10,11,-1,10,Premier League,0.38,0.5,-1,1.25,2.63,2.0,10
Sheffield Wed,8,3,1,4,10,11,-1,10,Premier League,0.38,0.5,-1,1.25,2.63,2.0,10
Portsmouth,8,3,1,4,8,11,-3,10,Premier League,0.38,0.5,-3,1.0,2.63,2.0,10
Swansea City,8,3,1,4,7,11,-4,10,Premier League,0.38,0.5,-4,0.88,2.63,2.0,10
Preston,8,2,3,3,6,7,-1,9,Premier League,0.25,0.62,-1,0.75,4.0,1.61,11
Plymouth,8,2,3,3,11,13,-2,9,Premier League,0.25,0.62,-2,1.38,4.0,1.61,11
Stoke City,8,2,2,4,10,14,-4,8,Premier League,0.25,0.5,-4,1.25,4.0,2.0,12
Watford,8,2,2,4,7,11,-4,8,Premier League,0.25,0.5,-4,0.88,4.0,2.0,12
Cardiff City,8,2,2,4,8,16,-8,8,Premier League,0.25,0.5,-8,1.0,4.0,2.0,12
QP Rangers,8,2,0,6,9,11,-2,6,Premier League,0.25,0.25,-2,1.12,4.0,4.0,14
Middlesbrough,8,2,0,6,9,13,-4,6,Premier League,0.25,0.25,-4,1.12,4.0,4.0,14
Derby County,8,1,2,5,4,11,-7,5,Premier League,0.12,0.38,-7,0.5,8.33,2.63,15
Luton Town,8,1,2,5,3,12,-9,5,Premier League,0.12,0.38,-9,0.38,8.33,2.63,15
Oxford Utd,8,0,4,4,4,10,-6,4,Premier League,0.0,0.5,-6,0.5,0.0,2.0,16
Birmingham City,8,6,1,1,12,4,8,19,League One,0.75,0.88,8,1.5,1.33,1.14,1
Bolton,8,6,1,1,17,10,7,19,League One,0.75,0.88,7,2.12,1.33,1.14,1
Charlton,8,5,2,1,12,5,7,17,League One,0.62,0.88,7,1.5,1.61,1.14,2
Wrexham,8,5,1,2,11,7,4,16,League One,0.62,0.75,4,1.38,1.61,1.33,3
Stockport,8,4,3,1,9,6,3,15,League One,0.5,0.88,3,1.12,2.0,1.14,4
Reading,8,3,5,0,7,4,3,14,League One,0.38,1.0,3,0.88,2.63,1.0,5
Northampton,8,4,2,2,11,10,1,14,League One,0.5,0.75,1,1.38,2.0,1.33,5
Wycombe,8,3,4,1,9,5,4,13,League One,0.38,0.88,4,1.12,2.63,1.14,6
Peterborough,8,3,3,2,9,8,1,12,League One,0.38,0.75,1,1.12,2.63,1.33,7
Blackpool,8,2,5,1,13,9,4,11,League One,0.25,0.88,4,1.62,4.0,1.14,8
Bristol Rovers,8,3,2,3,11,10,1,11,League One,0.38,0.62,1,1.38,2.63,1.61,8
Huddersfield,8,3,1,4,6,7,-1,10,League One,0.38,0.5,-1,0.75,2.63,2.0,9
Wigan Athletic,8,2,4,2,6,7,-1,10,League One,0.25,0.75,-1,0.75,4.0,1.33,9
Barnsley,8,3,1,4,9,12,-3,10,League One,0.38,0.5,-3,1.12,2.63,2.0,9
Leyton Orient,8,3,0,5,11,12,-1,9,League One,0.38,0.38,-1,1.38,2.63,2.63,10
Burton Albion,8,2,3,3,6,9,-3,9,League One,0.25,0.62,-3,0.75,4.0,1.61,10
Lincoln City,8,2,2,4,14,12,2,8,League One,0.25,0.5,2,1.75,4.0,2.0,11
Cambridge Utd,8,2,2,4,6,9,-3,8,League One,0.25,0.5,-3,0.75,4.0,2.0,11
Stevenage,8,2,2,4,6,10,-4,8,League One,0.25,0.5,-4,0.75,4.0,2.0,11
Exeter City,8,2,2,4,8,17,-9,8,League One,0.25,0.5,-9,1.0,4.0,2.0,11
Rotherham,8,2,1,5,7,10,-3,7,League One,0.25,0.38,-3,0.88,4.0,2.63,12
Crawley Town,8,1,3,4,11,17,-6,6,League One,0.12,0.5,-6,1.38,8.33,2.0,13
Shrewsbury,8,1,2,5,6,12,-6,5,League One,0.12,0.38,-6,0.75,8.33,2.63,14
Mansfield,8,0,4,4,6,14,-8,4,League One,0.0,0.5,-8,0.75,0.0,2.0,15
Bradford,8,6,1,1,10,2,8,19,League Two,0.75,0.88,8,1.25,1.33,1.14,1
Grimsby,8,5,3,0,14,7,7,18,League Two,0.62,1.0,7,1.75,1.61,1.0,2
Colchester Utd,8,5,3,0,10,4,6,18,League Two,0.62,1.0,6,1.25,1.61,1.0,2
Bromley,8,5,1,2,10,6,4,16,League Two,0.62,0.75,4,1.25,1.61,1.33,3
Swindon Town,8,4,3,1,17,10,7,15,League Two,0.5,0.88,7,2.12,2.0,1.14,4
Port Vale,8,3,5,0,11,8,3,14,League Two,0.38,1.0,3,1.38,2.63,1.0,5
Doncaster,8,4,1,3,13,12,1,13,League Two,0.5,0.62,1,1.62,2.0,1.61,6
Newport,8,4,1,3,10,10,0,13,League Two,0.5,0.62,0,1.25,2.0,1.61,6
AFC Wimbledon,8,3,3,2,7,3,4,12,League Two,0.38,0.75,4,0.88,2.63,1.33,7
Barrow,8,4,0,4,11,10,1,12,League Two,0.5,0.5,1,1.38,2.0,2.0,7
Notts County,8,3,2,3,10,10,0,11,League Two,0.38,0.62,0,1.25,2.63,1.61,8
Cheltenham,8,3,2,3,10,11,-1,11,League Two,0.38,0.62,-1,1.25,2.63,1.61,8
Harrogate,8,3,2,3,6,7,-1,11,League Two,0.38,0.62,-1,0.75,2.63,1.61,8
Fleetwood,8,2,4,2,10,8,2,10,League Two,0.25,0.75,2,1.25,4.0,1.33,9
Chesterfield,8,3,0,5,12,12,0,9,League Two,0.38,0.38,0,1.5,2.63,2.63,10
Walsall,8,2,3,3,11,11,0,9,League Two,0.25,0.62,0,1.38,4.0,1.61,10
Crewe Alexandra,8,2,3,3,9,13,-4,9,League Two,0.25,0.62,-4,1.12,4.0,1.61,10
Gillingham,8,2,3,3,5,9,-4,9,League Two,0.25,0.62,-4,0.62,4.0,1.61,10
Salford City,8,1,4,3,12,13,-1,7,League Two,0.12,0.62,-1,1.5,8.33,1.61,11
Tranmere,8,1,4,3,6,9,-3,7,League Two,0.12,0.62,-3,0.75,8.33,1.61,11
Accrington,8,2,1,5,5,9,-4,7,League Two,0.25,0.38,-4,0.62,4.0,2.63,11
Morecambe,8,2,0,6,5,10,-5,6,League Two,0.25,0.25,-5,0.62,4.0,4.0,12
Carlisle Utd,8,1,3,4,4,10,-6,6,League Two,0.12,0.5,-6,0.5,8.33,2.0,12
Milton Keynes,8,1,1,6,5,12,-7,4,League Two,0.12,0.25,-7,0.62,8.33,4.0,13
Barnet,8,7,1,0,20,2,18,22,England - National League,0.88,1.0,18,2.5,1.14,1.0,1
Eastleigh,8,4,2,2,12,6,6,14,England - National League,0.5,0.75,6,1.5,2.0,1.33,2
York City,8,4,2,2,14,9,5,14,England - National League,0.5,0.75,5,1.75,2.0,1.33,2
Aldershot Town,8,4,2,2,15,11,4,14,England - National League,0.5,0.75,4,1.88,2.0,1.33,2
Altrincham,8,4,2,2,13,10,3,14,England - National League,0.5,0.75,3,1.62,2.0,1.33,2
Halifax Town,8,4,2,2,10,9,1,14,England - National League,0.5,0.75,1,1.25,2.0,1.33,2
Southend Utd,8,3,4,1,13,10,3,13,England - National League,0.38,0.88,3,1.62,2.63,1.14,3
Boston Utd,8,3,3,2,11,8,3,12,England - National League,0.38,0.75,3,1.38,2.63,1.33,4
Braintree Town,8,3,3,2,12,10,2,12,England - National League,0.38,0.75,2,1.5,2.63,1.33,4
Forest Green,8,3,3,2,9,7,2,12,England - National League,0.38,0.75,2,1.12,2.63,1.33,4
Sutton Utd,8,3,3,2,10,9,1,12,England - National League,0.38,0.75,1,1.25,2.63,1.33,4
Gateshead FC,8,3,2,3,14,11,3,11,England - National League,0.38,0.62,3,1.75,2.63,1.61,5
Tamworth,8,2,5,1,14,11,3,11,England - National League,0.25,0.88,3,1.75,4.0,1.14,5
AFC Fylde,8,3,2,3,10,11,-1,11,England - National League,0.38,0.62,-1,1.25,2.63,1.61,5
Woking,8,2,5,1,10,11,-1,11,England - National League,0.25,0.88,-1,1.25,4.0,1.14,5
Rochdale,8,2,4,2,7,8,-1,10,England - National League,0.25,0.75,-1,0.88,4.0,1.33,6
Wealdstone,8,3,1,4,11,18,-7,10,England - National League,0.38,0.5,-7,1.38,2.63,2.0,6
Oldham,8,1,5,2,6,9,-3,8,England - National League,0.12,0.75,-3,0.75,8.33,1.33,7
Maidenhead Utd,8,2,2,4,6,11,-5,8,England - National League,0.25,0.5,-5,0.75,4.0,2.0,7
Yeovil Town,8,2,2,4,8,16,-8,8,England - National League,0.25,0.5,-8,1.0,4.0,2.0,7
Hartlepool,8,1,3,4,9,12,-3,6,England - National League,0.12,0.5,-3,1.12,8.33,2.0,8
Solihull Moors,8,1,2,5,7,14,-7,5,England - National League,0.12,0.38,-7,0.88,8.33,2.63,9
Dagenham & R.,8,0,4,4,6,13,-7,4,England - National League,0.0,0.5,-7,0.75,0.0,2.0,10
Ebbsfleet Utd,8,0,2,6,5,15,-10,2,England - National League,0.0,0.25,-10,0.62,0.0,4.0,11
Brackley Town,8,7,0,1,19,9,10,21,England - National L. North,0.88,0.88,10,2.38,1.14,1.14,1
Scunthorpe,8,5,3,0,11,3,8,18,England - National L. North,0.62,1.0,8,1.38,1.61,1.0,2
Chorley,8,5,1,2,18,11,7,16,England - National L. North,0.62,0.75,7,2.25,1.61,1.33,3
Spennymoor,8,5,1,2,16,10,6,16,England - National L. North,0.62,0.75,6,2.0,1.61,1.33,3
Hereford Utd,8,5,1,2,13,9,4,16,England - National L. North,0.62,0.75,4,1.62,1.61,1.33,3
Marine,8,5,1,2,13,9,4,16,England - National L. North,0.62,0.75,4,1.62,1.61,1.33,3
Peterborough S.,8,4,3,1,11,6,5,15,England - National L. North,0.5,0.88,5,1.38,2.0,1.14,4
Leamington,8,4,2,2,12,8,4,14,England - National L. North,0.5,0.75,4,1.5,2.0,1.33,5
Kidderminster,8,4,1,3,17,9,8,13,England - National L. North,0.5,0.62,8,2.12,2.0,1.61,6
Radcliffe,8,4,1,3,14,9,5,13,England - National L. North,0.5,0.62,5,1.75,2.0,1.61,6
Kings Lynn,8,4,1,3,9,8,1,13,England - National L. North,0.5,0.62,1,1.12,2.0,1.61,6
Chester,8,3,3,2,10,7,3,12,England - National L. North,0.38,0.75,3,1.25,2.63,1.33,7
Curzon,8,3,3,2,8,7,1,12,England - National L. North,0.38,0.75,1,1.0,2.63,1.33,7
South Shields,8,4,0,4,11,12,-1,12,England - National L. North,0.5,0.5,-1,1.38,2.0,2.0,7
Buxton,8,3,2,3,16,7,9,11,England - National L. North,0.38,0.62,9,2.0,2.63,1.61,8
Scarborough,8,3,1,4,10,10,0,10,England - National L. North,0.38,0.5,0,1.25,2.63,2.0,9
Darlington,8,3,1,4,9,10,-1,10,England - National L. North,0.38,0.5,-1,1.12,2.63,2.0,9
Needham Market,8,2,2,4,13,9,4,8,England - National L. North,0.25,0.5,4,1.62,4.0,2.0,10
Southport,8,2,2,4,5,10,-5,8,England - National L. North,0.25,0.5,-5,0.62,4.0,2.0,10
Warrington,8,1,2,5,8,14,-6,5,England - National L. North,0.12,0.38,-6,1.0,8.33,2.63,11
Oxford City,8,1,2,5,4,17,-13,5,England - National L. North,0.12,0.38,-13,0.5,8.33,2.63,11
Alfreton Town,8,1,1,6,6,15,-9,4,England - National L. North,0.12,0.25,-9,0.75,8.33,4.0,12
Rushall,8,0,2,6,5,23,-18,2,England - National L. North,0.0,0.25,-18,0.62,0.0,4.0,13
Farsley Celtic,8,0,0,8,2,27,-25,0,England - National L. North,0.0,0.0,-25,0.25,0.0,0.0,14
Truro City,8,6,2,0,17,7,10,20,England - National L. South,0.75,1.0,10,2.12,1.33,1.0,1
Dorking,8,5,3,0,15,7,8,18,England - National L. South,0.62,1.0,8,1.88,1.61,1.0,2
Hornchurch,8,5,2,1,14,8,6,17,England - National L. South,0.62,0.88,6,1.75,1.61,1.14,3
Worthing,8,5,1,2,15,13,2,16,England - National L. South,0.62,0.75,2,1.88,1.61,1.33,4
Hemel Hempstead,8,4,3,1,16,11,5,15,England - National L. South,0.5,0.88,5,2.0,2.0,1.14,5
Torquay Utd,8,4,3,1,15,10,5,15,England - National L. South,0.5,0.88,5,1.88,2.0,1.14,5
Eastbourne,8,4,2,2,16,10,6,14,England - National L. South,0.5,0.75,6,2.0,2.0,1.33,6
Boreham Wood,8,4,1,3,12,8,4,13,England - National L. South,0.5,0.62,4,1.5,2.0,1.61,7
Farnborough,8,3,3,2,14,11,3,12,England - National L. South,0.38,0.75,3,1.75,2.63,1.33,8
St Albans,8,3,3,2,10,8,2,12,England - National L. South,0.38,0.75,2,1.25,2.63,1.33,8
Weston-s.-Mare,8,3,3,2,10,8,2,12,England - National L. South,0.38,0.75,2,1.25,2.63,1.33,8
Enfield Town,8,4,0,4,10,15,-5,12,England - National L. South,0.5,0.5,-5,1.25,2.0,2.0,8
Chelmsford City,8,3,2,3,14,13,1,11,England - National L. South,0.38,0.62,1,1.75,2.63,1.61,9
Maidstone Utd,8,3,2,3,7,6,1,11,England - National L. South,0.38,0.62,1,0.88,2.63,1.61,9
Chippenham,8,3,2,3,12,15,-3,11,England - National L. South,0.38,0.62,-3,1.5,2.63,1.61,9
Weymouth,8,2,3,3,15,16,-1,9,England - National L. South,0.25,0.62,-1,1.88,4.0,1.61,10
Slough Town,8,2,2,4,10,11,-1,8,England - National L. South,0.25,0.5,-1,1.25,4.0,2.0,11
Bath City,8,2,2,4,6,9,-3,8,England - National L. South,0.25,0.5,-3,0.75,4.0,2.0,11
Tonbridge,8,2,1,5,8,10,-2,7,England - National L. South,0.25,0.38,-2,1.0,4.0,2.63,12
Chesham Utd,8,2,1,5,9,17,-8,7,England - National L. South,0.25,0.38,-8,1.12,4.0,2.63,12
Salisbury,8,1,2,5,13,18,-5,5,England - National L. South,0.12,0.38,-5,1.62,8.33,2.63,13
Hampton & R.,8,1,1,6,9,17,-8,4,England - National L. South,0.12,0.25,-8,1.12,8.33,4.0,14
Aveley,8,1,1,6,7,15,-8,4,England - National L. South,0.12,0.25,-8,0.88,8.33,4.0,14
Welling Utd,8,0,3,5,7,17,-10,3,England - National L. South,0.0,0.38,-10,0.88,0.0,2.63,15
Carshalton,8,6,1,1,16,10,6,19,England - Isthmian league,0.75,0.88,6,2.0,1.33,1.14,1
Billericay Town,8,6,0,2,19,12,7,18,England - Isthmian league,0.75,0.75,7,2.38,1.33,1.33,2
Wingate & F.,8,5,2,1,18,8,10,17,England - Isthmian league,0.62,0.88,10,2.25,1.61,1.14,3
Chichester City,8,5,2,1,12,8,4,17,England - Isthmian league,0.62,0.88,4,1.5,1.61,1.14,3
Dartford,8,5,1,2,15,10,5,16,England - Isthmian league,0.62,0.75,5,1.88,1.61,1.33,4
Lewes,8,4,2,2,13,10,3,14,England - Isthmian league,0.5,0.75,3,1.62,2.0,1.33,5
Folkestone,8,4,1,3,18,14,4,13,England - Isthmian league,0.5,0.62,4,2.25,2.0,1.61,6
Chatham Town,8,4,1,3,13,9,4,13,England - Isthmian league,0.5,0.62,4,1.62,2.0,1.61,6
Cray Wanderers,8,4,1,3,14,11,3,13,England - Isthmian league,0.5,0.62,3,1.75,2.0,1.61,6
Horsham,8,4,1,3,11,10,1,13,England - Isthmian league,0.5,0.62,1,1.38,2.0,1.61,6
Hashtag United,8,3,3,2,16,15,1,12,England - Isthmian league,0.38,0.75,1,2.0,2.63,1.33,7
Potters Bar,8,3,2,3,9,10,-1,11,England - Isthmian league,0.38,0.62,-1,1.12,2.63,1.61,8
Whitehawk,8,3,1,4,14,12,2,10,England - Isthmian league,0.38,0.5,2,1.75,2.63,2.0,9
Cray Valley PM,8,2,4,2,10,8,2,10,England - Isthmian league,0.25,0.75,2,1.25,4.0,1.33,9
Cheshunt,8,3,1,4,10,11,-1,10,England - Isthmian league,0.38,0.5,-1,1.25,2.63,2.0,9
Bognor Regis,8,2,3,3,14,14,0,9,England - Isthmian league,0.25,0.62,0,1.75,4.0,1.61,10
Dover Athletic,8,2,2,4,8,11,-3,8,England - Isthmian league,0.25,0.5,-3,1.0,4.0,2.0,11
Dulwich Hamlet,8,2,2,4,10,14,-4,8,England - Isthmian league,0.25,0.5,-4,1.25,4.0,2.0,11
Canvey Island,8,2,1,5,5,14,-9,7,England - Isthmian league,0.25,0.38,-9,0.62,4.0,2.63,12
Hastings Utd,8,1,2,5,5,9,-4,5,England - Isthmian league,0.12,0.38,-4,0.62,8.33,2.63,13
Hendon,8,0,4,4,10,16,-6,4,England - Isthmian league,0.0,0.5,-6,1.25,0.0,2.0,14
Bowers & Pitsea,8,0,1,7,3,22,-19,1,England - Isthmian league,0.0,0.12,-19,0.38,0.0,8.33,15
Macclesfield,8,7,1,0,21,4,17,22,England - Northern league,0.88,1.0,17,2.62,1.14,1.0,1
Worksop Town,8,6,1,1,23,11,12,19,England - Northern league,0.75,0.88,12,2.88,1.33,1.14,2
Morpeth Town,8,5,2,1,12,6,6,17,England - Northern league,0.62,0.88,6,1.5,1.61,1.14,3
Stockton Town,8,5,1,2,12,9,3,16,England - Northern league,0.62,0.75,3,1.5,1.61,1.33,4
FC United,8,4,3,1,12,9,3,15,England - Northern league,0.5,0.88,3,1.5,2.0,1.14,5
Rylands,8,4,2,2,13,10,3,14,England - Northern league,0.5,0.75,3,1.62,2.0,1.33,6
Gainsborough,8,3,4,1,12,7,5,13,England - Northern league,0.38,0.88,5,1.5,2.63,1.14,7
Hyde Utd,8,3,4,1,10,6,4,13,England - Northern league,0.38,0.88,4,1.25,2.63,1.14,7
Workington,8,4,0,4,13,12,1,12,England - Northern league,0.5,0.5,1,1.62,2.0,2.0,8
Ashton Utd,8,3,3,2,11,10,1,12,England - Northern league,0.38,0.75,1,1.38,2.63,1.33,8
Bamber Bridge,8,3,1,4,13,11,2,10,England - Northern league,0.38,0.5,2,1.62,2.63,2.0,9
Lancaster City,8,3,1,4,11,10,1,10,England - Northern league,0.38,0.5,1,1.38,2.63,2.0,9
Prescot Cables,8,3,1,4,6,8,-2,10,England - Northern league,0.38,0.5,-2,0.75,2.63,2.0,9
Guiseley,8,2,3,3,9,10,-1,9,England - Northern league,0.25,0.62,-1,1.12,4.0,1.61,10
Leek Town,8,2,2,4,6,9,-3,8,England - Northern league,0.25,0.5,-3,0.75,4.0,2.0,11
Basford Utd,8,2,2,4,7,11,-4,8,England - Northern league,0.25,0.5,-4,0.88,4.0,2.0,11
Hebburn Town,8,1,4,3,7,10,-3,7,England - Northern league,0.12,0.62,-3,0.88,8.33,1.61,12
Ilkeston Town,8,1,4,3,7,10,-3,7,England - Northern league,0.12,0.62,-3,0.88,8.33,1.61,12
Whitby Town,8,1,2,5,6,17,-11,5,England - Northern league,0.12,0.38,-11,0.75,8.33,2.63,13
Blyth Spartans,8,1,2,5,8,21,-13,5,England - Northern league,0.12,0.38,-13,1.0,8.33,2.63,13
Matlock,8,0,4,4,8,12,-4,4,England - Northern league,0.0,0.5,-4,1.0,0.0,2.0,14
Mickleover,8,1,1,6,4,19,-15,4,England - Northern league,0.12,0.25,-15,0.5,8.33,4.0,14
Harborough Town,8,5,2,1,11,4,7,17,England - Southern Central,0.62,0.88,7,1.38,1.61,1.14,1
Bedford Town,8,5,1,2,14,11,3,16,England - Southern Central,0.62,0.75,3,1.75,1.61,1.33,2
Leiston,8,5,1,2,12,9,3,16,England - Southern Central,0.62,0.75,3,1.5,1.61,1.33,2
Stamford,8,4,3,1,10,6,4,15,England - Southern Central,0.5,0.88,4,1.25,2.0,1.14,3
Telford Utd,8,3,5,0,17,10,7,14,England - Southern Central,0.38,1.0,7,2.12,2.63,1.0,4
Stratford Town,8,4,2,2,13,7,6,14,England - Southern Central,0.5,0.75,6,1.62,2.0,1.33,4
Halesowen Town,8,4,2,2,11,7,4,14,England - Southern Central,0.5,0.75,4,1.38,2.0,1.33,4
Kettering Town,8,4,1,3,13,9,4,13,England - Southern Central,0.5,0.62,4,1.62,2.0,1.61,5
Bromsgrove,8,4,1,3,11,9,2,13,England - Southern Central,0.5,0.62,2,1.38,2.0,1.61,5
Stourbridge,8,4,0,4,12,10,2,12,England - Southern Central,0.5,0.5,2,1.5,2.0,2.0,6
St. Ives Town,8,2,5,1,12,11,1,11,England - Southern Central,0.25,0.88,1,1.5,4.0,1.14,7
Alvechurch,8,3,2,3,9,8,1,11,England - Southern Central,0.38,0.62,1,1.12,2.63,1.61,7
Royston,8,2,5,1,6,7,-1,11,England - Southern Central,0.25,0.88,-1,0.75,4.0,1.14,7
Spalding United,8,3,1,4,7,9,-2,10,England - Southern Central,0.38,0.5,-2,0.88,2.63,2.0,8
Banbury Utd,8,2,3,3,7,9,-2,9,England - Southern Central,0.25,0.62,-2,0.88,4.0,1.61,9
B. Stortford,8,2,3,3,9,14,-5,9,England - Southern Central,0.25,0.62,-5,1.12,4.0,1.61,9
Hitchin Town,8,2,2,4,10,13,-3,8,England - Southern Central,0.25,0.5,-3,1.25,4.0,2.0,10
Barwell,8,2,1,5,11,14,-3,7,England - Southern Central,0.25,0.38,-3,1.38,4.0,2.63,11
Redditch Utd,8,1,2,5,6,11,-5,5,England - Southern Central,0.12,0.38,-5,0.75,8.33,2.63,12
AFC Sudbury,8,1,2,5,7,14,-7,5,England - Southern Central,0.12,0.38,-7,0.88,8.33,2.63,12
Biggleswade,8,1,2,5,7,14,-7,5,England - Southern Central,0.12,0.38,-7,0.88,8.33,2.63,12
Lowestoft,8,1,2,5,9,17,-8,5,England - Southern Central,0.12,0.38,-8,1.12,8.33,2.63,12
Levadia,2,2,0,0,8,2,6,6,Estonia - Meistriliiga,1.0,1.0,6,4.0,1.0,1.0,1
Nomme Kalju,1,1,0,0,3,0,3,3,Estonia - Meistriliiga,1.0,1.0,3,3.0,1.0,1.0,2
Kuressaare,2,1,0,1,3,2,1,3,Estonia - Meistriliiga,0.5,0.5,1,1.5,2.0,2.0,2
Paide,1,1,0,0,2,1,1,3,Estonia - Meistriliiga,1.0,1.0,1,2.0,1.0,1.0,2
Tammeka,2,1,0,1,4,4,0,3,Estonia - Meistriliiga,0.5,0.5,0,2.0,2.0,2.0,2
Vaprus,2,1,0,1,1,3,-2,3,Estonia - Meistriliiga,0.5,0.5,-2,0.5,2.0,2.0,2
Flora,2,0,1,1,2,3,-1,1,Estonia - Meistriliiga,0.0,0.5,-1,1.0,0.0,2.0,3
Narva Trans,2,0,1,1,2,4,-2,1,Estonia - Meistriliiga,0.0,0.5,-2,1.0,0.0,2.0,3
Tallinna Kalev,1,0,0,1,1,2,-1,0,Estonia - Meistriliiga,0.0,0.0,-1,1.0,0.0,0.0,4
Harju JK,1,0,0,1,0,5,-5,0,Estonia - Meistriliiga,0.0,0.0,-5,0.0,0.0,0.0,4
Elva,2,1,1,0,5,3,2,4,Estonia - Esiliiga,0.5,1.0,2,2.5,2.0,1.0,1
Tartu Welco,2,1,1,0,4,3,1,4,Estonia - Esiliiga,0.5,1.0,1,2.0,2.0,1.0,1
Flora B,1,1,0,0,2,0,2,3,Estonia - Esiliiga,1.0,1.0,2,2.0,1.0,1.0,2
Nomme Utd,1,1,0,0,2,1,1,3,Estonia - Esiliiga,1.0,1.0,1,2.0,1.0,1.0,2
Nomme Kalju B,2,1,0,1,2,3,-1,3,Estonia - Esiliiga,0.5,0.5,-1,1.0,2.0,2.0,2
Viimsi,1,0,1,0,3,3,0,1,Estonia - Esiliiga,0.0,1.0,0,3.0,0.0,1.0,3
Tallinna K. B,2,0,1,1,2,3,-1,1,Estonia - Esiliiga,0.0,0.5,-1,1.0,0.0,2.0,3
Tammeka B,1,0,0,1,2,3,-1,0,Estonia - Esiliiga,0.0,0.0,-1,2.0,0.0,0.0,4
FC Tallinn,1,0,0,1,1,2,-1,0,Estonia - Esiliiga,0.0,0.0,-1,1.0,0.0,0.0,4
Levadia B,1,0,0,1,0,2,-2,0,Estonia - Esiliiga,0.0,0.0,-2,0.0,0.0,0.0,4
HB Torshavn,1,1,0,0,3,2,1,3,FaroeIslands - Premier League,1.0,1.0,1,3.0,1.0,1.0,1
07 Vestur,0,0,0,0,0,0,0,0,FaroeIslands - Premier League,0.0,0.0,0,0.0,0.0,0.0,2
B36 Torshavn,0,0,0,0,0,0,0,0,FaroeIslands - Premier League,0.0,0.0,0,0.0,0.0,0.0,2
Klaksvik,0,0,0,0,0,0,0,0,FaroeIslands - Premier League,0.0,0.0,0,0.0,0.0,0.0,2
NSI Runavik,0,0,0,0,0,0,0,0,FaroeIslands - Premier League,0.0,0.0,0,0.0,0.0,0.0,2
Streymur,0,0,0,0,0,0,0,0,FaroeIslands - Premier League,0.0,0.0,0,0.0,0.0,0.0,2
Suduroy,0,0,0,0,0,0,0,0,FaroeIslands - Premier League,0.0,0.0,0,0.0,0.0,0.0,2
TB Tvoroyri,0,0,0,0,0,0,0,0,FaroeIslands - Premier League,0.0,0.0,0,0.0,0.0,0.0,2
Vikingur,0,0,0,0,0,0,0,0,FaroeIslands - Premier League,0.0,0.0,0,0.0,0.0,0.0,2
B68 Toftir,1,0,0,1,2,3,-1,0,FaroeIslands - Premier League,0.0,0.0,-1,2.0,0.0,0.0,2
Skala,1,1,0,0,4,0,4,3,FaroeIslands - 1. Deild,1.0,1.0,4,4.0,1.0,1.0,1
AB Argir,1,1,0,0,3,1,2,3,FaroeIslands - 1. Deild,1.0,1.0,2,3.0,1.0,1.0,1
Vikingur B,1,1,0,0,3,1,2,3,FaroeIslands - 1. Deild,1.0,1.0,2,3.0,1.0,1.0,1
Streymur B,1,1,0,0,2,1,1,3,FaroeIslands - 1. Deild,1.0,1.0,1,2.0,1.0,1.0,1
B71 Sandur,1,1,0,0,1,0,1,3,FaroeIslands - 1. Deild,1.0,1.0,1,1.0,1.0,1.0,1
NSI Runavik B,1,0,0,1,1,2,-1,0,FaroeIslands - 1. Deild,0.0,0.0,-1,1.0,0.0,0.0,2
Klaksvik B,1,0,0,1,0,1,-1,0,FaroeIslands - 1. Deild,0.0,0.0,-1,0.0,0.0,0.0,2
B36 Torshavn B,1,0,0,1,1,3,-2,0,FaroeIslands - 1. Deild,0.0,0.0,-2,1.0,0.0,0.0,2
IF Fuglafjordur,1,0,0,1,1,3,-2,0,FaroeIslands - 1. Deild,0.0,0.0,-2,1.0,0.0,0.0,2
07 Vestur B,1,0,0,1,0,4,-4,0,FaroeIslands - 1. Deild,0.0,0.0,-4,0.0,0.0,0.0,2
Ilves,8,6,1,1,17,4,13,19,Finland - Veikkausliiga,0.75,0.88,13,2.12,1.33,1.14,1
KuPS,8,6,0,2,12,4,8,18,Finland - Veikkausliiga,0.75,0.75,8,1.5,1.33,1.33,2
Inter Turku,8,5,1,2,13,7,6,16,Finland - Veikkausliiga,0.62,0.75,6,1.62,1.61,1.33,3
Gnistan,8,4,2,2,12,11,1,14,Finland - Veikkausliiga,0.5,0.75,1,1.5,2.0,1.33,4
HJK Helsinki,8,3,2,3,10,7,3,11,Finland - Veikkausliiga,0.38,0.62,3,1.25,2.63,1.61,5
VPS,8,3,2,3,13,14,-1,11,Finland - Veikkausliiga,0.38,0.62,-1,1.62,2.63,1.61,5
Mariehamn,8,3,0,5,10,12,-2,9,Finland - Veikkausliiga,0.38,0.38,-2,1.25,2.63,2.63,6
Lahti,8,1,5,2,6,10,-4,8,Finland - Veikkausliiga,0.12,0.75,-4,0.75,8.33,1.33,7
Oulu,8,2,1,5,7,9,-2,7,Finland - Veikkausliiga,0.25,0.38,-2,0.88,4.0,2.63,8
Haka,8,2,1,5,9,15,-6,7,Finland - Veikkausliiga,0.25,0.38,-6,1.12,4.0,2.63,8
Ekenas IF,8,1,4,3,6,15,-9,7,Finland - Veikkausliiga,0.12,0.62,-9,0.75,8.33,1.61,8
SJK,8,1,2,5,7,16,-9,5,Finland - Veikkausliiga,0.12,0.38,-9,0.88,8.33,2.63,9
JaPS,8,5,1,2,17,13,4,16,Finland - Ykkosliga,0.62,0.75,4,2.12,1.61,1.33,1
JIPPO,8,5,0,3,17,9,8,15,Finland - Ykkosliga,0.62,0.62,8,2.12,1.61,1.61,2
PK-35,8,4,3,1,8,5,3,15,Finland - Ykkosliga,0.5,0.88,3,1.0,2.0,1.14,2
Jaro,8,5,0,3,15,14,1,15,Finland - Ykkosliga,0.62,0.62,1,1.88,1.61,1.61,2
KTP,8,4,2,2,26,14,12,14,Finland - Ykkosliga,0.5,0.75,12,3.25,2.0,1.33,3
KaPa,8,3,1,4,20,25,-5,10,Finland - Ykkosliga,0.38,0.5,-5,2.5,2.63,2.0,4
TPS,8,2,3,3,13,11,2,9,Finland - Ykkosliga,0.25,0.62,2,1.62,4.0,1.61,5
SalPa,8,2,1,5,8,18,-10,7,Finland - Ykkosliga,0.25,0.38,-10,1.0,4.0,2.63,6
SJK Akatemia,8,0,5,3,13,18,-5,5,Finland - Ykkosliga,0.0,0.62,-5,1.62,0.0,1.61,7
Mikkelin,8,1,2,5,9,19,-10,5,Finland - Ykkosliga,0.12,0.38,-10,1.12,8.33,2.63,7
KPV Kokkola,8,6,1,1,16,7,9,19,Finland - Ykkonen,0.75,0.88,9,2.0,1.33,1.14,1
Klubi-04,8,5,0,3,16,11,5,15,Finland - Ykkonen,0.62,0.62,5,2.0,1.61,1.61,2
JJK,8,5,0,3,14,15,-1,15,Finland - Ykkonen,0.62,0.62,-1,1.75,1.61,1.61,2
Atlantis,8,4,2,2,22,18,4,14,Finland - Ykkonen,0.5,0.75,4,2.75,2.0,1.33,3
OLS Oulu,8,4,2,2,21,19,2,14,Finland - Ykkonen,0.5,0.75,2,2.62,2.0,1.33,3
PKKU,8,4,1,3,24,18,6,13,Finland - Ykkonen,0.5,0.62,6,3.0,2.0,1.61,4
Rovaniemi,8,3,1,4,13,12,1,10,Finland - Ykkonen,0.38,0.5,1,1.62,2.63,2.0,5
VIFK,8,3,1,4,18,18,0,10,Finland - Ykkonen,0.38,0.5,0,2.25,2.63,2.0,5
Jazz Pori,8,3,1,4,18,20,-2,10,Finland - Ykkonen,0.38,0.5,-2,2.25,2.63,2.0,5
EPS,8,3,1,4,17,20,-3,10,Finland - Ykkonen,0.38,0.5,-3,2.12,2.63,2.0,5
KuPS Ak.,8,2,0,6,12,20,-8,6,Finland - Ykkonen,0.25,0.25,-8,1.5,4.0,4.0,6
Vaajakoski,8,0,2,6,10,23,-13,2,Finland - Ykkonen,0.0,0.25,-13,1.25,0.0,4.0,7
PEPO,8,4,4,0,15,9,6,16,Finland - Kakkonen Group A,0.5,1.0,6,1.88,2.0,1.0,1
Reipas,8,4,2,2,18,10,8,14,Finland - Kakkonen Group A,0.5,0.75,8,2.25,2.0,1.33,2
PPJ,8,4,1,3,17,12,5,13,Finland - Kakkonen Group A,0.5,0.62,5,2.12,2.0,1.61,3
NJS,8,3,4,1,16,12,4,13,Finland - Kakkonen Group A,0.38,0.88,4,2.0,2.63,1.14,3
Atlantis B,8,4,1,3,13,13,0,13,Finland - Kakkonen Group A,0.5,0.62,0,1.62,2.0,1.61,3
MYPA,8,3,3,2,13,13,0,12,Finland - Kakkonen Group A,0.38,0.75,0,1.62,2.63,1.33,4
Kiffen,8,3,2,3,12,9,3,11,Finland - Kakkonen Group A,0.38,0.62,3,1.5,2.63,1.61,5
JaPS B,8,2,1,5,11,19,-8,7,Finland - Kakkonen Group A,0.25,0.38,-8,1.38,4.0,2.63,6
GrIFK,8,1,3,4,9,15,-6,6,Finland - Kakkonen Group A,0.12,0.5,-6,1.12,8.33,2.0,7
Futura,8,1,1,6,7,19,-12,4,Finland - Kakkonen Group A,0.12,0.25,-12,0.88,8.33,4.0,8
Inter Turku B,8,7,1,0,30,7,23,22,Finland - Kakkonen Group B,0.88,1.0,23,3.75,1.14,1.0,1
HJS Akatemia,8,6,1,1,20,6,14,19,Finland - Kakkonen Group B,0.75,0.88,14,2.5,1.33,1.14,2
Tampere Utd,8,5,1,2,21,10,11,16,Finland - Kakkonen Group B,0.62,0.75,11,2.62,1.61,1.33,3
VJS,8,5,0,3,21,13,8,15,Finland - Kakkonen Group B,0.62,0.62,8,2.62,1.61,1.61,4
Ilves B,8,4,0,4,17,17,0,12,Finland - Kakkonen Group B,0.5,0.5,0,2.12,2.0,2.0,5
P-Iirot,8,4,0,4,11,11,0,12,Finland - Kakkonen Group B,0.5,0.5,0,1.38,2.0,2.0,5
TPV,8,2,3,3,16,19,-3,9,Finland - Kakkonen Group B,0.25,0.62,-3,2.0,4.0,1.61,6
Honka,8,2,3,3,14,17,-3,9,Finland - Kakkonen Group B,0.25,0.62,-3,1.75,4.0,1.61,6
Ilves-Kissat,8,2,1,5,17,30,-13,7,Finland - Kakkonen Group B,0.25,0.38,-13,2.12,4.0,2.63,7
Poxyt,8,1,0,7,10,22,-12,3,Finland - Kakkonen Group B,0.12,0.12,-12,1.25,8.33,8.33,8
EBK,8,0,0,8,8,35,-27,0,Finland - Kakkonen Group B,0.0,0.0,-27,1.0,0.0,0.0,9
TP-47,8,6,2,0,25,9,16,20,Finland - Kakkonen Group C,0.75,1.0,16,3.12,1.33,1.0,1
Narpes Kraft,8,6,0,2,26,15,11,18,Finland - Kakkonen Group C,0.75,0.75,11,3.25,1.33,1.33,2
GBK,8,5,0,3,15,13,2,15,Finland - Kakkonen Group C,0.62,0.62,2,1.88,1.61,1.61,3
JBK,8,4,2,2,14,10,4,14,Finland - Kakkonen Group C,0.5,0.75,4,1.75,2.0,1.33,4
Kuopion Elo,8,3,2,3,19,18,1,11,Finland - Kakkonen Group C,0.38,0.62,1,2.38,2.63,1.61,5
JS Hercules,8,3,2,3,18,18,0,11,Finland - Kakkonen Group C,0.38,0.62,0,2.25,2.63,1.61,5
SJK Akatemia B,8,2,1,5,16,21,-5,7,Finland - Kakkonen Group C,0.25,0.38,-5,2.0,4.0,2.63,6
OPS,8,2,1,5,14,23,-9,7,Finland - Kakkonen Group C,0.25,0.38,-9,1.75,4.0,2.63,6
JPS,8,1,3,4,19,17,2,6,Finland - Kakkonen Group C,0.12,0.5,2,2.38,8.33,2.0,7
OTP,8,1,0,7,12,33,-21,3,Finland - Kakkonen Group C,0.12,0.12,-21,1.5,8.33,8.33,8
Paris SG,8,7,1,0,24,9,15,22,France - Ligue 1,0.88,1.0,15,3.0,1.14,1.0,1
Nice,8,6,1,1,18,7,11,19,France - Ligue 1,0.75,0.88,11,2.25,1.33,1.14,2
Strasbourg,8,5,2,1,10,4,6,17,France - Ligue 1,0.62,0.88,6,1.25,1.61,1.14,3
Lille,8,5,0,3,14,11,3,15,France - Ligue 1,0.62,0.62,3,1.75,1.61,1.61,4
Brest,8,4,2,2,12,11,1,14,France - Ligue 1,0.5,0.75,1,1.5,2.0,1.33,5
Monaco,8,4,1,3,21,14,7,13,France - Ligue 1,0.5,0.62,7,2.62,2.0,1.61,6
Marseille,8,4,1,3,13,10,3,13,France - Ligue 1,0.5,0.62,3,1.62,2.0,1.61,6
Rennes,8,4,0,4,12,11,1,12,France - Ligue 1,0.5,0.5,1,1.5,2.0,2.0,7
Lyon,8,3,2,3,16,11,5,11,France - Ligue 1,0.38,0.62,5,2.0,2.63,1.61,8
Angers,8,3,2,3,10,12,-2,11,France - Ligue 1,0.38,0.62,-2,1.25,2.63,1.61,8
Toulouse,8,2,4,2,13,8,5,10,France - Ligue 1,0.25,0.75,5,1.62,4.0,1.33,9
Lens,8,3,0,5,9,13,-4,9,France - Ligue 1,0.38,0.38,-4,1.12,2.63,2.63,10
Nantes,8,2,3,3,10,17,-7,9,France - Ligue 1,0.25,0.62,-7,1.25,4.0,1.61,10
Le Havre,8,2,2,4,11,16,-5,8,France - Ligue 1,0.25,0.5,-5,1.38,4.0,2.0,11
Auxerre,8,1,4,3,10,12,-2,7,France - Ligue 1,0.12,0.62,-2,1.25,8.33,1.61,12
Montpellier,8,2,0,6,5,17,-12,6,France - Ligue 1,0.25,0.25,-12,0.62,4.0,4.0,13
Saint-Etienne,8,0,3,5,9,21,-12,3,France - Ligue 1,0.0,0.38,-12,1.12,0.0,2.63,14
Reims,8,0,2,6,5,17,-12,2,France - Ligue 1,0.0,0.25,-12,0.62,0.0,4.0,15
Metz,8,6,1,1,20,6,14,19,France - Ligue 2,0.75,0.88,14,2.5,1.33,1.14,1
Paris FC,8,6,0,2,16,10,6,18,France - Ligue 2,0.75,0.75,6,2.0,1.33,1.33,2
Lorient,8,6,0,2,15,9,6,18,France - Ligue 2,0.75,0.75,6,1.88,1.33,1.33,2
USL Dunkerque,8,5,1,2,11,4,7,16,France - Ligue 2,0.62,0.75,7,1.38,1.61,1.33,3
AC Ajaccio,8,5,1,2,12,9,3,16,France - Ligue 2,0.62,0.75,3,1.5,1.61,1.33,3
Guingamp,8,4,1,3,12,9,3,13,France - Ligue 2,0.5,0.62,3,1.5,2.0,1.61,4
Troyes,8,4,0,4,9,5,4,12,France - Ligue 2,0.5,0.5,4,1.12,2.0,2.0,5
Martigues,8,4,0,4,8,5,3,12,France - Ligue 2,0.5,0.5,3,1.0,2.0,2.0,5
Grenoble,8,3,3,2,10,9,1,12,France - Ligue 2,0.38,0.75,1,1.25,2.63,1.33,5
SC Bastia,8,3,3,2,7,6,1,12,France - Ligue 2,0.38,0.75,1,0.88,2.63,1.33,5
Laval,8,3,2,3,5,7,-2,11,France - Ligue 2,0.38,0.62,-2,0.62,2.63,1.61,6
Red Star,8,3,1,4,9,11,-2,10,France - Ligue 2,0.38,0.5,-2,1.12,2.63,2.0,7
Pau FC,8,2,3,3,9,15,-6,9,France - Ligue 2,0.25,0.62,-6,1.12,4.0,1.61,8
Annecy,8,3,0,5,6,13,-7,9,France - Ligue 2,0.38,0.38,-7,0.75,2.63,2.63,8
Rodez Aveyron,8,2,1,5,11,14,-3,7,France - Ligue 2,0.25,0.38,-3,1.38,4.0,2.63,9
Amiens,8,2,1,5,6,15,-9,7,France - Ligue 2,0.25,0.38,-9,0.75,4.0,2.63,9
Caen,8,1,1,6,4,12,-8,4,France - Ligue 2,0.12,0.25,-8,0.5,8.33,4.0,10
Clermont,8,0,2,6,6,16,-10,2,France - Ligue 2,0.0,0.25,-10,0.75,0.0,4.0,11
Le Mans,8,6,2,0,18,5,13,20,France - National,0.75,1.0,13,2.25,1.33,1.0,1
Valenciennes,8,4,4,0,8,3,5,16,France - National,0.5,1.0,5,1.0,2.0,1.0,2
Chateauroux,8,4,2,2,9,10,-1,14,France - National,0.5,0.75,-1,1.12,2.0,1.33,3
Boulogne,8,3,4,1,11,7,4,13,France - National,0.38,0.88,4,1.38,2.63,1.14,4
Versailles,8,3,3,2,13,11,2,12,France - National,0.38,0.75,2,1.62,2.63,1.33,5
Nancy,8,4,0,4,8,9,-1,12,France - National,0.5,0.5,-1,1.0,2.0,2.0,5
Villefranche,8,4,0,4,7,8,-1,12,France - National,0.5,0.5,-1,0.88,2.0,2.0,5
Rouen,8,3,2,3,9,8,1,11,France - National,0.38,0.62,1,1.12,2.63,1.61,6
Bourg-en-Bresse,8,2,5,1,6,5,1,11,France - National,0.25,0.88,1,0.75,4.0,1.14,6
Dijon,8,2,4,2,13,14,-1,10,France - National,0.25,0.75,-1,1.62,4.0,1.33,7
Aubagne,8,3,1,4,7,9,-2,10,France - National,0.38,0.5,-2,0.88,2.63,2.0,7
Paris 13 A.,8,2,3,3,6,8,-2,9,France - National,0.25,0.62,-2,0.75,4.0,1.61,8
Nimes,8,2,2,4,8,9,-1,8,France - National,0.25,0.5,-1,1.0,4.0,2.0,9
Quevilly Rouen,8,2,2,4,8,10,-2,8,France - National,0.25,0.5,-2,1.0,4.0,2.0,9
Orleans,8,2,2,4,12,15,-3,8,France - National,0.25,0.5,-3,1.5,4.0,2.0,9
Sochaux,8,0,5,3,6,10,-4,5,France - National,0.0,0.62,-4,0.75,0.0,1.61,10
Concarneau,8,1,1,6,8,16,-8,4,France - National,0.12,0.25,-8,1.0,8.33,4.0,11
Iberia,2,2,0,0,4,0,4,6,Georgia - Erovnuli Liga,1.0,1.0,4,2.0,1.0,1.0,1
Dinamo Tbilisi,1,1,0,0,2,1,1,3,Georgia - Erovnuli Liga,1.0,1.0,1,2.0,1.0,1.0,2
Torpedo Kutaisi,2,1,0,1,2,3,-1,3,Georgia - Erovnuli Liga,0.5,0.5,-1,1.0,2.0,2.0,2
Telavi,2,1,0,1,1,2,-1,3,Georgia - Erovnuli Liga,0.5,0.5,-1,0.5,2.0,2.0,2
Dila Gori,1,0,1,0,0,0,0,1,Georgia - Erovnuli Liga,0.0,1.0,0,0.0,0.0,1.0,3
Dinamo Batumi,1,0,1,0,0,0,0,1,Georgia - Erovnuli Liga,0.0,1.0,0,0.0,0.0,1.0,3
Gareji Sagarejo,1,0,1,0,0,0,0,1,Georgia - Erovnuli Liga,0.0,1.0,0,0.0,0.0,1.0,3
Gagra,2,0,1,1,1,2,-1,1,Georgia - Erovnuli Liga,0.0,0.5,-1,0.5,0.0,2.0,3
Samgurali,1,0,0,1,1,2,-1,0,Georgia - Erovnuli Liga,0.0,0.0,-1,1.0,0.0,0.0,4
Kolkheti Poti,1,0,0,1,0,1,-1,0,Georgia - Erovnuli Liga,0.0,0.0,-1,0.0,0.0,0.0,4
D. Tbilisi B,1,0,1,0,3,3,0,1,Georgia - Erovnuli Liga 2,0.0,1.0,0,3.0,0.0,1.0,1
Spaeri,1,0,1,0,3,3,0,1,Georgia - Erovnuli Liga 2,0.0,1.0,0,3.0,0.0,1.0,1
Gonio,1,0,1,0,1,1,0,1,Georgia - Erovnuli Liga 2,0.0,1.0,0,1.0,0.0,1.0,1
L. Tbilisi,1,0,1,0,1,1,0,1,Georgia - Erovnuli Liga 2,0.0,1.0,0,1.0,0.0,1.0,1
Bolnisi,0,0,0,0,0,0,0,0,Georgia - Erovnuli Liga 2,0.0,0.0,0,0.0,0.0,0.0,2
Iberia B,0,0,0,0,0,0,0,0,Georgia - Erovnuli Liga 2,0.0,0.0,0,0.0,0.0,0.0,2
Merani Martvili,0,0,0,0,0,0,0,0,Georgia - Erovnuli Liga 2,0.0,0.0,0,0.0,0.0,0.0,2
Meshakhte,0,0,0,0,0,0,0,0,Georgia - Erovnuli Liga 2,0.0,0.0,0,0.0,0.0,0.0,2
Rustavi,0,0,0,0,0,0,0,0,Georgia - Erovnuli Liga 2,0.0,0.0,0,0.0,0.0,0.0,2
Samtredia,0,0,0,0,0,0,0,0,Georgia - Erovnuli Liga 2,0.0,0.0,0,0.0,0.0,0.0,2
Bayern Munich,8,6,1,1,21,10,11,19,Germany - Bundesliga,0.75,0.88,11,2.62,1.33,1.14,1
FSV Mainz,8,5,1,2,12,5,7,16,Germany - Bundesliga,0.62,0.75,7,1.5,1.61,1.33,2
FC Augsburg,8,4,4,0,9,2,7,16,Germany - Bundesliga,0.5,1.0,7,1.12,2.0,1.0,2
Leverkusen,8,4,3,1,14,7,7,15,Germany - Bundesliga,0.5,0.88,7,1.75,2.0,1.14,3
Freiburg,8,4,2,2,9,6,3,14,Germany - Bundesliga,0.5,0.75,3,1.12,2.0,1.33,4
Monchengladbach,8,4,1,3,13,12,1,13,Germany - Bundesliga,0.5,0.62,1,1.62,2.0,1.61,5
E. Frankfurt,8,3,3,2,14,14,0,12,Germany - Bundesliga,0.38,0.75,0,1.75,2.63,1.33,6
Wolfsburg,8,2,5,1,11,10,1,11,Germany - Bundesliga,0.25,0.88,1,1.38,4.0,1.14,7
Hoffenheim,8,3,2,3,11,17,-6,11,Germany - Bundesliga,0.38,0.62,-6,1.38,2.63,1.61,7
Dortmund,8,3,1,4,13,10,3,10,Germany - Bundesliga,0.38,0.5,3,1.62,2.63,2.0,8
RB Leipzig,8,1,6,1,10,9,1,9,Germany - Bundesliga,0.12,0.88,1,1.25,8.33,1.14,9
Bochum,8,2,3,3,11,13,-2,9,Germany - Bundesliga,0.25,0.62,-2,1.38,4.0,1.61,9
Stuttgart,8,2,2,4,12,13,-1,8,Germany - Bundesliga,0.25,0.5,-1,1.5,4.0,2.0,10
Sankt Pauli,8,2,2,4,7,9,-2,8,Germany - Bundesliga,0.25,0.5,-2,0.88,4.0,2.0,10
Union Berlin,8,2,1,5,7,15,-8,7,Germany - Bundesliga,0.25,0.38,-8,0.88,4.0,2.63,11
Werder Bremen,8,2,1,5,7,17,-10,7,Germany - Bundesliga,0.25,0.38,-10,0.88,4.0,2.63,11
Holstein Kiel,8,1,3,4,12,18,-6,6,Germany - Bundesliga,0.12,0.5,-6,1.5,8.33,2.0,12
Heidenheim,8,0,2,6,7,17,-10,2,Germany - Bundesliga,0.0,0.25,-10,0.88,0.0,4.0,13
Hamburger SV,8,5,2,1,16,9,7,17,Germany - 2. Bundesliga,0.62,0.88,7,2.0,1.61,1.14,1
Kaiserslautern,8,5,2,1,13,8,5,17,Germany - 2. Bundesliga,0.62,0.88,5,1.62,1.61,1.14,1
FC Nurnberg,8,5,1,2,12,9,3,16,Germany - 2. Bundesliga,0.62,0.75,3,1.5,1.61,1.33,2
Magdeburg,8,4,2,2,23,14,9,14,Germany - 2. Bundesliga,0.5,0.75,9,2.88,2.0,1.33,3
Paderborn,8,4,1,3,11,7,4,13,Germany - 2. Bundesliga,0.5,0.62,4,1.38,2.0,1.61,4
Greuther Furth,8,4,1,3,13,12,1,13,Germany - 2. Bundesliga,0.5,0.62,1,1.62,2.0,1.61,4
Schalke 04,8,4,1,3,10,11,-1,13,Germany - 2. Bundesliga,0.5,0.62,-1,1.25,2.0,1.61,4
FC Koln,8,4,1,3,6,7,-1,13,Germany - 2. Bundesliga,0.5,0.62,-1,0.75,2.0,1.61,4
Elversberg,8,3,3,2,14,9,5,12,Germany - 2. Bundesliga,0.38,0.75,5,1.75,2.63,1.33,5
Hannover 96,8,2,6,0,9,7,2,12,Germany - 2. Bundesliga,0.25,1.0,2,1.12,4.0,1.0,5
Dusseldorf,8,3,3,2,14,15,-1,12,Germany - 2. Bundesliga,0.38,0.75,-1,1.75,2.63,1.33,5
Braunschweig,8,2,3,3,6,8,-2,9,Germany - 2. Bundesliga,0.25,0.62,-2,0.75,4.0,1.61,6
Preuss. Munster,8,2,2,4,8,10,-2,8,Germany - 2. Bundesliga,0.25,0.5,-2,1.0,4.0,2.0,7
Darmstadt,8,2,1,5,8,12,-4,7,Germany - 2. Bundesliga,0.25,0.38,-4,1.0,4.0,2.63,8
Karlsruher SC,8,2,1,5,10,15,-5,7,Germany - 2. Bundesliga,0.25,0.38,-5,1.25,4.0,2.63,8
Regensburg,8,2,1,5,7,15,-8,7,Germany - 2. Bundesliga,0.25,0.38,-8,0.88,4.0,2.63,8
Ulm,8,1,2,5,9,12,-3,5,Germany - 2. Bundesliga,0.12,0.38,-3,1.12,8.33,2.63,9
Hertha Berlin,8,1,1,6,6,15,-9,4,Germany - 2. Bundesliga,0.12,0.25,-9,0.75,8.33,4.0,10
Saarbrucken,8,6,0,2,18,10,8,18,Germany - 3. Liga,0.75,0.75,8,2.25,1.33,1.33,1
RW Essen,8,5,2,1,16,8,8,17,Germany - 3. Liga,0.62,0.88,8,2.0,1.61,1.14,2
Osnabruck,8,5,2,1,15,8,7,17,Germany - 3. Liga,0.62,0.88,7,1.88,1.61,1.14,2
Hansa Rostock,8,5,1,2,11,10,1,16,Germany - 3. Liga,0.62,0.75,1,1.38,1.61,1.33,3
Viktoria Koln,8,4,2,2,13,9,4,14,Germany - 3. Liga,0.5,0.75,4,1.62,2.0,1.33,4
Verl,8,4,2,2,9,9,0,14,Germany - 3. Liga,0.5,0.75,0,1.12,2.0,1.33,4
Dynamo Dresden,8,4,1,3,15,10,5,13,Germany - 3. Liga,0.5,0.62,5,1.88,2.0,1.61,5
Bielefeld,8,4,0,4,15,9,6,12,Germany - 3. Liga,0.5,0.5,6,1.88,2.0,2.0,6
Wehen Wiesbaden,8,4,0,4,10,9,1,12,Germany - 3. Liga,0.5,0.5,1,1.25,2.0,2.0,6
FC Ingolstadt,8,3,3,2,8,8,0,12,Germany - 3. Liga,0.38,0.75,0,1.0,2.63,1.33,6
Erzgebirge Aue,8,3,2,3,10,8,2,11,Germany - 3. Liga,0.38,0.62,2,1.25,2.63,1.61,7
Energie Cottbus,8,3,2,3,8,8,0,11,Germany - 3. Liga,0.38,0.62,0,1.0,2.63,1.61,7
VfB Stuttgart B,8,3,2,3,9,13,-4,11,Germany - 3. Liga,0.38,0.62,-4,1.12,2.63,1.61,7
Mannheim,8,2,4,2,12,8,4,10,Germany - 3. Liga,0.25,0.75,4,1.5,4.0,1.33,8
Dortmund B,8,2,2,4,5,11,-6,8,Germany - 3. Liga,0.25,0.5,-6,0.62,4.0,2.0,9
1860 Munchen,8,2,2,4,10,19,-9,8,Germany - 3. Liga,0.25,0.5,-9,1.25,4.0,2.0,9
Alemannia A.,8,1,3,4,8,11,-3,6,Germany - 3. Liga,0.12,0.5,-3,1.0,8.33,2.0,10
Sandhausen,8,1,2,5,11,15,-4,5,Germany - 3. Liga,0.12,0.38,-4,1.38,8.33,2.63,11
Unterhaching,8,1,2,5,9,15,-6,5,Germany - 3. Liga,0.12,0.38,-6,1.12,8.33,2.63,11
Hannover 96 B,8,1,1,6,9,23,-14,4,Germany - 3. Liga,0.12,0.25,-14,1.12,8.33,4.0,12
Asante Kotoko,8,6,1,1,13,4,9,19,Ghana - Premier League,0.75,0.88,9,1.62,1.33,1.14,1
Hearts of Oak,8,5,2,1,10,4,6,17,Ghana - Premier League,0.62,0.88,6,1.25,1.61,1.14,2
Bechem Utd,8,5,1,2,9,4,5,16,Ghana - Premier League,0.62,0.75,5,1.12,1.61,1.33,3
Heart of Lions,8,5,0,3,10,7,3,15,Ghana - Premier League,0.62,0.62,3,1.25,1.61,1.61,4
Bibiani GS,8,4,2,2,10,5,5,14,Ghana - Premier League,0.5,0.75,5,1.25,2.0,1.33,5
Holy Stars,8,3,2,3,11,9,2,11,Ghana - Premier League,0.38,0.62,2,1.38,2.63,1.61,6
Medeama,8,3,2,3,9,8,1,11,Ghana - Premier League,0.38,0.62,1,1.12,2.63,1.61,6
Berekum Chelsea,8,3,2,3,6,8,-2,11,Ghana - Premier League,0.38,0.62,-2,0.75,2.63,1.61,6
Young Apostles,8,3,2,3,6,8,-2,11,Ghana - Premier League,0.38,0.62,-2,0.75,2.63,1.61,6
Vision,8,3,2,3,9,12,-3,11,Ghana - Premier League,0.38,0.62,-3,1.12,2.63,1.61,6
Nations,8,3,1,4,9,8,1,10,Ghana - Premier League,0.38,0.5,1,1.12,2.63,2.0,7
Nsoatreman,8,2,3,3,6,7,-1,9,Ghana - Premier League,0.25,0.62,-1,0.75,4.0,1.61,8
Aduana Stars,8,2,3,3,4,6,-2,9,Ghana - Premier League,0.25,0.62,-2,0.5,4.0,1.61,8
Dreams,8,2,3,3,6,9,-3,9,Ghana - Premier League,0.25,0.62,-3,0.75,4.0,1.61,8
Karela,8,2,2,4,5,8,-3,8,Ghana - Premier League,0.25,0.5,-3,0.62,4.0,2.0,9
Samartex,8,1,4,3,3,5,-2,7,Ghana - Premier League,0.12,0.62,-2,0.38,8.33,1.61,10
Accra Lions,8,2,1,5,5,10,-5,7,Ghana - Premier League,0.25,0.38,-5,0.62,4.0,2.63,10
Legon Cities,8,2,0,6,4,11,-7,6,Ghana - Premier League,0.25,0.25,-7,0.5,4.0,4.0,11
St Josephs,8,7,1,0,26,6,20,22,Gibraltar - Premier Division,0.88,1.0,20,3.25,1.14,1.0,1
Lincoln RI,8,6,1,1,20,4,16,19,Gibraltar - Premier Division,0.75,0.88,16,2.5,1.33,1.14,2
Lions FC,8,5,2,1,15,9,6,17,Gibraltar - Premier Division,0.62,0.88,6,1.88,1.61,1.14,3
Europa FC,8,5,1,2,23,8,15,16,Gibraltar - Premier Division,0.62,0.75,15,2.88,1.61,1.33,4
Manchester 62,8,3,2,3,15,14,1,11,Gibraltar - Premier Division,0.38,0.62,1,1.88,2.63,1.61,5
College 1975,8,3,1,4,12,12,0,10,Gibraltar - Premier Division,0.38,0.5,0,1.5,2.63,2.0,6
Magpies,8,3,0,5,15,13,2,9,Gibraltar - Premier Division,0.38,0.38,2,1.88,2.63,2.63,7
Glacis Utd,8,3,0,5,16,25,-9,9,Gibraltar - Premier Division,0.38,0.38,-9,2.0,2.63,2.63,7
Lynx,8,2,1,5,8,23,-15,7,Gibraltar - Premier Division,0.25,0.38,-15,1.0,4.0,2.63,8
Mons Calpe,8,1,1,6,8,22,-14,4,Gibraltar - Premier Division,0.12,0.25,-14,1.0,8.33,4.0,9
Europa Point,8,0,2,6,7,23,-16,2,Gibraltar - Premier Division,0.0,0.25,-16,0.88,0.0,4.0,10
Olympiakos,8,6,2,0,14,5,9,20,Greece - Super League,0.75,1.0,9,1.75,1.33,1.0,1
AEK Athens,8,6,0,2,15,4,11,18,Greece - Super League,0.75,0.75,11,1.88,1.33,1.33,2
Atromitos,8,5,0,3,11,7,4,15,Greece - Super League,0.62,0.62,4,1.38,1.61,1.61,3
Aris,8,4,2,2,10,8,2,14,Greece - Super League,0.5,0.75,2,1.25,2.0,1.33,4
Panathinaikos,8,4,2,2,12,11,1,14,Greece - Super League,0.5,0.75,1,1.5,2.0,1.33,4
PAOK,8,4,1,3,18,6,12,13,Greece - Super League,0.5,0.62,12,2.25,2.0,1.61,5
OFI Crete,8,4,1,3,13,13,0,13,Greece - Super League,0.5,0.62,0,1.62,2.0,1.61,5
Asteras T.,8,4,1,3,8,9,-1,13,Greece - Super League,0.5,0.62,-1,1.0,2.0,1.61,5
Levadiakos,8,3,1,4,10,8,2,10,Greece - Super League,0.38,0.5,2,1.25,2.63,2.0,6
Panaitolikos,8,3,0,5,5,8,-3,9,Greece - Super League,0.38,0.38,-3,0.62,2.63,2.63,7
Panserraikos,8,2,2,4,9,17,-8,8,Greece - Super League,0.25,0.5,-8,1.12,4.0,2.0,8
A. Kallithea,8,2,0,6,6,12,-6,6,Greece - Super League,0.25,0.25,-6,0.75,4.0,4.0,9
Volos,8,1,2,5,6,11,-5,5,Greece - Super League,0.12,0.38,-5,0.75,8.33,2.63,10
Lamia,8,1,0,7,3,21,-18,3,Greece - Super League,0.12,0.12,-18,0.38,8.33,8.33,11
Malacateco,8,6,0,2,15,5,10,18,Guatemala - Liga Nacional - Apertura,0.75,0.75,10,1.88,1.33,1.33,1
Xelaju,8,5,2,1,16,5,11,17,Guatemala - Liga Nacional - Apertura,0.62,0.88,11,2.0,1.61,1.14,2
Municipal,8,4,2,2,13,13,0,14,Guatemala - Liga Nacional - Apertura,0.5,0.75,0,1.62,2.0,1.33,3
Coban Imperial,8,4,1,3,13,9,4,13,Guatemala - Liga Nacional - Apertura,0.5,0.62,4,1.62,2.0,1.61,4
Antigua GFC,8,3,3,2,14,11,3,12,Guatemala - Liga Nacional - Apertura,0.38,0.75,3,1.75,2.63,1.33,5
Xinabajul,8,3,2,3,15,14,1,11,Guatemala - Liga Nacional - Apertura,0.38,0.62,1,1.88,2.63,1.61,6
Comunicaciones,8,3,2,3,12,13,-1,11,Guatemala - Liga Nacional - Apertura,0.38,0.62,-1,1.5,2.63,1.61,6
Guastatoya,8,2,4,2,12,10,2,10,Guatemala - Liga Nacional - Apertura,0.25,0.75,2,1.5,4.0,1.33,7
Mixco,8,3,1,4,7,11,-4,10,Guatemala - Liga Nacional - Apertura,0.38,0.5,-4,0.88,2.63,2.0,7
Achuapa,8,2,3,3,6,10,-4,9,Guatemala - Liga Nacional - Apertura,0.25,0.62,-4,0.75,4.0,1.61,8
Marquense,8,0,3,5,4,16,-12,3,Guatemala - Liga Nacional - Apertura,0.0,0.38,-12,0.5,0.0,2.63,9
Zacapa Tellioz,8,0,2,6,3,14,-11,2,Guatemala - Liga Nacional - Apertura,0.0,0.25,-11,0.38,0.0,4.0,10
Olimpia,8,6,2,0,16,4,12,20,Honduras - Liga Nacional - Apertura,0.75,1.0,12,2.0,1.33,1.0,1
Genesis,8,4,3,1,16,8,8,15,Honduras - Liga Nacional - Apertura,0.5,0.88,8,2.0,2.0,1.14,2
Motagua,8,4,2,2,18,14,4,14,Honduras - Liga Nacional - Apertura,0.5,0.75,4,2.25,2.0,1.33,3
Olancho,8,3,4,1,15,10,5,13,Honduras - Liga Nacional - Apertura,0.38,0.88,5,1.88,2.63,1.14,4
Marathon,8,2,4,2,9,8,1,10,Honduras - Liga Nacional - Apertura,0.25,0.75,1,1.12,4.0,1.33,5
Juticalpa,8,2,2,4,7,14,-7,8,Honduras - Liga Nacional - Apertura,0.25,0.5,-7,0.88,4.0,2.0,6
UPNFM,8,2,2,4,6,16,-10,8,Honduras - Liga Nacional - Apertura,0.25,0.5,-10,0.75,4.0,2.0,6
Real Espana,8,1,4,3,6,7,-1,7,Honduras - Liga Nacional - Apertura,0.12,0.62,-1,0.75,8.33,1.61,7
Real Sociedad,8,1,3,4,10,17,-7,6,Honduras - Liga Nacional - Apertura,0.12,0.5,-7,1.25,8.33,2.0,8
Victoria,8,1,2,5,13,18,-5,5,Honduras - Liga Nacional - Apertura,0.12,0.38,-5,1.62,8.33,2.63,9
LM Warriors,8,6,1,1,20,12,8,19,Hong Kong - Premier League,0.75,0.88,8,2.5,1.33,1.14,1
Tai Po,8,6,0,2,18,10,8,18,Hong Kong - Premier League,0.75,0.75,8,2.25,1.33,1.33,2
Kitchee,8,5,2,1,19,8,11,17,Hong Kong - Premier League,0.62,0.88,11,2.38,1.61,1.14,3
Eastern,8,5,1,2,18,11,7,16,Hong Kong - Premier League,0.62,0.75,7,2.25,1.61,1.33,4
HK Rangers,8,2,2,4,15,19,-4,8,Hong Kong - Premier League,0.25,0.5,-4,1.88,4.0,2.0,5
Kowloon City,8,2,2,4,10,20,-10,8,Hong Kong - Premier League,0.25,0.5,-10,1.25,4.0,2.0,5
Southern D.,8,2,1,5,12,14,-2,7,Hong Kong - Premier League,0.25,0.38,-2,1.5,4.0,2.63,6
Hong Kong FC,8,2,1,5,4,13,-9,7,Hong Kong - Premier League,0.25,0.38,-9,0.5,4.0,2.63,6
North District,8,1,2,5,16,26,-10,5,Hong Kong - Premier League,0.12,0.38,-10,2.0,8.33,2.63,7
Gyor,8,5,2,1,16,7,9,17,Hungary - NB I,0.62,0.88,9,2.0,1.61,1.14,1
Paks,8,5,2,1,18,11,7,17,Hungary - NB I,0.62,0.88,7,2.25,1.61,1.14,1
Puskas A.,8,5,0,3,13,10,3,15,Hungary - NB I,0.62,0.62,3,1.62,1.61,1.61,2
Ferencvaros,8,3,3,2,9,8,1,12,Hungary - NB I,0.38,0.75,1,1.12,2.63,1.33,3
Zalaegerszegi,8,3,3,2,9,9,0,12,Hungary - NB I,0.38,0.75,0,1.12,2.63,1.33,3
Kecskemeti TE,8,2,5,1,13,9,4,11,Hungary - NB I,0.25,0.88,4,1.62,4.0,1.14,4
MTK Budapest,8,3,2,3,15,15,0,11,Hungary - NB I,0.38,0.62,0,1.88,2.63,1.61,4
Fehervar,8,3,1,4,10,12,-2,10,Hungary - NB I,0.38,0.5,-2,1.25,2.63,2.0,5
Debrecen,8,3,0,5,17,17,0,9,Hungary - NB I,0.38,0.38,0,2.12,2.63,2.63,6
DVTK,8,2,2,4,9,15,-6,8,Hungary - NB I,0.25,0.5,-6,1.12,4.0,2.0,7
Ujpest,8,1,4,3,6,13,-7,7,Hungary - NB I,0.12,0.62,-7,0.75,8.33,1.61,8
Nyiregyhaza,8,1,3,4,3,8,-5,6,Hungary - NB I,0.12,0.5,-5,0.38,8.33,2.0,9
Kazincbarcika,8,4,4,0,9,3,6,16,Hungary - NB II,0.5,1.0,6,1.12,2.0,1.0,1
Kisvarda,8,4,3,1,13,9,4,15,Hungary - NB II,0.5,0.88,4,1.62,2.0,1.14,2
Vasas,8,4,2,2,8,3,5,14,Hungary - NB II,0.5,0.75,5,1.0,2.0,1.33,3
Bekescsaba,8,4,1,3,8,7,1,13,Hungary - NB II,0.5,0.62,1,1.0,2.0,1.61,4
Szentlorinc,8,3,3,2,11,8,3,12,Hungary - NB II,0.38,0.75,3,1.38,2.63,1.33,5
Honved,8,3,2,3,13,9,4,11,Hungary - NB II,0.38,0.62,4,1.62,2.63,1.61,6
Ajka,8,3,2,3,10,8,2,11,Hungary - NB II,0.38,0.62,2,1.25,2.63,1.61,6
Szeged,8,3,2,3,9,8,1,11,Hungary - NB II,0.38,0.62,1,1.12,2.63,1.61,6
Mezokovesd,8,2,4,2,9,8,1,10,Hungary - NB II,0.25,0.75,1,1.12,4.0,1.33,7
Csakvari,8,3,1,4,11,15,-4,10,Hungary - NB II,0.38,0.5,-4,1.38,2.63,2.0,7
Kozarmisleny,8,3,1,4,10,14,-4,10,Hungary - NB II,0.38,0.5,-4,1.25,2.63,2.0,7
Tatabanya,8,3,1,4,7,11,-4,10,Hungary - NB II,0.38,0.5,-4,0.88,2.63,2.0,7
BVSC,8,2,3,3,6,8,-2,9,Hungary - NB II,0.25,0.62,-2,0.75,4.0,1.61,8
Soroksar,8,2,3,3,8,12,-4,9,Hungary - NB II,0.25,0.62,-4,1.0,4.0,1.61,8
Budafoki,8,2,1,5,9,14,-5,7,Hungary - NB II,0.25,0.38,-5,1.12,4.0,2.63,9
Gyirmot,8,1,3,4,11,15,-4,6,Hungary - NB II,0.12,0.5,-4,1.38,8.33,2.0,10
Breidablik,8,7,1,0,20,9,11,22,Iceland - Besta deild,0.88,1.0,11,2.5,1.14,1.0,1
Vikingur R.,8,6,1,1,24,12,12,19,Iceland - Besta deild,0.75,0.88,12,3.0,1.33,1.14,2
Stjarnan,8,5,2,1,17,8,9,17,Iceland - Besta deild,0.62,0.88,9,2.12,1.61,1.14,3
KR Reykjavik,8,5,1,2,26,12,14,16,Iceland - Besta deild,0.62,0.75,14,3.25,1.61,1.33,4
KA Akureyri,8,4,1,3,16,15,1,13,Iceland - Besta deild,0.5,0.62,1,2.0,2.0,1.61,5
Valur,8,3,3,2,22,14,8,12,Iceland - Besta deild,0.38,0.75,8,2.75,2.63,1.33,6
Vestri,8,2,2,4,11,14,-3,8,Iceland - Besta deild,0.25,0.5,-3,1.38,4.0,2.0,7
HK Kopavogur,8,2,2,4,12,22,-10,8,Iceland - Besta deild,0.25,0.5,-10,1.5,4.0,2.0,7
IA Akranes,8,2,0,6,12,22,-10,6,Iceland - Besta deild,0.25,0.25,-10,1.5,4.0,4.0,8
Hafnarfjordur,8,1,2,5,10,20,-10,5,Iceland - Besta deild,0.12,0.38,-10,1.25,8.33,2.63,9
Fylkir,8,1,2,5,8,18,-10,5,Iceland - Besta deild,0.12,0.38,-10,1.0,8.33,2.63,9
Fram,8,1,1,6,11,23,-12,4,Iceland - Besta deild,0.12,0.25,-12,1.38,8.33,4.0,10
Afturelding,8,6,1,1,18,7,11,19,Iceland - 1. Deild,0.75,0.88,11,2.25,1.33,1.14,1
Keflavik,8,5,2,1,17,9,8,17,Iceland - 1. Deild,0.62,0.88,8,2.12,1.61,1.14,2
Leiknir R.,8,4,4,0,18,10,8,16,Iceland - 1. Deild,0.5,1.0,8,2.25,2.0,1.0,3
IBV,8,4,2,2,22,12,10,14,Iceland - 1. Deild,0.5,0.75,10,2.75,2.0,1.33,4
IR Reykjavik,8,3,4,1,10,10,0,13,Iceland - 1. Deild,0.38,0.88,0,1.25,2.63,1.14,5
Throttur R.,8,3,2,3,15,12,3,11,Iceland - 1. Deild,0.38,0.62,3,1.88,2.63,1.61,6
Grindavik,8,2,3,3,18,19,-1,9,Iceland - 1. Deild,0.25,0.62,-1,2.25,4.0,1.61,7
Thor Akureyri,8,2,3,3,11,16,-5,9,Iceland - 1. Deild,0.25,0.62,-5,1.38,4.0,1.61,7
Njardvik,8,1,5,2,8,11,-3,8,Iceland - 1. Deild,0.12,0.75,-3,1.0,8.33,1.33,8
Fjolnir,8,1,3,4,6,14,-8,6,Iceland - 1. Deild,0.12,0.5,-8,0.75,8.33,2.0,9
Dalvik / Reynir,8,1,1,6,10,25,-15,4,Iceland - 1. Deild,0.12,0.25,-15,1.25,8.33,4.0,10
Grotta,8,1,0,7,9,17,-8,3,Iceland - 1. Deild,0.12,0.12,-8,1.12,8.33,8.33,11
Throttur Vogar,8,6,2,0,29,7,22,20,Iceland - 2. Deild,0.75,1.0,22,3.62,1.33,1.0,1
Selfoss,8,6,1,1,22,12,10,19,Iceland - 2. Deild,0.75,0.88,10,2.75,1.33,1.14,2
Volsungur,8,5,3,0,21,7,14,18,Iceland - 2. Deild,0.62,1.0,14,2.62,1.61,1.0,3
V. Olafsvik,8,5,1,2,19,13,6,16,Iceland - 2. Deild,0.62,0.75,6,2.38,1.61,1.33,4
Haukar,8,3,1,4,16,14,2,10,Iceland - 2. Deild,0.38,0.5,2,2.0,2.63,2.0,5
Fjardabyggd/L.,8,3,1,4,23,24,-1,10,Iceland - 2. Deild,0.38,0.5,-1,2.88,2.63,2.0,5
AEggir,8,2,4,2,9,12,-3,10,Iceland - 2. Deild,0.25,0.75,-3,1.12,4.0,1.33,5
Hottur/Huginn,8,3,0,5,11,23,-12,9,Iceland - 2. Deild,0.38,0.38,-12,1.38,2.63,2.63,6
KFG,8,2,2,4,12,16,-4,8,Iceland - 2. Deild,0.25,0.5,-4,1.5,4.0,2.0,7
Reynir,8,2,1,5,11,16,-5,7,Iceland - 2. Deild,0.25,0.38,-5,1.38,4.0,2.63,8
Fjallabyggd,8,2,1,5,12,22,-10,7,Iceland - 2. Deild,0.25,0.38,-10,1.5,4.0,2.63,8
Kormakur/Hvot,8,0,1,7,5,24,-19,1,Iceland - 2. Deild,0.0,0.12,-19,0.62,0.0,8.33,9
Mohun Bagan,8,6,2,0,16,2,14,20,India - Super League,0.75,1.0,14,2.0,1.33,1.0,1
Goa,8,6,0,2,13,7,6,18,India - Super League,0.75,0.75,6,1.62,1.33,1.33,2
NorthEast Utd,8,4,2,2,15,7,8,14,India - Super League,0.5,0.75,8,1.88,2.0,1.33,3
East Bengal,8,4,2,2,11,11,0,14,India - Super League,0.5,0.75,0,1.38,2.0,1.33,3
Odisha FC,8,3,3,2,13,11,2,12,India - Super League,0.38,0.75,2,1.62,2.63,1.33,4
Bengaluru,8,3,2,3,12,9,3,11,India - Super League,0.38,0.62,3,1.5,2.63,1.61,5
Kerala Blasters,8,3,2,3,9,11,-2,11,India - Super League,0.38,0.62,-2,1.12,2.63,1.61,5
Mumbai City,8,2,4,2,9,7,2,10,India - Super League,0.25,0.75,2,1.12,4.0,1.33,6
Jamshedpur,8,3,1,4,12,14,-2,10,India - Super League,0.38,0.5,-2,1.5,2.63,2.0,6
Chennaiyin,8,2,2,4,8,12,-4,8,India - Super League,0.25,0.5,-4,1.0,4.0,2.0,7
Hyderabad,8,2,2,4,10,16,-6,8,India - Super League,0.25,0.5,-6,1.25,4.0,2.0,7
Punjab,8,2,1,5,10,15,-5,7,India - Super League,0.25,0.38,-5,1.25,4.0,2.63,8
Mohammedan,8,0,2,6,4,19,-15,2,India - Super League,0.0,0.25,-15,0.5,0.0,4.0,9
Churchill B.,8,4,4,0,19,9,10,16,India - I-League,0.5,1.0,10,2.38,2.0,1.0,1
Real Kashmir,8,5,1,2,11,9,2,16,India - I-League,0.62,0.75,2,1.38,1.61,1.33,1
Inter Kashi,8,4,2,2,12,10,2,14,India - I-League,0.5,0.75,2,1.5,2.0,1.33,2
Sreenidi Deccan,8,4,2,2,11,10,1,14,India - I-League,0.5,0.75,1,1.38,2.0,1.33,2
Shillong Lajong,8,4,1,3,17,18,-1,13,India - I-League,0.5,0.62,-1,2.12,2.0,1.61,3
Gokulam,8,4,0,4,22,16,6,12,India - I-League,0.5,0.5,6,2.75,2.0,2.0,4
Rajasthan,8,3,3,2,14,8,6,12,India - I-League,0.38,0.75,6,1.75,2.63,1.33,4
Dempo,8,3,2,3,18,14,4,11,India - I-League,0.38,0.62,4,2.25,2.63,1.61,5
Namdhari,8,2,3,3,11,11,0,9,India - I-League,0.25,0.62,0,1.38,4.0,1.61,6
SC Bengaluru,8,2,3,3,8,15,-7,9,India - I-League,0.25,0.62,-7,1.0,4.0,1.61,6
Aizawl,8,2,2,4,9,15,-6,8,India - I-League,0.25,0.5,-6,1.12,4.0,2.0,7
Delhi FC,8,1,1,6,7,15,-8,4,India - I-League,0.12,0.25,-8,0.88,8.33,4.0,8
Dewa Utd,8,7,0,1,22,8,14,21,Indonesia - Liga 1,0.88,0.88,14,2.75,1.14,1.14,1
Malut United,8,5,3,0,13,5,8,18,Indonesia - Liga 1,0.62,1.0,8,1.62,1.61,1.0,2
Barito Putera,8,5,2,1,17,9,8,17,Indonesia - Liga 1,0.62,0.88,8,2.12,1.61,1.14,3
Persib,8,4,2,2,12,10,2,14,Indonesia - Liga 1,0.5,0.75,2,1.5,2.0,1.33,4
Persis Solo,8,3,4,1,11,10,1,13,Indonesia - Liga 1,0.38,0.88,1,1.38,2.63,1.14,5
Bali Utd,8,3,3,2,15,12,3,12,Indonesia - Liga 1,0.38,0.75,3,1.88,2.63,1.33,6
Persija,8,3,3,2,15,12,3,12,Indonesia - Liga 1,0.38,0.75,3,1.88,2.63,1.33,6
Madura Utd,8,3,3,2,10,9,1,12,Indonesia - Liga 1,0.38,0.75,1,1.25,2.63,1.33,6
Borneo,8,4,0,4,10,11,-1,12,Indonesia - Liga 1,0.5,0.5,-1,1.25,2.0,2.0,6
Persebaya S.,8,3,1,4,8,11,-3,10,Indonesia - Liga 1,0.38,0.5,-3,1.0,2.63,2.0,7
PSM,8,2,3,3,9,9,0,9,Indonesia - Liga 1,0.25,0.62,0,1.12,4.0,1.61,8
Semen Padang,8,2,3,3,11,18,-7,9,Indonesia - Liga 1,0.25,0.62,-7,1.38,4.0,1.61,8
Arema,8,2,2,4,13,15,-2,8,Indonesia - Liga 1,0.25,0.5,-2,1.62,4.0,2.0,9
PSBS Biak N.,8,1,5,2,7,9,-2,8,Indonesia - Liga 1,0.12,0.75,-2,0.88,8.33,1.33,9
Persita,8,1,3,4,6,11,-5,6,Indonesia - Liga 1,0.12,0.5,-5,0.75,8.33,2.0,10
PSIS Semarang,8,1,2,5,9,15,-6,5,Indonesia - Liga 1,0.12,0.38,-6,1.12,8.33,2.63,11
Persik Kediri,8,0,4,4,5,11,-6,4,Indonesia - Liga 1,0.0,0.5,-6,0.62,0.0,2.0,12
PSS Sleman,8,1,1,6,8,17,-9,4,Indonesia - Liga 1,0.12,0.25,-9,1.0,8.33,4.0,12
Persepolis,8,5,3,0,13,3,10,18,Iran - Pro League,0.62,1.0,10,1.62,1.61,1.0,1
Tractor Sazi,8,5,2,1,15,4,11,17,Iran - Pro League,0.62,0.88,11,1.88,1.61,1.14,2
Gol Gohar,8,5,2,1,9,3,6,17,Iran - Pro League,0.62,0.88,6,1.12,1.61,1.14,2
Sepahan,8,3,5,0,12,6,6,14,Iran - Pro League,0.38,1.0,6,1.5,2.63,1.0,3
Foolad,8,4,2,2,10,9,1,14,Iran - Pro League,0.5,0.75,1,1.25,2.0,1.33,3
Aluminium Arak,8,3,3,2,10,6,4,12,Iran - Pro League,0.38,0.75,4,1.25,2.63,1.33,4
Malavan,8,3,2,3,6,6,0,11,Iran - Pro League,0.38,0.62,0,0.75,2.63,1.61,5
Esteghlal,8,2,4,2,5,4,1,10,Iran - Pro League,0.25,0.75,1,0.62,4.0,1.33,6
K. Khorramabad,8,3,1,4,8,9,-1,10,Iran - Pro League,0.38,0.5,-1,1.0,2.63,2.0,6
Mes Rafsanjan,8,2,3,3,7,12,-5,9,Iran - Pro League,0.25,0.62,-5,0.88,4.0,1.61,7
Chadormalu,8,2,2,4,6,7,-1,8,Iran - Pro League,0.25,0.5,-1,0.75,4.0,2.0,8
Shams A. Qazvin,8,2,2,4,6,9,-3,8,Iran - Pro League,0.25,0.5,-3,0.75,4.0,2.0,8
Zob Ahan,8,1,4,3,6,9,-3,7,Iran - Pro League,0.12,0.62,-3,0.75,8.33,1.61,9
E. Khuzestan,8,1,3,4,5,13,-8,6,Iran - Pro League,0.12,0.5,-8,0.62,8.33,2.0,10
N. Mazandaran,8,1,2,5,3,7,-4,5,Iran - Pro League,0.12,0.38,-4,0.38,8.33,2.63,11
Havadar,8,1,1,6,2,21,-19,4,Iran - Pro League,0.12,0.25,-19,0.25,8.33,4.0,12
Drogheda Utd,5,3,2,0,6,1,5,11,Ireland - Premier Division,0.6,1.0,5,1.2,1.67,1.0,1
Waterford,5,3,0,2,7,8,-1,9,Ireland - Premier Division,0.6,0.6,-1,1.4,1.67,1.67,2
Shelbourne,5,2,2,1,6,4,2,8,Ireland - Premier Division,0.4,0.8,2,1.2,2.5,1.25,3
Galway Utd,5,1,4,0,7,6,1,7,Ireland - Premier Division,0.2,1.0,1,1.4,5.0,1.0,4
St. Patricks,5,2,1,2,7,6,1,7,Ireland - Premier Division,0.4,0.6,1,1.4,2.5,1.67,4
Bohemians,5,2,0,3,5,4,1,6,Ireland - Premier Division,0.4,0.4,1,1.0,2.5,2.5,5
Cork City,4,1,2,1,6,6,0,5,Ireland - Premier Division,0.25,0.75,0,1.5,4.0,1.33,6
Shamrock Rovers,4,1,1,2,3,4,-1,4,Ireland - Premier Division,0.25,0.5,-1,0.75,4.0,2.0,7
Sligo Rovers,5,1,1,3,8,12,-4,4,Ireland - Premier Division,0.2,0.4,-4,1.6,5.0,2.5,7
Derry City,5,1,1,3,4,8,-4,4,Ireland - Premier Division,0.2,0.4,-4,0.8,5.0,2.5,7
Dundalk,4,3,1,0,5,2,3,10,Ireland - First Division,0.75,1.0,3,1.25,1.33,1.0,1
Cobh Ramblers,4,2,2,0,9,3,6,8,Ireland - First Division,0.5,1.0,6,2.25,2.0,1.0,2
Treaty Utd,4,2,1,1,12,6,6,7,Ireland - First Division,0.5,0.75,6,3.0,2.0,1.33,3
Wexford,3,2,0,1,5,1,4,6,Ireland - First Division,0.67,0.67,4,1.67,1.49,1.49,4
Bray Wanderers,3,2,0,1,2,2,0,6,Ireland - First Division,0.67,0.67,0,0.67,1.49,1.49,4
Kerry,4,1,1,2,2,2,0,4,Ireland - First Division,0.25,0.5,0,0.5,4.0,2.0,5
Athlone Town,4,1,1,2,2,7,-5,4,Ireland - First Division,0.25,0.5,-5,0.5,4.0,2.0,5
UC Dublin,3,0,2,1,2,5,-3,2,Ireland - First Division,0.0,0.67,-3,0.67,0.0,1.49,6
Finn Harps,4,0,1,3,2,7,-5,1,Ireland - First Division,0.0,0.25,-5,0.5,0.0,4.0,7
Longford Town,3,0,1,2,1,7,-6,1,Ireland - First Division,0.0,0.33,-6,0.33,0.0,3.03,7
M. Tel Aviv,8,6,1,1,18,7,11,19,Israel - Ligat HaAl,0.75,0.88,11,2.25,1.33,1.14,1
H. Beer Sheva,8,6,1,1,15,5,10,19,Israel - Ligat HaAl,0.75,0.88,10,1.88,1.33,1.14,1
Maccabi Haifa,8,4,3,1,18,12,6,15,Israel - Ligat HaAl,0.5,0.88,6,2.25,2.0,1.14,2
Maccabi Netanya,8,4,2,2,11,10,1,14,Israel - Ligat HaAl,0.5,0.75,1,1.38,2.0,1.33,3
Hapoel Haifa,8,4,2,2,14,14,0,14,Israel - Ligat HaAl,0.5,0.75,0,1.75,2.0,1.33,3
B. Jerusalem,8,3,3,2,11,10,1,12,Israel - Ligat HaAl,0.38,0.75,1,1.38,2.63,1.33,4
Ironi Tiberias,8,3,2,3,8,14,-6,11,Israel - Ligat HaAl,0.38,0.62,-6,1.0,2.63,1.61,5
H. Jerusalem,8,2,4,2,12,9,3,10,Israel - Ligat HaAl,0.25,0.75,3,1.5,4.0,1.33,6
M. Petah Tikva,8,3,1,4,9,9,0,10,Israel - Ligat HaAl,0.38,0.5,0,1.12,2.63,2.0,6
Kiryat Shmona,8,2,2,4,8,13,-5,8,Israel - Ligat HaAl,0.25,0.5,-5,1.0,4.0,2.0,7
Ashdod,8,1,4,3,10,11,-1,7,Israel - Ligat HaAl,0.12,0.62,-1,1.25,8.33,1.61,8
Hapoel Hadera,8,2,1,5,8,13,-5,7,Israel - Ligat HaAl,0.25,0.38,-5,1.0,4.0,2.63,8
M. Bnei Raina,8,2,1,5,5,11,-6,7,Israel - Ligat HaAl,0.25,0.38,-6,0.62,4.0,2.63,8
Sakhnin,8,1,0,7,4,13,-9,3,Israel - Ligat HaAl,0.12,0.12,-9,0.5,8.33,8.33,9
Hapoel Tel Aviv,8,7,1,0,19,2,17,22,Israel - Leumit League,0.88,1.0,17,2.38,1.14,1.0,1
H. Petah Tikva,8,7,1,0,18,3,15,22,Israel - Leumit League,0.88,1.0,15,2.25,1.14,1.0,1
H. Kfar Shalem,8,4,2,2,15,9,6,14,Israel - Leumit League,0.5,0.75,6,1.88,2.0,1.33,2
Hapoel Raanana,8,4,2,2,7,4,3,14,Israel - Leumit League,0.5,0.75,3,0.88,2.0,1.33,2
Hapoel Akko,8,4,1,3,7,9,-2,13,Israel - Leumit League,0.5,0.62,-2,0.88,2.0,1.61,3
H. Ironi Rishon,8,3,3,2,13,9,4,12,Israel - Leumit League,0.38,0.75,4,1.62,2.63,1.33,4
Kafr Qasim,8,3,2,3,7,6,1,11,Israel - Leumit League,0.38,0.62,1,0.88,2.63,1.61,5
Bnei Yehuda,8,3,2,3,8,8,0,11,Israel - Leumit League,0.38,0.62,0,1.0,2.63,1.61,5
H. Kfar Saba,8,3,1,4,10,10,0,10,Israel - Leumit League,0.38,0.5,0,1.25,2.63,2.0,6
M. Herziliya,8,3,1,4,8,12,-4,10,Israel - Leumit League,0.38,0.5,-4,1.0,2.63,2.0,6
Maccabi Jaffa,8,2,3,3,6,9,-3,9,Israel - Leumit League,0.25,0.62,-3,0.75,4.0,1.61,7
H. Ramat Gan,8,2,2,4,6,6,0,8,Israel - Leumit League,0.25,0.5,0,0.75,4.0,2.0,8
Hapoel Afula,8,2,1,5,4,12,-8,7,Israel - Leumit League,0.25,0.38,-8,0.5,4.0,2.63,9
H. Umm al-Fahm,8,2,1,5,3,12,-9,7,Israel - Leumit League,0.25,0.38,-9,0.38,4.0,2.63,9
H. Nof Hagalil,8,1,1,6,2,10,-8,4,Israel - Leumit League,0.12,0.25,-8,0.25,8.33,4.0,10
Ramat Hasharon,8,1,1,6,4,17,-13,4,Israel - Leumit League,0.12,0.25,-13,0.5,8.33,4.0,10
AS Roma,8,6,2,0,16,6,10,20,Italy - Serie A,0.75,1.0,10,2.0,1.33,1.0,1
Juventus,8,6,1,1,14,5,9,19,Italy - Serie A,0.75,0.88,9,1.75,1.33,1.14,2
Bologna,8,5,2,1,13,8,5,17,Italy - Serie A,0.62,0.88,5,1.62,1.61,1.14,3
Lazio,8,4,3,1,16,8,8,15,Italy - Serie A,0.5,0.88,8,2.0,2.0,1.14,4
Inter Milan,8,4,2,2,12,9,3,14,Italy - Serie A,0.5,0.75,3,1.5,2.0,1.33,5
Udinese,8,4,2,2,11,9,2,14,Italy - Serie A,0.5,0.75,2,1.38,2.0,1.33,5
Atalanta,8,3,4,1,16,6,10,13,Italy - Serie A,0.38,0.88,10,2.0,2.63,1.14,6
Torino,8,3,4,1,13,9,4,13,Italy - Serie A,0.38,0.88,4,1.62,2.63,1.14,6
Napoli,8,3,4,1,13,10,3,13,Italy - Serie A,0.38,0.88,3,1.62,2.63,1.14,6
AC Milan,8,4,1,3,13,11,2,13,Italy - Serie A,0.5,0.62,2,1.62,2.0,1.61,6
Fiorentina,8,4,1,3,10,8,2,13,Italy - Serie A,0.5,0.62,2,1.25,2.0,1.61,6
Como,8,3,1,4,12,11,1,10,Italy - Serie A,0.38,0.5,1,1.5,2.63,2.0,7
Genoa,8,2,3,3,9,9,0,9,Italy - Serie A,0.25,0.62,0,1.12,4.0,1.61,8
Cagliari,8,2,2,4,9,10,-1,8,Italy - Serie A,0.25,0.5,-1,1.12,4.0,2.0,9
Hellas Verona,8,2,1,5,3,14,-11,7,Italy - Serie A,0.25,0.38,-11,0.38,4.0,2.63,10
Parma,8,1,2,5,9,13,-4,5,Italy - Serie A,0.12,0.38,-4,1.12,8.33,2.63,11
Venezia,8,0,5,3,5,9,-4,5,Italy - Serie A,0.0,0.62,-4,0.62,0.0,1.61,11
Lecce,8,1,2,5,6,14,-8,5,Italy - Serie A,0.12,0.38,-8,0.75,8.33,2.63,11
Empoli,8,0,2,6,5,22,-17,2,Italy - Serie A,0.0,0.25,-17,0.62,0.0,4.0,12
Monza,8,0,1,7,4,20,-16,1,Italy - Serie A,0.0,0.12,-16,0.5,0.0,8.33,13
Sassuolo,8,6,1,1,16,6,10,19,Italy - Serie B,0.75,0.88,10,2.0,1.33,1.14,1
Cesena,8,4,3,1,12,9,3,15,Italy - Serie B,0.5,0.88,3,1.5,2.0,1.14,2
Catanzaro,8,4,3,1,11,10,1,15,Italy - Serie B,0.5,0.88,1,1.38,2.0,1.14,2
Pisa,8,4,2,2,9,6,3,14,Italy - Serie B,0.5,0.75,3,1.12,2.0,1.33,3
Spezia,8,3,4,1,13,7,6,13,Italy - Serie B,0.38,0.88,6,1.62,2.63,1.14,4
Cremonese,8,3,3,2,16,10,6,12,Italy - Serie B,0.38,0.75,6,2.0,2.63,1.33,5
Palermo,8,3,3,2,12,9,3,12,Italy - Serie B,0.38,0.75,3,1.5,2.63,1.33,5
Sudtirol,8,3,3,2,13,11,2,12,Italy - Serie B,0.38,0.75,2,1.62,2.63,1.33,5
Bari,8,2,5,1,9,9,0,11,Italy - Serie B,0.25,0.88,0,1.12,4.0,1.14,6
Salernitana,8,3,2,3,7,8,-1,11,Italy - Serie B,0.38,0.62,-1,0.88,2.63,1.61,6
Modena,8,2,4,2,10,8,2,10,Italy - Serie B,0.25,0.75,2,1.25,4.0,1.33,7
Juve Stabia,8,3,1,4,10,10,0,10,Italy - Serie B,0.38,0.5,0,1.25,2.63,2.0,7
Sampdoria,8,2,4,2,8,8,0,10,Italy - Serie B,0.25,0.75,0,1.0,4.0,1.33,7
Frosinone,8,2,4,2,8,10,-2,10,Italy - Serie B,0.25,0.75,-2,1.0,4.0,1.33,7
Cittadella,8,3,1,4,4,7,-3,10,Italy - Serie B,0.38,0.5,-3,0.5,2.63,2.0,7
Brescia,8,1,4,3,7,10,-3,7,Italy - Serie B,0.12,0.62,-3,0.88,8.33,1.61,8
Cosenza,8,2,1,5,4,12,-8,7,Italy - Serie B,0.25,0.38,-8,0.5,4.0,2.63,8
Reggiana,8,1,3,4,7,11,-4,6,Italy - Serie B,0.12,0.5,-4,0.88,8.33,2.0,9
Mantova,8,1,3,4,9,15,-6,6,Italy - Serie B,0.12,0.5,-6,1.12,8.33,2.0,9
Carrarese,8,1,2,5,9,16,-7,5,Italy - Serie B,0.12,0.38,-7,1.12,8.33,2.63,10
Vicenza,8,6,1,1,16,4,12,19,Italy - Serie C - Group A,0.75,0.88,12,2.0,1.33,1.14,1
Triestina,8,5,2,1,12,7,5,17,Italy - Serie C - Group A,0.62,0.88,5,1.5,1.61,1.14,2
Virtus Verona,8,5,1,2,17,10,7,16,Italy - Serie C - Group A,0.62,0.75,7,2.12,1.61,1.33,3
Giana Erminio,8,5,1,2,13,9,4,16,Italy - Serie C - Group A,0.62,0.75,4,1.62,1.61,1.33,3
FeralpiSalo,8,5,1,2,12,8,4,16,Italy - Serie C - Group A,0.62,0.75,4,1.5,1.61,1.33,3
Novara,8,4,3,1,11,6,5,15,Italy - Serie C - Group A,0.5,0.88,5,1.38,2.0,1.14,4
Pergolettese,8,4,2,2,10,7,3,14,Italy - Serie C - Group A,0.5,0.75,3,1.25,2.0,1.33,5
Padova,8,3,3,2,11,6,5,12,Italy - Serie C - Group A,0.38,0.75,5,1.38,2.63,1.33,6
AlbinoLeffe,8,3,3,2,7,9,-2,12,Italy - Serie C - Group A,0.38,0.75,-2,0.88,2.63,1.33,6
Pro Vercelli,8,3,2,3,7,8,-1,11,Italy - Serie C - Group A,0.38,0.62,-1,0.88,2.63,1.61,7
Trento,8,2,4,2,12,9,3,10,Italy - Serie C - Group A,0.25,0.75,3,1.5,4.0,1.33,8
Lumezzane,8,2,3,3,10,10,0,9,Italy - Serie C - Group A,0.25,0.62,0,1.25,4.0,1.61,9
Arzignano,8,2,3,3,7,11,-4,9,Italy - Serie C - Group A,0.25,0.62,-4,0.88,4.0,1.61,9
Lecco,8,2,3,3,6,11,-5,9,Italy - Serie C - Group A,0.25,0.62,-5,0.75,4.0,1.61,9
Alcione,8,2,2,4,6,10,-4,8,Italy - Serie C - Group A,0.25,0.5,-4,0.75,4.0,2.0,10
Clodiense,8,2,1,5,6,13,-7,7,Italy - Serie C - Group A,0.25,0.38,-7,0.75,4.0,2.63,11
Renate,8,2,0,6,3,9,-6,6,Italy - Serie C - Group A,0.25,0.25,-6,0.38,4.0,4.0,12
Atalanta B,8,1,2,5,8,14,-6,5,Italy - Serie C - Group A,0.12,0.38,-6,1.0,8.33,2.63,13
Caldiero Terme,8,1,2,5,8,14,-6,5,Italy - Serie C - Group A,0.12,0.38,-6,1.0,8.33,2.63,13
Pro Patria,8,1,1,6,7,14,-7,4,Italy - Serie C - Group A,0.12,0.25,-7,0.88,8.33,4.0,14
Entella,8,6,2,0,14,4,10,20,Italy - Serie C - Group B,0.75,1.0,10,1.75,1.33,1.0,1
Ternana,8,6,0,2,13,5,8,18,Italy - Serie C - Group B,0.75,0.75,8,1.62,1.33,1.33,2
Pianese,8,5,0,3,10,8,2,15,Italy - Serie C - Group B,0.62,0.62,2,1.25,1.61,1.61,3
Torres,8,4,3,1,7,5,2,15,Italy - Serie C - Group B,0.5,0.88,2,0.88,2.0,1.14,3
Pineto,8,4,2,2,10,7,3,14,Italy - Serie C - Group B,0.5,0.75,3,1.25,2.0,1.33,4
Arezzo,8,4,1,3,11,8,3,13,Italy - Serie C - Group B,0.5,0.62,3,1.38,2.0,1.61,5
Pescara,8,3,3,2,14,11,3,12,Italy - Serie C - Group B,0.38,0.75,3,1.75,2.63,1.33,6
Rimini,8,3,3,2,7,4,3,12,Italy - Serie C - Group B,0.38,0.75,3,0.88,2.63,1.33,6
Pontedera,8,4,0,4,12,12,0,12,Italy - Serie C - Group B,0.5,0.5,0,1.5,2.0,2.0,6
Lucchese,8,3,3,2,10,11,-1,12,Italy - Serie C - Group B,0.38,0.75,-1,1.25,2.63,1.33,6
Gubbio,8,3,3,2,6,7,-1,12,Italy - Serie C - Group B,0.38,0.75,-1,0.75,2.63,1.33,6
Vis Pesaro,8,3,2,3,6,6,0,11,Italy - Serie C - Group B,0.38,0.62,0,0.75,2.63,1.61,7
Athletic Carpi,8,3,1,4,9,11,-2,10,Italy - Serie C - Group B,0.38,0.5,-2,1.12,2.63,2.0,8
Legnago Salus,8,2,3,3,7,8,-1,9,Italy - Serie C - Group B,0.25,0.62,-1,0.88,4.0,1.61,9
Sestri Levante,8,1,4,3,8,9,-1,7,Italy - Serie C - Group B,0.12,0.62,-1,1.0,8.33,1.61,10
Ascoli,8,2,1,5,8,14,-6,7,Italy - Serie C - Group B,0.25,0.38,-6,1.0,4.0,2.63,10
Campobasso,8,2,1,5,6,12,-6,7,Italy - Serie C - Group B,0.25,0.38,-6,0.75,4.0,2.63,10
Perugia,8,1,3,4,4,7,-3,6,Italy - Serie C - Group B,0.12,0.5,-3,0.5,8.33,2.0,11
AC Milan B,8,1,3,4,7,11,-4,6,Italy - Serie C - Group B,0.12,0.5,-4,0.88,8.33,2.0,11
SPAL,8,0,2,6,5,14,-9,2,Italy - Serie C - Group B,0.0,0.25,-9,0.62,0.0,4.0,12
A. Cerignola,8,7,1,0,16,4,12,22,Italy - Serie C - Group C,0.88,1.0,12,2.0,1.14,1.0,1
Avellino,8,7,0,1,15,6,9,21,Italy - Serie C - Group C,0.88,0.88,9,1.88,1.14,1.14,2
Crotone,8,4,2,2,14,6,8,14,Italy - Serie C - Group C,0.5,0.75,8,1.75,2.0,1.33,3
Trapani,8,4,1,3,12,6,6,13,Italy - Serie C - Group C,0.5,0.62,6,1.5,2.0,1.61,4
Catania,8,3,4,1,13,9,4,13,Italy - Serie C - Group C,0.38,0.88,4,1.62,2.63,1.14,4
Giugliano,8,4,1,3,13,11,2,13,Italy - Serie C - Group C,0.5,0.62,2,1.62,2.0,1.61,4
Picerno,8,2,6,0,13,5,8,12,Italy - Serie C - Group C,0.25,1.0,8,1.62,4.0,1.0,5
Sorrento,8,3,3,2,12,6,6,12,Italy - Serie C - Group C,0.38,0.75,6,1.5,2.63,1.33,5
Juventus U23,8,3,3,2,9,6,3,12,Italy - Serie C - Group C,0.38,0.75,3,1.12,2.63,1.33,5
Altamura,8,2,5,1,12,8,4,11,Italy - Serie C - Group C,0.25,0.88,4,1.5,4.0,1.14,6
Foggia,8,3,2,3,12,10,2,11,Italy - Serie C - Group C,0.38,0.62,2,1.5,2.63,1.61,6
Monopoli,8,3,2,3,8,8,0,11,Italy - Serie C - Group C,0.38,0.62,0,1.0,2.63,1.61,6
Potenza,8,2,3,3,16,18,-2,9,Italy - Serie C - Group C,0.25,0.62,-2,2.0,4.0,1.61,7
Cavese,8,2,3,3,9,11,-2,9,Italy - Serie C - Group C,0.25,0.62,-2,1.12,4.0,1.61,7
Casertana,8,2,2,4,11,8,3,8,Italy - Serie C - Group C,0.25,0.5,3,1.38,4.0,2.0,8
ACR Messina,8,1,3,4,4,8,-4,6,Italy - Serie C - Group C,0.12,0.5,-4,0.5,8.33,2.0,9
Benevento,8,0,6,2,5,10,-5,6,Italy - Serie C - Group C,0.0,0.75,-5,0.62,0.0,1.33,9
Latina,8,1,2,5,7,17,-10,5,Italy - Serie C - Group C,0.12,0.38,-10,0.88,8.33,2.63,10
Turris,8,0,0,8,6,25,-19,0,Italy - Serie C - Group C,0.0,0.0,-19,0.75,0.0,0.0,11
Taranto,8,0,0,8,2,34,-32,0,Italy - Serie C - Group C,0.0,0.0,-32,0.25,0.0,0.0,11
NovaRomentin,8,7,0,1,20,6,14,21,Italy - Serie D - Group A,0.88,0.88,14,2.5,1.14,1.14,1
Ligorna,8,6,1,1,18,7,11,19,Italy - Serie D - Group A,0.75,0.88,11,2.25,1.33,1.14,2
Bra,8,5,2,1,13,7,6,17,Italy - Serie D - Group A,0.62,0.88,6,1.62,1.61,1.14,3
Lavagnese,8,4,3,1,14,6,8,15,Italy - Serie D - Group A,0.5,0.88,8,1.75,2.0,1.14,4
Gozzano,8,4,3,1,9,4,5,15,Italy - Serie D - Group A,0.5,0.88,5,1.12,2.0,1.14,4
Citta di Varese,8,4,2,2,9,5,4,14,Italy - Serie D - Group A,0.5,0.75,4,1.12,2.0,1.33,5
Derthona,8,3,3,2,8,7,1,12,Italy - Serie D - Group A,0.38,0.75,1,1.0,2.63,1.33,6
Saluzzo,8,3,2,3,10,9,1,11,Italy - Serie D - Group A,0.38,0.62,1,1.25,2.63,1.61,7
Sanremese,8,2,4,2,8,10,-2,10,Italy - Serie D - Group A,0.25,0.75,-2,1.0,4.0,1.33,8
Fossano,8,3,1,4,8,11,-3,10,Italy - Serie D - Group A,0.38,0.5,-3,1.0,2.63,2.0,8
Vado,8,2,3,3,8,9,-1,9,Italy - Serie D - Group A,0.25,0.62,-1,1.0,4.0,1.61,9
Chisola,8,2,3,3,7,8,-1,9,Italy - Serie D - Group A,0.25,0.62,-1,0.88,4.0,1.61,9
Asti,8,2,2,4,9,11,-2,8,Italy - Serie D - Group A,0.25,0.5,-2,1.12,4.0,2.0,10
Cairese,8,2,2,4,7,11,-4,8,Italy - Serie D - Group A,0.25,0.5,-4,0.88,4.0,2.0,10
Vogherese,8,1,5,2,6,10,-4,8,Italy - Serie D - Group A,0.12,0.75,-4,0.75,8.33,1.33,10
Pro Imperia,8,1,3,4,11,16,-5,6,Italy - Serie D - Group A,0.12,0.5,-5,1.38,8.33,2.0,11
Oltrepo,8,1,2,5,3,13,-10,5,Italy - Serie D - Group A,0.12,0.38,-10,0.38,8.33,2.63,12
Chieri,8,1,2,5,5,17,-12,5,Italy - Serie D - Group A,0.12,0.38,-12,0.62,8.33,2.63,12
Borgaro Nobis,8,1,1,6,7,14,-7,4,Italy - Serie D - Group A,0.12,0.25,-7,0.88,8.33,4.0,13
Albenga,0,0,0,0,0,0,0,0,Italy - Serie D - Group A,0.0,0.0,0,0.0,0.0,0.0,14
USD Casatese,8,5,3,0,14,5,9,18,Italy - Serie D - Group B,0.62,1.0,9,1.75,1.61,1.0,1
Pro Palazzolo,8,4,3,1,18,7,11,15,Italy - Serie D - Group B,0.5,0.88,11,2.25,2.0,1.14,2
F. Caratese,8,4,3,1,14,10,4,15,Italy - Serie D - Group B,0.5,0.88,4,1.75,2.0,1.14,2
Crema,8,4,2,2,10,8,2,14,Italy - Serie D - Group B,0.5,0.75,2,1.25,2.0,1.33,3
Varesina,8,4,2,2,10,8,2,14,Italy - Serie D - Group B,0.5,0.75,2,1.25,2.0,1.33,3
Chievo,8,4,2,2,10,9,1,14,Italy - Serie D - Group B,0.5,0.75,1,1.25,2.0,1.33,3
Vigasio,8,3,3,2,8,5,3,12,Italy - Serie D - Group B,0.38,0.75,3,1.0,2.63,1.33,4
Sondrio,8,3,2,3,9,11,-2,11,Italy - Serie D - Group B,0.38,0.62,-2,1.12,2.63,1.61,5
Breno,8,2,4,2,13,12,1,10,Italy - Serie D - Group B,0.25,0.75,1,1.62,4.0,1.33,6
Ospitaletto,8,2,4,2,10,9,1,10,Italy - Serie D - Group B,0.25,0.75,1,1.25,4.0,1.33,6
Club Milano,8,3,1,4,9,11,-2,10,Italy - Serie D - Group B,0.38,0.5,-2,1.12,2.63,2.0,6
Ciliverghe,8,3,1,4,10,16,-6,10,Italy - Serie D - Group B,0.38,0.5,-6,1.25,2.63,2.0,6
Fanfulla,8,2,3,3,9,11,-2,9,Italy - Serie D - Group B,0.25,0.62,-2,1.12,4.0,1.61,7
Castellanzese,8,2,3,3,8,10,-2,9,Italy - Serie D - Group B,0.25,0.62,-2,1.0,4.0,1.61,7
Pro Sesto,8,2,3,3,6,8,-2,9,Italy - Serie D - Group B,0.25,0.62,-2,0.75,4.0,1.61,7
Sangiuliano C.,8,2,3,3,5,7,-2,9,Italy - Serie D - Group B,0.25,0.62,-2,0.62,4.0,1.61,7
Desenxano,8,1,4,3,5,7,-2,7,Italy - Serie D - Group B,0.12,0.62,-2,0.62,8.33,1.61,8
Arconatese,8,1,4,3,6,9,-3,7,Italy - Serie D - Group B,0.12,0.62,-3,0.75,8.33,1.61,8
SantAngelo,8,0,5,3,6,10,-4,5,Italy - Serie D - Group B,0.0,0.62,-4,0.75,0.0,1.61,9
Magenta,8,1,1,6,8,15,-7,4,Italy - Serie D - Group B,0.12,0.25,-7,1.0,8.33,4.0,10
Mestre,8,6,1,1,10,5,5,19,Italy - Serie D - Group C,0.75,0.88,5,1.25,1.33,1.14,1
D. Bellunesi,8,5,1,2,19,13,6,16,Italy - Serie D - Group C,0.62,0.75,6,2.38,1.61,1.33,2
Este,8,4,3,1,11,6,5,15,Italy - Serie D - Group C,0.5,0.88,5,1.38,2.0,1.14,3
Villa Alme,8,4,2,2,19,13,6,14,Italy - Serie D - Group C,0.5,0.75,6,2.38,2.0,1.33,4
Cjarlins Muzane,8,4,2,2,12,9,3,14,Italy - Serie D - Group C,0.5,0.75,3,1.5,2.0,1.33,4
Adriese,8,3,4,1,9,7,2,13,Italy - Serie D - Group C,0.38,0.88,2,1.12,2.63,1.14,5
Real Calepina,8,3,4,1,11,10,1,13,Italy - Serie D - Group C,0.38,0.88,1,1.38,2.63,1.14,5
Luparense,8,3,3,2,12,9,3,12,Italy - Serie D - Group C,0.38,0.75,3,1.5,2.63,1.33,6
Bassano Virtus,8,3,3,2,10,10,0,12,Italy - Serie D - Group C,0.38,0.75,0,1.25,2.63,1.33,6
Portogruaro,8,3,2,3,10,7,3,11,Italy - Serie D - Group C,0.38,0.62,3,1.25,2.63,1.61,7
Brusaporto,8,2,4,2,8,8,0,10,Italy - Serie D - Group C,0.25,0.75,0,1.0,4.0,1.33,8
Campodarsego,8,2,4,2,7,9,-2,10,Italy - Serie D - Group C,0.25,0.75,-2,0.88,4.0,1.33,8
Calvi Noale,8,2,3,3,9,11,-2,9,Italy - Serie D - Group C,0.25,0.62,-2,1.12,4.0,1.61,9
Treviso,8,3,0,5,7,10,-3,9,Italy - Serie D - Group C,0.38,0.38,-3,0.88,2.63,2.63,9
Brian Lignano,8,1,5,2,9,8,1,8,Italy - Serie D - Group C,0.12,0.75,1,1.12,8.33,1.33,10
Ciserano,8,1,5,2,9,9,0,8,Italy - Serie D - Group C,0.12,0.75,0,1.12,8.33,1.33,10
Montecchio M.,8,2,2,4,8,10,-2,8,Italy - Serie D - Group C,0.25,0.5,-2,1.0,4.0,2.0,10
Chions,8,1,4,3,7,10,-3,7,Italy - Serie D - Group C,0.12,0.62,-3,0.88,8.33,1.61,11
Caravaggio,8,1,1,6,9,16,-7,4,Italy - Serie D - Group C,0.12,0.25,-7,1.12,8.33,4.0,12
Lavis,8,0,1,7,4,20,-16,1,Italy - Serie D - Group C,0.0,0.12,-16,0.5,0.0,8.33,13
Forli,8,7,0,1,14,3,11,21,Italy - Serie D - Group D,0.88,0.88,11,1.75,1.14,1.14,1
Ravenna,8,6,2,0,16,4,12,20,Italy - Serie D - Group D,0.75,1.0,12,2.0,1.33,1.0,2
Pistoiese,8,4,3,1,12,4,8,15,Italy - Serie D - Group D,0.5,0.88,8,1.5,2.0,1.14,3
Tau Altopascio,8,4,2,2,13,6,7,14,Italy - Serie D - Group D,0.5,0.75,7,1.62,2.0,1.33,4
Zenith Prato,8,4,1,3,13,7,6,13,Italy - Serie D - Group D,0.5,0.62,6,1.62,2.0,1.61,5
Prato,8,4,1,3,7,6,1,13,Italy - Serie D - Group D,0.5,0.62,1,0.88,2.0,1.61,5
Lentigione,8,3,3,2,12,9,3,12,Italy - Serie D - Group D,0.38,0.75,3,1.5,2.63,1.33,6
Cittadella Vis,8,3,2,3,12,10,2,11,Italy - Serie D - Group D,0.38,0.62,2,1.5,2.63,1.61,7
San Marino C.,8,3,2,3,7,5,2,11,Italy - Serie D - Group D,0.38,0.62,2,0.88,2.63,1.61,7
Corticella,8,3,2,3,7,8,-1,11,Italy - Serie D - Group D,0.38,0.62,-1,0.88,2.63,1.61,7
Piacenza,8,3,2,3,7,8,-1,11,Italy - Serie D - Group D,0.38,0.62,-1,0.88,2.63,1.61,7
Progresso,8,3,2,3,4,8,-4,11,Italy - Serie D - Group D,0.38,0.62,-4,0.5,2.63,1.61,7
Sammaurese,8,2,2,4,8,6,2,8,Italy - Serie D - Group D,0.25,0.5,2,1.0,4.0,2.0,8
Imolese,8,2,2,4,7,15,-8,8,Italy - Serie D - Group D,0.25,0.5,-8,0.88,4.0,2.0,8
Sasso Marconi,8,2,1,5,7,12,-5,7,Italy - Serie D - Group D,0.25,0.38,-5,0.88,4.0,2.63,9
Tuttocuoio,8,1,3,4,6,13,-7,6,Italy - Serie D - Group D,0.12,0.5,-7,0.75,8.33,2.0,10
Fiorenzuola,8,1,1,6,5,12,-7,4,Italy - Serie D - Group D,0.12,0.25,-7,0.62,8.33,4.0,11
United Riccione,8,1,1,6,3,23,-20,4,Italy - Serie D - Group D,0.12,0.25,-20,0.38,8.33,4.0,11
Livorno,8,7,1,0,18,6,12,22,Italy - Serie D - Group E,0.88,1.0,12,2.25,1.14,1.0,1
Fulgens Foligno,8,5,1,2,17,9,8,16,Italy - Serie D - Group E,0.62,0.75,8,2.12,1.61,1.33,2
Ostia Mare,8,4,3,1,12,9,3,15,Italy - Serie D - Group E,0.5,0.88,3,1.5,2.0,1.14,3
Figline,8,4,2,2,11,5,6,14,Italy - Serie D - Group E,0.5,0.75,6,1.38,2.0,1.33,4
Seravezza,8,3,4,1,8,4,4,13,Italy - Serie D - Group E,0.38,0.88,4,1.0,2.63,1.14,5
FC Siena,8,3,4,1,6,5,1,13,Italy - Serie D - Group E,0.38,0.88,1,0.75,2.63,1.14,5
Gavorrano,8,2,4,2,9,9,0,10,Italy - Serie D - Group E,0.25,0.75,0,1.12,4.0,1.33,6
Fezzanese,8,2,4,2,11,13,-2,10,Italy - Serie D - Group E,0.25,0.75,-2,1.38,4.0,1.33,6
San Donato,8,3,1,4,5,7,-2,10,Italy - Serie D - Group E,0.38,0.5,-2,0.62,2.63,2.0,6
Flaminia,8,2,3,3,9,7,2,9,Italy - Serie D - Group E,0.25,0.62,2,1.12,4.0,1.61,7
Sangiovannese,8,2,3,3,8,9,-1,9,Italy - Serie D - Group E,0.25,0.62,-1,1.0,4.0,1.61,7
Orvietana,8,2,3,3,11,13,-2,9,Italy - Serie D - Group E,0.25,0.62,-2,1.38,4.0,1.61,7
Grosseto,8,2,3,3,5,8,-3,9,Italy - Serie D - Group E,0.25,0.62,-3,0.62,4.0,1.61,7
T. Traiana,8,2,2,4,7,10,-3,8,Italy - Serie D - Group E,0.25,0.5,-3,0.88,4.0,2.0,8
Ghiviborgo,8,2,1,5,6,12,-6,7,Italy - Serie D - Group E,0.25,0.38,-6,0.75,4.0,2.63,9
S. Trestina,8,2,1,5,5,15,-10,7,Italy - Serie D - Group E,0.25,0.38,-10,0.62,4.0,2.63,9
Poggibonsi,8,1,3,4,6,9,-3,6,Italy - Serie D - Group E,0.12,0.5,-3,0.75,8.33,2.0,10
Montevarchi,8,1,3,4,4,8,-4,6,Italy - Serie D - Group E,0.12,0.5,-4,0.5,8.33,2.0,10
Teramo,8,5,1,2,17,8,9,16,Italy - Serie D - Group F,0.62,0.75,9,2.12,1.61,1.33,1
Chieti,8,4,4,0,14,8,6,16,Italy - Serie D - Group F,0.5,1.0,6,1.75,2.0,1.0,1
Sambenedettese,8,4,3,1,14,6,8,15,Italy - Serie D - Group F,0.5,0.88,8,1.75,2.0,1.14,2
LAquila,8,4,2,2,12,7,5,14,Italy - Serie D - Group F,0.5,0.75,5,1.5,2.0,1.33,3
San Nicolo,8,4,2,2,12,8,4,14,Italy - Serie D - Group F,0.5,0.75,4,1.5,2.0,1.33,3
Avezzano,8,3,4,1,9,10,-1,13,Italy - Serie D - Group F,0.38,0.88,-1,1.12,2.63,1.14,4
Fossombrone,8,2,4,2,10,8,2,10,Italy - Serie D - Group F,0.25,0.75,2,1.25,4.0,1.33,5
Sora,8,2,4,2,6,6,0,10,Italy - Serie D - Group F,0.25,0.75,0,0.75,4.0,1.33,5
Civitanovese,8,2,4,2,6,7,-1,10,Italy - Serie D - Group F,0.25,0.75,-1,0.75,4.0,1.33,5
Atletico Ascoli,8,2,3,3,8,9,-1,9,Italy - Serie D - Group F,0.25,0.62,-1,1.0,4.0,1.61,6
V. Senigallia,8,2,3,3,7,10,-3,9,Italy - Serie D - Group F,0.25,0.62,-3,0.88,4.0,1.61,6
Recanatese,8,2,3,3,12,19,-7,9,Italy - Serie D - Group F,0.25,0.62,-7,1.5,4.0,1.61,6
Castelfidardo,8,2,2,4,8,9,-1,8,Italy - Serie D - Group F,0.25,0.5,-1,1.0,4.0,2.0,7
Roma City,8,1,5,2,6,7,-1,8,Italy - Serie D - Group F,0.12,0.75,-1,0.75,8.33,1.33,7
Termoli Calcio,8,1,5,2,7,9,-2,8,Italy - Serie D - Group F,0.12,0.75,-2,0.88,8.33,1.33,7
Fermana,8,2,2,4,8,11,-3,8,Italy - Serie D - Group F,0.25,0.5,-3,1.0,4.0,2.0,7
Ancona 1905,8,1,3,4,9,12,-3,6,Italy - Serie D - Group F,0.12,0.5,-3,1.12,8.33,2.0,8
Isernia,8,0,4,4,4,15,-11,4,Italy - Serie D - Group F,0.0,0.5,-11,0.5,0.0,2.0,9
Guidonia,8,6,1,1,17,7,10,19,Italy - Serie D - Group G,0.75,0.88,10,2.12,1.33,1.14,1
CynthiAlbalonga,8,6,0,2,14,6,8,18,Italy - Serie D - Group G,0.75,0.75,8,1.75,1.33,1.33,2
Sarnese,8,5,1,2,18,12,6,16,Italy - Serie D - Group G,0.62,0.75,6,2.25,1.61,1.33,3
Savoia,8,5,1,2,14,10,4,16,Italy - Serie D - Group G,0.62,0.75,4,1.75,1.61,1.33,3
Olbia,8,4,2,2,12,7,5,14,Italy - Serie D - Group G,0.5,0.75,5,1.5,2.0,1.33,4
Gelbison,8,4,2,2,13,11,2,14,Italy - Serie D - Group G,0.5,0.75,2,1.62,2.0,1.33,4
Cassino,8,3,4,1,8,3,5,13,Italy - Serie D - Group G,0.38,0.88,5,1.0,2.63,1.14,5
Atletico Uri,8,3,4,1,15,11,4,13,Italy - Serie D - Group G,0.38,0.88,4,1.88,2.63,1.14,5
Trastevere,8,4,1,3,12,9,3,13,Italy - Serie D - Group G,0.5,0.62,3,1.5,2.0,1.61,5
S. Ogliastra,8,3,2,3,11,13,-2,11,Italy - Serie D - Group G,0.38,0.62,-2,1.38,2.63,1.61,6
Puteolana,8,3,1,4,8,10,-2,10,Italy - Serie D - Group G,0.38,0.5,-2,1.0,2.63,2.0,7
Paganese,8,2,3,3,6,9,-3,9,Italy - Serie D - Group G,0.25,0.62,-3,0.75,4.0,1.61,8
A. Lodigiani,8,2,2,4,11,11,0,8,Italy - Serie D - Group G,0.25,0.5,0,1.38,4.0,2.0,9
Ilvamaddalena,8,2,2,4,7,7,0,8,Italy - Serie D - Group G,0.25,0.5,0,0.88,4.0,2.0,9
R. Monterotondo,8,1,4,3,6,9,-3,7,Italy - Serie D - Group G,0.12,0.62,-3,0.75,8.33,1.61,10
Terracina,8,1,1,6,5,19,-14,4,Italy - Serie D - Group G,0.12,0.25,-14,0.62,8.33,4.0,11
Anzio,8,0,3,5,6,17,-11,3,Italy - Serie D - Group G,0.0,0.38,-11,0.75,0.0,2.63,12
Latte Dolce,8,1,0,7,8,20,-12,3,Italy - Serie D - Group G,0.12,0.12,-12,1.0,8.33,8.33,12
Casarano,8,5,3,0,14,4,10,18,Italy - Serie D - Group H,0.62,1.0,10,1.75,1.61,1.0,1
Martina Franca,8,5,2,1,12,6,6,17,Italy - Serie D - Group H,0.62,0.88,6,1.5,1.61,1.14,2
Nocerina,8,4,4,0,10,3,7,16,Italy - Serie D - Group H,0.5,1.0,7,1.25,2.0,1.0,3
Citta di Fasano,8,4,2,2,11,6,5,14,Italy - Serie D - Group H,0.5,0.75,5,1.38,2.0,1.33,4
Fidelis Andria,8,4,1,3,8,8,0,13,Italy - Serie D - Group H,0.5,0.62,0,1.0,2.0,1.61,5
Brindisi,8,3,3,2,15,12,3,12,Italy - Serie D - Group H,0.38,0.75,3,1.88,2.63,1.33,6
Francavilla,8,3,2,3,9,8,1,11,Italy - Serie D - Group H,0.38,0.62,1,1.12,2.63,1.61,7
Ugento,8,3,2,3,12,13,-1,11,Italy - Serie D - Group H,0.38,0.62,-1,1.5,2.63,1.61,7
Nardo,8,3,1,4,8,8,0,10,Italy - Serie D - Group H,0.38,0.5,0,1.0,2.63,2.0,8
Angri Calcio,8,2,3,3,11,10,1,9,Italy - Serie D - Group H,0.25,0.62,1,1.38,4.0,1.61,9
Gravina,8,2,3,3,10,11,-1,9,Italy - Serie D - Group H,0.25,0.62,-1,1.25,4.0,1.61,9
Ischia,8,2,3,3,6,7,-1,9,Italy - Serie D - Group H,0.25,0.62,-1,0.75,4.0,1.61,9
USD Palmese,8,2,3,3,9,12,-3,9,Italy - Serie D - Group H,0.25,0.62,-3,1.12,4.0,1.61,9
Manfredonia,8,2,3,3,6,11,-5,9,Italy - Serie D - Group H,0.25,0.62,-5,0.75,4.0,1.61,9
Real Acerrana,8,2,2,4,9,13,-4,8,Italy - Serie D - Group H,0.25,0.5,-4,1.12,4.0,2.0,10
Matera,8,2,2,4,8,12,-4,8,Italy - Serie D - Group H,0.25,0.5,-4,1.0,4.0,2.0,10
V. Francavilla,8,0,5,3,7,12,-5,5,Italy - Serie D - Group H,0.0,0.62,-5,0.88,0.0,1.61,11
Costa DAmalfi,8,0,4,4,6,15,-9,4,Italy - Serie D - Group H,0.0,0.5,-9,0.75,0.0,2.0,12
Reggina,8,7,0,1,20,3,17,21,Italy - Serie D - Group I,0.88,0.88,17,2.5,1.14,1.14,1
Siracusa,8,7,0,1,22,6,16,21,Italy - Serie D - Group I,0.88,0.88,16,2.75,1.14,1.14,1
Scafatese,8,5,3,0,11,2,9,18,Italy - Serie D - Group I,0.62,1.0,9,1.38,1.61,1.0,2
Igea Virtus,8,5,1,2,15,9,6,16,Italy - Serie D - Group I,0.62,0.75,6,1.88,1.61,1.33,3
Nissa,8,4,3,1,14,9,5,15,Italy - Serie D - Group I,0.5,0.88,5,1.75,2.0,1.14,4
Sambiase,8,4,2,2,10,7,3,14,Italy - Serie D - Group I,0.5,0.75,3,1.25,2.0,1.33,5
Ragusa,8,4,0,4,13,8,5,12,Italy - Serie D - Group I,0.5,0.5,5,1.62,2.0,2.0,6
Vibonese,8,4,0,4,13,8,5,12,Italy - Serie D - Group I,0.5,0.5,5,1.62,2.0,2.0,6
CD S. Agata,8,2,3,3,9,11,-2,9,Italy - Serie D - Group I,0.25,0.62,-2,1.12,4.0,1.61,7
Acireale,8,2,3,3,6,11,-5,9,Italy - Serie D - Group I,0.25,0.62,-5,0.75,4.0,1.61,7
CastrumFavara,8,2,3,3,6,11,-5,9,Italy - Serie D - Group I,0.25,0.62,-5,0.75,4.0,1.61,7
Pompei,8,2,2,4,4,11,-7,8,Italy - Serie D - Group I,0.25,0.5,-7,0.5,4.0,2.0,8
Licata,8,2,2,4,7,18,-11,8,Italy - Serie D - Group I,0.25,0.5,-11,0.88,4.0,2.0,8
Paterno,8,1,4,3,7,12,-5,7,Italy - Serie D - Group I,0.12,0.62,-5,0.88,8.33,1.61,9
Sancataldese,8,1,3,4,7,10,-3,6,Italy - Serie D - Group I,0.12,0.5,-3,0.88,8.33,2.0,10
Enna,8,0,5,3,4,9,-5,5,Italy - Serie D - Group I,0.0,0.62,-5,0.5,0.0,1.61,11
Akragas,8,1,1,6,4,15,-11,4,Italy - Serie D - Group I,0.12,0.25,-11,0.5,8.33,4.0,12
Locri 1909,8,0,2,6,6,19,-13,2,Italy - Serie D - Group I,0.0,0.25,-13,0.75,0.0,4.0,13
Inter Milan U20,8,6,1,1,21,7,14,19,Italy - Primavera 1,0.75,0.88,14,2.62,1.33,1.14,1
Roma U20,8,6,0,2,12,6,6,18,Italy - Primavera 1,0.75,0.75,6,1.5,1.33,1.33,2
Sassuolo U20,8,5,2,1,12,8,4,17,Italy - Primavera 1,0.62,0.88,4,1.5,1.61,1.14,3
Fiorentina U20,8,5,0,3,15,12,3,15,Italy - Primavera 1,0.62,0.62,3,1.88,1.61,1.61,4
Lazio U20,8,4,3,1,12,9,3,15,Italy - Primavera 1,0.5,0.88,3,1.5,2.0,1.14,4
Juventus U20,8,5,0,3,21,19,2,15,Italy - Primavera 1,0.62,0.62,2,2.62,1.61,1.61,4
Monza U20,8,5,0,3,19,18,1,15,Italy - Primavera 1,0.62,0.62,1,2.38,1.61,1.61,4
Genoa U20,8,4,2,2,15,12,3,14,Italy - Primavera 1,0.5,0.75,3,1.88,2.0,1.33,5
Cagliari U20,8,4,2,2,9,9,0,14,Italy - Primavera 1,0.5,0.75,0,1.12,2.0,1.33,5
H. Verona U20,8,3,3,2,15,6,9,12,Italy - Primavera 1,0.38,0.75,9,1.88,2.63,1.33,6
Milan U20,8,3,3,2,11,10,1,12,Italy - Primavera 1,0.38,0.75,1,1.38,2.63,1.33,6
Lecce U20,8,3,1,4,7,12,-5,10,Italy - Primavera 1,0.38,0.5,-5,0.88,2.63,2.0,7
Atalanta U20,8,3,0,5,10,12,-2,9,Italy - Primavera 1,0.38,0.38,-2,1.25,2.63,2.63,8
Cremonese U20,8,1,5,2,8,8,0,8,Italy - Primavera 1,0.12,0.75,0,1.0,8.33,1.33,9
Cesena U20,8,2,1,5,19,21,-2,7,Italy - Primavera 1,0.25,0.38,-2,2.38,4.0,2.63,10
Torino U20,8,2,1,5,9,14,-5,7,Italy - Primavera 1,0.25,0.38,-5,1.12,4.0,2.63,10
Bologna U20,8,1,4,3,5,11,-6,7,Italy - Primavera 1,0.12,0.62,-6,0.62,8.33,1.61,10
Sampdoria U20,8,1,3,4,9,13,-4,6,Italy - Primavera 1,0.12,0.5,-4,1.12,8.33,2.0,11
Udinese U20,8,1,1,6,8,19,-11,4,Italy - Primavera 1,0.12,0.25,-11,1.0,8.33,4.0,12
Empoli U20,8,0,3,5,7,13,-6,3,Italy - Primavera 1,0.0,0.38,-6,0.88,0.0,2.63,13
Arnett Gardens,8,6,2,0,23,8,15,20,Jamaica - Premier League,0.75,1.0,15,2.88,1.33,1.0,1
Mount Pleasant,8,6,1,1,20,6,14,19,Jamaica - Premier League,0.75,0.88,14,2.5,1.33,1.14,2
Racing United,8,5,3,0,12,5,7,18,Jamaica - Premier League,0.62,1.0,7,1.5,1.61,1.0,3
Dunbeholden,8,5,1,2,11,8,3,16,Jamaica - Premier League,0.62,0.75,3,1.38,1.61,1.33,4
Montego Bay,8,3,4,1,9,6,3,13,Jamaica - Premier League,0.38,0.88,3,1.12,2.63,1.14,5
Cavalier,8,3,3,2,10,9,1,12,Jamaica - Premier League,0.38,0.75,1,1.25,2.63,1.33,6
Harbour View,8,3,2,3,10,8,2,11,Jamaica - Premier League,0.38,0.62,2,1.25,2.63,1.61,7
Portmore Utd,8,2,5,1,4,3,1,11,Jamaica - Premier League,0.25,0.88,1,0.5,4.0,1.14,7
Molynes Utd,8,2,2,4,10,17,-7,8,Jamaica - Premier League,0.25,0.5,-7,1.25,4.0,2.0,8
Humble Lions,8,2,1,5,11,21,-10,7,Jamaica - Premier League,0.25,0.38,-10,1.38,4.0,2.63,9
Tivoli Gardens,8,1,3,4,11,16,-5,6,Jamaica - Premier League,0.12,0.5,-5,1.38,8.33,2.0,10
Chapelton,8,1,2,5,8,15,-7,5,Jamaica - Premier League,0.12,0.38,-7,1.0,8.33,2.63,11
Waterhouse,8,1,1,6,6,14,-8,4,Jamaica - Premier League,0.12,0.25,-8,0.75,8.33,4.0,12
Vere Utd,8,0,2,6,7,18,-11,2,Jamaica - Premier League,0.0,0.25,-11,0.88,0.0,4.0,13
Kashima Antlers,5,4,0,1,11,3,8,12,Japan - J1 League,0.8,0.8,8,2.2,1.25,1.25,1
Shonan Bellmare,5,3,2,0,6,3,3,11,Japan - J1 League,0.6,1.0,3,1.2,1.67,1.0,2
S. Hiroshima,4,3,1,0,5,2,3,10,Japan - J1 League,0.75,1.0,3,1.25,1.33,1.0,3
Kashiwa Reysol,5,3,1,1,7,5,2,10,Japan - J1 League,0.6,0.8,2,1.4,1.67,1.25,3
Machida Zelvia,5,3,0,2,6,4,2,9,Japan - J1 League,0.6,0.6,2,1.2,1.67,1.67,4
Gamba Osaka,5,3,0,2,6,8,-2,9,Japan - J1 League,0.6,0.6,-2,1.2,1.67,1.67,4
Shimizu S-Pulse,5,2,2,1,5,3,2,8,Japan - J1 League,0.4,0.8,2,1.0,2.5,1.25,5
K. Frontale,4,2,1,1,7,3,4,7,Japan - J1 League,0.5,0.75,4,1.75,2.0,1.33,6
Fagiano Okayama,5,2,1,2,5,3,2,7,Japan - J1 League,0.4,0.6,2,1.0,2.5,1.67,6
FC Tokyo,5,2,1,2,4,4,0,7,Japan - J1 League,0.4,0.6,0,0.8,2.5,1.67,6
Avispa Fukuoka,5,2,0,3,4,5,-1,6,Japan - J1 League,0.4,0.4,-1,0.8,2.5,2.5,7
Cerezo Osaka,5,1,2,2,10,9,1,5,Japan - J1 League,0.2,0.6,1,2.0,5.0,1.67,8
Kyoto Sanga,5,1,2,2,3,5,-2,5,Japan - J1 League,0.2,0.6,-2,0.6,5.0,1.67,8
Urawa RD,5,1,2,2,3,5,-2,5,Japan - J1 League,0.2,0.6,-2,0.6,5.0,1.67,8
Yokohama FC,5,1,1,3,1,4,-3,4,Japan - J1 League,0.2,0.4,-3,0.2,5.0,2.5,9
Tokyo Verdy,5,1,1,3,3,8,-5,4,Japan - J1 League,0.2,0.4,-5,0.6,5.0,2.5,9
Vissel Kobe,4,0,3,1,3,4,-1,3,Japan - J1 League,0.0,0.75,-1,0.75,0.0,1.33,10
Yokohama M.,4,0,3,1,2,3,-1,3,Japan - J1 League,0.0,0.75,-1,0.5,0.0,1.33,10
Albirex Niigata,5,0,3,2,6,9,-3,3,Japan - J1 League,0.0,0.6,-3,1.2,0.0,1.67,10
Nagoya G.,5,0,2,3,5,12,-7,2,Japan - J1 League,0.0,0.4,-7,1.0,0.0,2.5,11
JEF Utd Chiba,4,4,0,0,10,3,7,12,Japan - J2 League,1.0,1.0,7,2.5,1.0,1.0,1
Omiya Ardija,4,4,0,0,9,2,7,12,Japan - J2 League,1.0,1.0,7,2.25,1.0,1.0,1
Kataller Toyama,4,3,0,1,6,3,3,9,Japan - J2 League,0.75,0.75,3,1.5,1.33,1.33,2
Tokushima V.,4,2,2,0,4,1,3,8,Japan - J2 League,0.5,1.0,3,1.0,2.0,1.0,3
V-V. Nagasaki,4,2,2,0,7,5,2,8,Japan - J2 League,0.5,1.0,2,1.75,2.0,1.0,3
FC Imabari,4,2,1,1,7,4,3,7,Japan - J2 League,0.5,0.75,3,1.75,2.0,1.33,4
Vegalta Sendai,4,2,1,1,4,2,2,7,Japan - J2 League,0.5,0.75,2,1.0,2.0,1.33,4
Blaublitz Akita,4,2,0,2,6,7,-1,6,Japan - J2 League,0.5,0.5,-1,1.5,2.0,2.0,5
Jubilo Iwata,4,2,0,2,5,6,-1,6,Japan - J2 League,0.5,0.5,-1,1.25,2.0,2.0,5
Mito Hollyhock,4,1,2,1,4,4,0,5,Japan - J2 League,0.25,0.75,0,1.0,4.0,1.33,6
Oita Trinita,4,1,2,1,2,2,0,5,Japan - J2 League,0.25,0.75,0,0.5,4.0,1.33,6
Fujieda MYFC,4,1,2,1,5,6,-1,5,Japan - J2 League,0.25,0.75,-1,1.25,4.0,1.33,6
R. Yamaguchi,4,1,1,2,5,5,0,4,Japan - J2 League,0.25,0.5,0,1.25,4.0,2.0,7
R. Kumamoto,4,1,1,2,5,7,-2,4,Japan - J2 League,0.25,0.5,-2,1.25,4.0,2.0,7
Ventforet Kofu,4,1,1,2,4,6,-2,4,Japan - J2 League,0.25,0.5,-2,1.0,4.0,2.0,7
M. Yamagata,4,1,0,3,7,8,-1,3,Japan - J2 League,0.25,0.25,-1,1.75,4.0,4.0,8
Iwaki,4,0,3,1,2,4,-2,3,Japan - J2 League,0.0,0.75,-2,0.5,0.0,1.33,8
Ehime FC,4,0,1,3,4,7,-3,1,Japan - J2 League,0.0,0.25,-3,1.0,0.0,4.0,9
Sagan Tosu,4,0,1,3,2,7,-5,1,Japan - J2 League,0.0,0.25,-5,0.5,0.0,4.0,9
C. Sapporo,4,0,0,4,1,10,-9,0,Japan - J2 League,0.0,0.0,-9,0.25,0.0,0.0,10
Osaka,4,3,1,0,5,2,3,10,Japan - J3 League,0.75,1.0,3,1.25,1.33,1.0,1
Kagoshima Utd,4,2,1,1,9,5,4,7,Japan - J3 League,0.5,0.75,4,2.25,2.0,1.33,2
T. Miyazaki,4,2,1,1,5,3,2,7,Japan - J3 League,0.5,0.75,2,1.25,2.0,1.33,2
Fukushima Utd,4,2,1,1,8,8,0,7,Japan - J3 League,0.5,0.75,0,2.0,2.0,1.33,2
Nara Club,4,2,1,1,6,6,0,7,Japan - J3 League,0.5,0.75,0,1.5,2.0,1.33,2
G. Kitakyushu,3,2,0,1,5,2,3,6,Japan - J3 League,0.67,0.67,3,1.67,1.49,1.49,3
AC Numazu,4,1,3,0,4,1,3,6,Japan - J3 League,0.25,1.0,3,1.0,4.0,1.0,3
Nagano Parceiro,3,2,0,1,4,4,0,6,Japan - J3 League,0.67,0.67,0,1.33,1.49,1.49,3
SC Sagamihara,4,2,0,2,4,5,-1,6,Japan - J3 League,0.5,0.5,-1,1.0,2.0,2.0,3
Kamatamare S.,4,1,2,1,4,4,0,5,Japan - J3 League,0.25,0.75,0,1.0,4.0,1.33,4
Z. Kanazawa,3,1,1,1,4,4,0,4,Japan - J3 League,0.33,0.67,0,1.33,3.03,1.49,5
V. Hachinohe,3,1,1,1,3,3,0,4,Japan - J3 League,0.33,0.67,0,1.0,3.03,1.49,5
Gifu,4,1,1,2,6,7,-1,4,Japan - J3 League,0.25,0.5,-1,1.5,4.0,2.0,5
Kochi United,4,1,1,2,3,4,-1,4,Japan - J3 League,0.25,0.5,-1,0.75,4.0,2.0,5
Tochigi City,3,1,1,1,2,3,-1,4,Japan - J3 League,0.33,0.67,-1,0.67,3.03,1.49,5
Tochigi SC,4,1,1,2,2,3,-1,4,Japan - J3 League,0.25,0.5,-1,0.5,4.0,2.0,5
Kusatsu,4,1,1,2,6,8,-2,4,Japan - J3 League,0.25,0.5,-2,1.5,4.0,2.0,5
Matsumoto Y.,3,0,2,1,2,3,-1,2,Japan - J3 League,0.0,0.67,-1,0.67,0.0,1.49,6
Gainare Tottori,4,0,2,2,1,5,-4,2,Japan - J3 League,0.0,0.5,-4,0.25,0.0,2.0,6
FC Ryukyu,4,0,1,3,1,4,-3,1,Japan - J3 League,0.0,0.25,-3,0.25,0.0,4.0,7
Al Hussein,8,8,0,0,24,6,18,24,Jordan - Premier League,1.0,1.0,18,3.0,1.0,1.0,1
Al Jazeera,8,6,1,1,17,9,8,19,Jordan - Premier League,0.75,0.88,8,2.12,1.33,1.14,2
Al Wihdat,8,6,0,2,17,7,10,18,Jordan - Premier League,0.75,0.75,10,2.12,1.33,1.33,3
Al Faysali,8,4,4,0,13,6,7,16,Jordan - Premier League,0.5,1.0,7,1.62,2.0,1.0,4
Al Salt,8,4,1,3,14,7,7,13,Jordan - Premier League,0.5,0.62,7,1.75,2.0,1.61,5
Aqaba,8,3,2,3,10,15,-5,11,Jordan - Premier League,0.38,0.62,-5,1.25,2.63,1.61,6
Al Ramtha,8,3,2,3,6,11,-5,11,Jordan - Premier League,0.38,0.62,-5,0.75,2.63,1.61,6
Shabab Al Ordon,8,2,2,4,9,12,-3,8,Jordan - Premier League,0.25,0.5,-3,1.12,4.0,2.0,7
Maan,8,2,0,6,7,19,-12,6,Jordan - Premier League,0.25,0.25,-12,0.88,4.0,4.0,8
Moghayer Al S.,8,1,1,6,6,14,-8,4,Jordan - Premier League,0.12,0.25,-8,0.75,8.33,4.0,9
Al Sareeh,8,0,3,5,7,15,-8,3,Jordan - Premier League,0.0,0.38,-8,0.88,0.0,2.63,10
Al Ahli,8,0,2,6,3,11,-8,2,Jordan - Premier League,0.0,0.25,-8,0.38,0.0,4.0,11
Kairat Almaty,2,1,1,0,5,1,4,4,Kazakhstan - Premier League,0.5,1.0,4,2.5,2.0,1.0,1
Tobol,2,1,1,0,2,0,2,4,Kazakhstan - Premier League,0.5,1.0,2,1.0,2.0,1.0,1
Turan,1,1,0,0,2,0,2,3,Kazakhstan - Premier League,1.0,1.0,2,2.0,1.0,1.0,2
Atyrau,2,1,0,1,3,3,0,3,Kazakhstan - Premier League,0.5,0.5,0,1.5,2.0,2.0,2
Okzhetpes,2,1,0,1,2,3,-1,3,Kazakhstan - Premier League,0.5,0.5,-1,1.0,2.0,2.0,2
Zhetysu,2,0,2,0,1,1,0,2,Kazakhstan - Premier League,0.0,1.0,0,0.5,0.0,1.0,3
Zhenys,2,0,2,0,0,0,0,2,Kazakhstan - Premier League,0.0,1.0,0,0.0,0.0,1.0,3
FC Astana,1,0,1,0,1,1,0,1,Kazakhstan - Premier League,0.0,1.0,0,1.0,0.0,1.0,4
Kyzylzhar,1,0,1,0,1,1,0,1,Kazakhstan - Premier League,0.0,1.0,0,1.0,0.0,1.0,4
Aktobe,1,0,1,0,0,0,0,1,Kazakhstan - Premier League,0.0,1.0,0,0.0,0.0,1.0,4
Kaisar K.,1,0,1,0,0,0,0,1,Kazakhstan - Premier League,0.0,1.0,0,0.0,0.0,1.0,4
Ulytau,2,0,1,1,0,2,-2,1,Kazakhstan - Premier League,0.0,0.5,-2,0.0,0.0,2.0,4
Ordabasy,2,0,1,1,0,4,-4,1,Kazakhstan - Premier League,0.0,0.5,-4,0.0,0.0,2.0,4
Yelimay Semey,1,0,0,1,1,2,-1,0,Kazakhstan - Premier League,0.0,0.0,-1,1.0,0.0,0.0,5
Drita,8,6,1,1,19,10,9,19,Kosovo - Superliga,0.75,0.88,9,2.38,1.33,1.14,1
Ballkani,8,4,2,2,11,8,3,14,Kosovo - Superliga,0.5,0.75,3,1.38,2.0,1.33,2
Gjilani,8,4,2,2,11,8,3,14,Kosovo - Superliga,0.5,0.75,3,1.38,2.0,1.33,2
Malisheva,8,3,2,3,7,8,-1,11,Kosovo - Superliga,0.38,0.62,-1,0.88,2.63,1.61,3
Dukagjini,8,3,1,4,6,8,-2,10,Kosovo - Superliga,0.38,0.5,-2,0.75,2.63,2.0,4
Ferizaj,8,2,3,3,10,10,0,9,Kosovo - Superliga,0.25,0.62,0,1.25,4.0,1.61,5
Prishtina,8,1,6,1,10,10,0,9,Kosovo - Superliga,0.12,0.88,0,1.25,8.33,1.14,5
Suhareka,8,2,2,4,12,14,-2,8,Kosovo - Superliga,0.25,0.5,-2,1.5,4.0,2.0,6
Feronikeli,8,2,1,5,7,13,-6,7,Kosovo - Superliga,0.25,0.38,-6,0.88,4.0,2.63,7
Llapi,8,1,3,4,7,12,-5,6,Kosovo - Superliga,0.12,0.5,-5,0.88,8.33,2.0,8
Al Arabi SC,8,6,2,0,14,4,10,20,Kuwait - Premier League,0.75,1.0,10,1.75,1.33,1.0,1
Al Kuwait,8,5,2,1,22,5,17,17,Kuwait - Premier League,0.62,0.88,17,2.75,1.61,1.14,2
Al Qadsia,8,5,1,2,16,13,3,16,Kuwait - Premier League,0.62,0.75,3,2.0,1.61,1.33,3
Al Salmiyah,8,4,2,2,13,10,3,14,Kuwait - Premier League,0.5,0.75,3,1.62,2.0,1.33,4
Al Fahaheel,8,3,2,3,11,12,-1,11,Kuwait - Premier League,0.38,0.62,-1,1.38,2.63,1.61,5
Al Tadhamon,8,3,0,5,7,15,-8,9,Kuwait - Premier League,0.38,0.38,-8,0.88,2.63,2.63,6
Al Nasar,8,2,2,4,11,14,-3,8,Kuwait - Premier League,0.25,0.5,-3,1.38,4.0,2.0,7
Kazma,8,1,3,4,10,13,-3,6,Kuwait - Premier League,0.12,0.5,-3,1.25,8.33,2.0,8
Khaitan,8,1,3,4,4,7,-3,6,Kuwait - Premier League,0.12,0.5,-3,0.5,8.33,2.0,8
Yarmouk,8,0,3,5,6,21,-15,3,Kuwait - Premier League,0.0,0.38,-15,0.75,0.0,2.63,9
Liepaja,1,1,0,0,4,0,4,3,Latvia - Virsliga,1.0,1.0,4,4.0,1.0,1.0,1
Daugavpils,1,1,0,0,3,0,3,3,Latvia - Virsliga,1.0,1.0,3,3.0,1.0,1.0,1
Riga FC,1,1,0,0,2,0,2,3,Latvia - Virsliga,1.0,1.0,2,2.0,1.0,1.0,1
RFS,1,1,0,0,2,1,1,3,Latvia - Virsliga,1.0,1.0,1,2.0,1.0,1.0,1
FS Jelgava,1,0,1,0,1,1,0,1,Latvia - Virsliga,0.0,1.0,0,1.0,0.0,1.0,2
Grobina,1,0,1,0,1,1,0,1,Latvia - Virsliga,0.0,1.0,0,1.0,0.0,1.0,2
Auda,1,0,0,1,1,2,-1,0,Latvia - Virsliga,0.0,0.0,-1,1.0,0.0,0.0,3
Super Nova,1,0,0,1,0,2,-2,0,Latvia - Virsliga,0.0,0.0,-2,0.0,0.0,0.0,3
Tukums,1,0,0,1,0,3,-3,0,Latvia - Virsliga,0.0,0.0,-3,0.0,0.0,0.0,3
Metta,1,0,0,1,0,4,-4,0,Latvia - Virsliga,0.0,0.0,-4,0.0,0.0,0.0,3
Siauliai,2,1,1,0,5,3,2,4,Lithuania - A Lyga,0.5,1.0,2,2.5,2.0,1.0,1
Zalgiris,2,1,1,0,5,4,1,4,Lithuania - A Lyga,0.5,1.0,1,2.5,2.0,1.0,1
Banga,1,1,0,0,2,0,2,3,Lithuania - A Lyga,1.0,1.0,2,2.0,1.0,1.0,2
Kauno Zalgiris,2,1,0,1,4,3,1,3,Lithuania - A Lyga,0.5,0.5,1,2.0,2.0,2.0,2
Suduva,1,1,0,0,4,3,1,3,Lithuania - A Lyga,1.0,1.0,1,4.0,1.0,1.0,2
Dziugas Telsiai,2,1,0,1,3,3,0,3,Lithuania - A Lyga,0.5,0.5,0,1.5,2.0,2.0,2
Riteriai,2,0,1,1,6,7,-1,1,Lithuania - A Lyga,0.0,0.5,-1,3.0,0.0,2.0,3
Dainava,2,0,1,1,3,5,-2,1,Lithuania - A Lyga,0.0,0.5,-2,1.5,0.0,2.0,3
Panevezys,1,0,0,1,1,3,-2,0,Lithuania - A Lyga,0.0,0.0,-2,1.0,0.0,0.0,4
Hegelmann L.,1,0,0,1,0,2,-2,0,Lithuania - A Lyga,0.0,0.0,-2,0.0,0.0,0.0,4
Riteriai,8,7,0,1,18,4,14,21,Lithuania - 1st League,0.88,0.88,14,2.25,1.14,1.14,1
Siauliai B,8,5,0,3,22,13,9,15,Lithuania - 1st League,0.62,0.62,9,2.75,1.61,1.61,2
Ekranas,8,4,2,2,14,8,6,14,Lithuania - 1st League,0.5,0.75,6,1.75,2.0,1.33,3
Kauno Z. B,8,4,2,2,14,11,3,14,Lithuania - 1st League,0.5,0.75,3,1.75,2.0,1.33,3
Be1 NFA,8,3,4,1,13,9,4,13,Lithuania - 1st League,0.38,0.88,4,1.62,2.63,1.14,4
Tauras,8,4,1,3,11,7,4,13,Lithuania - 1st League,0.5,0.62,4,1.38,2.0,1.61,4
Nevezis,8,3,2,3,12,11,1,11,Lithuania - 1st League,0.38,0.62,1,1.5,2.63,1.61,5
Atmosfera,8,3,2,3,9,8,1,11,Lithuania - 1st League,0.38,0.62,1,1.12,2.63,1.61,5
Panevezys B,8,3,2,3,8,15,-7,11,Lithuania - 1st League,0.38,0.62,-7,1.0,2.63,1.61,5
Neptuna K.,8,3,1,4,14,13,1,10,Lithuania - 1st League,0.38,0.5,1,1.75,2.63,2.0,6
Babrungas,8,2,4,2,9,9,0,10,Lithuania - 1st League,0.25,0.75,0,1.12,4.0,1.33,6
BFA Vilnius,8,3,1,4,10,12,-2,10,Lithuania - 1st League,0.38,0.5,-2,1.25,2.63,2.0,6
Garliava,8,3,1,4,10,16,-6,10,Lithuania - 1st League,0.38,0.5,-6,1.25,2.63,2.0,6
Hegelmann B,8,3,0,5,10,14,-4,9,Lithuania - 1st League,0.38,0.38,-4,1.25,2.63,2.63,7
Minija,8,1,3,4,4,11,-7,6,Lithuania - 1st League,0.12,0.5,-7,0.5,8.33,2.0,8
Banga B,8,0,1,7,4,21,-17,1,Lithuania - 1st League,0.0,0.12,-17,0.5,0.0,8.33,9
Differdange,8,7,0,1,21,3,18,21,Luxembourg - National Division,0.88,0.88,18,2.62,1.14,1.14,1
UNA Strassen,8,6,2,0,24,5,19,20,Luxembourg - National Division,0.75,1.0,19,3.0,1.33,1.0,2
Dudelange,8,5,2,1,17,8,9,17,Luxembourg - National Division,0.62,0.88,9,2.12,1.61,1.14,3
Hostert,8,5,1,2,18,13,5,16,Luxembourg - National Division,0.62,0.75,5,2.25,1.61,1.33,4
Racing,8,4,1,3,8,4,4,13,Luxembourg - National Division,0.5,0.62,4,1.0,2.0,1.61,5
Wiltz,8,4,1,3,12,13,-1,13,Luxembourg - National Division,0.5,0.62,-1,1.5,2.0,1.61,5
Hesperange,8,2,5,1,12,9,3,11,Luxembourg - National Division,0.25,0.88,3,1.5,4.0,1.14,6
Niedercorn,8,2,4,2,7,9,-2,10,Luxembourg - National Division,0.25,0.75,-2,0.88,4.0,1.33,7
Petange,8,2,3,3,5,6,-1,9,Luxembourg - National Division,0.25,0.62,-1,0.62,4.0,1.61,8
Mondorf,8,2,3,3,7,11,-4,9,Luxembourg - National Division,0.25,0.62,-4,0.88,4.0,1.61,8
Jeunesse Esch,8,2,3,3,11,16,-5,9,Luxembourg - National Division,0.25,0.62,-5,1.38,4.0,1.61,8
Mondercange,8,2,2,4,6,10,-4,8,Luxembourg - National Division,0.25,0.5,-4,0.75,4.0,2.0,9
V. Rosport,8,1,4,3,6,13,-7,7,Luxembourg - National Division,0.12,0.62,-7,0.75,8.33,1.61,10
Rodange,8,1,3,4,15,20,-5,6,Luxembourg - National Division,0.12,0.5,-5,1.88,8.33,2.0,11
Bettembourg,8,1,0,7,4,13,-9,3,Luxembourg - National Division,0.12,0.12,-9,0.5,8.33,8.33,12
Fola Esch,8,1,0,7,5,25,-20,3,Luxembourg - National Division,0.12,0.12,-20,0.62,8.33,8.33,12
Johor Darul,8,8,0,0,26,1,25,24,Malaysia - Super League,1.0,1.0,25,3.25,1.0,1.0,1
Selangor,8,6,2,0,18,2,16,20,Malaysia - Super League,0.75,1.0,16,2.25,1.33,1.0,2
Kuching,8,4,3,1,15,7,8,15,Malaysia - Super League,0.5,0.88,8,1.88,2.0,1.14,3
Terengganu,8,4,2,2,15,9,6,14,Malaysia - Super League,0.5,0.75,6,1.88,2.0,1.33,4
Kuala Lumpur,8,4,2,2,11,11,0,14,Malaysia - Super League,0.5,0.75,0,1.38,2.0,1.33,4
Sabah,8,3,4,1,13,12,1,13,Malaysia - Super League,0.38,0.88,1,1.62,2.63,1.14,5
Pulau Pinang,8,2,3,3,13,12,1,9,Malaysia - Super League,0.25,0.62,1,1.62,4.0,1.61,6
Kedah,8,2,2,4,8,13,-5,8,Malaysia - Super League,0.25,0.5,-5,1.0,4.0,2.0,7
Perak,8,1,4,3,13,14,-1,7,Malaysia - Super League,0.12,0.62,-1,1.62,8.33,1.61,8
Negeri Sembilan,8,2,1,5,6,15,-9,7,Malaysia - Super League,0.25,0.38,-9,0.75,4.0,2.63,8
PDRM,8,1,2,5,9,15,-6,5,Malaysia - Super League,0.12,0.38,-6,1.12,8.33,2.63,9
Pahang,8,1,2,5,9,18,-9,5,Malaysia - Super League,0.12,0.38,-9,1.12,8.33,2.63,9
Kelantan United,8,0,0,8,3,35,-32,0,Malaysia - Super League,0.0,0.0,-32,0.38,0.0,0.0,10
Marsaxlokk,8,5,1,2,12,6,6,16,Malta - Premier League,0.62,0.75,6,1.5,1.61,1.33,1
Floriana,8,4,3,1,10,6,4,15,Malta - Premier League,0.5,0.88,4,1.25,2.0,1.14,2
Hamrun Spartans,8,4,2,2,10,5,5,14,Malta - Premier League,0.5,0.75,5,1.25,2.0,1.33,3
Birkirkara,8,3,4,1,12,6,6,13,Malta - Premier League,0.38,0.88,6,1.5,2.63,1.14,4
Sliema,8,4,0,4,15,11,4,12,Malta - Premier League,0.5,0.5,4,1.88,2.0,2.0,5
Hibernians,8,4,0,4,13,14,-1,12,Malta - Premier League,0.5,0.5,-1,1.62,2.0,2.0,5
Gzira Utd,8,3,2,3,8,12,-4,11,Malta - Premier League,0.38,0.62,-4,1.0,2.63,1.61,6
Melita,8,2,4,2,13,14,-1,10,Malta - Premier League,0.25,0.75,-1,1.62,4.0,1.33,7
Mosta,8,3,1,4,8,11,-3,10,Malta - Premier League,0.38,0.5,-3,1.0,2.63,2.0,7
Zabbar,8,2,2,4,10,10,0,8,Malta - Premier League,0.25,0.5,0,1.25,4.0,2.0,8
Balzan,8,2,2,4,9,13,-4,8,Malta - Premier League,0.25,0.5,-4,1.12,4.0,2.0,8
Naxxar Lions,8,2,1,5,8,17,-9,7,Malta - Premier League,0.25,0.38,-9,1.0,4.0,2.63,9
Cruz Azul,8,6,2,0,20,6,14,20,Mexico - Liga MX - Apertura,0.75,1.0,14,2.5,1.33,1.0,1
Toluca,8,5,2,1,21,7,14,17,Mexico - Liga MX - Apertura,0.62,0.88,14,2.62,1.61,1.14,2
A. San Luis,8,5,1,2,12,8,4,16,Mexico - Liga MX - Apertura,0.62,0.75,4,1.5,1.61,1.33,3
Pumas UNAM,8,4,3,1,8,3,5,15,Mexico - Liga MX - Apertura,0.5,0.88,5,1.0,2.0,1.14,4
Tijuana,8,4,3,1,10,9,1,15,Mexico - Liga MX - Apertura,0.5,0.88,1,1.25,2.0,1.14,4
CF America,8,4,2,2,15,10,5,14,Mexico - Liga MX - Apertura,0.5,0.75,5,1.88,2.0,1.33,5
Tigres,8,4,2,2,13,11,2,14,Mexico - Liga MX - Apertura,0.5,0.75,2,1.62,2.0,1.33,5
Juarez,8,4,1,3,13,15,-2,13,Mexico - Liga MX - Apertura,0.5,0.62,-2,1.62,2.0,1.61,6
Monterrey,8,3,3,2,12,7,5,12,Mexico - Liga MX - Apertura,0.38,0.75,5,1.5,2.63,1.33,7
Club Leon,8,2,5,1,13,9,4,11,Mexico - Liga MX - Apertura,0.25,0.88,4,1.62,4.0,1.14,8
Guadalajara,8,3,2,3,10,8,2,11,Mexico - Liga MX - Apertura,0.38,0.62,2,1.25,2.63,1.61,8
Queretaro,8,2,2,4,7,13,-6,8,Mexico - Liga MX - Apertura,0.25,0.5,-6,0.88,4.0,2.0,9
Atlas,8,1,5,2,6,12,-6,8,Mexico - Liga MX - Apertura,0.12,0.75,-6,0.75,8.33,1.33,9
Mazatlan,8,1,4,3,4,9,-5,7,Mexico - Liga MX - Apertura,0.12,0.62,-5,0.5,8.33,1.61,10
Pachuca,8,1,1,6,12,16,-4,4,Mexico - Liga MX - Apertura,0.12,0.25,-4,1.5,8.33,4.0,11
Necaxa,8,0,3,5,7,18,-11,3,Mexico - Liga MX - Apertura,0.0,0.38,-11,0.88,0.0,2.63,12
Puebla,8,1,0,7,7,18,-11,3,Mexico - Liga MX - Apertura,0.12,0.12,-11,0.88,8.33,8.33,12
Santos Laguna,8,0,2,6,4,16,-12,2,Mexico - Liga MX - Apertura,0.0,0.25,-12,0.5,0.0,4.0,13
Club Leon,8,6,2,0,15,9,6,20,Mexico - Liga MX - Clausura,0.75,1.0,6,1.88,1.33,1.0,1
CF America,8,5,2,1,17,5,12,17,Mexico - Liga MX - Clausura,0.62,0.88,12,2.12,1.61,1.14,2
Toluca,8,5,2,1,21,10,11,17,Mexico - Liga MX - Clausura,0.62,0.88,11,2.62,1.61,1.14,2
Cruz Azul,8,5,2,1,13,8,5,17,Mexico - Liga MX - Clausura,0.62,0.88,5,1.62,1.61,1.14,2
Tigres,8,5,0,3,11,6,5,15,Mexico - Liga MX - Clausura,0.62,0.62,5,1.38,1.61,1.61,3
Monterrey,8,4,2,2,17,12,5,14,Mexico - Liga MX - Clausura,0.5,0.75,5,2.12,2.0,1.33,4
Juarez,8,4,1,3,8,13,-5,13,Mexico - Liga MX - Clausura,0.5,0.62,-5,1.0,2.0,1.61,5
Necaxa,8,4,0,4,17,16,1,12,Mexico - Liga MX - Clausura,0.5,0.5,1,2.12,2.0,2.0,6
Guadalajara,8,3,2,3,9,10,-1,11,Mexico - Liga MX - Clausura,0.38,0.62,-1,1.12,2.63,1.61,7
Pumas UNAM,8,3,1,4,11,13,-2,10,Mexico - Liga MX - Clausura,0.38,0.5,-2,1.38,2.63,2.0,8
Pachuca,8,2,3,3,10,11,-1,9,Mexico - Liga MX - Clausura,0.25,0.62,-1,1.25,4.0,1.61,9
Mazatlan,8,2,3,3,7,9,-2,9,Mexico - Liga MX - Clausura,0.25,0.62,-2,0.88,4.0,1.61,9
Atlas,8,2,3,3,10,14,-4,9,Mexico - Liga MX - Clausura,0.25,0.62,-4,1.25,4.0,1.61,9
Queretaro,8,2,1,5,6,13,-7,7,Mexico - Liga MX - Clausura,0.25,0.38,-7,0.75,4.0,2.63,10
Puebla,8,2,0,6,9,13,-4,6,Mexico - Liga MX - Clausura,0.25,0.25,-4,1.12,4.0,4.0,11
Tijuana,8,2,0,6,11,18,-7,6,Mexico - Liga MX - Clausura,0.25,0.25,-7,1.38,4.0,4.0,11
A. San Luis,8,2,0,6,9,16,-7,6,Mexico - Liga MX - Clausura,0.25,0.25,-7,1.12,4.0,4.0,11
Santos Laguna,8,1,1,6,8,16,-8,4,Mexico - Liga MX - Clausura,0.12,0.25,-8,1.0,8.33,4.0,12
Buducnost,8,8,0,0,24,6,18,24,Montenegro - First League,1.0,1.0,18,3.0,1.0,1.0,1
Petrovac,8,5,0,3,15,13,2,15,Montenegro - First League,0.62,0.62,2,1.88,1.61,1.61,2
Sutjeska,8,4,2,2,9,7,2,14,Montenegro - First League,0.5,0.75,2,1.12,2.0,1.33,3
Decic,8,3,3,2,10,7,3,12,Montenegro - First League,0.38,0.75,3,1.25,2.63,1.33,4
Bokelj,8,3,1,4,8,10,-2,10,Montenegro - First League,0.38,0.5,-2,1.0,2.63,2.0,5
Arsenal Tivat,8,2,2,4,9,11,-2,8,Montenegro - First League,0.25,0.5,-2,1.12,4.0,2.0,6
Mornar Bar,8,2,2,4,8,15,-7,8,Montenegro - First League,0.25,0.5,-7,1.0,4.0,2.0,6
Jezero,8,2,1,5,8,11,-3,7,Montenegro - First League,0.25,0.38,-3,1.0,4.0,2.63,7
Otrant,8,2,1,5,4,8,-4,7,Montenegro - First League,0.25,0.38,-4,0.5,4.0,2.63,7
Jedinstvo,8,1,2,5,6,15,-9,5,Montenegro - First League,0.12,0.38,-9,0.75,8.33,2.63,8
Berkane,8,6,2,0,15,3,12,20,morocco,0.75,1.0,12,1.88,1.33,1.0,1
Wydad,8,5,2,1,14,7,7,17,morocco,0.62,0.88,7,1.75,1.61,1.14,2
FUS Rabat,8,5,1,2,11,4,7,16,morocco,0.62,0.75,7,1.38,1.61,1.33,3
Maghreb de Fes,8,3,4,1,11,8,3,13,morocco,0.38,0.88,3,1.38,2.63,1.14,4
Meknes,8,3,4,1,10,7,3,13,morocco,0.38,0.88,3,1.25,2.63,1.14,4
R. Zemamra,8,4,0,4,10,8,2,12,morocco,0.5,0.5,2,1.25,2.0,2.0,5
FAR Rabat,8,3,3,2,10,10,0,12,morocco,0.38,0.75,0,1.25,2.63,1.33,5
Olympic Safi,8,2,5,1,9,9,0,11,morocco,0.25,0.88,0,1.12,4.0,1.14,6
Ittihad Tanger,8,3,2,3,11,12,-1,11,morocco,0.38,0.62,-1,1.38,2.63,1.61,6
Union Touarga,8,3,2,3,9,10,-1,11,morocco,0.38,0.62,-1,1.12,2.63,1.61,6
Raja Casablanca,8,2,4,2,7,7,0,10,morocco,0.25,0.75,0,0.88,4.0,1.33,7
Difaa El Jadida,8,2,2,4,5,10,-5,8,morocco,0.25,0.5,-5,0.62,4.0,2.0,8
Moghreb Tetouan,8,1,2,5,7,11,-4,5,morocco,0.12,0.38,-4,0.88,8.33,2.63,9
Hassania Agadir,8,1,2,5,7,12,-5,5,morocco,0.12,0.38,-5,0.88,8.33,2.63,9
JS Sousalem,8,0,2,6,4,16,-12,2,morocco,0.0,0.25,-12,0.5,0.0,4.0,10
C. Mohammedia,8,0,1,7,4,16,-12,1,morocco,0.0,0.12,-12,0.5,0.0,8.33,11
Shan Utd,8,7,1,0,24,2,22,22,myanmar,0.88,1.0,22,3.0,1.14,1.0,1
Yangon Utd,8,5,2,1,21,6,15,17,myanmar,0.62,0.88,15,2.62,1.61,1.14,2
Sagaing Utd,8,4,2,2,16,13,3,14,myanmar,0.5,0.75,3,2.0,2.0,1.33,3
Thitsar Arman,8,4,1,3,15,12,3,13,myanmar,0.5,0.62,3,1.88,2.0,1.61,4
Yadanarbon,8,3,3,2,18,15,3,12,myanmar,0.38,0.75,3,2.25,2.63,1.33,5
Dagon,8,3,2,3,10,11,-1,11,myanmar,0.38,0.62,-1,1.25,2.63,1.61,6
Hantharwady,8,3,2,3,7,11,-4,11,myanmar,0.38,0.62,-4,0.88,2.63,1.61,6
Rakhine Utd,8,3,2,3,10,16,-6,11,myanmar,0.38,0.62,-6,1.25,2.63,1.61,6
Ayeyawady,8,2,0,6,9,16,-7,6,myanmar,0.25,0.25,-7,1.12,4.0,4.0,7
Ispe FC,8,1,3,4,4,14,-10,6,myanmar,0.12,0.5,-10,0.5,8.33,2.0,7
Dagon Port,8,1,2,5,12,21,-9,5,myanmar,0.12,0.38,-9,1.5,8.33,2.63,8
Myawady,8,1,2,5,11,20,-9,5,myanmar,0.12,0.38,-9,1.38,8.33,2.63,8
Ajax Amsterdam,8,8,0,0,17,2,15,24,netherlands,1.0,1.0,15,2.12,1.0,1.0,1
Go Ahead Eagles,8,5,1,2,15,12,3,16,netherlands,0.62,0.75,3,1.88,1.61,1.33,2
AZ Alkmaar,8,4,2,2,10,7,3,14,netherlands,0.5,0.75,3,1.25,2.0,1.33,3
FC Twente,8,3,3,2,17,11,6,12,netherlands,0.38,0.75,6,2.12,2.63,1.33,4
Sparta,8,3,3,2,10,8,2,12,netherlands,0.38,0.75,2,1.25,2.63,1.33,4
FC Groningen,8,3,3,2,9,7,2,12,netherlands,0.38,0.75,2,1.12,2.63,1.33,4
Heracles Almelo,8,3,3,2,13,12,1,12,netherlands,0.38,0.75,1,1.62,2.63,1.33,4
RKC Waalwijk,8,3,2,3,15,9,6,11,netherlands,0.38,0.62,6,1.88,2.63,1.61,5
PSV Eindhoven,8,2,4,2,16,17,-1,10,netherlands,0.25,0.75,-1,2.0,4.0,1.33,6
FC Utrecht,8,2,4,2,11,13,-2,10,netherlands,0.25,0.75,-2,1.38,4.0,1.33,6
Heerenveen,8,2,3,3,14,14,0,9,netherlands,0.25,0.62,0,1.75,4.0,1.61,7
PEC Zwolle,8,2,3,3,14,14,0,9,netherlands,0.25,0.62,0,1.75,4.0,1.61,7
Feyenoord,8,2,3,3,8,9,-1,9,netherlands,0.25,0.62,-1,1.0,4.0,1.61,7
NEC Nijmegen,8,2,3,3,12,14,-2,9,netherlands,0.25,0.62,-2,1.5,4.0,1.61,7
Almere City,8,2,2,4,8,11,-3,8,netherlands,0.25,0.5,-3,1.0,4.0,2.0,8
Fortuna Sittard,8,2,1,5,7,17,-10,7,netherlands,0.25,0.38,-10,0.88,4.0,2.63,9
NAC Breda,8,1,3,4,8,16,-8,6,netherlands,0.12,0.5,-8,1.0,8.33,2.0,10
Willem II,8,1,2,5,9,20,-11,5,netherlands,0.12,0.38,-11,1.12,8.33,2.63,11
ADO Den Haag,8,7,0,1,14,6,8,21,netherlands2,0.88,0.88,8,1.75,1.14,1.14,1
FC Volendam,8,6,0,2,18,9,9,18,netherlands2,0.75,0.75,9,2.25,1.33,1.33,2
Cambuur,8,5,2,1,18,8,10,17,netherlands2,0.62,0.88,10,2.25,1.61,1.14,3
FC Dordrecht,8,5,2,1,13,9,4,17,netherlands2,0.62,0.88,4,1.62,1.61,1.14,3
De Graafschap,8,5,1,2,16,8,8,16,netherlands2,0.62,0.75,8,2.0,1.61,1.33,4
Telstar,8,5,0,3,19,7,12,15,netherlands2,0.62,0.62,12,2.38,1.61,1.61,5
FC Eindhoven,8,4,1,3,16,12,4,13,netherlands2,0.5,0.62,4,2.0,2.0,1.61,6
Vitesse Arnhem,8,4,1,3,11,14,-3,13,netherlands2,0.5,0.62,-3,1.38,2.0,1.61,6
VVV,8,4,1,3,9,13,-4,13,netherlands2,0.5,0.62,-4,1.12,2.0,1.61,6
Helmond Sport,8,3,2,3,13,9,4,11,netherlands2,0.38,0.62,4,1.62,2.63,1.61,7
Jong AZ,8,3,2,3,17,15,2,11,netherlands2,0.38,0.62,2,2.12,2.63,1.61,7
FC Den Bosch,8,3,1,4,7,6,1,10,netherlands2,0.38,0.5,1,0.88,2.63,2.0,8
Jong Ajax,8,3,1,4,10,11,-1,10,netherlands2,0.38,0.5,-1,1.25,2.63,2.0,8
MVV Maastricht,8,3,1,4,12,14,-2,10,netherlands2,0.38,0.5,-2,1.5,2.63,2.0,8
Roda JC,8,2,3,3,12,11,1,9,netherlands2,0.25,0.62,1,1.5,4.0,1.61,9
FC Emmen,8,3,0,5,11,15,-4,9,netherlands2,0.38,0.38,-4,1.38,2.63,2.63,9
Excelsior,8,2,2,4,10,12,-2,8,netherlands2,0.25,0.5,-2,1.25,4.0,2.0,10
Jong Utrecht,8,1,2,5,6,21,-15,5,netherlands2,0.12,0.38,-15,0.75,8.33,2.63,11
TOP Oss,8,0,3,5,3,15,-12,3,netherlands2,0.0,0.38,-12,0.38,0.0,2.63,12
Jong PSV,8,0,0,8,7,21,-14,0,netherlands2,0.0,0.0,-14,0.88,0.0,0.0,13
Diriangen,8,7,1,0,29,1,28,22,nicaragua,0.88,1.0,28,3.62,1.14,1.0,1
Matagalpa,8,6,1,1,16,6,10,19,nicaragua,0.75,0.88,10,2.0,1.33,1.14,2
Real Esteli,8,4,3,1,13,9,4,15,nicaragua,0.5,0.88,4,1.62,2.0,1.14,3
Walter Ferreti,8,3,3,2,7,6,1,12,nicaragua,0.38,0.75,1,0.88,2.63,1.33,4
Managua FC,8,3,1,4,11,10,1,10,nicaragua,0.38,0.5,1,1.38,2.63,2.0,5
UNAN Managua,8,3,1,4,9,15,-6,10,nicaragua,0.38,0.5,-6,1.12,2.63,2.0,5
Jalapa,8,2,3,3,6,13,-7,9,nicaragua,0.25,0.62,-7,0.75,4.0,1.61,6
Export Sebaco,8,2,2,4,9,10,-1,8,nicaragua,0.25,0.5,-1,1.12,4.0,2.0,7
Rancho Santana,8,1,1,6,6,20,-14,4,nicaragua,0.12,0.25,-14,0.75,8.33,4.0,8
D. Ocotal,8,1,1,6,6,21,-15,4,nicaragua,0.12,0.25,-15,0.75,8.33,4.0,8
Diriangen,8,7,0,1,18,5,13,21,nicaragua2,0.88,0.88,13,2.25,1.14,1.14,1
Real Esteli,8,6,1,1,19,4,15,19,nicaragua2,0.75,0.88,15,2.38,1.33,1.14,2
Managua FC,8,4,3,1,9,5,4,15,nicaragua2,0.5,0.88,4,1.12,2.0,1.14,3
CS Sebaco,8,4,2,2,10,7,3,14,nicaragua2,0.5,0.75,3,1.25,2.0,1.33,4
UNAN Managua,8,3,2,3,9,13,-4,11,nicaragua2,0.38,0.62,-4,1.12,2.63,1.61,5
Matagalpa,8,2,3,3,10,12,-2,9,nicaragua2,0.25,0.62,-2,1.25,4.0,1.61,6
Jalapa,8,2,3,3,8,10,-2,9,nicaragua2,0.25,0.62,-2,1.0,4.0,1.61,6
Walter Ferreti,8,2,2,4,6,8,-2,8,nicaragua2,0.25,0.5,-2,0.75,4.0,2.0,7
Rancho Santana,8,1,2,5,4,9,-5,5,nicaragua2,0.12,0.38,-5,0.5,8.33,2.63,8
D. Ocotal,8,1,2,5,9,20,-11,5,nicaragua2,0.12,0.38,-11,1.12,8.33,2.63,8
Linfield,8,6,1,1,13,7,6,19,northernireland,0.75,0.88,6,1.62,1.33,1.14,1
Glentoran,8,5,2,1,9,5,4,17,northernireland,0.62,0.88,4,1.12,1.61,1.14,2
Glenavon,8,5,1,2,13,7,6,16,northernireland,0.62,0.75,6,1.62,1.61,1.33,3
Crusaders,8,5,0,3,12,12,0,15,northernireland,0.62,0.62,0,1.5,1.61,1.61,4
Coleraine,8,4,2,2,8,5,3,14,northernireland,0.5,0.75,3,1.0,2.0,1.33,5
Dungannon,8,4,1,3,14,11,3,13,northernireland,0.5,0.62,3,1.75,2.0,1.61,6
Cliftonville,8,3,2,3,11,9,2,11,northernireland,0.38,0.62,2,1.38,2.63,1.61,7
Larne,8,3,1,4,8,8,0,10,northernireland,0.38,0.5,0,1.0,2.63,2.0,8
Ballymena Utd,8,2,3,3,10,9,1,9,northernireland,0.25,0.62,1,1.25,4.0,1.61,9
Portadown,8,2,2,4,9,13,-4,8,northernireland,0.25,0.5,-4,1.12,4.0,2.0,10
Carrick Rangers,8,0,1,7,4,14,-10,1,northernireland,0.0,0.12,-10,0.5,0.0,8.33,11
Loughgall,8,0,1,7,2,13,-11,1,northernireland,0.0,0.12,-11,0.25,0.0,8.33,11
HW Welders,8,5,3,0,20,7,13,18,northernireland2,0.62,1.0,13,2.5,1.61,1.0,1
Bangor,8,4,2,2,16,6,10,14,northernireland2,0.5,0.75,10,2.0,2.0,1.33,2
Annagh Utd,8,4,1,3,20,12,8,13,northernireland2,0.5,0.62,8,2.5,2.0,1.61,3
Limavady,8,3,3,2,11,7,4,12,northernireland2,0.38,0.75,4,1.38,2.63,1.33,4
Ards,8,3,3,2,11,10,1,12,northernireland2,0.38,0.75,1,1.38,2.63,1.33,4
Ballinamallard,8,3,2,3,11,15,-4,11,northernireland2,0.38,0.62,-4,1.38,2.63,1.61,5
Institute,8,2,4,2,12,11,1,10,northernireland2,0.25,0.75,1,1.5,4.0,1.33,6
Newington,8,3,1,4,12,13,-1,10,northernireland2,0.38,0.5,-1,1.5,2.63,2.0,6
Dundela,8,3,1,4,15,19,-4,10,northernireland2,0.38,0.5,-4,1.88,2.63,2.0,6
Newry City,8,2,2,4,8,15,-7,8,northernireland2,0.25,0.5,-7,1.0,4.0,2.0,7
Ballyclare,8,2,2,4,9,17,-8,8,northernireland2,0.25,0.5,-8,1.12,4.0,2.0,7
Armagh City,8,2,2,4,14,23,-9,8,northernireland2,0.25,0.5,-9,1.75,4.0,2.0,7
Shkendija,8,6,1,1,11,6,5,19,northmacedonia,0.75,0.88,5,1.38,1.33,1.14,1
Sileks,8,5,2,1,18,7,11,17,northmacedonia,0.62,0.88,11,2.25,1.61,1.14,2
Rabotnicki,8,5,1,2,13,6,7,16,northmacedonia,0.62,0.75,7,1.62,1.61,1.33,3
Gostivar,8,4,4,0,5,0,5,16,northmacedonia,0.5,1.0,5,0.62,2.0,1.0,3
Shkupi,8,5,0,3,11,8,3,15,northmacedonia,0.62,0.62,3,1.38,1.61,1.61,4
Struga,8,3,1,4,9,11,-2,10,northmacedonia,0.38,0.5,-2,1.12,2.63,2.0,5
Pelister,8,3,1,4,5,9,-4,10,northmacedonia,0.38,0.5,-4,0.62,2.63,2.0,5
Vardar,8,2,3,3,6,6,0,9,northmacedonia,0.25,0.62,0,0.75,4.0,1.61,6
Tikves,8,2,2,4,6,8,-2,8,northmacedonia,0.25,0.5,-2,0.75,4.0,2.0,7
Voska Sport,8,2,1,5,7,10,-3,7,northmacedonia,0.25,0.38,-3,0.88,4.0,2.63,8
Brera Strumica,8,1,2,5,5,12,-7,5,northmacedonia,0.12,0.38,-7,0.62,8.33,2.63,9
Besa,8,0,2,6,1,14,-13,2,northmacedonia,0.0,0.25,-13,0.12,0.0,4.0,10
Bodo.Glimt,0,0,0,0,0,0,0,0,norway,0.0,0.0,0,0.0,0.0,0.0,1
Brann,0,0,0,0,0,0,0,0,norway,0.0,0.0,0,0.0,0.0,0.0,1
Bryne,0,0,0,0,0,0,0,0,norway,0.0,0.0,0,0.0,0.0,0.0,1
Fredrikstad,0,0,0,0,0,0,0,0,norway,0.0,0.0,0,0.0,0.0,0.0,1
HamKam,0,0,0,0,0,0,0,0,norway,0.0,0.0,0,0.0,0.0,0.0,1
Haugesund,0,0,0,0,0,0,0,0,norway,0.0,0.0,0,0.0,0.0,0.0,1
KFUM Oslo,0,0,0,0,0,0,0,0,norway,0.0,0.0,0,0.0,0.0,0.0,1
Kristiansund,0,0,0,0,0,0,0,0,norway,0.0,0.0,0,0.0,0.0,0.0,1
Molde,0,0,0,0,0,0,0,0,norway,0.0,0.0,0,0.0,0.0,0.0,1
Rosenborg,0,0,0,0,0,0,0,0,norway,0.0,0.0,0,0.0,0.0,0.0,1
Sandefjord,0,0,0,0,0,0,0,0,norway,0.0,0.0,0,0.0,0.0,0.0,1
Sarpsborg 08,0,0,0,0,0,0,0,0,norway,0.0,0.0,0,0.0,0.0,0.0,1
Stromsgodset,0,0,0,0,0,0,0,0,norway,0.0,0.0,0,0.0,0.0,0.0,1
Tromso,0,0,0,0,0,0,0,0,norway,0.0,0.0,0,0.0,0.0,0.0,1
Valerenga,0,0,0,0,0,0,0,0,norway,0.0,0.0,0,0.0,0.0,0.0,1
Viking,0,0,0,0,0,0,0,0,norway,0.0,0.0,0,0.0,0.0,0.0,1
Aalesund,0,0,0,0,0,0,0,0,norway2,0.0,0.0,0,0.0,0.0,0.0,1
Asane,0,0,0,0,0,0,0,0,norway2,0.0,0.0,0,0.0,0.0,0.0,1
Egersund,0,0,0,0,0,0,0,0,norway2,0.0,0.0,0,0.0,0.0,0.0,1
Hodd,0,0,0,0,0,0,0,0,norway2,0.0,0.0,0,0.0,0.0,0.0,1
Kongsvinger,0,0,0,0,0,0,0,0,norway2,0.0,0.0,0,0.0,0.0,0.0,1
Lillestrom,0,0,0,0,0,0,0,0,norway2,0.0,0.0,0,0.0,0.0,0.0,1
Lyn,0,0,0,0,0,0,0,0,norway2,0.0,0.0,0,0.0,0.0,0.0,1
Mjondalen,0,0,0,0,0,0,0,0,norway2,0.0,0.0,0,0.0,0.0,0.0,1
Moss,0,0,0,0,0,0,0,0,norway2,0.0,0.0,0,0.0,0.0,0.0,1
Odd,0,0,0,0,0,0,0,0,norway2,0.0,0.0,0,0.0,0.0,0.0,1
Ranheim,0,0,0,0,0,0,0,0,norway2,0.0,0.0,0,0.0,0.0,0.0,1
Raufoss,0,0,0,0,0,0,0,0,norway2,0.0,0.0,0,0.0,0.0,0.0,1
Skeid,0,0,0,0,0,0,0,0,norway2,0.0,0.0,0,0.0,0.0,0.0,1
Sogndal,0,0,0,0,0,0,0,0,norway2,0.0,0.0,0,0.0,0.0,0.0,1
Stabaek,0,0,0,0,0,0,0,0,norway2,0.0,0.0,0,0.0,0.0,0.0,1
Start,0,0,0,0,0,0,0,0,norway2,0.0,0.0,0,0.0,0.0,0.0,1
Arendal,0,0,0,0,0,0,0,0,norway3,0.0,0.0,0,0.0,0.0,0.0,1
Brann B,0,0,0,0,0,0,0,0,norway3,0.0,0.0,0,0.0,0.0,0.0,1
Brattvag,0,0,0,0,0,0,0,0,norway3,0.0,0.0,0,0.0,0.0,0.0,1
Eik Tonsberg,0,0,0,0,0,0,0,0,norway3,0.0,0.0,0,0.0,0.0,0.0,1
Flekkeroy,0,0,0,0,0,0,0,0,norway3,0.0,0.0,0,0.0,0.0,0.0,1
Jerv,0,0,0,0,0,0,0,0,norway3,0.0,0.0,0,0.0,0.0,0.0,1
Lysekloster,0,0,0,0,0,0,0,0,norway3,0.0,0.0,0,0.0,0.0,0.0,1
Notodden,0,0,0,0,0,0,0,0,norway3,0.0,0.0,0,0.0,0.0,0.0,1
Pors Grenland,0,0,0,0,0,0,0,0,norway3,0.0,0.0,0,0.0,0.0,0.0,1
Sandnes Ulf,0,0,0,0,0,0,0,0,norway3,0.0,0.0,0,0.0,0.0,0.0,1
Sandviken,0,0,0,0,0,0,0,0,norway3,0.0,0.0,0,0.0,0.0,0.0,1
Sotra,0,0,0,0,0,0,0,0,norway3,0.0,0.0,0,0.0,0.0,0.0,1
Traef,0,0,0,0,0,0,0,0,norway3,0.0,0.0,0,0.0,0.0,0.0,1
V. Haugesund,0,0,0,0,0,0,0,0,norway3,0.0,0.0,0,0.0,0.0,0.0,1
Alta,0,0,0,0,0,0,0,0,norway4,0.0,0.0,0,0.0,0.0,0.0,1
Asker,0,0,0,0,0,0,0,0,norway4,0.0,0.0,0,0.0,0.0,0.0,1
Eidsvold,0,0,0,0,0,0,0,0,norway4,0.0,0.0,0,0.0,0.0,0.0,1
Follo,0,0,0,0,0,0,0,0,norway4,0.0,0.0,0,0.0,0.0,0.0,1
Grorud,0,0,0,0,0,0,0,0,norway4,0.0,0.0,0,0.0,0.0,0.0,1
Honefoss,0,0,0,0,0,0,0,0,norway4,0.0,0.0,0,0.0,0.0,0.0,1
Kjelsas,0,0,0,0,0,0,0,0,norway4,0.0,0.0,0,0.0,0.0,0.0,1
Levanger,0,0,0,0,0,0,0,0,norway4,0.0,0.0,0,0.0,0.0,0.0,1
Rana,0,0,0,0,0,0,0,0,norway4,0.0,0.0,0,0.0,0.0,0.0,1
Stjordals-Blink,0,0,0,0,0,0,0,0,norway4,0.0,0.0,0,0.0,0.0,0.0,1
Strindheim,0,0,0,0,0,0,0,0,norway4,0.0,0.0,0,0.0,0.0,0.0,1
Strommen,0,0,0,0,0,0,0,0,norway4,0.0,0.0,0,0.0,0.0,0.0,1
Tromsdalen,0,0,0,0,0,0,0,0,norway4,0.0,0.0,0,0.0,0.0,0.0,1
Ull/Kisa,0,0,0,0,0,0,0,0,norway4,0.0,0.0,0,0.0,0.0,0.0,1
Alta B,0,0,0,0,0,0,0,0,norway5,0.0,0.0,0,0.0,0.0,0.0,1
Baerum,0,0,0,0,0,0,0,0,norway5,0.0,0.0,0,0.0,0.0,0.0,1
Floya,0,0,0,0,0,0,0,0,norway5,0.0,0.0,0,0.0,0.0,0.0,1
Frigg,0,0,0,0,0,0,0,0,norway5,0.0,0.0,0,0.0,0.0,0.0,1
Funnefoss/V.,0,0,0,0,0,0,0,0,norway5,0.0,0.0,0,0.0,0.0,0.0,1
Gamle Oslo,0,0,0,0,0,0,0,0,norway5,0.0,0.0,0,0.0,0.0,0.0,1
Harstad,0,0,0,0,0,0,0,0,norway5,0.0,0.0,0,0.0,0.0,0.0,1
Junkeren,0,0,0,0,0,0,0,0,norway5,0.0,0.0,0,0.0,0.0,0.0,1
KFUM B,0,0,0,0,0,0,0,0,norway5,0.0,0.0,0,0.0,0.0,0.0,1
Skjervoy,0,0,0,0,0,0,0,0,norway5,0.0,0.0,0,0.0,0.0,0.0,1
Sortland,0,0,0,0,0,0,0,0,norway5,0.0,0.0,0,0.0,0.0,0.0,1
Tromso B,0,0,0,0,0,0,0,0,norway5,0.0,0.0,0,0.0,0.0,0.0,1
Ulfstind,0,0,0,0,0,0,0,0,norway5,0.0,0.0,0,0.0,0.0,0.0,1
Ullern,0,0,0,0,0,0,0,0,norway5,0.0,0.0,0,0.0,0.0,0.0,1
Aalesund B,0,0,0,0,0,0,0,0,norway6,0.0,0.0,0,0.0,0.0,0.0,1
Byasen,0,0,0,0,0,0,0,0,norway6,0.0,0.0,0,0.0,0.0,0.0,1
Kristiansund B,0,0,0,0,0,0,0,0,norway6,0.0,0.0,0,0.0,0.0,0.0,1
Kvik Trondheim,0,0,0,0,0,0,0,0,norway6,0.0,0.0,0,0.0,0.0,0.0,1
Melhus,0,0,0,0,0,0,0,0,norway6,0.0,0.0,0,0.0,0.0,0.0,1
Molde B,0,0,0,0,0,0,0,0,norway6,0.0,0.0,0,0.0,0.0,0.0,1
Nardo,0,0,0,0,0,0,0,0,norway6,0.0,0.0,0,0.0,0.0,0.0,1
Ranheim B,0,0,0,0,0,0,0,0,norway6,0.0,0.0,0,0.0,0.0,0.0,1
Rosenborg B,0,0,0,0,0,0,0,0,norway6,0.0,0.0,0,0.0,0.0,0.0,1
Spjelkavik,0,0,0,0,0,0,0,0,norway6,0.0,0.0,0,0.0,0.0,0.0,1
Surnadal,0,0,0,0,0,0,0,0,norway6,0.0,0.0,0,0.0,0.0,0.0,1
Tiller,0,0,0,0,0,0,0,0,norway6,0.0,0.0,0,0.0,0.0,0.0,1
Trygg.Lade,0,0,0,0,0,0,0,0,norway6,0.0,0.0,0,0.0,0.0,0.0,1
Volda,0,0,0,0,0,0,0,0,norway6,0.0,0.0,0,0.0,0.0,0.0,1
Assiden IF,0,0,0,0,0,0,0,0,norway7,0.0,0.0,0,0.0,0.0,0.0,1
Bjorkelangen,0,0,0,0,0,0,0,0,norway7,0.0,0.0,0,0.0,0.0,0.0,1
Elverum,0,0,0,0,0,0,0,0,norway7,0.0,0.0,0,0.0,0.0,0.0,1
Gjovik-Lyn,0,0,0,0,0,0,0,0,norway7,0.0,0.0,0,0.0,0.0,0.0,1
HamKam B,0,0,0,0,0,0,0,0,norway7,0.0,0.0,0,0.0,0.0,0.0,1
Kongsvinger B,0,0,0,0,0,0,0,0,norway7,0.0,0.0,0,0.0,0.0,0.0,1
Lillehammer,0,0,0,0,0,0,0,0,norway7,0.0,0.0,0,0.0,0.0,0.0,1
Lillestrom B,0,0,0,0,0,0,0,0,norway7,0.0,0.0,0,0.0,0.0,0.0,1
Lorenskog,0,0,0,0,0,0,0,0,norway7,0.0,0.0,0,0.0,0.0,0.0,1
Nordstrand,0,0,0,0,0,0,0,0,norway7,0.0,0.0,0,0.0,0.0,0.0,1
Skedsmo,0,0,0,0,0,0,0,0,norway7,0.0,0.0,0,0.0,0.0,0.0,1
Skjetten,0,0,0,0,0,0,0,0,norway7,0.0,0.0,0,0.0,0.0,0.0,1
Stromsgodset B,0,0,0,0,0,0,0,0,norway7,0.0,0.0,0,0.0,0.0,0.0,1
Ull/Kisa B,0,0,0,0,0,0,0,0,norway7,0.0,0.0,0,0.0,0.0,0.0,1
Asane B,0,0,0,0,0,0,0,0,norway8,0.0,0.0,0,0.0,0.0,0.0,1
Askoy,0,0,0,0,0,0,0,0,norway8,0.0,0.0,0,0.0,0.0,0.0,1
Bjarg,0,0,0,0,0,0,0,0,norway8,0.0,0.0,0,0.0,0.0,0.0,1
Fana,0,0,0,0,0,0,0,0,norway8,0.0,0.0,0,0.0,0.0,0.0,1
Fjora,0,0,0,0,0,0,0,0,norway8,0.0,0.0,0,0.0,0.0,0.0,1
Forde,0,0,0,0,0,0,0,0,norway8,0.0,0.0,0,0.0,0.0,0.0,1
Fyllingsdalen,0,0,0,0,0,0,0,0,norway8,0.0,0.0,0,0.0,0.0,0.0,1
Gneist,0,0,0,0,0,0,0,0,norway8,0.0,0.0,0,0.0,0.0,0.0,1
Loddefjord,0,0,0,0,0,0,0,0,norway8,0.0,0.0,0,0.0,0.0,0.0,1
Lyn B,0,0,0,0,0,0,0,0,norway8,0.0,0.0,0,0.0,0.0,0.0,1
Lyngbo,0,0,0,0,0,0,0,0,norway8,0.0,0.0,0,0.0,0.0,0.0,1
OS,0,0,0,0,0,0,0,0,norway8,0.0,0.0,0,0.0,0.0,0.0,1
Sandefjord B,0,0,0,0,0,0,0,0,norway8,0.0,0.0,0,0.0,0.0,0.0,1
Valerenga B,0,0,0,0,0,0,0,0,norway8,0.0,0.0,0,0.0,0.0,0.0,1
Brodd,0,0,0,0,0,0,0,0,norway9,0.0,0.0,0,0.0,0.0,0.0,1
Djerv,0,0,0,0,0,0,0,0,norway9,0.0,0.0,0,0.0,0.0,0.0,1
Haugesund B,0,0,0,0,0,0,0,0,norway9,0.0,0.0,0,0.0,0.0,0.0,1
Hinna,0,0,0,0,0,0,0,0,norway9,0.0,0.0,0,0.0,0.0,0.0,1
Madla,0,0,0,0,0,0,0,0,norway9,0.0,0.0,0,0.0,0.0,0.0,1
Sandnes Ulf B,0,0,0,0,0,0,0,0,norway9,0.0,0.0,0,0.0,0.0,0.0,1
Sola,0,0,0,0,0,0,0,0,norway9,0.0,0.0,0,0.0,0.0,0.0,1
Staal Jorpeland,0,0,0,0,0,0,0,0,norway9,0.0,0.0,0,0.0,0.0,0.0,1
Stord,0,0,0,0,0,0,0,0,norway9,0.0,0.0,0,0.0,0.0,0.0,1
Torvastad,0,0,0,0,0,0,0,0,norway9,0.0,0.0,0,0.0,0.0,0.0,1
Vag,0,0,0,0,0,0,0,0,norway9,0.0,0.0,0,0.0,0.0,0.0,1
Vidar,0,0,0,0,0,0,0,0,norway9,0.0,0.0,0,0.0,0.0,0.0,1
Viking B,0,0,0,0,0,0,0,0,norway9,0.0,0.0,0,0.0,0.0,0.0,1
Vindbjart,0,0,0,0,0,0,0,0,norway9,0.0,0.0,0,0.0,0.0,0.0,1
Drobak-Frogn,0,0,0,0,0,0,0,0,norway10,0.0,0.0,0,0.0,0.0,0.0,1
Flint,0,0,0,0,0,0,0,0,norway10,0.0,0.0,0,0.0,0.0,0.0,1
Fram,0,0,0,0,0,0,0,0,norway10,0.0,0.0,0,0.0,0.0,0.0,1
Fredrikstad B,0,0,0,0,0,0,0,0,norway10,0.0,0.0,0,0.0,0.0,0.0,1
Grei,0,0,0,0,0,0,0,0,norway10,0.0,0.0,0,0.0,0.0,0.0,1
IF Ready,0,0,0,0,0,0,0,0,norway10,0.0,0.0,0,0.0,0.0,0.0,1
Kvik Halden,0,0,0,0,0,0,0,0,norway10,0.0,0.0,0,0.0,0.0,0.0,1
Lokomotiv Oslo,0,0,0,0,0,0,0,0,norway10,0.0,0.0,0,0.0,0.0,0.0,1
Odd B,0,0,0,0,0,0,0,0,norway10,0.0,0.0,0,0.0,0.0,0.0,1
Oppsal,0,0,0,0,0,0,0,0,norway10,0.0,0.0,0,0.0,0.0,0.0,1
Orn Horten,0,0,0,0,0,0,0,0,norway10,0.0,0.0,0,0.0,0.0,0.0,1
Pors Grenland B,0,0,0,0,0,0,0,0,norway10,0.0,0.0,0,0.0,0.0,0.0,1
Sarpsborg 08 B,0,0,0,0,0,0,0,0,norway10,0.0,0.0,0,0.0,0.0,0.0,1
Stabaek B,0,0,0,0,0,0,0,0,norway10,0.0,0.0,0,0.0,0.0,0.0,1
Plaza Amador,8,5,1,2,13,10,3,16,panama,0.62,0.75,3,1.62,1.61,1.33,1
San Miguelito,7,4,2,1,9,5,4,14,panama,0.57,0.86,4,1.29,1.75,1.16,2
UMECIT,7,3,3,1,9,6,3,12,panama,0.43,0.86,3,1.29,2.33,1.16,3
Universitario,8,2,5,1,10,7,3,11,panama,0.25,0.88,3,1.25,4.0,1.14,4
Independiente,7,3,2,2,8,7,1,11,panama,0.43,0.71,1,1.14,2.33,1.41,4
Arabe Unido,7,2,4,1,7,6,1,10,panama,0.29,0.86,1,1.0,3.45,1.16,5
Veraguas,8,2,3,3,7,11,-4,9,panama,0.25,0.62,-4,0.88,4.0,1.61,6
Costa del Este,7,1,5,1,9,9,0,8,panama,0.14,0.86,0,1.29,7.14,1.16,7
Alianza,8,1,4,3,7,11,-4,7,panama,0.12,0.62,-4,0.88,8.33,1.61,8
Tauro,8,1,3,4,9,9,0,6,panama,0.12,0.5,0,1.12,8.33,2.0,9
San Francisco,7,1,3,3,3,6,-3,6,panama,0.14,0.57,-3,0.43,7.14,1.75,9
Herrera,8,1,3,4,5,9,-4,6,panama,0.12,0.5,-4,0.62,8.33,2.0,9
San Miguelito,8,5,2,1,8,4,4,17,panama2,0.62,0.88,4,1.0,1.61,1.14,1
Independiente,8,5,1,2,14,11,3,16,panama2,0.62,0.75,3,1.75,1.61,1.33,2
Plaza Amador,8,4,3,1,9,6,3,15,panama2,0.5,0.88,3,1.12,2.0,1.14,3
Tauro,8,4,3,1,9,6,3,15,panama2,0.5,0.88,3,1.12,2.0,1.14,3
Veraguas,8,3,3,2,11,7,4,12,panama2,0.38,0.75,4,1.38,2.63,1.33,4
Arabe Unido,8,2,5,1,7,6,1,11,panama2,0.25,0.88,1,0.88,4.0,1.14,5
Universitario,8,3,2,3,6,5,1,11,panama2,0.38,0.62,1,0.75,2.63,1.61,5
UMECIT,8,3,1,4,8,8,0,10,panama2,0.38,0.5,0,1.0,2.63,2.0,6
Costa del Este,8,2,3,3,10,15,-5,9,panama2,0.25,0.62,-5,1.25,4.0,1.61,7
Alianza,8,2,0,6,8,12,-4,6,panama2,0.25,0.25,-4,1.0,4.0,4.0,8
San Francisco,8,1,2,5,4,10,-6,5,panama2,0.12,0.38,-6,0.5,8.33,2.63,9
Herrera,8,1,1,6,4,8,-4,4,panama2,0.12,0.25,-4,0.5,8.33,4.0,10
Libertad,8,6,2,0,19,6,13,20,paraguay,0.75,1.0,13,2.38,1.33,1.0,1
Guarani,7,5,0,2,9,6,3,15,paraguay,0.71,0.71,3,1.29,1.41,1.41,2
Olimpia,7,4,2,1,13,7,6,14,paraguay,0.57,0.86,6,1.86,1.75,1.16,3
D. Recoleta,8,3,2,3,13,15,-2,11,paraguay,0.38,0.62,-2,1.62,2.63,1.61,4
S. Trinidense,8,2,4,2,9,10,-1,10,paraguay,0.25,0.75,-1,1.12,4.0,1.33,5
G. Caballero,7,2,3,2,8,6,2,9,paraguay,0.29,0.71,2,1.14,3.45,1.41,6
S. Ameliano,7,2,3,2,8,9,-1,9,paraguay,0.29,0.71,-1,1.14,3.45,1.41,6
Cerro Porteno,7,2,2,3,9,9,0,8,paraguay,0.29,0.57,0,1.29,3.45,1.75,7
2 de Mayo,7,1,5,1,5,5,0,8,paraguay,0.14,0.86,0,0.71,7.14,1.16,7
A. Tembetary,8,1,3,4,8,13,-5,6,paraguay,0.12,0.5,-5,1.0,8.33,2.0,8
Nacional,7,1,1,5,4,11,-7,4,paraguay,0.14,0.29,-7,0.57,7.14,3.45,9
S. Luqueno,7,0,3,4,2,10,-8,3,paraguay,0.0,0.43,-8,0.29,0.0,2.33,10
Olimpia,8,4,3,1,10,4,6,15,paraguay2,0.5,0.88,6,1.25,2.0,1.14,1
Guarani,8,3,5,0,10,7,3,14,paraguay2,0.38,1.0,3,1.25,2.63,1.0,2
S. Ameliano,8,4,1,3,7,6,1,13,paraguay2,0.5,0.62,1,0.88,2.0,1.61,3
Sol de America,8,3,3,2,12,9,3,12,paraguay2,0.38,0.75,3,1.5,2.63,1.33,4
S. Luqueno,8,3,3,2,10,8,2,12,paraguay2,0.38,0.75,2,1.25,2.63,1.33,4
S. Trinidense,8,3,3,2,10,9,1,12,paraguay2,0.38,0.75,1,1.25,2.63,1.33,4
2 de Mayo,8,2,4,2,7,5,2,10,paraguay2,0.25,0.75,2,0.88,4.0,1.33,5
G. Caballero,8,2,3,3,7,7,0,9,paraguay2,0.25,0.62,0,0.88,4.0,1.61,6
Nacional,8,1,5,2,8,9,-1,8,paraguay2,0.12,0.75,-1,1.0,8.33,1.33,7
Cerro Porteno,8,2,2,4,11,15,-4,8,paraguay2,0.25,0.5,-4,1.38,4.0,2.0,7
Libertad,8,2,1,5,8,12,-4,7,paraguay2,0.25,0.38,-4,1.0,4.0,2.63,8
Tacuary,8,1,3,4,5,14,-9,6,paraguay2,0.12,0.5,-9,0.62,8.33,2.0,9
FBC Melgar,4,4,0,0,7,1,6,12,peru,1.0,1.0,6,1.75,1.0,1.0,1
Alianza Lima,5,4,0,1,9,4,5,12,peru,0.8,0.8,5,1.8,1.25,1.25,1
D. Garcilaso,5,3,2,0,9,5,4,11,peru,0.6,1.0,4,1.8,1.67,1.0,2
Sport Huancayo,5,3,1,1,6,4,2,10,peru,0.6,0.8,2,1.2,1.67,1.25,3
ADT,5,2,2,1,12,11,1,8,peru,0.4,0.8,1,2.4,2.5,1.25,4
Universitario,3,2,1,0,8,3,5,7,peru,0.67,1.0,5,2.67,1.49,1.0,5
Alianza A.,5,2,1,2,9,6,3,7,peru,0.4,0.6,3,1.8,2.5,1.67,5
Sport Boys,4,2,1,1,6,5,1,7,peru,0.5,0.75,1,1.5,2.0,1.33,5
S. Cristal,5,2,1,2,6,6,0,7,peru,0.4,0.6,0,1.2,2.5,1.67,5
Ayacucho,5,1,1,3,5,8,-3,4,peru,0.2,0.4,-3,1.0,5.0,2.5,6
Cusco,4,1,1,2,3,6,-3,4,peru,0.25,0.5,-3,0.75,4.0,2.0,6
Binacional,3,1,0,2,6,6,0,3,peru,0.33,0.33,0,2.0,3.03,3.03,7
Atletico Grau,3,1,0,2,4,6,-2,3,peru,0.33,0.33,-2,1.33,3.03,3.03,7
Los Chankas,2,0,2,0,3,3,0,2,peru,0.0,1.0,0,1.5,0.0,1.0,8
Comerciantes U.,3,0,2,1,3,4,-1,2,peru,0.0,0.67,-1,1.0,0.0,1.49,8
A. Huanuco,5,0,2,3,6,12,-6,2,peru,0.0,0.4,-6,1.2,0.0,2.5,8
Cajamarca,4,0,2,2,1,8,-7,2,peru,0.0,0.5,-7,0.25,0.0,2.0,8
Cienciano,3,0,1,2,6,8,-2,1,peru,0.0,0.33,-2,2.0,0.0,3.03,9
Juan Pablo II C,3,0,0,3,0,3,-3,0,peru,0.0,0.0,-3,0.0,0.0,0.0,10
Manila Digger,8,7,0,1,35,5,30,21,philippines,0.88,0.88,30,4.38,1.14,1.14,1
Kaya FC,8,7,0,1,23,6,17,21,philippines,0.88,0.88,17,2.88,1.14,1.14,1
Stallion,8,4,1,3,19,9,10,13,philippines,0.5,0.62,10,2.38,2.0,1.61,2
One Taguig,8,4,1,3,13,5,8,13,philippines,0.5,0.62,8,1.62,2.0,1.61,2
Loyola,8,4,1,3,11,8,3,13,philippines,0.5,0.62,3,1.38,2.0,1.61,2
Davao Aguilas,8,4,0,4,11,7,4,12,philippines,0.5,0.5,4,1.38,2.0,2.0,3
DH Cebu,8,3,2,3,13,10,3,11,philippines,0.38,0.62,3,1.62,2.63,1.61,4
Maharlika,8,1,2,5,6,16,-10,5,philippines,0.12,0.38,-10,0.75,8.33,2.63,5
Mendiola,8,1,2,5,8,35,-27,5,philippines,0.12,0.38,-27,1.0,8.33,2.63,5
PFF Development,8,0,1,7,7,33,-26,1,philippines,0.0,0.12,-26,0.88,0.0,8.33,6
Rakow C.,8,5,2,1,14,7,7,17,poland,0.62,0.88,7,1.75,1.61,1.14,1
Pogon Szczecin,8,4,3,1,12,6,6,15,poland,0.5,0.88,6,1.5,2.0,1.14,2
Korona Kielce,8,4,3,1,10,7,3,15,poland,0.5,0.88,3,1.25,2.0,1.14,2
Legia Warsaw,8,4,2,2,15,10,5,14,poland,0.5,0.75,5,1.88,2.0,1.33,3
Motor Lublin,8,4,2,2,10,10,0,14,poland,0.5,0.75,0,1.25,2.0,1.33,3
Jagiellonia,8,3,4,1,16,8,8,13,poland,0.38,0.88,8,2.0,2.63,1.14,4
Lech Poznan,8,4,1,3,14,7,7,13,poland,0.5,0.62,7,1.75,2.0,1.61,4
Piast Gliwice,8,3,4,1,7,6,1,13,poland,0.38,0.88,1,0.88,2.63,1.14,4
Gornik Zabrze,8,4,1,3,11,11,0,13,poland,0.5,0.62,0,1.38,2.0,1.61,4
Radomiak Radom,8,3,3,2,12,14,-2,12,poland,0.38,0.75,-2,1.5,2.63,1.33,5
Katowice,8,3,2,3,8,8,0,11,poland,0.38,0.62,0,1.0,2.63,1.61,6
Lechia Gdansk,8,3,1,4,7,12,-5,10,poland,0.38,0.5,-5,0.88,2.63,2.0,7
Cracovia Krakow,8,1,6,1,7,7,0,9,poland,0.12,0.88,0,0.88,8.33,1.14,8
Puszcza Niepolo,8,2,2,4,7,9,-2,8,poland,0.25,0.5,-2,0.88,4.0,2.0,9
Stal Mielec,8,1,2,5,9,14,-5,5,poland,0.12,0.38,-5,1.12,8.33,2.63,10
Slask Wroclaw,8,1,2,5,8,13,-5,5,poland,0.12,0.38,-5,1.0,8.33,2.63,10
Widzew Lodz,8,1,2,5,7,19,-12,5,poland,0.12,0.38,-12,0.88,8.33,2.63,10
Zaglebie Lubin,8,1,1,6,6,15,-9,4,poland,0.12,0.25,-9,0.75,8.33,4.0,11
Tychy,8,6,2,0,23,7,16,20,poland2,0.75,1.0,16,2.88,1.33,1.0,1
Arka Gdynia,8,5,3,0,14,5,9,18,poland2,0.62,1.0,9,1.75,1.61,1.0,2
Polonia Warszaw,8,5,2,1,10,5,5,17,poland2,0.62,0.88,5,1.25,1.61,1.14,3
T. Nieciecza,8,4,4,0,17,8,9,16,poland2,0.5,1.0,9,2.12,2.0,1.0,4
Znicz Pruszkow,8,4,1,3,12,11,1,13,poland2,0.5,0.62,1,1.5,2.0,1.61,5
Wisla Krakow,8,3,3,2,14,8,6,12,poland2,0.38,0.75,6,1.75,2.63,1.33,6
Wisla Plock,8,3,3,2,13,10,3,12,poland2,0.38,0.75,3,1.62,2.63,1.33,6
Ruch Chorzow,8,3,2,3,17,12,5,11,poland2,0.38,0.62,5,2.12,2.63,1.61,7
Stal Rzeszow,8,3,2,3,9,11,-2,11,poland2,0.38,0.62,-2,1.12,2.63,1.61,7
Gornik Leczna,8,2,3,3,13,12,1,9,poland2,0.25,0.62,1,1.62,4.0,1.61,8
Miedz Legnica,8,2,3,3,13,14,-1,9,poland2,0.25,0.62,-1,1.62,4.0,1.61,8
Chrobry Glogow,8,2,2,4,7,15,-8,8,poland2,0.25,0.5,-8,0.88,4.0,2.0,9
LKS Lodz,8,1,4,3,8,10,-2,7,poland2,0.12,0.62,-2,1.0,8.33,1.61,10
Odra Opole,8,1,4,3,6,16,-10,7,poland2,0.12,0.62,-10,0.75,8.33,1.61,10
Pogon Siedlce,8,1,2,5,6,12,-6,5,poland2,0.12,0.38,-6,0.75,8.33,2.63,11
Warta Poznan,8,1,2,5,4,13,-9,5,poland2,0.12,0.38,-9,0.5,8.33,2.63,11
K. Kolobrzeg,8,1,2,5,4,14,-10,5,poland2,0.12,0.38,-10,0.5,8.33,2.63,11
Stalowa Wola,8,0,3,5,3,17,-14,3,poland2,0.0,0.38,-14,0.38,0.0,2.63,12
Wieczysta K.,8,6,2,0,19,5,14,20,poland3,0.75,1.0,14,2.38,1.33,1.0,1
Pogon Grodzisk,8,6,1,1,13,6,7,19,poland3,0.75,0.88,7,1.62,1.33,1.14,2
LKS Lodz B,8,5,1,2,12,7,5,16,poland3,0.62,0.75,5,1.5,1.61,1.33,3
Chojniczanka,8,5,1,2,8,5,3,16,poland3,0.62,0.75,3,1.0,1.61,1.33,3
Swit Skolwin,8,4,2,2,16,14,2,14,poland3,0.5,0.75,2,2.0,2.0,1.33,4
Z. Sosnowiec,8,3,3,2,12,11,1,12,poland3,0.38,0.75,1,1.5,2.63,1.33,5
Jastrzebie,8,3,2,3,8,6,2,11,poland3,0.38,0.62,2,1.0,2.63,1.61,6
Podbeskidzie,8,3,2,3,7,6,1,11,poland3,0.38,0.62,1,0.88,2.63,1.61,6
Kalisz,8,3,2,3,8,9,-1,11,poland3,0.38,0.62,-1,1.0,2.63,1.61,6
Hutnik Krakow,8,3,2,3,9,11,-2,11,poland3,0.38,0.62,-2,1.12,2.63,1.61,6
SKRA Czestochow,8,3,2,3,8,10,-2,11,poland3,0.38,0.62,-2,1.0,2.63,1.61,6
Polonia Bytom,8,2,3,3,7,7,0,9,poland3,0.25,0.62,0,0.88,4.0,1.61,7
Rekord Bielsko,8,1,4,3,10,12,-2,7,poland3,0.12,0.62,-2,1.25,8.33,1.61,8
Zaglebie L. B,8,2,1,5,14,17,-3,7,poland3,0.25,0.38,-3,1.75,4.0,2.63,8
Wisla Pulawy,8,2,0,6,8,23,-15,6,poland3,0.25,0.25,-15,1.0,4.0,4.0,9
Resovia Rzeszow,8,1,2,5,9,14,-5,5,poland3,0.12,0.38,-5,1.12,8.33,2.63,10
O. Grudziadz,8,0,4,4,8,13,-5,4,poland3,0.0,0.5,-5,1.0,0.0,2.0,11
Olimpia Elblag,8,1,1,6,6,15,-9,4,poland3,0.12,0.25,-9,0.75,8.33,4.0,11
Sporting Braga,8,6,1,1,11,3,8,19,portugal,0.75,0.88,8,1.38,1.33,1.14,1
Benfica,8,6,0,2,19,9,10,18,portugal,0.75,0.75,10,2.38,1.33,1.33,2
Estoril,8,5,2,1,15,12,3,17,portugal,0.62,0.88,3,1.88,1.61,1.14,3
Sporting CP,8,4,4,0,20,11,9,16,portugal,0.5,1.0,9,2.5,2.0,1.0,4
Casa Pia,8,4,1,3,12,10,2,13,portugal,0.5,0.62,2,1.5,2.0,1.61,5
Arouca,8,3,4,1,11,10,1,13,portugal,0.38,0.88,1,1.38,2.63,1.14,5
Famalicao,8,3,3,2,8,7,1,12,portugal,0.38,0.75,1,1.0,2.63,1.33,6
Guimaraes,8,2,5,1,10,8,2,11,portugal,0.25,0.88,2,1.25,4.0,1.14,7
FC Porto,8,2,4,2,9,9,0,10,portugal,0.25,0.75,0,1.12,4.0,1.33,8
Nacional,8,3,1,4,10,12,-2,10,portugal,0.38,0.5,-2,1.25,2.63,2.0,8
Rio Ave,8,2,4,2,10,12,-2,10,portugal,0.25,0.75,-2,1.25,4.0,1.33,8
Santa Clara,8,2,3,3,7,8,-1,9,portugal,0.25,0.62,-1,0.88,4.0,1.61,9
AVS,8,2,2,4,7,11,-4,8,portugal,0.25,0.5,-4,0.88,4.0,2.0,10
Estrela Amadora,8,1,4,3,5,7,-2,7,portugal,0.12,0.62,-2,0.62,8.33,1.61,11
Moreirense,8,1,3,4,8,12,-4,6,portugal,0.12,0.5,-4,1.0,8.33,2.0,12
Gil Vicente,8,1,2,5,6,11,-5,5,portugal,0.12,0.38,-5,0.75,8.33,2.63,13
Farense,8,0,3,5,6,13,-7,3,portugal,0.0,0.38,-7,0.75,0.0,2.63,14
Boavista,8,1,0,7,5,17,-12,3,portugal,0.12,0.12,-12,0.62,8.33,8.33,14
Vizela,8,5,3,0,16,4,12,18,portugal2,0.62,1.0,12,2.0,1.61,1.0,1
Alverca,8,5,2,1,17,7,10,17,portugal2,0.62,0.88,10,2.12,1.61,1.14,2
Chaves,8,4,3,1,10,4,6,15,portugal2,0.5,0.88,6,1.25,2.0,1.14,3
Feirense,8,4,1,3,11,13,-2,13,portugal2,0.5,0.62,-2,1.38,2.0,1.61,4
Uniao de Leiria,8,3,3,2,8,7,1,12,portugal2,0.38,0.75,1,1.0,2.63,1.33,5
Portimonense,8,4,0,4,10,12,-2,12,portugal2,0.5,0.5,-2,1.25,2.0,2.0,5
Oliveirense,8,3,3,2,9,11,-2,12,portugal2,0.38,0.75,-2,1.12,2.63,1.33,5
Benfica B,8,3,2,3,11,8,3,11,portugal2,0.38,0.62,3,1.38,2.63,1.61,6
Tondela,8,2,5,1,9,7,2,11,portugal2,0.25,0.88,2,1.12,4.0,1.14,6
Torreense,8,2,4,2,12,11,1,10,portugal2,0.25,0.75,1,1.5,4.0,1.33,7
Pacos Ferreira,8,2,3,3,7,10,-3,9,portugal2,0.25,0.62,-3,0.88,4.0,1.61,8
Maritimo,8,2,3,3,9,13,-4,9,portugal2,0.25,0.62,-4,1.12,4.0,1.61,8
Penafiel,8,2,2,4,12,13,-1,8,portugal2,0.25,0.5,-1,1.5,4.0,2.0,9
FC Porto B,8,2,2,4,9,12,-3,8,portugal2,0.25,0.5,-3,1.12,4.0,2.0,9
Academico Viseu,8,1,5,2,8,11,-3,8,portugal2,0.12,0.75,-3,1.0,8.33,1.33,9
Felgueiras,8,2,2,4,8,11,-3,8,portugal2,0.25,0.5,-3,1.0,4.0,2.0,9
Leixoes,8,0,5,3,4,10,-6,5,portugal2,0.0,0.62,-6,0.5,0.0,1.61,10
Mafra,8,0,2,6,2,12,-10,2,portugal2,0.0,0.25,-10,0.25,0.0,4.0,11
Al Sadd,8,6,1,1,18,4,14,19,qatar,0.75,0.88,14,2.25,1.33,1.14,1
Al Gharafa,8,6,1,1,18,12,6,19,qatar,0.75,0.88,6,2.25,1.33,1.14,1
Al Rayyan,8,5,2,1,22,9,13,17,qatar,0.62,0.88,13,2.75,1.61,1.14,2
Al Duhail,8,5,1,2,15,9,6,16,qatar,0.62,0.75,6,1.88,1.61,1.33,3
Al Arabi,8,4,0,4,17,18,-1,12,qatar,0.5,0.5,-1,2.12,2.0,2.0,4
Al Shahaniya,8,4,0,4,12,18,-6,12,qatar,0.5,0.5,-6,1.5,2.0,2.0,4
Qatar SC,8,3,2,3,13,14,-1,11,qatar,0.38,0.62,-1,1.62,2.63,1.61,5
Al Shamal,8,3,1,4,12,7,5,10,qatar,0.38,0.5,5,1.5,2.63,2.0,6
Al Ahli Doha,8,2,2,4,14,19,-5,8,qatar,0.25,0.5,-5,1.75,4.0,2.0,7
Al Wakrah,8,2,1,5,11,21,-10,7,qatar,0.25,0.38,-10,1.38,4.0,2.63,8
Umm Salal,8,1,1,6,10,19,-9,4,qatar,0.12,0.25,-9,1.25,8.33,4.0,9
Al Khor,8,1,0,7,9,21,-12,3,qatar,0.12,0.12,-12,1.12,8.33,8.33,10
Univ. Craiova,8,5,2,1,12,6,6,17,romania,0.62,0.88,6,1.5,1.61,1.14,1
CFR Cluj,8,4,4,0,14,6,8,16,romania,0.5,1.0,8,1.75,2.0,1.0,2
FCSB,8,4,4,0,10,3,7,16,romania,0.5,1.0,7,1.25,2.0,1.0,2
Rapid Bucharest,8,4,2,2,9,6,3,14,romania,0.5,0.75,3,1.12,2.0,1.33,3
Hermannstadt,8,4,2,2,9,7,2,14,romania,0.5,0.75,2,1.12,2.0,1.33,3
Din. Bucharest,8,3,3,2,9,7,2,12,romania,0.38,0.75,2,1.12,2.63,1.33,4
U. Cluj,8,3,3,2,9,8,1,12,romania,0.38,0.75,1,1.12,2.63,1.33,4
Sepsi OSK,8,3,2,3,8,9,-1,11,romania,0.38,0.62,-1,1.0,2.63,1.61,5
Botosani,8,2,4,2,8,8,0,10,romania,0.25,0.75,0,1.0,4.0,1.33,6
Farul Constanta,8,3,1,4,8,10,-2,10,romania,0.38,0.5,-2,1.0,2.63,2.0,6
UTA Arad,8,2,3,3,6,9,-3,9,romania,0.25,0.62,-3,0.75,4.0,1.61,7
P. Iasi,8,2,3,3,8,12,-4,9,romania,0.25,0.62,-4,1.0,4.0,1.61,7
Petrolul,8,2,2,4,6,8,-2,8,romania,0.25,0.5,-2,0.75,4.0,2.0,8
Otelul,8,2,1,5,7,11,-4,7,romania,0.25,0.38,-4,0.88,4.0,2.63,9
FC Buzau,8,1,1,6,7,12,-5,4,romania,0.12,0.25,-5,0.88,8.33,4.0,10
Unirea Slobozia,8,1,1,6,7,15,-8,4,romania,0.12,0.25,-8,0.88,8.33,4.0,10
Spartak Moscow,8,7,0,1,21,5,16,21,russia,0.88,0.88,16,2.62,1.14,1.14,1
Rostov,8,5,2,1,18,9,9,17,russia,0.62,0.88,9,2.25,1.61,1.14,2
Dinamo Moscow,8,4,4,0,19,9,10,16,russia,0.5,1.0,10,2.38,2.0,1.0,3
Zenit,8,4,2,2,11,8,3,14,russia,0.5,0.75,3,1.38,2.0,1.33,4
FC Krasnodar,8,3,4,1,13,8,5,13,russia,0.38,0.88,5,1.62,2.63,1.14,5
CSKA Moscow,8,3,3,2,7,7,0,12,russia,0.38,0.75,0,0.88,2.63,1.33,6
Rubin Kazan,8,3,2,3,12,13,-1,11,russia,0.38,0.62,-1,1.5,2.63,1.61,7
Akhmat Grozny,8,3,2,3,10,11,-1,11,russia,0.38,0.62,-1,1.25,2.63,1.61,7
Lokomotiv M.,8,2,4,2,9,12,-3,10,russia,0.25,0.75,-3,1.12,4.0,1.33,8
Akron,8,3,1,4,7,16,-9,10,russia,0.38,0.5,-9,0.88,2.63,2.0,8
Khimki,8,2,2,4,12,16,-4,8,russia,0.25,0.5,-4,1.5,4.0,2.0,9
Krylya Sovetov,8,2,2,4,11,15,-4,8,russia,0.25,0.5,-4,1.38,4.0,2.0,9
Makhachkala,8,1,4,3,7,12,-5,7,russia,0.12,0.62,-5,0.88,8.33,1.61,10
Nizhny Novgorod,8,2,1,5,5,16,-11,7,russia,0.25,0.38,-11,0.62,4.0,2.63,10
Fakel Voronezh,8,0,4,4,3,8,-5,4,russia,0.0,0.5,-5,0.38,0.0,2.0,11
Orenburg,8,0,0,8,3,15,-12,0,russia,0.0,0.0,-12,0.38,0.0,0.0,12
Baltika,8,7,1,0,15,4,11,22,russia2,0.88,1.0,11,1.88,1.14,1.0,1
Torpedo Moscow,8,5,2,1,14,6,8,17,russia2,0.62,0.88,8,1.75,1.61,1.14,2
PFC Sochi,8,5,2,1,13,6,7,17,russia2,0.62,0.88,7,1.62,1.61,1.14,2
Chernomorets,8,5,1,2,12,10,2,16,russia2,0.62,0.75,2,1.5,1.61,1.33,3
SKA Khabarovsk,8,4,3,1,14,8,6,15,russia2,0.5,0.88,6,1.75,2.0,1.14,4
Ural,8,3,4,1,12,9,3,13,russia2,0.38,0.88,3,1.5,2.63,1.14,5
Kamaz,8,4,0,4,11,10,1,12,russia2,0.5,0.5,1,1.38,2.0,2.0,6
Rotor Volgograd,8,3,3,2,7,7,0,12,russia2,0.38,0.75,0,0.88,2.63,1.33,6
Yenisey,8,3,2,3,9,10,-1,11,russia2,0.38,0.62,-1,1.12,2.63,1.61,7
Chayka,8,2,4,2,9,9,0,10,russia2,0.25,0.75,0,1.12,4.0,1.33,8
Ufa,8,3,1,4,10,11,-1,10,russia2,0.38,0.5,-1,1.25,2.63,2.0,8
Tyumen,8,3,1,4,8,11,-3,10,russia2,0.38,0.5,-3,1.0,2.63,2.0,8
Shinnik,8,1,5,2,4,7,-3,8,russia2,0.12,0.75,-3,0.5,8.33,1.33,9
Neftekhimik,8,1,3,4,8,9,-1,6,russia2,0.12,0.5,-1,1.0,8.33,2.0,10
Rodina Moskva,8,1,3,4,4,8,-4,6,russia2,0.12,0.5,-4,0.5,8.33,2.0,10
Sokol Saratov,8,1,2,5,3,9,-6,5,russia2,0.12,0.38,-6,0.38,8.33,2.63,11
Arsenal Tula,8,0,4,4,5,10,-5,4,russia2,0.0,0.5,-5,0.62,0.0,2.0,12
A. Vladikavkaz,8,0,2,6,3,14,-11,2,russia2,0.0,0.25,-11,0.38,0.0,4.0,13
Al Ahli Jeddah,8,6,1,1,22,8,14,19,saudiarabia,0.75,0.88,14,2.75,1.33,1.14,1
Al Ittifaq,8,5,2,1,15,9,6,17,saudiarabia,0.62,0.88,6,1.88,1.61,1.14,2
Al Quadisiya,8,5,2,1,13,9,4,17,saudiarabia,0.62,0.88,4,1.62,1.61,1.14,2
Al Nassr,8,5,1,2,18,11,7,16,saudiarabia,0.62,0.75,7,2.25,1.61,1.33,3
Al Ittihad,8,4,3,1,18,11,7,15,saudiarabia,0.5,0.88,7,2.25,2.0,1.14,4
Al Kholood,8,5,0,3,14,16,-2,15,saudiarabia,0.62,0.62,-2,1.75,1.61,1.61,4
Al Shabab,8,4,2,2,18,13,5,14,saudiarabia,0.5,0.75,5,2.25,2.0,1.33,5
Al Orubah,8,4,1,3,11,9,2,13,saudiarabia,0.5,0.62,2,1.38,2.0,1.61,6
Al Taawon,8,3,3,2,9,6,3,12,saudiarabia,0.38,0.75,3,1.12,2.63,1.33,7
Al Hilal,8,3,2,3,18,13,5,11,saudiarabia,0.38,0.62,5,2.25,2.63,1.61,8
Al Fateh,8,3,1,4,10,12,-2,10,saudiarabia,0.38,0.5,-2,1.25,2.63,2.0,9
Al Riyadh,8,2,2,4,6,13,-7,8,saudiarabia,0.25,0.5,-7,0.75,4.0,2.0,10
Al Feiha,8,1,4,3,3,7,-4,7,saudiarabia,0.12,0.62,-4,0.38,8.33,1.61,11
Al Khaleej,8,1,4,3,8,13,-5,7,saudiarabia,0.12,0.62,-5,1.0,8.33,1.61,11
Damak,8,1,3,4,6,13,-7,6,saudiarabia,0.12,0.5,-7,0.75,8.33,2.0,12
Al Wahda,8,1,2,5,8,15,-7,5,saudiarabia,0.12,0.38,-7,1.0,8.33,2.63,13
Al Raed,8,1,1,6,8,15,-7,4,saudiarabia,0.12,0.25,-7,1.0,8.33,4.0,14
Al Akhdoud,8,0,2,6,3,15,-12,2,saudiarabia,0.0,0.25,-12,0.38,0.0,4.0,15
Neom SC,8,7,1,0,16,4,12,22,saudiarabia2,0.88,1.0,12,2.0,1.14,1.0,1
Al Najma,8,5,2,1,14,6,8,17,saudiarabia2,0.62,0.88,8,1.75,1.61,1.14,2
Al Jabalain,8,5,2,1,10,6,4,17,saudiarabia2,0.62,0.88,4,1.25,1.61,1.14,2
Al Adalha,8,4,3,1,15,12,3,15,saudiarabia2,0.5,0.88,3,1.88,2.0,1.14,3
Al Hazm,8,4,2,2,13,9,4,14,saudiarabia2,0.5,0.75,4,1.62,2.0,1.33,4
Al Jandal,8,3,4,1,10,6,4,13,saudiarabia2,0.38,0.88,4,1.25,2.63,1.14,5
Jeddah,8,4,1,3,7,5,2,13,saudiarabia2,0.5,0.62,2,0.88,2.0,1.61,5
Al Tai,8,3,3,2,10,7,3,12,saudiarabia2,0.38,0.75,3,1.25,2.63,1.33,6
Al Bukayriyah,8,3,2,3,13,7,6,11,saudiarabia2,0.38,0.62,6,1.62,2.63,1.61,7
Al Zulfi,8,2,5,1,9,8,1,11,saudiarabia2,0.25,0.88,1,1.12,4.0,1.14,7
Al Jubail,8,2,5,1,12,12,0,11,saudiarabia2,0.25,0.88,0,1.5,4.0,1.14,7
Abha,8,2,5,1,10,10,0,11,saudiarabia2,0.25,0.88,0,1.25,4.0,1.14,7
Al Batin,8,2,2,4,8,11,-3,8,saudiarabia2,0.25,0.5,-3,1.0,4.0,2.0,8
Al Ain,8,2,2,4,8,14,-6,8,saudiarabia2,0.25,0.5,-6,1.0,4.0,2.0,8
Al Faisaly,8,1,3,4,7,12,-5,6,saudiarabia2,0.12,0.5,-5,0.88,8.33,2.0,9
Al Arabi,8,1,2,5,9,14,-5,5,saudiarabia2,0.12,0.38,-5,1.12,8.33,2.63,10
Ohod,8,0,1,7,4,13,-9,1,saudiarabia2,0.0,0.12,-9,0.5,0.0,8.33,11
Al Safa,8,0,0,8,5,22,-17,0,saudiarabia2,0.0,0.0,-17,0.62,0.0,0.0,12
Celtic,8,6,1,1,30,10,20,19,scotland,0.75,0.88,20,3.75,1.33,1.14,1
Rangers,8,6,0,2,21,9,12,18,scotland,0.75,0.75,12,2.62,1.33,1.33,2
Hibernian,8,5,3,0,16,8,8,18,scotland,0.62,1.0,8,2.0,1.61,1.0,2
Hearts,8,5,1,2,17,9,8,16,scotland,0.62,0.75,8,2.12,1.61,1.33,3
Ross County,8,4,1,3,10,11,-1,13,scotland,0.5,0.62,-1,1.25,2.0,1.61,4
St. Johnstone,8,3,1,4,9,13,-4,10,scotland,0.38,0.5,-4,1.12,2.63,2.0,5
Aberdeen,8,2,2,4,6,16,-10,8,scotland,0.25,0.5,-10,0.75,4.0,2.0,6
Kilmarnock,8,2,1,5,8,11,-3,7,scotland,0.25,0.38,-3,1.0,4.0,2.63,7
St. Mirren,8,2,1,5,8,13,-5,7,scotland,0.25,0.38,-5,1.0,4.0,2.63,7
Motherwell,8,2,1,5,7,14,-7,7,scotland,0.25,0.38,-7,0.88,4.0,2.63,7
Dundee Utd,8,2,1,5,6,14,-8,7,scotland,0.25,0.38,-8,0.75,4.0,2.63,7
Dundee FC,8,0,3,5,8,24,-16,3,scotland,0.0,0.38,-16,1.0,0.0,2.63,8
Livingston,8,5,3,0,13,6,7,18,scotland2,0.62,1.0,7,1.62,1.61,1.0,1
Falkirk,8,5,2,1,18,8,10,17,scotland2,0.62,0.88,10,2.25,1.61,1.14,2
Ayr Utd,8,5,1,2,17,10,7,16,scotland2,0.62,0.75,7,2.12,1.61,1.33,3
Airdrieonians,8,4,2,2,12,12,0,14,scotland2,0.5,0.75,0,1.5,2.0,1.33,4
Greenock Morton,8,3,2,3,13,13,0,11,scotland2,0.38,0.62,0,1.62,2.63,1.61,5
Raith Rovers,8,3,1,4,9,10,-1,10,scotland2,0.38,0.5,-1,1.12,2.63,2.0,6
Queens Park,8,2,2,4,11,9,2,8,scotland2,0.25,0.5,2,1.38,4.0,2.0,7
Dunfermline,8,2,2,4,5,9,-4,8,scotland2,0.25,0.5,-4,0.62,4.0,2.0,7
Hamilton,8,2,1,5,6,14,-8,7,scotland2,0.25,0.38,-8,0.75,4.0,2.63,8
Partick Thistle,8,1,3,4,10,19,-9,6,scotland2,0.12,0.5,-9,1.25,8.33,2.0,9
Arbroath,8,6,0,2,17,8,9,18,scotland3,0.75,0.75,9,2.12,1.33,1.33,1
Stenhousemuir,8,5,2,1,13,7,6,17,scotland3,0.62,0.88,6,1.62,1.61,1.14,2
Cove Rangers,8,5,1,2,16,8,8,16,scotland3,0.62,0.75,8,2.0,1.61,1.33,3
Inverness,8,5,1,2,11,8,3,16,scotland3,0.62,0.75,3,1.38,1.61,1.33,3
Alloa Athletic,8,3,3,2,15,13,2,12,scotland3,0.38,0.75,2,1.88,2.63,1.33,4
Queen of South,8,3,0,5,11,13,-2,9,scotland3,0.38,0.38,-2,1.38,2.63,2.63,5
Montrose,8,1,5,2,9,14,-5,8,scotland3,0.12,0.75,-5,1.12,8.33,1.33,6
Annan Athletic,8,2,1,5,11,19,-8,7,scotland3,0.25,0.38,-8,1.38,4.0,2.63,7
Kelty Hearts,8,1,3,4,3,8,-5,6,scotland3,0.12,0.5,-5,0.38,8.33,2.0,8
Dumbarton,8,0,1,7,8,17,-9,1,scotland3,0.0,0.12,-9,1.0,0.0,8.33,9
Edinburgh City,8,6,0,2,16,9,7,18,scotland4,0.75,0.75,7,2.0,1.33,1.33,1
East Fife,8,4,2,2,10,5,5,14,scotland4,0.5,0.75,5,1.25,2.0,1.33,2
Peterhead,8,3,4,1,13,10,3,13,scotland4,0.38,0.88,3,1.62,2.63,1.14,3
Stirling Albion,8,4,1,3,14,12,2,13,scotland4,0.5,0.62,2,1.75,2.0,1.61,3
Stranraer,8,4,1,3,9,7,2,13,scotland4,0.5,0.62,2,1.12,2.0,1.61,3
Forfar Athletic,8,3,2,3,9,9,0,11,scotland4,0.38,0.62,0,1.12,2.63,1.61,4
Spartans,8,3,2,3,9,11,-2,11,scotland4,0.38,0.62,-2,1.12,2.63,1.61,4
Clyde,8,2,2,4,7,10,-3,8,scotland4,0.25,0.5,-3,0.88,4.0,2.0,5
Elgin City,8,2,1,5,6,9,-3,7,scotland4,0.25,0.38,-3,0.75,4.0,2.63,6
Bonnyrigg Rose,8,2,1,5,10,16,-6,7,scotland4,0.25,0.38,-6,1.25,4.0,2.63,6
Red Star,8,7,1,0,30,7,23,22,serbia,0.88,1.0,23,3.75,1.14,1.0,1
Partizan,8,5,3,0,19,9,10,18,serbia,0.62,1.0,10,2.38,1.61,1.0,2
Novi Pazar,8,4,1,3,13,11,2,13,serbia,0.5,0.62,2,1.62,2.0,1.61,3
Radnicki 1923,8,4,1,3,10,13,-3,13,serbia,0.5,0.62,-3,1.25,2.0,1.61,3
Vojvodina,8,3,3,2,13,10,3,12,serbia,0.38,0.75,3,1.62,2.63,1.33,4
S. Subotica,8,3,3,2,9,8,1,12,serbia,0.38,0.75,1,1.12,2.63,1.33,4
Z. Pancevo,8,2,5,1,13,6,7,11,serbia,0.25,0.88,7,1.62,4.0,1.14,5
Napredak,8,3,2,3,8,10,-2,11,serbia,0.38,0.62,-2,1.0,2.63,1.61,5
OFK Beograd,8,3,2,3,8,11,-3,11,serbia,0.38,0.62,-3,1.0,2.63,1.61,5
Jedinstvo U.,8,3,0,5,9,11,-2,9,serbia,0.38,0.38,-2,1.12,2.63,2.63,6
Cukaricki,8,2,3,3,8,11,-3,9,serbia,0.25,0.62,-3,1.0,4.0,1.61,6
Backa Topola,8,3,0,5,12,16,-4,9,serbia,0.38,0.38,-4,1.5,2.63,2.63,6
Mladost Lucani,8,2,2,4,7,9,-2,8,serbia,0.25,0.5,-2,0.88,4.0,2.0,7
IMT N. Beograd,8,2,2,4,6,13,-7,8,serbia,0.25,0.5,-7,0.75,4.0,2.0,7
Tekstilac Odzac,8,2,1,5,7,14,-7,7,serbia,0.25,0.38,-7,0.88,4.0,2.63,8
Radnicki Nis,8,1,2,5,6,15,-9,5,serbia,0.12,0.38,-9,0.75,8.33,2.63,9
R. Surdulica,8,6,1,1,14,3,11,19,serbia2,0.75,0.88,11,1.75,1.33,1.14,1
Javor Ivanjica,8,5,3,0,11,4,7,18,serbia2,0.62,1.0,7,1.38,1.61,1.0,2
Vozdovac,8,4,3,1,6,2,4,15,serbia2,0.5,0.88,4,0.75,2.0,1.14,3
Mladost,8,4,2,2,6,6,0,14,serbia2,0.5,0.75,0,0.75,2.0,1.33,4
Zemun,8,3,4,1,15,8,7,13,serbia2,0.38,0.88,7,1.88,2.63,1.14,5
Borac Cacak,8,4,1,3,10,7,3,13,serbia2,0.5,0.62,3,1.25,2.0,1.61,5
Vrsac,8,3,2,3,7,5,2,11,serbia2,0.38,0.62,2,0.88,2.63,1.61,6
Trajal Krusevac,8,3,2,3,7,9,-2,11,serbia2,0.38,0.62,-2,0.88,2.63,1.61,6
Macva Sabac,8,2,4,2,7,8,-1,10,serbia2,0.25,0.75,-1,0.88,4.0,1.33,7
Graficar,8,2,4,2,8,10,-2,10,serbia2,0.25,0.75,-2,1.0,4.0,1.33,7
Sloven Ruma,8,1,5,2,7,6,1,8,serbia2,0.12,0.75,1,0.88,8.33,1.33,8
Smederevo,8,1,5,2,6,11,-5,8,serbia2,0.12,0.75,-5,0.75,8.33,1.33,8
Dubocica,8,2,1,5,7,14,-7,7,serbia2,0.25,0.38,-7,0.88,4.0,2.63,9
S. Mitrovica,8,1,3,4,5,11,-6,6,serbia2,0.12,0.5,-6,0.62,8.33,2.0,10
Sloboda Uzice,8,0,3,5,3,8,-5,3,serbia2,0.0,0.38,-5,0.38,0.0,2.63,11
Indija,8,0,3,5,6,12,-6,3,serbia2,0.0,0.38,-6,0.75,0.0,2.63,11
Lion City,8,7,1,0,27,8,19,22,singapore,0.88,1.0,19,3.38,1.14,1.0,1
A. Niigata (S),8,5,1,2,15,14,1,16,singapore,0.62,0.75,1,1.88,1.61,1.33,2
Tampines Rovers,8,5,0,3,21,10,11,15,singapore,0.62,0.62,11,2.62,1.61,1.61,3
Geylang,8,4,1,3,19,12,7,13,singapore,0.5,0.62,7,2.38,2.0,1.61,4
Hougang,8,3,1,4,21,16,5,10,singapore,0.38,0.5,5,2.62,2.63,2.0,5
Young Lions,8,2,3,3,12,17,-5,9,singapore,0.25,0.62,-5,1.5,4.0,1.61,6
Khalsa,8,3,0,5,17,23,-6,9,singapore,0.38,0.38,-6,2.12,2.63,2.63,6
DPMM FC,8,2,1,5,10,17,-7,7,singapore,0.25,0.38,-7,1.25,4.0,2.63,7
Tanjong Pagar,8,1,1,6,6,28,-22,4,singapore,0.12,0.25,-22,0.75,8.33,4.0,8
Spartak Trnava,8,5,2,1,13,6,7,17,slovakia,0.62,0.88,7,1.62,1.61,1.14,1
Podbrezova,8,4,4,0,13,7,6,16,slovakia,0.5,1.0,6,1.62,2.0,1.0,2
S. Bratislava,8,4,2,2,19,8,11,14,slovakia,0.5,0.75,11,2.38,2.0,1.33,3
Zilina,8,4,2,2,12,9,3,14,slovakia,0.5,0.75,3,1.5,2.0,1.33,3
Z. Michalovce,8,3,4,1,11,8,3,13,slovakia,0.38,0.88,3,1.38,2.63,1.14,4
FC Kosice,8,3,3,2,13,8,5,12,slovakia,0.38,0.75,5,1.62,2.63,1.33,5
DAC Streda,8,2,4,2,12,9,3,10,slovakia,0.25,0.75,3,1.5,4.0,1.33,6
Komarno,8,2,4,2,7,10,-3,10,slovakia,0.25,0.75,-3,0.88,4.0,1.33,6
Skalica,8,1,4,3,4,8,-4,7,slovakia,0.12,0.62,-4,0.5,8.33,1.61,7
Trencin,8,1,4,3,9,16,-7,7,slovakia,0.12,0.62,-7,1.12,8.33,1.61,7
Banska Bystrica,8,1,0,7,9,20,-11,3,slovakia,0.12,0.12,-11,1.12,8.33,8.33,8
Ruzomberok,8,1,0,7,6,21,-15,3,slovakia,0.12,0.12,-15,0.75,8.33,8.33,8
Presov,8,7,1,0,17,5,12,22,slovakia2,0.88,1.0,12,2.12,1.14,1.0,1
L. Mikulas,8,6,1,1,15,8,7,19,slovakia2,0.75,0.88,7,1.88,1.33,1.14,2
Zlate Moravce,8,4,2,2,8,5,3,14,slovakia2,0.5,0.75,3,1.0,2.0,1.33,3
Malzenice,8,4,1,3,12,9,3,13,slovakia2,0.5,0.62,3,1.5,2.0,1.61,4
P. Bystrica,8,4,1,3,13,12,1,13,slovakia2,0.5,0.62,1,1.62,2.0,1.61,4
Puchov,8,4,1,3,12,11,1,13,slovakia2,0.5,0.62,1,1.5,2.0,1.61,4
Humenne,8,3,1,4,6,11,-5,10,slovakia2,0.38,0.5,-5,0.75,2.63,2.0,5
Zvolen,8,3,1,4,5,12,-7,10,slovakia2,0.38,0.5,-7,0.62,2.63,2.0,5
Petrzalka,8,3,0,5,10,9,1,9,slovakia2,0.38,0.38,1,1.25,2.63,2.63,6
Pohronie,8,3,0,5,12,18,-6,9,slovakia2,0.38,0.38,-6,1.5,2.63,2.63,6
S. Lubovna,8,2,2,4,11,10,1,8,slovakia2,0.25,0.5,1,1.38,4.0,2.0,7
Zilina B,8,2,1,5,10,11,-1,7,slovakia2,0.25,0.38,-1,1.25,4.0,2.63,8
S. Bratislava B,8,2,0,6,4,9,-5,6,slovakia2,0.25,0.25,-5,0.5,4.0,4.0,9
Samorin,8,1,0,7,10,21,-11,3,slovakia2,0.12,0.12,-11,1.25,8.33,8.33,10
NK Olimpija,8,6,1,1,17,5,12,19,slovenia,0.75,0.88,12,2.12,1.33,1.14,1
Maribor,8,5,1,2,17,8,9,16,slovenia,0.62,0.75,9,2.12,1.61,1.33,2
Bravo,8,4,4,0,14,9,5,16,slovenia,0.5,1.0,5,1.75,2.0,1.0,2
Koper,8,3,3,2,12,10,2,12,slovenia,0.38,0.75,2,1.5,2.63,1.33,3
NK Celje,8,2,3,3,15,10,5,9,slovenia,0.25,0.62,5,1.88,4.0,1.61,4
Mura,8,2,3,3,5,7,-2,9,slovenia,0.25,0.62,-2,0.62,4.0,1.61,4
Primorje,8,2,3,3,8,13,-5,9,slovenia,0.25,0.62,-5,1.0,4.0,1.61,4
Nafta,8,1,5,2,5,11,-6,8,slovenia,0.12,0.75,-6,0.62,8.33,1.33,5
Domzale,8,2,1,5,11,13,-2,7,slovenia,0.25,0.38,-2,1.38,4.0,2.63,6
Radomlje,8,1,2,5,5,20,-15,5,slovenia,0.12,0.38,-15,0.62,8.33,2.63,7
Mamelodi S.,8,6,1,1,20,7,13,19,southafrica,0.75,0.88,13,2.5,1.33,1.14,1
Stellenbosch,8,4,3,1,14,7,7,15,southafrica,0.5,0.88,7,1.75,2.0,1.14,2
Orlando Pirates,8,5,0,3,8,9,-1,15,southafrica,0.62,0.62,-1,1.0,1.61,1.61,2
TS Galaxy,8,4,2,2,10,8,2,14,southafrica,0.5,0.75,2,1.25,2.0,1.33,3
AmaZulu,8,4,2,2,13,12,1,14,southafrica,0.5,0.75,1,1.62,2.0,1.33,3
Richards Bay,8,3,4,1,8,5,3,13,southafrica,0.38,0.88,3,1.0,2.63,1.14,4
Polokwane,8,2,4,2,4,5,-1,10,southafrica,0.25,0.75,-1,0.5,4.0,1.33,5
Kaizer Chiefs,8,3,1,4,6,9,-3,10,southafrica,0.38,0.5,-3,0.75,2.63,2.0,5
Magesi,8,3,1,4,6,10,-4,10,southafrica,0.38,0.5,-4,0.75,2.63,2.0,5
Chippa Utd,8,2,2,4,8,7,1,8,southafrica,0.25,0.5,1,1.0,4.0,2.0,6
Sekhukhune,8,2,2,4,11,13,-2,8,southafrica,0.25,0.5,-2,1.38,4.0,2.0,6
Marumo G.,8,2,2,4,7,10,-3,8,southafrica,0.25,0.5,-3,0.88,4.0,2.0,6
Golden Arrows,8,1,5,2,4,9,-5,8,southafrica,0.12,0.75,-5,0.5,8.33,1.33,6
Royal AM,8,1,2,5,9,13,-4,5,southafrica,0.12,0.38,-4,1.12,8.33,2.63,7
SuperSport Utd,8,1,2,5,6,12,-6,5,southafrica,0.12,0.38,-6,0.75,8.33,2.63,7
Cape Town City,8,1,2,5,5,13,-8,5,southafrica,0.12,0.38,-8,0.62,8.33,2.63,7
Durban City,8,6,0,2,14,7,7,18,southafrica2,0.75,0.75,7,1.75,1.33,1.33,1
Kruger United,8,4,2,2,12,10,2,14,southafrica2,0.5,0.75,2,1.5,2.0,1.33,2
Highbury,8,4,1,3,12,8,4,13,southafrica2,0.5,0.62,4,1.5,2.0,1.61,3
Orbit College,8,3,4,1,9,7,2,13,southafrica2,0.38,0.88,2,1.12,2.63,1.14,3
Baroka,8,3,4,1,16,15,1,13,southafrica2,0.38,0.88,1,2.0,2.63,1.14,3
Casric Stars,8,3,3,2,10,8,2,12,southafrica2,0.38,0.75,2,1.25,2.63,1.33,4
Pretoria C.,8,3,2,3,11,10,1,11,southafrica2,0.38,0.62,1,1.38,2.63,1.61,5
JDR Stars,8,2,5,1,9,9,0,11,southafrica2,0.25,0.88,0,1.12,4.0,1.14,5
Upington City,8,2,4,2,8,9,-1,10,southafrica2,0.25,0.75,-1,1.0,4.0,1.33,6
Pretoria U.,8,2,3,3,6,8,-2,9,southafrica2,0.25,0.62,-2,0.75,4.0,1.61,7
Cape Town Spurs,8,2,3,3,8,11,-3,9,southafrica2,0.25,0.62,-3,1.0,4.0,1.61,7
Venda FC,8,2,2,4,10,9,1,8,southafrica2,0.25,0.5,1,1.25,4.0,2.0,8
Hungry Lions,8,2,2,4,10,11,-1,8,southafrica2,0.25,0.5,-1,1.25,4.0,2.0,8
Black Leopards,8,2,2,4,10,12,-2,8,southafrica2,0.25,0.5,-2,1.25,4.0,2.0,8
Leruma United,8,2,1,5,3,9,-6,7,southafrica2,0.25,0.38,-6,0.38,4.0,2.63,9
Milford,8,1,3,4,8,14,-6,6,southafrica2,0.12,0.5,-6,1.0,8.33,2.0,10
Ulsan,4,3,0,1,5,1,4,9,southkorea,0.75,0.75,4,1.25,1.33,1.33,1
Daejeon Citizen,4,3,0,1,6,3,3,9,southkorea,0.75,0.75,3,1.5,1.33,1.33,1
Gimcheon Sangmu,4,2,1,1,7,5,2,7,southkorea,0.5,0.75,2,1.75,2.0,1.33,2
Daegu,4,2,1,1,6,4,2,7,southkorea,0.5,0.75,2,1.5,2.0,1.33,2
Gwangju,3,1,2,0,4,3,1,5,southkorea,0.33,1.0,1,1.33,3.03,1.0,3
Seoul,4,1,2,1,2,3,-1,5,southkorea,0.25,0.75,-1,0.5,4.0,1.33,3
Jeonbuk Motors,3,1,1,1,4,4,0,4,southkorea,0.33,0.67,0,1.33,3.03,1.49,4
Gangwon,3,1,1,1,3,3,0,4,southkorea,0.33,0.67,0,1.0,3.03,1.49,4
Jeju Utd,4,1,1,2,4,5,-1,4,southkorea,0.25,0.5,-1,1.0,4.0,2.0,4
Anyang,4,1,0,3,4,7,-3,3,southkorea,0.25,0.25,-3,1.0,4.0,4.0,5
Suwon City,4,0,2,2,1,4,-3,2,southkorea,0.0,0.5,-3,0.25,0.0,2.0,6
Pohang Steelers,3,0,1,2,1,5,-4,1,southkorea,0.0,0.33,-4,0.33,0.0,3.03,7
Jeonnam,3,2,1,0,4,1,3,7,southkorea2,0.67,1.0,3,1.33,1.49,1.0,1
Incheon Utd,2,2,0,0,4,0,4,6,southkorea2,1.0,1.0,4,2.0,1.0,1.0,2
Bucheon FC,3,2,0,1,5,4,1,6,southkorea2,0.67,0.67,1,1.67,1.49,1.49,2
Seongnam,2,1,1,0,3,1,2,4,southkorea2,0.5,1.0,2,1.5,2.0,1.0,3
Gimpo,3,1,1,1,4,3,1,4,southkorea2,0.33,0.67,1,1.33,3.03,1.49,3
Seoul E-Land,2,1,1,0,3,2,1,4,southkorea2,0.5,1.0,1,1.5,2.0,1.0,3
Busan IPark,3,1,1,1,2,1,1,4,southkorea2,0.33,0.67,1,0.67,3.03,1.49,3
Cheongju,3,1,1,1,5,6,-1,4,southkorea2,0.33,0.67,-1,1.67,3.03,1.49,3
Gyeongnam,3,1,1,1,2,3,-1,4,southkorea2,0.33,0.67,-1,0.67,3.03,1.49,3
Suwon Bluewings,2,1,0,1,1,2,-1,3,southkorea2,0.5,0.5,-1,0.5,2.0,2.0,4
Cheonan City,3,1,0,2,2,4,-2,3,southkorea2,0.33,0.33,-2,0.67,3.03,3.03,4
Hwaseong,3,0,2,1,2,4,-2,2,southkorea2,0.0,0.67,-2,0.67,0.0,1.49,5
Asan,3,0,1,2,2,4,-2,1,southkorea2,0.0,0.33,-2,0.67,0.0,3.03,6
Ansan Greeners,3,0,0,3,0,4,-4,0,southkorea2,0.0,0.0,-4,0.0,0.0,0.0,7
FC Barcelona,8,6,1,1,21,5,16,19,spain,0.75,0.88,16,2.62,1.33,1.14,1
Athletic Bilbao,8,4,3,1,17,7,10,15,spain,0.5,0.88,10,2.12,2.0,1.14,2
Atletico Madrid,8,4,3,1,10,4,6,15,spain,0.5,0.88,6,1.25,2.0,1.14,2
Villarreal,8,4,2,2,14,6,8,14,spain,0.5,0.75,8,1.75,2.0,1.33,3
Real Madrid,8,4,2,2,14,7,7,14,spain,0.5,0.75,7,1.75,2.0,1.33,3
Getafe,8,4,2,2,10,6,4,14,spain,0.5,0.75,4,1.25,2.0,1.33,3
Rayo Vallecano,8,4,2,2,8,6,2,14,spain,0.5,0.75,2,1.0,2.0,1.33,3
Valencia,8,4,2,2,12,16,-4,14,spain,0.5,0.75,-4,1.5,2.0,1.33,3
Real Betis,8,4,1,3,13,11,2,13,spain,0.5,0.62,2,1.62,2.0,1.61,4
Celta Vigo,8,3,3,2,12,11,1,12,spain,0.38,0.75,1,1.5,2.63,1.33,5
Espanyol,8,3,3,2,8,7,1,12,spain,0.38,0.75,1,1.0,2.63,1.33,5
Sevilla FC,8,2,5,1,11,9,2,11,spain,0.25,0.88,2,1.38,4.0,1.14,6
Alaves,8,2,3,3,9,9,0,9,spain,0.25,0.62,0,1.12,4.0,1.61,7
Mallorca,8,2,3,3,7,11,-4,9,spain,0.25,0.62,-4,0.88,4.0,1.61,7
Real Sociedad,8,3,0,5,7,14,-7,9,spain,0.38,0.38,-7,0.88,2.63,2.63,7
Osasuna,8,1,5,2,9,10,-1,8,spain,0.12,0.75,-1,1.12,8.33,1.33,8
Leganes,8,2,2,4,6,11,-5,8,spain,0.25,0.5,-5,0.75,4.0,2.0,8
Girona,8,2,1,5,8,14,-6,7,spain,0.25,0.38,-6,1.0,4.0,2.63,9
Las Palmas,8,0,2,6,7,17,-10,2,spain,0.0,0.25,-10,0.88,0.0,4.0,10
Valladolid,8,0,1,7,5,25,-20,1,spain,0.0,0.12,-20,0.62,0.0,8.33,11
Huesca,8,5,3,0,12,3,9,18,spain2,0.62,1.0,9,1.5,1.61,1.0,1
Cordoba,8,5,1,2,15,8,7,16,spain2,0.62,0.75,7,1.88,1.61,1.33,2
Mirandes,8,5,1,2,14,7,7,16,spain2,0.62,0.75,7,1.75,1.61,1.33,2
Cadiz,8,4,3,1,15,9,6,15,spain2,0.5,0.88,6,1.88,2.0,1.14,3
Levante,8,4,3,1,9,5,4,15,spain2,0.5,0.88,4,1.12,2.0,1.14,3
Racing,8,4,2,2,18,10,8,14,spain2,0.5,0.75,8,2.25,2.0,1.33,4
Elche,8,4,2,2,11,9,2,14,spain2,0.5,0.75,2,1.38,2.0,1.33,4
Real Oviedo,8,4,2,2,7,5,2,14,spain2,0.5,0.75,2,0.88,2.0,1.33,4
Eldense,8,4,1,3,10,11,-1,13,spain2,0.5,0.62,-1,1.25,2.0,1.61,5
Deportivo,8,3,3,2,8,7,1,12,spain2,0.38,0.75,1,1.0,2.63,1.33,6
Albacete,8,3,2,3,11,10,1,11,spain2,0.38,0.62,1,1.38,2.63,1.61,7
Castellon,8,3,1,4,9,9,0,10,spain2,0.38,0.5,0,1.12,2.63,2.0,8
Granada,8,2,4,2,10,12,-2,10,spain2,0.25,0.75,-2,1.25,4.0,1.33,8
Burgos,8,3,1,4,6,8,-2,10,spain2,0.38,0.5,-2,0.75,2.63,2.0,8
Sporting Gijon,8,1,6,1,7,7,0,9,spain2,0.12,0.88,0,0.88,8.33,1.14,9
Malaga,8,2,3,3,10,11,-1,9,spain2,0.25,0.62,-1,1.25,4.0,1.61,9
Eibar,8,2,3,3,6,8,-2,9,spain2,0.25,0.62,-2,0.75,4.0,1.61,9
Real Zaragoza,8,1,4,3,10,13,-3,7,spain2,0.12,0.62,-3,1.25,8.33,1.61,10
Almeria,8,0,5,3,7,11,-4,5,spain2,0.0,0.62,-4,0.88,0.0,1.61,11
Tenerife,8,1,2,5,7,12,-5,5,spain2,0.12,0.38,-5,0.88,8.33,2.63,11
Racing Ferrol,8,1,1,6,4,18,-14,4,spain2,0.12,0.25,-14,0.5,8.33,4.0,12
Cartagena,8,0,1,7,3,16,-13,1,spain2,0.0,0.12,-13,0.38,0.0,8.33,13
Athletic B. B,8,6,1,1,14,5,9,19,spain3,0.75,0.88,9,1.75,1.33,1.14,1
Leonesa,8,4,4,0,17,10,7,16,spain3,0.5,1.0,7,2.12,2.0,1.0,2
Ourense CF,8,4,3,1,10,6,4,15,spain3,0.5,0.88,4,1.25,2.0,1.14,3
Arenteiro,8,4,2,2,13,11,2,14,spain3,0.5,0.75,2,1.62,2.0,1.33,4
Tarazona,8,4,2,2,9,7,2,14,spain3,0.5,0.75,2,1.12,2.0,1.33,4
Real Sociedad B,8,3,4,1,10,6,4,13,spain3,0.38,0.88,4,1.25,2.63,1.14,5
Unionistas,8,4,1,3,15,14,1,13,spain3,0.5,0.62,1,1.88,2.0,1.61,5
Zamora,8,4,1,3,8,8,0,13,spain3,0.5,0.62,0,1.0,2.0,1.61,5
Real Union,8,4,0,4,13,8,5,12,spain3,0.5,0.5,5,1.62,2.0,2.0,6
Gimnastic T.,8,3,3,2,13,9,4,12,spain3,0.38,0.75,4,1.62,2.63,1.33,6
Ponferradina,8,3,2,3,12,8,4,11,spain3,0.38,0.62,4,1.5,2.63,1.61,7
Amorebieta,8,3,2,3,11,8,3,11,spain3,0.38,0.62,3,1.38,2.63,1.61,7
Barakaldo,8,3,2,3,11,10,1,11,spain3,0.38,0.62,1,1.38,2.63,1.61,7
Osasuna B,8,2,4,2,12,10,2,10,spain3,0.25,0.75,2,1.5,4.0,1.33,8
FC Andorra,8,3,1,4,8,12,-4,10,spain3,0.38,0.5,-4,1.0,2.63,2.0,8
Sestao River,8,1,4,3,6,9,-3,7,spain3,0.12,0.62,-3,0.75,8.33,1.61,9
Lugo,8,2,1,5,10,15,-5,7,spain3,0.25,0.38,-5,1.25,4.0,2.63,9
Celta Vigo B,8,2,1,5,6,11,-5,7,spain3,0.25,0.38,-5,0.75,4.0,2.63,9
Gimnastica,8,1,1,6,7,21,-14,4,spain3,0.12,0.25,-14,0.88,8.33,4.0,10
FC Barcelona B,8,0,3,5,8,17,-9,3,spain3,0.0,0.38,-9,1.0,0.0,2.63,11
UD Ibiza,8,7,0,1,21,9,12,21,spain4,0.88,0.88,12,2.62,1.14,1.14,1
Real Madrid B,8,5,3,0,17,7,10,18,spain4,0.62,1.0,10,2.12,1.61,1.0,2
Ceuta,8,5,3,0,12,3,9,18,spain4,0.62,1.0,9,1.5,1.61,1.0,2
Sevilla FC B,8,6,0,2,7,3,4,18,spain4,0.75,0.75,4,0.88,1.33,1.33,2
Atletico M. B,8,4,1,3,10,9,1,13,spain4,0.5,0.62,1,1.25,2.0,1.61,3
Merida,8,4,1,3,16,16,0,13,spain4,0.5,0.62,0,2.0,2.0,1.61,3
Real Murcia,8,4,0,4,11,9,2,12,spain4,0.5,0.5,2,1.38,2.0,2.0,4
Fuenlabrada,8,3,2,3,14,12,2,11,spain4,0.38,0.62,2,1.75,2.63,1.61,5
Recreativo H.,8,2,5,1,8,7,1,11,spain4,0.25,0.88,1,1.0,4.0,1.14,5
Hercules,8,3,1,4,11,9,2,10,spain4,0.38,0.5,2,1.38,2.63,2.0,6
Antequera,8,2,4,2,12,13,-1,10,spain4,0.25,0.75,-1,1.5,4.0,1.33,6
Intercity,8,2,3,3,9,9,0,9,spain4,0.25,0.62,0,1.12,4.0,1.61,7
Alcorcon,8,2,3,3,9,10,-1,9,spain4,0.25,0.62,-1,1.12,4.0,1.61,7
Alcoyano,8,2,3,3,2,6,-4,9,spain4,0.25,0.62,-4,0.25,4.0,1.61,7
Sanluqueno,8,2,2,4,9,13,-4,8,spain4,0.25,0.5,-4,1.12,4.0,2.0,8
Villarreal B,8,1,4,3,10,10,0,7,spain4,0.12,0.62,0,1.25,8.33,1.61,9
Marbella,8,1,4,3,12,16,-4,7,spain4,0.12,0.62,-4,1.5,8.33,1.61,9
Yeclano,8,1,3,4,7,9,-2,6,spain4,0.12,0.5,-2,0.88,8.33,2.0,10
Algeciras,8,1,2,5,4,14,-10,5,spain4,0.12,0.38,-10,0.5,8.33,2.63,11
Real Betis B,8,0,3,5,6,22,-16,3,spain4,0.0,0.38,-16,0.75,0.0,2.63,12
Numancia,8,5,3,0,13,5,8,18,spain5,0.62,1.0,8,1.62,1.61,1.0,1
Real Avila,8,5,2,1,9,2,7,17,spain5,0.62,0.88,7,1.12,1.61,1.14,2
Llanera,8,5,2,1,15,9,6,17,spain5,0.62,0.88,6,1.88,1.61,1.14,2
Real Aviles,8,3,5,0,14,8,6,14,spain5,0.38,1.0,6,1.75,2.63,1.0,3
Pontevedra,8,4,2,2,11,8,3,14,spain5,0.5,0.75,3,1.38,2.0,1.33,3
D. Fabril,8,3,3,2,8,4,4,12,spain5,0.38,0.75,4,1.0,2.63,1.33,4
Escobedo,8,3,3,2,3,3,0,12,spain5,0.38,0.75,0,0.38,2.63,1.33,4
Langreo,8,3,2,3,5,7,-2,11,spain5,0.38,0.62,-2,0.62,2.63,1.61,5
Salamanca CF,8,3,1,4,11,11,0,10,spain5,0.38,0.5,0,1.38,2.63,2.0,6
Guijuelo,8,2,4,2,8,11,-3,10,spain5,0.25,0.75,-3,1.0,4.0,1.33,6
Bergantinos,8,3,0,5,7,10,-3,9,spain5,0.38,0.38,-3,0.88,2.63,2.63,7
Coruxo,8,2,3,3,5,8,-3,9,spain5,0.25,0.62,-3,0.62,4.0,1.61,7
Marino de L.,8,2,2,4,9,9,0,8,spain5,0.25,0.5,0,1.12,4.0,2.0,8
Valladolid B,8,1,5,2,7,9,-2,8,spain5,0.12,0.75,-2,0.88,8.33,1.33,8
Laredo,8,1,4,3,7,11,-4,7,spain5,0.12,0.62,-4,0.88,8.33,1.61,9
Rayo Cantabria,8,2,1,5,11,17,-6,7,spain5,0.25,0.38,-6,1.38,4.0,2.63,9
Torrelavega,8,1,3,4,3,8,-5,6,spain5,0.12,0.5,-5,0.38,8.33,2.0,10
Compostela,8,1,2,5,9,14,-5,5,spain5,0.12,0.38,-5,1.12,8.33,2.63,11
Teruel,8,7,1,0,14,2,12,22,spain6,0.88,1.0,12,1.75,1.14,1.0,1
Ejea,8,6,2,0,15,3,12,20,spain6,0.75,1.0,12,1.88,1.33,1.0,2
Eibar B,8,6,0,2,13,2,11,18,spain6,0.75,0.75,11,1.62,1.33,1.33,3
SD Logrones,8,6,0,2,16,8,8,18,spain6,0.75,0.75,8,2.0,1.33,1.33,3
Gernika,8,4,2,2,12,12,0,14,spain6,0.5,0.75,0,1.5,2.0,1.33,4
Utebo,8,3,3,2,9,6,3,12,spain6,0.38,0.75,3,1.12,2.63,1.33,5
Alfaro,8,3,3,2,9,9,0,12,spain6,0.38,0.75,0,1.12,2.63,1.33,5
UD Logrones,8,2,4,2,11,7,4,10,spain6,0.25,0.75,4,1.38,4.0,1.33,6
Arenas Club,8,3,1,4,7,8,-1,10,spain6,0.38,0.5,-1,0.88,2.63,2.0,6
Subiza,8,3,1,4,10,13,-3,10,spain6,0.38,0.5,-3,1.25,2.63,2.0,6
Anguiano,8,3,1,4,9,14,-5,10,spain6,0.38,0.5,-5,1.12,2.63,2.0,6
Real Zaragoza B,8,3,0,5,8,13,-5,9,spain6,0.38,0.38,-5,1.0,2.63,2.63,7
Barbastro,8,2,2,4,8,11,-3,8,spain6,0.25,0.5,-3,1.0,4.0,2.0,8
Alaves B,8,2,2,4,4,8,-4,8,spain6,0.25,0.5,-4,0.5,4.0,2.0,8
Real Sociedad C,8,2,1,5,8,11,-3,7,spain6,0.25,0.38,-3,1.0,4.0,2.63,9
Calahorra,8,1,4,3,5,8,-3,7,spain6,0.12,0.62,-3,0.62,8.33,1.61,9
Tudelano,8,1,3,4,10,14,-4,6,spain6,0.12,0.5,-4,1.25,8.33,2.0,10
Izarra,8,0,1,7,3,18,-15,1,spain6,0.0,0.12,-15,0.38,0.0,8.33,11
Torrent,8,6,2,0,12,5,7,20,spain7,0.75,1.0,7,1.5,1.33,1.0,1
Europa,8,5,2,1,12,6,6,17,spain7,0.62,0.88,6,1.5,1.61,1.14,2
Valencia B,8,5,1,2,12,6,6,16,spain7,0.62,0.75,6,1.5,1.61,1.33,3
A. Baleares,8,3,5,0,8,4,4,14,spain7,0.38,1.0,4,1.0,2.63,1.0,4
Sant Andreu,8,3,4,1,16,6,10,13,spain7,0.38,0.88,10,2.0,2.63,1.14,5
SD Ibiza,8,3,4,1,10,8,2,13,spain7,0.38,0.88,2,1.25,2.63,1.14,5
Terrassa,8,4,1,3,7,5,2,13,spain7,0.5,0.62,2,0.88,2.0,1.61,5
Espanyol B,8,3,3,2,13,10,3,12,spain7,0.38,0.75,3,1.62,2.63,1.33,6
Elche B,8,3,2,3,8,4,4,11,spain7,0.38,0.62,4,1.0,2.63,1.61,7
Andratx,8,3,2,3,8,12,-4,11,spain7,0.38,0.62,-4,1.0,2.63,1.61,7
Lleida,8,1,7,0,11,8,3,10,spain7,0.12,1.0,3,1.38,8.33,1.0,8
Cornella,8,2,4,2,8,11,-3,10,spain7,0.25,0.75,-3,1.0,4.0,1.33,8
Olot,8,2,3,3,6,9,-3,9,spain7,0.25,0.62,-3,0.75,4.0,1.61,9
Pena Deportiva,8,1,3,4,6,9,-3,6,spain7,0.12,0.5,-3,0.75,8.33,2.0,10
Sabadell,8,1,3,4,6,12,-6,6,spain7,0.12,0.5,-6,0.75,8.33,2.0,10
Badalona,8,1,1,6,3,12,-9,4,spain7,0.12,0.25,-9,0.38,8.33,4.0,11
Mallorca B,8,1,0,7,5,13,-8,3,spain7,0.12,0.12,-8,0.62,8.33,8.33,12
Alzira,8,0,3,5,10,20,-10,3,spain7,0.0,0.38,-10,1.25,0.0,2.63,12
La Union,8,6,1,1,11,3,8,19,spain8,0.75,0.88,8,1.38,1.33,1.14,1
Linares,8,5,3,0,13,4,9,18,spain8,0.62,1.0,9,1.62,1.61,1.0,2
Torremolinos,8,5,3,0,10,4,6,18,spain8,0.62,1.0,6,1.25,1.61,1.0,2
Aguilas CF,8,4,3,1,10,7,3,15,spain8,0.5,0.88,3,1.25,2.0,1.14,3
Almeria B,8,4,1,3,8,6,2,13,spain8,0.5,0.62,2,1.0,2.0,1.61,4
San Fernando,8,2,6,0,9,7,2,12,spain8,0.25,1.0,2,1.12,4.0,1.0,5
Xerez CD,8,3,3,2,7,5,2,12,spain8,0.38,0.75,2,0.88,2.63,1.33,5
CD Estepona,8,2,5,1,11,6,5,11,spain8,0.25,0.88,5,1.38,4.0,1.14,6
Antoniano,8,3,2,3,9,10,-1,11,spain8,0.38,0.62,-1,1.12,2.63,1.61,6
Orihuela,8,2,3,3,4,5,-1,9,spain8,0.25,0.62,-1,0.5,4.0,1.61,7
D. Minera,8,2,3,3,7,10,-3,9,spain8,0.25,0.62,-3,0.88,4.0,1.61,7
Cadiz B,8,2,3,3,7,12,-5,9,spain8,0.25,0.62,-5,0.88,4.0,1.61,7
UCAM Murcia,8,1,5,2,7,6,1,8,spain8,0.12,0.75,1,0.88,8.33,1.33,8
Linense,8,2,2,4,7,10,-3,8,spain8,0.25,0.5,-3,0.88,4.0,2.0,8
Villanovense,8,1,3,4,7,11,-4,6,spain8,0.12,0.5,-4,0.88,8.33,2.0,9
Granada B,8,1,2,5,6,11,-5,5,spain8,0.12,0.38,-5,0.75,8.33,2.63,10
Xerez D. FC,8,1,2,5,3,10,-7,5,spain8,0.12,0.38,-7,0.38,8.33,2.63,10
Don Benito,8,0,3,5,4,12,-8,3,spain8,0.0,0.38,-8,0.5,0.0,2.63,11
CD Coria,8,6,1,1,14,9,5,19,spain9,0.75,0.88,5,1.75,1.33,1.14,1
Guadalajara,8,5,3,0,10,3,7,18,spain9,0.62,1.0,7,1.25,1.61,1.0,2
Talavera CF,8,4,4,0,17,7,10,16,spain9,0.5,1.0,10,2.12,2.0,1.0,3
Navalcarnero,8,5,1,2,11,6,5,16,spain9,0.62,0.75,5,1.38,1.61,1.33,3
Cacereno,8,5,1,2,11,7,4,16,spain9,0.62,0.75,4,1.38,1.61,1.33,3
R. Majadahonda,8,4,3,1,15,8,7,15,spain9,0.5,0.88,7,1.88,2.0,1.14,4
CD Mostoles,8,4,0,4,10,9,1,12,spain9,0.5,0.5,1,1.25,2.0,2.0,5
Conquense,8,4,0,4,10,9,1,12,spain9,0.5,0.5,1,1.25,2.0,2.0,5
Getafe B,8,3,3,2,9,9,0,12,spain9,0.38,0.75,0,1.12,2.63,1.33,5
Real Madrid C,8,2,4,2,8,9,-1,10,spain9,0.25,0.75,-1,1.0,4.0,1.33,6
S. Sebastian R.,8,2,3,3,7,12,-5,9,spain9,0.25,0.62,-5,0.88,4.0,1.61,7
Melilla,8,2,2,4,9,10,-1,8,spain9,0.25,0.5,-1,1.12,4.0,2.0,8
Tenerife B,8,2,1,5,12,17,-5,7,spain9,0.25,0.38,-5,1.5,4.0,2.63,9
Union Adarve,8,1,3,4,7,12,-5,6,spain9,0.12,0.5,-5,0.88,8.33,2.0,10
Colonia M.,8,1,3,4,6,11,-5,6,spain9,0.12,0.5,-5,0.75,8.33,2.0,10
Atletico Paso,8,1,3,4,7,13,-6,6,spain9,0.12,0.5,-6,0.88,8.33,2.0,10
Yaiza,8,1,2,5,7,11,-4,5,spain9,0.12,0.38,-4,0.88,8.33,2.63,11
Illescas,8,1,1,6,7,15,-8,4,spain9,0.12,0.25,-8,0.88,8.33,4.0,12
AIK,0,0,0,0,0,0,0,0,sweden,0.0,0.0,0,0.0,0.0,0.0,1
Brommapojkarna,0,0,0,0,0,0,0,0,sweden,0.0,0.0,0,0.0,0.0,0.0,1
Degerfors,0,0,0,0,0,0,0,0,sweden,0.0,0.0,0,0.0,0.0,0.0,1
Djurgarden,0,0,0,0,0,0,0,0,sweden,0.0,0.0,0,0.0,0.0,0.0,1
Elfsborg,0,0,0,0,0,0,0,0,sweden,0.0,0.0,0,0.0,0.0,0.0,1
GAIS,0,0,0,0,0,0,0,0,sweden,0.0,0.0,0,0.0,0.0,0.0,1
Hacken,0,0,0,0,0,0,0,0,sweden,0.0,0.0,0,0.0,0.0,0.0,1
Halmstad,0,0,0,0,0,0,0,0,sweden,0.0,0.0,0,0.0,0.0,0.0,1
Hammarby,0,0,0,0,0,0,0,0,sweden,0.0,0.0,0,0.0,0.0,0.0,1
IFK Goteborg,0,0,0,0,0,0,0,0,sweden,0.0,0.0,0,0.0,0.0,0.0,1
Malmo FF,0,0,0,0,0,0,0,0,sweden,0.0,0.0,0,0.0,0.0,0.0,1
Mjallby,0,0,0,0,0,0,0,0,sweden,0.0,0.0,0,0.0,0.0,0.0,1
Norrkoping,0,0,0,0,0,0,0,0,sweden,0.0,0.0,0,0.0,0.0,0.0,1
Oster,0,0,0,0,0,0,0,0,sweden,0.0,0.0,0,0.0,0.0,0.0,1
Sirius,0,0,0,0,0,0,0,0,sweden,0.0,0.0,0,0.0,0.0,0.0,1
Varnamo,0,0,0,0,0,0,0,0,sweden,0.0,0.0,0,0.0,0.0,0.0,1
Brage,0,0,0,0,0,0,0,0,sweden2,0.0,0.0,0,0.0,0.0,0.0,1
Falkenberg,0,0,0,0,0,0,0,0,sweden2,0.0,0.0,0,0.0,0.0,0.0,1
GIF Sundsvall,0,0,0,0,0,0,0,0,sweden2,0.0,0.0,0,0.0,0.0,0.0,1
Helsingborg,0,0,0,0,0,0,0,0,sweden2,0.0,0.0,0,0.0,0.0,0.0,1
Kalmar,0,0,0,0,0,0,0,0,sweden2,0.0,0.0,0,0.0,0.0,0.0,1
Landskrona,0,0,0,0,0,0,0,0,sweden2,0.0,0.0,0,0.0,0.0,0.0,1
Oddevold,0,0,0,0,0,0,0,0,sweden2,0.0,0.0,0,0.0,0.0,0.0,1
Orebro,0,0,0,0,0,0,0,0,sweden2,0.0,0.0,0,0.0,0.0,0.0,1
Orgryte,0,0,0,0,0,0,0,0,sweden2,0.0,0.0,0,0.0,0.0,0.0,1
Ostersunds,0,0,0,0,0,0,0,0,sweden2,0.0,0.0,0,0.0,0.0,0.0,1
Sandviken,0,0,0,0,0,0,0,0,sweden2,0.0,0.0,0,0.0,0.0,0.0,1
Trelleborg,0,0,0,0,0,0,0,0,sweden2,0.0,0.0,0,0.0,0.0,0.0,1
Umea,0,0,0,0,0,0,0,0,sweden2,0.0,0.0,0,0.0,0.0,0.0,1
Utsikten,0,0,0,0,0,0,0,0,sweden2,0.0,0.0,0,0.0,0.0,0.0,1
Varberg BoIS,0,0,0,0,0,0,0,0,sweden2,0.0,0.0,0,0.0,0.0,0.0,1
Vasteras,0,0,0,0,0,0,0,0,sweden2,0.0,0.0,0,0.0,0.0,0.0,1
BSC Young Boys,8,5,1,2,17,5,12,16,switzerland,0.62,0.75,12,2.12,1.61,1.33,1
Servette,8,4,4,0,13,8,5,16,switzerland,0.5,1.0,5,1.62,2.0,1.0,1
FC Basel,8,4,3,1,15,9,6,15,switzerland,0.5,0.88,6,1.88,2.0,1.14,2
Luzern,8,4,2,2,13,10,3,14,switzerland,0.5,0.75,3,1.62,2.0,1.33,3
St. Gallen,8,4,1,3,12,14,-2,13,switzerland,0.5,0.62,-2,1.5,2.0,1.61,4
FC Zurich,8,4,0,4,11,9,2,12,switzerland,0.5,0.5,2,1.38,2.0,2.0,5
Lugano,8,3,2,3,12,13,-1,11,switzerland,0.38,0.62,-1,1.5,2.63,1.61,6
Yverdon,8,3,2,3,11,15,-4,11,switzerland,0.38,0.62,-4,1.38,2.63,1.61,6
Grasshopper,8,1,5,2,9,11,-2,8,switzerland,0.12,0.75,-2,1.12,8.33,1.33,7
Lausanne Sport,8,1,3,4,12,15,-3,6,switzerland,0.12,0.5,-3,1.5,8.33,2.0,8
Winterthur,8,2,0,6,11,16,-5,6,switzerland,0.25,0.25,-5,1.38,4.0,4.0,8
Sion,8,1,1,6,10,21,-11,4,switzerland,0.12,0.25,-11,1.25,8.33,4.0,9
Bangkok Utd,8,6,2,0,15,7,8,20,thailand,0.75,1.0,8,1.88,1.33,1.0,1
Ratchaburi,8,5,3,0,15,8,7,18,thailand,0.62,1.0,7,1.88,1.61,1.0,2
Buriram Utd,8,5,1,2,27,7,20,16,thailand,0.62,0.75,20,3.38,1.61,1.33,3
Pathum Utd,8,5,1,2,14,6,8,16,thailand,0.62,0.75,8,1.75,1.61,1.33,3
Muang Thong Utd,8,5,0,3,17,10,7,15,thailand,0.62,0.62,7,2.12,1.61,1.61,4
Lamphun Warrior,8,4,3,1,9,4,5,15,thailand,0.5,0.88,5,1.12,2.0,1.14,4
Uthai Thani,8,3,2,3,11,8,3,11,thailand,0.38,0.62,3,1.38,2.63,1.61,5
Prachuap,8,3,1,4,11,9,2,10,thailand,0.38,0.5,2,1.38,2.63,2.0,6
Port FC,8,3,1,4,13,13,0,10,thailand,0.38,0.5,0,1.62,2.63,2.0,6
Chiangrai Utd,8,3,0,5,8,9,-1,9,thailand,0.38,0.38,-1,1.0,2.63,2.63,7
Rayong,8,2,3,3,16,19,-3,9,thailand,0.25,0.62,-3,2.0,4.0,1.61,7
N. Ratchasima,8,1,4,3,13,18,-5,7,thailand,0.12,0.62,-5,1.62,8.33,1.61,8
Nakhon Pathom,8,1,3,4,6,14,-8,6,thailand,0.12,0.5,-8,0.75,8.33,2.0,9
N. Bua Pitchaya,8,0,5,3,5,10,-5,5,thailand,0.0,0.62,-5,0.62,0.0,1.61,10
Sukhothai,8,1,2,5,8,16,-8,5,thailand,0.12,0.38,-8,1.0,8.33,2.63,10
Khon Kaen Utd,8,1,2,5,5,21,-16,5,thailand,0.12,0.38,-16,0.62,8.33,2.63,10
Kanchanaburi,8,4,4,0,13,7,6,16,thailand2,0.5,1.0,6,1.62,2.0,1.0,1
Chonburi,8,4,3,1,17,8,9,15,thailand2,0.5,0.88,9,2.12,2.0,1.14,2
Ayutthaya Utd,8,4,3,1,15,8,7,15,thailand2,0.5,0.88,7,1.88,2.0,1.14,2
Lampang,8,4,2,2,13,9,4,14,thailand2,0.5,0.75,4,1.62,2.0,1.33,3
Kasetsart,8,4,2,2,9,6,3,14,thailand2,0.5,0.75,3,1.12,2.0,1.33,3
Suphanburi,8,3,3,2,17,16,1,12,thailand2,0.38,0.75,1,2.12,2.63,1.33,4
Sisaket Utd,8,3,3,2,8,9,-1,12,thailand2,0.38,0.75,-1,1.0,2.63,1.33,4
Phrae Utd,8,3,2,3,12,11,1,11,thailand2,0.38,0.62,1,1.5,2.63,1.61,5
Nakhon Si,8,3,2,3,14,16,-2,11,thailand2,0.38,0.62,-2,1.75,2.63,1.61,5
Pattaya United,8,3,2,3,7,10,-3,11,thailand2,0.38,0.62,-3,0.88,2.63,1.61,5
Mahasarakham,8,2,4,2,10,11,-1,10,thailand2,0.25,0.75,-1,1.25,4.0,1.33,6
Police Tero,8,3,1,4,9,11,-2,10,thailand2,0.38,0.5,-2,1.12,2.63,2.0,6
Bangkok FC,8,2,2,4,10,13,-3,8,thailand2,0.25,0.5,-3,1.25,4.0,2.0,7
Chanthaburi,8,2,2,4,10,13,-3,8,thailand2,0.25,0.5,-3,1.25,4.0,2.0,7
Chiangmai Utd,8,2,2,4,11,17,-6,8,thailand2,0.25,0.5,-6,1.38,4.0,2.0,7
Trat FC,8,2,1,5,11,13,-2,7,thailand2,0.25,0.38,-2,1.38,4.0,2.63,8
Chainat,8,1,2,5,4,8,-4,5,thailand2,0.12,0.38,-4,0.5,8.33,2.63,9
Samut Prakan,0,0,0,0,0,0,0,0,thailand2,0.0,0.0,0,0.0,0.0,0.0,10
Fenerbahce,8,7,1,0,21,7,14,22,turkey,0.88,1.0,14,2.62,1.14,1.0,1
Besiktas,8,5,3,0,13,5,8,18,turkey,0.62,1.0,8,1.62,1.61,1.0,2
Galatasaray,8,5,3,0,13,6,7,18,turkey,0.62,1.0,7,1.62,1.61,1.0,2
Samsunspor,8,4,2,2,10,10,0,14,turkey,0.5,0.75,0,1.25,2.0,1.33,3
Trabzonspor,8,4,1,3,15,7,8,13,turkey,0.5,0.62,8,1.88,2.0,1.61,4
Eyupspor,8,4,1,3,12,9,3,13,turkey,0.5,0.62,3,1.5,2.0,1.61,4
Bodrumspor,8,3,3,2,4,4,0,12,turkey,0.38,0.75,0,0.5,2.63,1.33,5
Antalyaspor,8,3,3,2,9,10,-1,12,turkey,0.38,0.75,-1,1.12,2.63,1.33,5
Gaziantep,8,3,2,3,11,10,1,11,turkey,0.38,0.62,1,1.38,2.63,1.61,6
Kasimpasa,8,3,2,3,21,21,0,11,turkey,0.38,0.62,0,2.62,2.63,1.61,6
Kayserispor,8,3,2,3,10,12,-2,11,turkey,0.38,0.62,-2,1.25,2.63,1.61,6
Basaksehir,8,3,1,4,13,11,2,10,turkey,0.38,0.5,2,1.62,2.63,2.0,7
Alanyaspor,8,3,1,4,11,16,-5,10,turkey,0.38,0.5,-5,1.38,2.63,2.0,7
Rizespor,8,3,0,5,15,17,-2,9,turkey,0.38,0.38,-2,1.88,2.63,2.63,8
Goztepe,8,2,2,4,11,9,2,8,turkey,0.25,0.5,2,1.38,4.0,2.0,9
Konyaspor,8,2,2,4,12,13,-1,8,turkey,0.25,0.5,-1,1.5,4.0,2.0,9
Hatayspor,8,2,1,5,11,15,-4,7,turkey,0.25,0.38,-4,1.38,4.0,2.63,10
Sivasspor,8,1,2,5,8,14,-6,5,turkey,0.12,0.38,-6,1.0,8.33,2.63,11
Adana Demirspor,8,0,2,6,8,20,-12,2,turkey,0.0,0.25,-12,1.0,0.0,4.0,12
Genclerbirligi,8,5,3,0,17,6,11,18,turkey2,0.62,1.0,11,2.12,1.61,1.0,1
Kocaelispor,8,4,4,0,11,3,8,16,turkey2,0.5,1.0,8,1.38,2.0,1.0,2
Keciorengucu,8,4,3,1,20,10,10,15,turkey2,0.5,0.88,10,2.5,2.0,1.14,3
F. Karagumruk,8,4,2,2,10,8,2,14,turkey2,0.5,0.75,2,1.25,2.0,1.33,4
Igdir,8,4,2,2,9,7,2,14,turkey2,0.5,0.75,2,1.12,2.0,1.33,4
Istanbulspor,8,4,1,3,9,5,4,13,turkey2,0.5,0.62,4,1.12,2.0,1.61,5
Erzurum BB,8,3,3,2,15,9,6,12,turkey2,0.38,0.75,6,1.88,2.63,1.33,6
Adanaspor,8,3,3,2,8,8,0,12,turkey2,0.38,0.75,0,1.0,2.63,1.33,6
Umraniyespor,8,3,3,2,7,7,0,12,turkey2,0.38,0.75,0,0.88,2.63,1.33,6
Bandirmaspor,8,4,0,4,10,15,-5,12,turkey2,0.5,0.5,-5,1.25,2.0,2.0,6
Amed SK,8,2,4,2,10,7,3,10,turkey2,0.25,0.75,3,1.25,4.0,1.33,7
Boluspor,8,2,4,2,6,5,1,10,turkey2,0.25,0.75,1,0.75,4.0,1.33,7
Pendikspor,8,3,1,4,8,13,-5,10,turkey2,0.38,0.5,-5,1.0,2.63,2.0,7
Erokspor,8,1,6,1,12,11,1,9,turkey2,0.12,0.88,1,1.5,8.33,1.14,8
Sanliurfaspor,8,2,3,3,11,10,1,9,turkey2,0.25,0.62,1,1.38,4.0,1.61,8
Sakaryaspor,8,2,3,3,9,13,-4,9,turkey2,0.25,0.62,-4,1.12,4.0,1.61,8
Ankaragucu,8,2,1,5,11,10,1,7,turkey2,0.25,0.38,1,1.38,4.0,2.63,9
Corum,8,2,1,5,8,9,-1,7,turkey2,0.25,0.38,-1,1.0,4.0,2.63,9
Manisa BB,8,1,2,5,10,13,-3,5,turkey2,0.12,0.38,-3,1.25,8.33,2.63,10
Y. Malatyaspor,8,0,0,8,1,34,-33,0,turkey2,0.0,0.0,-33,0.12,0.0,0.0,11
Sariyer,8,6,1,1,25,8,17,19,turkey3,0.75,0.88,17,3.12,1.33,1.14,1
B. Petrolspor,8,6,1,1,13,7,6,19,turkey3,0.75,0.88,6,1.62,1.33,1.14,1
Adana,8,5,3,0,12,3,9,18,turkey3,0.62,1.0,9,1.5,1.61,1.0,2
Altinordu,8,4,4,0,19,7,12,16,turkey3,0.5,1.0,12,2.38,2.0,1.0,3
Kastamonuspor,8,4,4,0,12,4,8,16,turkey3,0.5,1.0,8,1.5,2.0,1.0,3
Iskenderun,8,4,1,3,11,9,2,13,turkey3,0.5,0.62,2,1.38,2.0,1.61,4
Kirklarelispor,8,3,2,3,12,9,3,11,turkey3,0.38,0.62,3,1.5,2.63,1.61,5
Trabzon FK,8,3,2,3,11,10,1,11,turkey3,0.38,0.62,1,1.38,2.63,1.61,5
Inegolspor,8,3,2,3,11,17,-6,11,turkey3,0.38,0.62,-6,1.38,2.63,1.61,5
Ankaraspor,8,3,1,4,16,8,8,10,turkey3,0.38,0.5,8,2.0,2.63,2.0,6
Altay,8,3,1,4,7,11,-4,10,turkey3,0.38,0.5,-4,0.88,2.63,2.0,6
Karakopru,8,2,3,3,8,8,0,9,turkey3,0.25,0.62,0,1.0,4.0,1.61,7
Isparta Davrazs,8,2,3,3,8,11,-3,9,turkey3,0.25,0.62,-3,1.0,4.0,1.61,7
B. Anadolu,8,2,3,3,5,11,-6,9,turkey3,0.25,0.62,-6,0.62,4.0,1.61,7
Kepez Belediyes,8,2,2,4,8,11,-3,8,turkey3,0.25,0.5,-3,1.0,4.0,2.0,8
Fethiyespor,8,0,5,3,3,6,-3,5,turkey3,0.0,0.62,-3,0.38,0.0,1.61,9
24 Erzincanspor,8,1,1,6,9,21,-12,4,turkey3,0.12,0.25,-12,1.12,8.33,4.0,10
Afyonspor,8,0,0,8,0,27,-27,0,turkey3,0.0,0.0,-27,0.0,0.0,0.0,11
Elazigspor,8,6,1,1,22,7,15,19,turkey4,0.75,0.88,15,2.75,1.33,1.14,1
Menemen B.,8,5,2,1,23,12,11,17,turkey4,0.62,0.88,11,2.88,1.61,1.14,2
Van Spor,8,5,2,1,19,8,11,17,turkey4,0.62,0.88,11,2.38,1.61,1.14,2
Serik Belediyes,8,4,3,1,13,5,8,15,turkey4,0.5,0.88,8,1.62,2.0,1.14,3
Bucaspor,8,4,2,2,9,7,2,14,turkey4,0.5,0.75,2,1.12,2.0,1.33,4
Aksaray B.,8,3,4,1,13,7,6,13,turkey4,0.38,0.88,6,1.62,2.63,1.14,5
A. Demirspor,8,3,4,1,11,7,4,13,turkey4,0.38,0.88,4,1.38,2.63,1.14,5
Erbaaspor,8,4,1,3,15,16,-1,13,turkey4,0.5,0.62,-1,1.88,2.0,1.61,5
Beyoglu Yeni C.,8,3,3,2,9,8,1,12,turkey4,0.38,0.75,1,1.12,2.63,1.33,6
Arnavutkoy B.,8,3,3,2,14,14,0,12,turkey4,0.38,0.75,0,1.75,2.63,1.33,6
Karacabey,8,3,2,3,15,15,0,11,turkey4,0.38,0.62,0,1.88,2.63,1.61,7
Derince,8,3,1,4,9,13,-4,10,turkey4,0.38,0.5,-4,1.12,2.63,2.0,8
Diyarbekirspor,8,2,3,3,5,7,-2,9,turkey4,0.25,0.62,-2,0.62,4.0,1.61,9
Somaspor,8,1,3,4,5,5,0,6,turkey4,0.12,0.5,0,0.62,8.33,2.0,10
Karaman,8,0,4,4,8,13,-5,4,turkey4,0.0,0.5,-5,1.0,0.0,2.0,11
Nazillispor,8,1,1,6,12,23,-11,4,turkey4,0.12,0.25,-11,1.5,8.33,4.0,11
Yeni Mersin,8,1,1,6,4,21,-17,4,turkey4,0.12,0.25,-17,0.5,8.33,4.0,11
Giresunspor,8,0,1,7,4,23,-19,1,turkey4,0.0,0.12,-19,0.5,0.0,8.33,12
Kutahyaspor,8,5,3,0,17,7,10,18,turkey5,0.62,1.0,10,2.12,1.61,1.0,1
Bursaspor,8,4,4,0,17,5,12,16,turkey5,0.5,1.0,12,2.12,2.0,1.0,2
Karsiyaka,8,4,3,1,13,6,7,15,turkey5,0.5,0.88,7,1.62,2.0,1.14,3
Duzcespor,8,4,3,1,10,7,3,15,turkey5,0.5,0.88,3,1.25,2.0,1.14,3
Anadolu U.,8,4,2,2,16,11,5,14,turkey5,0.5,0.75,5,2.0,2.0,1.33,4
Artvin Hopaspor,8,4,2,2,8,5,3,14,turkey5,0.5,0.75,3,1.0,2.0,1.33,4
Silifke,8,3,3,2,15,12,3,12,turkey5,0.38,0.75,3,1.88,2.63,1.33,5
Musspor,8,3,3,2,12,10,2,12,turkey5,0.38,0.75,2,1.5,2.63,1.33,5
K. Bulvarspor,8,3,2,3,10,8,2,11,turkey5,0.38,0.62,2,1.25,2.63,1.61,6
Elaziz K.,8,2,3,3,6,8,-2,9,turkey5,0.25,0.62,-2,0.75,4.0,1.61,7
Kahramanmar.,8,2,1,5,8,13,-5,7,turkey5,0.25,0.38,-5,1.0,4.0,2.63,8
Kirsehir B.,8,2,1,5,7,17,-10,7,turkey5,0.25,0.38,-10,0.88,4.0,2.63,8
Tokat,8,1,3,4,8,10,-2,6,turkey5,0.12,0.5,-2,1.0,8.33,2.0,9
Kusadasispor,8,2,0,6,5,11,-6,6,turkey5,0.25,0.25,-6,0.62,4.0,4.0,9
Viven Bornova,8,1,3,4,6,19,-13,6,turkey5,0.12,0.5,-13,0.75,8.33,2.0,9
Ergene Velimese,8,1,1,6,5,15,-10,4,turkey5,0.12,0.25,-10,0.62,8.33,4.0,10
Balikesirspor,8,6,1,1,15,4,11,19,turkey6,0.75,0.88,11,1.88,1.33,1.14,1
Muglaspor,8,5,3,0,10,2,8,18,turkey6,0.62,1.0,8,1.25,1.61,1.0,2
Etimesgut,8,4,3,1,10,7,3,15,turkey6,0.5,0.88,3,1.25,2.0,1.14,3
Amasyaspor,8,4,2,2,10,6,4,14,turkey6,0.5,0.75,4,1.25,2.0,1.33,4
Silivrispor,8,4,2,2,9,7,2,14,turkey6,0.5,0.75,2,1.12,2.0,1.33,4
Inegol Kafkas,8,4,1,3,6,7,-1,13,turkey6,0.5,0.62,-1,0.75,2.0,1.61,5
Usakspor,8,3,3,2,14,8,6,12,turkey6,0.38,0.75,6,1.75,2.63,1.33,6
Fatsa B.,8,4,0,4,8,10,-2,12,turkey6,0.5,0.5,-2,1.0,2.0,2.0,6
Beykoz Ishaklis,8,3,2,3,11,10,1,11,turkey6,0.38,0.62,1,1.38,2.63,1.61,7
Turk Metal 1963,8,2,3,3,10,12,-2,9,turkey6,0.25,0.62,-2,1.25,4.0,1.61,8
Tire 2021 FK,8,2,3,3,9,11,-2,9,turkey6,0.25,0.62,-2,1.12,4.0,1.61,8
Mazidagi,8,1,5,2,5,5,0,8,turkey6,0.12,0.75,0,0.62,8.33,1.33,9
Cayelispor,8,2,2,4,4,9,-5,8,turkey6,0.25,0.5,-5,0.5,4.0,2.0,9
Nevsehirspor,8,1,3,4,7,10,-3,6,turkey6,0.12,0.5,-3,0.88,8.33,2.0,10
Kelkit,8,0,4,4,5,9,-4,4,turkey6,0.0,0.5,-4,0.62,0.0,2.0,11
Adiyaman,8,0,1,7,6,22,-16,1,turkey6,0.0,0.12,-16,0.75,0.0,8.33,12
Orduspor,8,6,2,0,16,5,11,20,turkey7,0.75,1.0,11,2.0,1.33,1.0,1
Aliaga FAS,8,5,3,0,14,2,12,18,turkey7,0.62,1.0,12,1.75,1.61,1.0,2
Corluspor,8,6,0,2,19,11,8,18,turkey7,0.75,0.75,8,2.38,1.33,1.33,2
Ayvalikgucu,8,5,2,1,9,5,4,17,turkey7,0.62,0.88,4,1.12,1.61,1.14,3
Kucukcekmece,8,3,4,1,13,9,4,13,turkey7,0.38,0.88,4,1.62,2.63,1.14,4
Yozgat Bld Bozo,8,3,3,2,11,8,3,12,turkey7,0.38,0.75,3,1.38,2.63,1.33,5
Pazarspor,8,3,3,2,9,8,1,12,turkey7,0.38,0.75,1,1.12,2.63,1.33,5
Osmaniyespor,8,2,4,2,12,15,-3,10,turkey7,0.25,0.75,-3,1.5,4.0,1.33,6
Cankaya FK,8,2,3,3,10,12,-2,9,turkey7,0.25,0.62,-2,1.25,4.0,1.61,7
1922 Konyaspor,8,1,5,2,6,9,-3,8,turkey7,0.12,0.75,-3,0.75,8.33,1.33,8
Viransehir,8,2,2,4,6,11,-5,8,turkey7,0.25,0.5,-5,0.75,4.0,2.0,8
Efeler 09,8,2,1,5,5,13,-8,7,turkey7,0.25,0.38,-8,0.62,4.0,2.63,9
Bursa,8,2,1,5,8,17,-9,7,turkey7,0.25,0.38,-9,1.0,4.0,2.63,9
Alanya 1221,8,2,0,6,8,11,-3,6,turkey7,0.25,0.25,-3,1.0,4.0,4.0,10
Bayburt,8,2,0,6,8,12,-4,6,turkey7,0.25,0.25,-4,1.0,4.0,4.0,10
K. Idmanyurdu,8,1,2,5,6,11,-5,5,turkey7,0.12,0.38,-5,0.75,8.33,2.63,11
Sebat G.,8,6,1,1,17,5,12,19,turkey8,0.75,0.88,12,2.12,1.33,1.14,1
Mardin BB,8,6,0,2,20,8,12,18,turkey8,0.75,0.75,12,2.5,1.33,1.33,2
K. Istiklalspor,8,5,3,0,18,6,12,18,turkey8,0.62,1.0,12,2.25,1.61,1.0,2
Orduspor 1967,8,5,2,1,19,5,14,17,turkey8,0.62,0.88,14,2.38,1.61,1.14,3
Kirikkale B.,8,4,3,1,12,6,6,15,turkey8,0.5,0.88,6,1.5,2.0,1.14,4
Agri 1970,8,4,3,1,9,7,2,15,turkey8,0.5,0.88,2,1.12,2.0,1.14,4
Nilufer B.,8,3,2,3,9,7,2,11,turkey8,0.38,0.62,2,1.12,2.63,1.61,5
Polatli B.,8,2,4,2,10,12,-2,10,turkey8,0.25,0.75,-2,1.25,4.0,1.33,6
Z. Komurspor,8,2,3,3,8,14,-6,9,turkey8,0.25,0.62,-6,1.0,4.0,1.61,7
Coruhlu,8,1,5,2,11,14,-3,8,turkey8,0.12,0.75,-3,1.38,8.33,1.33,8
Denizlispor,8,2,2,4,6,11,-5,8,turkey8,0.25,0.5,-5,0.75,4.0,2.0,8
Turgutluspor,8,1,3,4,10,14,-4,6,turkey8,0.12,0.5,-4,1.25,8.33,2.0,9
Nigde Belediyes,8,1,3,4,8,14,-6,6,turkey8,0.12,0.5,-6,1.0,8.33,2.0,9
Erciyes,8,1,2,5,5,11,-6,5,turkey8,0.12,0.38,-6,0.62,8.33,2.63,10
Tepecik,8,1,1,6,6,16,-10,4,turkey8,0.12,0.25,-10,0.75,8.33,4.0,11
Edirnespor,8,0,3,5,5,21,-16,3,turkey8,0.0,0.38,-16,0.62,0.0,2.63,12
Shabab Al Ahli,8,8,0,0,18,3,15,24,uae,1.0,1.0,15,2.25,1.0,1.0,1
Al Sharjah,8,5,1,2,7,3,4,16,uae,0.62,0.75,4,0.88,1.61,1.33,2
Ajman,8,5,0,3,18,15,3,15,uae,0.62,0.62,3,2.25,1.61,1.61,3
Al Wasl,8,4,2,2,13,6,7,14,uae,0.5,0.75,7,1.62,2.0,1.33,4
Al Wahda,8,4,1,3,15,11,4,13,uae,0.5,0.62,4,1.88,2.0,1.61,5
Khorfakkan,8,4,1,3,14,11,3,13,uae,0.5,0.62,3,1.75,2.0,1.61,5
Al Jazira,8,4,1,3,14,12,2,13,uae,0.5,0.62,2,1.75,2.0,1.61,5
Al Bataeh,8,3,2,3,8,10,-2,11,uae,0.38,0.62,-2,1.0,2.63,1.61,6
Bani Yas,8,3,2,3,7,12,-5,11,uae,0.38,0.62,-5,0.88,2.63,1.61,6
Al Ain,8,3,1,4,14,13,1,10,uae,0.38,0.5,1,1.75,2.63,2.0,7
Ittihad Kalba,8,2,2,4,9,12,-3,8,uae,0.25,0.5,-3,1.12,4.0,2.0,8
Al Nasr,8,2,1,5,9,15,-6,7,uae,0.25,0.38,-6,1.12,4.0,2.63,9
Dibba Al Hisn,8,1,1,6,7,16,-9,4,uae,0.12,0.25,-9,0.88,8.33,4.0,10
Al Urooba,8,0,0,8,6,22,-16,0,uae,0.0,0.0,-16,0.75,0.0,0.0,11
Dynamo Kyiv,8,5,3,0,13,4,9,18,ukraine,0.62,1.0,9,1.62,1.61,1.0,1
Shakhtar,8,5,2,1,18,5,13,17,ukraine,0.62,0.88,13,2.25,1.61,1.14,2
Livyi Bereh,8,4,2,2,8,4,4,14,ukraine,0.5,0.75,4,1.0,2.0,1.33,3
Kryvbas KR,8,4,2,2,11,9,2,14,ukraine,0.5,0.75,2,1.38,2.0,1.33,3
Zorya Luhansk,8,4,1,3,12,11,1,13,ukraine,0.5,0.62,1,1.5,2.0,1.61,4
Veres,8,4,1,3,10,11,-1,13,ukraine,0.5,0.62,-1,1.25,2.0,1.61,4
Obolon,8,3,3,2,7,5,2,12,ukraine,0.38,0.75,2,0.88,2.63,1.33,5
Polessya,8,3,3,2,8,7,1,12,ukraine,0.38,0.75,1,1.0,2.63,1.33,5
Oleksandria,8,3,3,2,8,9,-1,12,ukraine,0.38,0.75,-1,1.0,2.63,1.33,5
Rukh Lviv,8,3,2,3,6,8,-2,11,ukraine,0.38,0.62,-2,0.75,2.63,1.61,6
Karpaty Lviv,8,3,1,4,8,9,-1,10,ukraine,0.38,0.5,-1,1.0,2.63,2.0,7
Vorskla Poltava,8,2,2,4,5,9,-4,8,ukraine,0.25,0.5,-4,0.62,4.0,2.0,8
Inhulets,8,2,1,5,7,15,-8,7,ukraine,0.25,0.38,-8,0.88,4.0,2.63,9
Kolos Kovalivka,8,1,3,4,6,8,-2,6,ukraine,0.12,0.5,-2,0.75,8.33,2.0,10
LNZ Cherkasy,8,1,1,6,5,12,-7,4,ukraine,0.12,0.25,-7,0.62,8.33,4.0,11
Chornomorets,8,1,0,7,6,17,-11,3,ukraine,0.12,0.12,-11,0.75,8.33,8.33,12
Dnipro-1,0,0,0,0,0,0,0,0,ukraine,0.0,0.0,0,0.0,0.0,0.0,13
Defensor S.,5,4,0,1,7,2,5,12,uruguay,0.8,0.8,5,1.4,1.25,1.25,1
Liverpool M.,5,3,2,0,7,4,3,11,uruguay,0.6,1.0,3,1.4,1.67,1.0,2
Plaza Colonia,5,3,1,1,6,3,3,10,uruguay,0.6,0.8,3,1.2,1.67,1.25,3
Nacional,5,2,2,1,12,8,4,8,uruguay,0.4,0.8,4,2.4,2.5,1.25,4
Cerro Largo,4,2,2,0,8,4,4,8,uruguay,0.5,1.0,4,2.0,2.0,1.0,4
Juventud,5,2,2,1,7,6,1,8,uruguay,0.4,0.8,1,1.4,2.5,1.25,4
Montevideo City,5,2,2,1,5,5,0,8,uruguay,0.4,0.8,0,1.0,2.5,1.25,4
Cerro,5,2,1,2,5,5,0,7,uruguay,0.4,0.6,0,1.0,2.5,1.67,5
Penarol,4,1,3,0,6,4,2,6,uruguay,0.25,1.0,2,1.5,4.0,1.0,6
Danubio,4,0,4,0,4,4,0,4,uruguay,0.0,1.0,0,1.0,0.0,1.0,7
Racing CM,4,1,1,2,3,4,-1,4,uruguay,0.25,0.5,-1,0.75,4.0,2.0,7
River Plate,5,0,3,2,6,8,-2,3,uruguay,0.0,0.6,-2,1.2,0.0,1.67,8
Boston River,4,0,2,2,3,6,-3,2,uruguay,0.0,0.5,-3,0.75,0.0,2.0,9
Wanderers,4,0,2,2,1,4,-3,2,uruguay,0.0,0.5,-3,0.25,0.0,2.0,9
Progreso,4,0,1,3,4,13,-9,1,uruguay,0.0,0.25,-9,1.0,0.0,4.0,10
Miramar Misione,4,0,0,4,4,8,-4,0,uruguay,0.0,0.0,-4,1.0,0.0,0.0,11
Nacional,7,5,1,1,18,5,13,16,uruguay2,0.71,0.86,13,2.57,1.41,1.16,1
Penarol,7,4,2,1,10,5,5,14,uruguay2,0.57,0.86,5,1.43,1.75,1.16,2
Danubio,7,4,2,1,11,11,0,14,uruguay2,0.57,0.86,0,1.57,1.75,1.16,2
Wanderers,7,4,1,2,11,9,2,13,uruguay2,0.57,0.71,2,1.57,1.75,1.41,3
Defensor S.,7,3,2,2,7,5,2,11,uruguay2,0.43,0.71,2,1.0,2.33,1.41,4
Cerro Largo,7,3,2,2,6,7,-1,11,uruguay2,0.43,0.71,-1,0.86,2.33,1.41,4
Cerro,7,3,1,3,8,5,3,10,uruguay2,0.43,0.57,3,1.14,2.33,1.75,5
Fenix,7,3,1,3,10,9,1,10,uruguay2,0.43,0.57,1,1.43,2.33,1.75,5
Miramar Misione,7,3,1,3,7,10,-3,10,uruguay2,0.43,0.57,-3,1.0,2.33,1.75,5
River Plate,7,2,2,3,8,9,-1,8,uruguay2,0.29,0.57,-1,1.14,3.45,1.75,6
Progreso,7,2,2,3,8,11,-3,8,uruguay2,0.29,0.57,-3,1.14,3.45,1.75,6
Rampla Juniors,7,2,2,3,8,12,-4,8,uruguay2,0.29,0.57,-4,1.14,3.45,1.75,6
Boston River,7,2,1,4,6,8,-2,7,uruguay2,0.29,0.43,-2,0.86,3.45,2.33,7
Racing CM,7,1,3,3,8,10,-2,6,uruguay2,0.14,0.57,-2,1.14,7.14,1.75,8
D. Maldonado,7,1,3,3,5,9,-4,6,uruguay2,0.14,0.57,-4,0.71,7.14,1.75,8
Liverpool M.,7,1,0,6,4,10,-6,3,uruguay2,0.14,0.14,-6,0.57,7.14,7.14,9
Philadelphia,3,3,0,0,10,3,7,9,usa,1.0,1.0,7,3.33,1.0,1.0,1
Vancouver,3,3,0,0,8,2,6,9,usa,1.0,1.0,6,2.67,1.0,1.0,1
San Diego,3,2,1,0,5,1,4,7,usa,0.67,1.0,4,1.67,1.49,1.0,2
Columbus Crew,3,2,1,0,5,2,3,7,usa,0.67,1.0,3,1.67,1.49,1.0,2
SJ Earthquakes,3,2,0,1,6,2,4,6,usa,0.67,0.67,4,2.0,1.49,1.49,3
Los Angeles FC,2,2,0,0,2,0,2,6,usa,1.0,1.0,2,1.0,1.0,1.0,3
Minnesota Utd,3,2,0,1,2,1,1,6,usa,0.67,0.67,1,0.67,1.49,1.49,3
Cincinnati,3,2,0,1,4,4,0,6,usa,0.67,0.67,0,1.33,1.49,1.49,3
DC United,3,1,2,0,6,5,1,5,usa,0.33,1.0,1,2.0,3.03,1.0,4
Colorado Rapids,3,1,2,0,4,3,1,5,usa,0.33,1.0,1,1.33,3.03,1.0,4
Inter Miami,2,1,1,0,6,3,3,4,usa,0.5,1.0,3,3.0,2.0,1.0,5
Charlotte,2,1,1,0,4,2,2,4,usa,0.5,1.0,2,2.0,2.0,1.0,5
New York RB,3,1,1,1,2,1,1,4,usa,0.33,0.67,1,0.67,3.03,1.49,5
Chicago Fire,3,1,1,1,7,7,0,4,usa,0.33,0.67,0,2.33,3.03,1.49,5
New York City,3,1,1,1,4,4,0,4,usa,0.33,0.67,0,1.33,3.03,1.49,5
Nashville SC,3,1,1,1,2,2,0,4,usa,0.33,0.67,0,0.67,3.03,1.49,5
Dallas,3,1,1,1,6,7,-1,4,usa,0.33,0.67,-1,2.0,3.03,1.49,5
Atlanta Utd,3,1,1,1,3,4,-1,4,usa,0.33,0.67,-1,1.0,3.03,1.49,5
Orlando City,3,1,0,2,7,8,-1,3,usa,0.33,0.33,-1,2.33,3.03,3.03,6
Austin,3,1,0,2,1,2,-1,3,usa,0.33,0.33,-1,0.33,3.03,3.03,6
Real Salt Lake,3,1,0,2,3,7,-4,3,usa,0.33,0.33,-4,1.0,3.03,3.03,6
Portland,3,1,0,2,2,6,-4,3,usa,0.33,0.33,-4,0.67,3.03,3.03,6
St. Louis City,2,0,2,0,0,0,0,2,usa,0.0,1.0,0,0.0,0.0,1.0,7
Seattle,2,0,1,1,2,4,-2,1,usa,0.0,0.5,-2,1.0,0.0,2.0,8
New England,3,0,1,2,0,3,-3,1,usa,0.0,0.33,-3,0.0,0.0,3.03,8
Toronto,3,0,1,2,4,8,-4,1,usa,0.0,0.33,-4,1.33,0.0,3.03,8
Houston Dynamo,3,0,1,2,2,6,-4,1,usa,0.0,0.33,-4,0.67,0.0,3.03,8
Sporting KC,3,0,0,3,2,5,-3,0,usa,0.0,0.0,-3,0.67,0.0,0.0,9
LA Galaxy,2,0,0,2,1,4,-3,0,usa,0.0,0.0,-3,0.5,0.0,0.0,9
Orange County,1,1,0,0,4,2,2,3,usa2,1.0,1.0,2,4.0,1.0,1.0,1
Loudoun Utd,1,1,0,0,3,1,2,3,usa2,1.0,1.0,2,3.0,1.0,1.0,1
Detroit City,1,1,0,0,2,0,2,3,usa2,1.0,1.0,2,2.0,1.0,1.0,1
Lexington,1,1,0,0,2,0,2,3,usa2,1.0,1.0,2,2.0,1.0,1.0,1
Louisville City,1,1,0,0,2,1,1,3,usa2,1.0,1.0,1,2.0,1.0,1.0,1
Sacramento R.,1,1,0,0,2,1,1,3,usa2,1.0,1.0,1,2.0,1.0,1.0,1
FC Tulsa,1,1,0,0,1,0,1,3,usa2,1.0,1.0,1,1.0,1.0,1.0,1
Las Vegas L.,1,1,0,0,1,0,1,3,usa2,1.0,1.0,1,1.0,1.0,1.0,1
San Antonio,1,1,0,0,1,0,1,3,usa2,1.0,1.0,1,1.0,1.0,1.0,1
Colorado S.,1,0,1,0,2,2,0,1,usa2,0.0,1.0,0,2.0,0.0,1.0,2
El Paso,1,0,1,0,2,2,0,1,usa2,0.0,1.0,0,2.0,0.0,1.0,2
North Carolina,1,0,1,0,1,1,0,1,usa2,0.0,1.0,0,1.0,0.0,1.0,2
Pittsburgh,1,0,1,0,1,1,0,1,usa2,0.0,1.0,0,1.0,0.0,1.0,2
Indy Eleven,0,0,0,0,0,0,0,0,usa2,0.0,0.0,0,0.0,0.0,0.0,3
Rhode Island,0,0,0,0,0,0,0,0,usa2,0.0,0.0,0,0.0,0.0,0.0,3
Charleston,1,0,0,1,1,2,-1,0,usa2,0.0,0.0,-1,1.0,0.0,0.0,3
New Mexico,1,0,0,1,1,2,-1,0,usa2,0.0,0.0,-1,1.0,0.0,0.0,3
Monterey Bay,1,0,0,1,0,1,-1,0,usa2,0.0,0.0,-1,0.0,0.0,0.0,3
Phoenix Rising,1,0,0,1,0,1,-1,0,usa2,0.0,0.0,-1,0.0,0.0,0.0,3
Tampa Bay,1,0,0,1,0,1,-1,0,usa2,0.0,0.0,-1,0.0,0.0,0.0,3
Oakland Roots,1,0,0,1,2,4,-2,0,usa2,0.0,0.0,-2,2.0,0.0,0.0,3
Birmingham L.,1,0,0,1,1,3,-2,0,usa2,0.0,0.0,-2,1.0,0.0,0.0,3
Hartford A.,1,0,0,1,0,2,-2,0,usa2,0.0,0.0,-2,0.0,0.0,0.0,3
Miami FC,1,0,0,1,0,2,-2,0,usa2,0.0,0.0,-2,0.0,0.0,0.0,3
Richmond K.,1,1,0,0,4,2,2,3,usa3,1.0,1.0,2,4.0,1.0,1.0,1
Chattanooga RW,1,0,1,0,1,1,0,1,usa3,0.0,1.0,0,1.0,0.0,1.0,2
Greenville,1,0,1,0,1,1,0,1,usa3,0.0,1.0,0,1.0,0.0,1.0,2
Naples,1,0,1,0,1,1,0,1,usa3,0.0,1.0,0,1.0,0.0,1.0,2
Westchester SC,1,0,1,0,1,1,0,1,usa3,0.0,1.0,0,1.0,0.0,1.0,2
Alta,0,0,0,0,0,0,0,0,usa3,0.0,0.0,0,0.0,0.0,0.0,3
Charlotte I.,0,0,0,0,0,0,0,0,usa3,0.0,0.0,0,0.0,0.0,0.0,3
Forward Madison,0,0,0,0,0,0,0,0,usa3,0.0,0.0,0,0.0,0.0,0.0,3
One Knoxville,0,0,0,0,0,0,0,0,usa3,0.0,0.0,0,0.0,0.0,0.0,3
Portland Hearts,0,0,0,0,0,0,0,0,usa3,0.0,0.0,0,0.0,0.0,0.0,3
Spokane V.,0,0,0,0,0,0,0,0,usa3,0.0,0.0,0,0.0,0.0,0.0,3
Texoma,0,0,0,0,0,0,0,0,usa3,0.0,0.0,0,0.0,0.0,0.0,3
Union Omaha,0,0,0,0,0,0,0,0,usa3,0.0,0.0,0,0.0,0.0,0.0,3
Tormenta,1,0,0,1,2,4,-2,0,usa3,0.0,0.0,-2,2.0,0.0,0.0,3
D. La Guaira,6,3,3,0,10,5,5,12,venezuela,0.5,1.0,5,1.67,2.0,1.0,1
D. Tachira,6,3,2,1,6,2,4,11,venezuela,0.5,0.83,4,1.0,2.0,1.2,2
A. Anzoategui,7,3,2,2,11,8,3,11,venezuela,0.43,0.71,3,1.57,2.33,1.41,2
Carabobo,6,3,2,1,8,6,2,11,venezuela,0.5,0.83,2,1.33,2.0,1.2,2
UCV,6,3,2,1,7,5,2,11,venezuela,0.5,0.83,2,1.17,2.0,1.2,2
Portuguesa,6,3,1,2,5,3,2,10,venezuela,0.5,0.67,2,0.83,2.0,1.49,3
Puerto Cabello,6,3,0,3,8,6,2,9,venezuela,0.5,0.5,2,1.33,2.0,2.0,4
Caracas,6,2,2,2,3,3,0,8,venezuela,0.33,0.67,0,0.5,3.03,1.49,5
Rayo Zuliano,6,2,2,2,5,6,-1,8,venezuela,0.33,0.67,-1,0.83,3.03,1.49,5
E. Merida,7,2,1,4,8,10,-2,7,venezuela,0.29,0.43,-2,1.14,3.45,2.33,6
Metropolitanos,6,2,1,3,7,9,-2,7,venezuela,0.33,0.5,-2,1.17,3.03,2.0,6
Zamora,6,1,2,3,5,8,-3,5,venezuela,0.17,0.5,-3,0.83,5.88,2.0,7
Monagas,6,1,1,4,4,11,-7,4,venezuela,0.17,0.33,-7,0.67,5.88,3.03,8
Yaracuyanos,6,0,3,3,5,10,-5,3,venezuela,0.0,0.5,-5,0.83,0.0,2.0,9
AGMK,1,1,0,0,2,1,1,3,uzbekistan,1.0,1.0,1,2.0,1.0,1.0,1
Andijan,0,0,0,0,0,0,0,0,uzbekistan,0.0,0.0,0,0.0,0.0,0.0,2
Bunyodkor,0,0,0,0,0,0,0,0,uzbekistan,0.0,0.0,0,0.0,0.0,0.0,2
D. Samarqand,0,0,0,0,0,0,0,0,uzbekistan,0.0,0.0,0,0.0,0.0,0.0,2
Kokand-1912,0,0,0,0,0,0,0,0,uzbekistan,0.0,0.0,0,0.0,0.0,0.0,2
Mashal,0,0,0,0,0,0,0,0,uzbekistan,0.0,0.0,0,0.0,0.0,0.0,2
Nasaf Qarshi,0,0,0,0,0,0,0,0,uzbekistan,0.0,0.0,0,0.0,0.0,0.0,2
Navbahor,0,0,0,0,0,0,0,0,uzbekistan,0.0,0.0,0,0.0,0.0,0.0,2
Neftchi,0,0,0,0,0,0,0,0,uzbekistan,0.0,0.0,0,0.0,0.0,0.0,2
Pakhtakor,0,0,0,0,0,0,0,0,uzbekistan,0.0,0.0,0,0.0,0.0,0.0,2
Qizilqum,0,0,0,0,0,0,0,0,uzbekistan,0.0,0.0,0,0.0,0.0,0.0,2
Shurtan,0,0,0,0,0,0,0,0,uzbekistan,0.0,0.0,0,0.0,0.0,0.0,2
Sogdiana,0,0,0,0,0,0,0,0,uzbekistan,0.0,0.0,0,0.0,0.0,0.0,2
Termez Surkhon,0,0,0,0,0,0,0,0,uzbekistan,0.0,0.0,0,0.0,0.0,0.0,2
Xorazm,0,0,0,0,0,0,0,0,uzbekistan,0.0,0.0,0,0.0,0.0,0.0,2
Buxoro,1,0,0,1,1,2,-1,0,uzbekistan,0.0,0.0,-1,1.0,0.0,0.0,2
Nam Dinh,8,5,2,1,17,5,12,17,vietnam,0.62,0.88,12,2.12,1.61,1.14,1
Ha Noi,8,4,2,2,14,7,7,14,vietnam,0.5,0.75,7,1.75,2.0,1.33,2
Viettel,8,4,1,3,13,9,4,13,vietnam,0.5,0.62,4,1.62,2.0,1.61,3
Hai Phong,8,4,1,3,8,5,3,13,vietnam,0.5,0.62,3,1.0,2.0,1.61,3
Ho Chi Minh,8,3,4,1,10,9,1,13,vietnam,0.38,0.88,1,1.25,2.63,1.14,3
Binh Duong,8,4,1,3,10,11,-1,13,vietnam,0.5,0.62,-1,1.25,2.0,1.61,3
Thanh Hoa,8,2,5,1,8,7,1,11,vietnam,0.25,0.88,1,1.0,4.0,1.14,4
Cong An Nhan,8,2,4,2,13,11,2,10,vietnam,0.25,0.75,2,1.62,4.0,1.33,5
Quang Nam,8,2,4,2,11,11,0,10,vietnam,0.25,0.75,0,1.38,4.0,1.33,5
Song Lam Nghe,8,2,3,3,6,13,-7,9,vietnam,0.25,0.62,-7,0.75,4.0,1.61,6
Hong Linh Ha T.,8,0,7,1,6,7,-1,7,vietnam,0.0,0.88,-1,0.75,0.0,1.14,7
Binh Dinh,8,1,2,5,5,12,-7,5,vietnam,0.12,0.38,-7,0.62,8.33,2.63,8
Gia Lai,8,1,2,5,5,12,-7,5,vietnam,0.12,0.38,-7,0.62,8.33,2.63,8
Da Nang,8,1,2,5,6,15,-9,5,vietnam,0.12,0.38,-9,0.75,8.33,2.63,8
Phu Dong,8,8,0,0,15,1,14,24,vietnam2,1.0,1.0,14,1.88,1.0,1.0,1
Binh Phuoc,8,5,2,1,13,7,6,17,vietnam2,0.62,0.88,6,1.62,1.61,1.14,2
PVF-CAND,8,4,2,2,8,8,0,14,vietnam2,0.5,0.75,0,1.0,2.0,1.33,3
Ba Ria Vung Tau,8,4,1,3,9,9,0,13,vietnam2,0.5,0.62,0,1.12,2.0,1.61,4
S. Khanh Hoa,8,2,4,2,8,8,0,10,vietnam2,0.25,0.75,0,1.0,4.0,1.33,5
Long An,8,2,4,2,5,5,0,10,vietnam2,0.25,0.75,0,0.62,4.0,1.33,5
Ho Chi Minh B,8,2,3,3,7,10,-3,9,vietnam2,0.25,0.62,-3,0.88,4.0,1.61,6
Hoa Binh,8,1,4,3,2,5,-3,7,vietnam2,0.12,0.62,-3,0.25,8.33,1.61,7
Dong Nai,8,0,6,2,1,3,-2,6,vietnam2,0.0,0.75,-2,0.12,0.0,1.33,8
Dong Thap,8,1,3,4,2,5,-3,6,vietnam2,0.12,0.5,-3,0.25,8.33,2.0,8
Hue,8,1,1,6,7,15,-8,4,vietnam2,0.12,0.25,-8,0.88,8.33,4.0,9
The New Saints,8,8,0,0,21,4,17,24,wales,1.0,1.0,17,2.62,1.0,1.0,1
Haverfordwest,8,4,3,1,13,10,3,15,wales,0.5,0.88,3,1.62,2.0,1.14,2
Caernarfon,8,4,1,3,16,14,2,13,wales,0.5,0.62,2,2.0,2.0,1.61,3
Flint,8,4,1,3,14,17,-3,13,wales,0.5,0.62,-3,1.75,2.0,1.61,3
Barry,8,3,3,2,12,11,1,12,wales,0.38,0.75,1,1.5,2.63,1.33,4
Penybont,8,3,2,3,11,14,-3,11,wales,0.38,0.62,-3,1.38,2.63,1.61,5
Cardiff MU,8,3,1,4,12,15,-3,10,wales,0.38,0.5,-3,1.5,2.63,2.0,6
Connahs Quay,8,3,0,5,8,8,0,9,wales,0.38,0.38,0,1.0,2.63,2.63,7
Briton Ferry,8,2,2,4,16,18,-2,8,wales,0.25,0.5,-2,2.0,4.0,2.0,8
Newtown,8,1,3,4,8,12,-4,6,wales,0.12,0.5,-4,1.0,8.33,2.0,9
Bala Town,8,1,1,6,8,15,-7,4,wales,0.12,0.25,-7,1.0,8.33,4.0,10
Aberystwyth,8,1,1,6,5,17,-12,4,wales,0.12,0.25,-12,0.62,8.33,4.0,10
