Equipe,GP,W,D,L,GF,GA,GD,Pts_Overall,Liga,PIO,PIO_HA,GD_Overall,GF_AVG_Overall,PPG_Overall,Odd_Justa_MO,Odd_Justa_HA,Rank_Overall
Skenderbeu K.,8,4,1,3,11,6,5,13,Albania - Abissnet Superiore,0.5,0.62,5,1.38,1.62,2.0,1.61,1
Egnatia R.,8,3,4,1,11,7,4,13,Albania - Abissnet Superiore,0.38,0.88,4,1.38,1.62,2.63,1.14,1
AF Elbasani,8,2,5,1,7,5,2,11,Albania - Abissnet Superiore,0.25,0.88,2,0.88,1.38,4.0,1.14,2
KF Tirana,8,2,4,2,11,11,0,10,Albania - Abissnet Superiore,0.25,0.75,0,1.38,1.25,4.0,1.33,3
Teuta Durres,8,2,4,2,4,6,-2,10,Albania - Abissnet Superiore,0.25,0.75,-2,0.5,1.25,4.0,1.33,3
Vllaznia S.,8,1,6,1,8,7,1,9,Albania - Abissnet Superiore,0.12,0.88,1,1.0,1.12,8.33,1.14,4
Bylis,8,2,3,3,8,14,-6,9,Albania - Abissnet Superiore,0.25,0.62,-6,1.0,1.12,4.0,1.61,4
Partizani T.,8,2,1,5,5,11,-6,7,Albania - Abissnet Superiore,0.25,0.38,-6,0.62,0.88,4.0,2.63,5
Laci,8,1,3,4,7,11,-4,6,Albania - Abissnet Superiore,0.12,0.5,-4,0.88,0.75,8.33,2.0,6
MC Alger,8,6,2,0,17,7,10,20,Algeria - Ligue 1,0.75,1.0,10,2.12,2.5,1.33,1.0,1
JS Saoura,8,5,0,3,11,6,5,15,Algeria - Ligue 1,0.62,0.62,5,1.38,1.88,1.61,1.61,2
El Bayadh,8,4,3,1,6,3,3,15,Algeria - Ligue 1,0.5,0.88,3,0.75,1.88,2.0,1.14,2
CR Belouizdad,8,4,2,2,10,6,4,14,Algeria - Ligue 1,0.5,0.75,4,1.25,1.75,2.0,1.33,3
USM Alger,8,3,4,1,9,4,5,13,Algeria - Ligue 1,0.38,0.88,5,1.12,1.62,2.63,1.14,4
ASO Chlef,8,3,4,1,9,6,3,13,Algeria - Ligue 1,0.38,0.88,3,1.12,1.62,2.63,1.14,4
JS Kabylie,8,3,3,2,10,9,1,12,Algeria - Ligue 1,0.38,0.75,1,1.25,1.5,2.63,1.33,5
Paradou AC,8,3,1,4,10,12,-2,10,Algeria - Ligue 1,0.38,0.5,-2,1.25,1.25,2.63,2.0,6
ES Setif,8,2,3,3,4,5,-1,9,Algeria - Ligue 1,0.25,0.62,-1,0.5,1.12,4.0,1.61,7
Mostaganem,8,2,2,4,5,7,-2,8,Algeria - Ligue 1,0.25,0.5,-2,0.62,1.0,4.0,2.0,8
Khenchela,8,2,2,4,8,16,-8,8,Algeria - Ligue 1,0.25,0.5,-8,1.0,1.0,4.0,2.0,8
Biskra,8,1,4,3,2,6,-4,7,Algeria - Ligue 1,0.12,0.62,-4,0.25,0.88,8.33,1.61,9
CS Constantine,8,1,3,4,6,10,-4,6,Algeria - Ligue 1,0.12,0.5,-4,0.75,0.75,8.33,2.0,10
NC Magra,8,0,5,3,3,7,-4,5,Algeria - Ligue 1,0.0,0.62,-4,0.38,0.62,0.0,1.61,11
O. Akbou,8,0,4,4,3,7,-4,4,Algeria - Ligue 1,0.0,0.5,-4,0.38,0.5,0.0,2.0,12
MC Oran,8,1,0,7,3,13,-10,3,Algeria - Ligue 1,0.12,0.12,-10,0.38,0.38,8.33,8.33,13
Huracan,8,6,2,0,11,1,10,20,Argentina - Liga Profesional,0.75,1.0,10,1.38,2.5,1.33,1.0,1
Boca Juniors,8,6,0,2,13,5,8,18,Argentina - Liga Profesional,0.75,0.75,8,1.62,2.25,1.33,1.33,2
Tigre,8,6,0,2,13,7,6,18,Argentina - Liga Profesional,0.75,0.75,6,1.62,2.25,1.33,1.33,2
Independiente,8,4,3,1,13,5,8,15,Argentina - Liga Profesional,0.5,0.88,8,1.62,1.88,2.0,1.14,3
Rosario Central,8,4,3,1,10,6,4,15,Argentina - Liga Profesional,0.5,0.88,4,1.25,1.88,2.0,1.14,3
River Plate,8,4,3,1,8,4,4,15,Argentina - Liga Profesional,0.5,0.88,4,1.0,1.88,2.0,1.14,3
Argentinos Jrs,8,4,3,1,10,7,3,15,Argentina - Liga Profesional,0.5,0.88,3,1.25,1.88,2.0,1.14,3
Barracas C.,8,3,4,1,14,10,4,13,Argentina - Liga Profesional,0.38,0.88,4,1.75,1.62,2.63,1.14,4
Central Cordoba,8,3,3,2,14,11,3,12,Argentina - Liga Profesional,0.38,0.75,3,1.75,1.5,2.63,1.33,5
Gimnasia,8,3,3,2,7,4,3,12,Argentina - Liga Profesional,0.38,0.75,3,0.88,1.5,2.63,1.33,5
Estudiantes,8,3,3,2,12,10,2,12,Argentina - Liga Profesional,0.38,0.75,2,1.5,1.5,2.63,1.33,5
Platense,8,3,3,2,8,6,2,12,Argentina - Liga Profesional,0.38,0.75,2,1.0,1.5,2.63,1.33,5
San Lorenzo,8,3,3,2,8,8,0,12,Argentina - Liga Profesional,0.38,0.75,0,1.0,1.5,2.63,1.33,5
Lanus,8,2,5,1,7,4,3,11,Argentina - Liga Profesional,0.25,0.88,3,0.88,1.38,4.0,1.14,6
Godoy Cruz,8,2,5,1,6,7,-1,11,Argentina - Liga Profesional,0.25,0.88,-1,0.75,1.38,4.0,1.14,6
Defensa y J.,8,3,2,3,6,10,-4,11,Argentina - Liga Profesional,0.38,0.62,-4,0.75,1.38,2.63,1.61,6
Belgrano,8,2,4,2,8,10,-2,10,Argentina - Liga Profesional,0.25,0.75,-2,1.0,1.25,4.0,1.33,7
D. Riestra,8,1,6,1,4,4,0,9,Argentina - Liga Profesional,0.12,0.88,0,0.5,1.12,8.33,1.14,8
T. de Cordoba,8,1,6,1,4,4,0,9,Argentina - Liga Profesional,0.12,0.88,0,0.5,1.12,8.33,1.14,8
I. Rivadavia,8,2,3,3,8,12,-4,9,Argentina - Liga Profesional,0.25,0.62,-4,1.0,1.12,4.0,1.61,8
Newells,8,2,2,4,6,9,-3,8,Argentina - Liga Profesional,0.25,0.5,-3,0.75,1.0,4.0,2.0,9
Aldosivi,8,2,2,4,10,14,-4,8,Argentina - Liga Profesional,0.25,0.5,-4,1.25,1.0,4.0,2.0,9
Sarmiento,8,1,5,2,6,11,-5,8,Argentina - Liga Profesional,0.12,0.75,-5,0.75,1.0,8.33,1.33,9
Velez Sarsfield,8,2,2,4,3,9,-6,8,Argentina - Liga Profesional,0.25,0.5,-6,0.38,1.0,4.0,2.0,9
Racing Club,8,2,1,5,9,11,-2,7,Argentina - Liga Profesional,0.25,0.38,-2,1.12,0.88,4.0,2.63,10
Union Santa Fe,8,2,1,5,5,8,-3,7,Argentina - Liga Profesional,0.25,0.38,-3,0.62,0.88,4.0,2.63,10
Instituto,8,1,2,5,3,11,-8,5,Argentina - Liga Profesional,0.12,0.38,-8,0.38,0.62,8.33,2.63,11
A. Tucuman,8,1,1,6,10,12,-2,4,Argentina - Liga Profesional,0.12,0.25,-2,1.25,0.5,8.33,4.0,12
SM San Juan,8,1,1,6,4,10,-6,4,Argentina - Liga Profesional,0.12,0.25,-6,0.5,0.5,8.33,4.0,12
G. Mendoza,8,4,4,0,9,3,6,16,Argentina - Primera Nacional,0.5,1.0,6,1.12,2.0,2.0,1.0,1
SM Tucuman,8,4,4,0,6,2,4,16,Argentina - Primera Nacional,0.5,1.0,4,0.75,2.0,2.0,1.0,1
Gimnasia Jujuy,8,4,3,1,8,2,6,15,Argentina - Primera Nacional,0.5,0.88,6,1.0,1.88,2.0,1.14,2
E. Rio Cuarto,8,4,3,1,11,6,5,15,Argentina - Primera Nacional,0.5,0.88,5,1.38,1.88,2.0,1.14,2
CA Estudiantes,8,4,2,2,10,7,3,14,Argentina - Primera Nacional,0.5,0.75,3,1.25,1.75,2.0,1.33,3
Colon Santa Fe,8,4,2,2,8,6,2,14,Argentina - Primera Nacional,0.5,0.75,2,1.0,1.75,2.0,1.33,3
Racing Cordoba,8,4,2,2,10,9,1,14,Argentina - Primera Nacional,0.5,0.75,1,1.25,1.75,2.0,1.33,3
Chaco For Ever,8,4,1,3,8,5,3,13,Argentina - Primera Nacional,0.5,0.62,3,1.0,1.62,2.0,1.61,4
Atlanta,7,3,4,0,6,3,3,13,Argentina - Primera Nacional,0.43,1.0,3,0.86,1.86,2.33,1.0,4
Los Andes,8,3,3,2,10,8,2,12,Argentina - Primera Nacional,0.38,0.75,2,1.25,1.5,2.63,1.33,5
Chacarita J.,8,3,3,2,8,6,2,12,Argentina - Primera Nacional,0.38,0.75,2,1.0,1.5,2.63,1.33,5
Quilmes,7,3,3,1,7,5,2,12,Argentina - Primera Nacional,0.43,0.86,2,1.0,1.71,2.33,1.16,5
Ferro Carril,8,3,3,2,5,3,2,12,Argentina - Primera Nacional,0.38,0.75,2,0.62,1.5,2.63,1.33,5
Tristan Suarez,8,3,3,2,7,6,1,12,Argentina - Primera Nacional,0.38,0.75,1,0.88,1.5,2.63,1.33,5
Gimnasia y Tiro,8,3,3,2,6,5,1,12,Argentina - Primera Nacional,0.38,0.75,1,0.75,1.5,2.63,1.33,5
San Telmo,8,3,3,2,8,8,0,12,Argentina - Primera Nacional,0.38,0.75,0,1.0,1.5,2.63,1.33,5
D. de Belgrano,8,2,5,1,6,3,3,11,Argentina - Primera Nacional,0.25,0.88,3,0.75,1.38,4.0,1.14,6
San Miguel,8,3,2,3,9,7,2,11,Argentina - Primera Nacional,0.38,0.62,2,1.12,1.38,2.63,1.61,6
Deportivo Maipu,8,3,2,3,8,8,0,11,Argentina - Primera Nacional,0.38,0.62,0,1.0,1.38,2.63,1.61,6
D. Madryn,8,3,2,3,6,6,0,11,Argentina - Primera Nacional,0.38,0.62,0,0.75,1.38,2.63,1.61,6
Deportivo Moron,8,2,4,2,6,5,1,10,Argentina - Primera Nacional,0.25,0.75,1,0.75,1.25,4.0,1.33,7
Agropecuario,8,3,1,4,8,8,0,10,Argentina - Primera Nacional,0.38,0.5,0,1.0,1.25,2.63,2.0,7
Atletico Mitre,8,3,1,4,5,6,-1,10,Argentina - Primera Nacional,0.38,0.5,-1,0.62,1.25,2.63,2.0,7
Temperley,8,3,1,4,5,8,-3,10,Argentina - Primera Nacional,0.38,0.5,-3,0.62,1.25,2.63,2.0,7
All Boys,8,2,3,3,7,6,1,9,Argentina - Primera Nacional,0.25,0.62,1,0.88,1.12,4.0,1.61,8
Almagro,8,2,3,3,7,9,-2,9,Argentina - Primera Nacional,0.25,0.62,-2,0.88,1.12,4.0,1.61,8
Alvarado,8,1,5,2,5,6,-1,8,Argentina - Primera Nacional,0.12,0.75,-1,0.62,1.0,8.33,1.33,9
Central Norte,8,2,2,4,5,9,-4,8,Argentina - Primera Nacional,0.25,0.5,-4,0.62,1.0,4.0,2.0,9
Patronato,8,1,4,3,6,9,-3,7,Argentina - Primera Nacional,0.12,0.62,-3,0.75,0.88,8.33,1.61,10
Argentino Merlo,8,6,1,1,15,6,9,19,Argentina - Primera B,0.75,0.88,9,1.88,2.38,1.33,1.14,1
A. Quilmes,8,5,2,1,12,4,8,17,Argentina - Primera B,0.62,0.88,8,1.5,2.12,1.61,1.14,2
Comunicaciones,8,5,2,1,12,6,6,17,Argentina - Primera B,0.62,0.88,6,1.5,2.12,1.61,1.14,2
Villa Dalmine,8,5,2,1,7,2,5,17,Argentina - Primera B,0.62,0.88,5,0.88,2.12,1.61,1.14,2
Deportivo Merlo,8,4,3,1,8,4,4,15,Argentina - Primera B,0.5,0.88,4,1.0,1.88,2.0,1.14,3
Excursionistas,8,4,2,2,16,9,7,14,Argentina - Primera B,0.5,0.75,7,2.0,1.75,2.0,1.33,4
D. Armenio,8,4,1,3,13,8,5,13,Argentina - Primera B,0.5,0.62,5,1.62,1.62,2.0,1.61,5
Colegiales,8,4,1,3,9,7,2,13,Argentina - Primera B,0.5,0.62,2,1.12,1.62,2.0,1.61,5
Midland,8,3,3,2,10,7,3,12,Argentina - Primera B,0.38,0.75,3,1.25,1.5,2.63,1.33,6
Sacachispas,8,3,2,3,4,6,-2,11,Argentina - Primera B,0.38,0.62,-2,0.5,1.38,2.63,1.61,7
Liniers,8,2,4,2,5,5,0,10,Argentina - Primera B,0.25,0.75,0,0.62,1.25,4.0,1.33,8
S. Italiano,8,2,3,3,9,9,0,9,Argentina - Primera B,0.25,0.62,0,1.12,1.12,4.0,1.61,9
Flandria,8,2,3,3,7,9,-2,9,Argentina - Primera B,0.25,0.62,-2,0.88,1.12,4.0,1.61,9
SM Burzaco,8,3,0,5,5,9,-4,9,Argentina - Primera B,0.38,0.38,-4,0.62,1.12,2.63,2.63,9
Dock Sud,8,2,2,4,5,8,-3,8,Argentina - Primera B,0.25,0.5,-3,0.62,1.0,4.0,2.0,10
Los Andes,8,2,2,4,5,9,-4,8,Argentina - Primera B,0.25,0.5,-4,0.62,1.0,4.0,2.0,10
Acassuso,8,2,2,4,5,12,-7,8,Argentina - Primera B,0.25,0.5,-7,0.62,1.0,4.0,2.0,10
UAI Urquiza,8,2,2,4,10,18,-8,8,Argentina - Primera B,0.25,0.5,-8,1.25,1.0,4.0,2.0,10
V. San Carlos,8,2,1,5,5,9,-4,7,Argentina - Primera B,0.25,0.38,-4,0.62,0.88,4.0,2.63,11
D. Laferrere,8,1,4,3,4,9,-5,7,Argentina - Primera B,0.12,0.62,-5,0.5,0.88,8.33,1.61,11
Canuelas,8,2,0,6,6,11,-5,6,Argentina - Primera B,0.25,0.25,-5,0.75,0.75,4.0,4.0,12
Fenix,8,1,1,6,5,12,-7,4,Argentina - Primera B,0.12,0.25,-7,0.62,0.5,8.33,4.0,13
D. Rincon,3,3,0,0,4,0,4,9,Argentina - Torneo Federal,1.0,1.0,4,1.33,3.0,1.0,1.0,1
Circulo D.,3,2,1,0,8,4,4,7,Argentina - Torneo Federal,0.67,1.0,4,2.67,2.33,1.49,1.0,2
G. Chivilcoy,3,2,1,0,3,1,2,7,Argentina - Torneo Federal,0.67,1.0,2,1.0,2.33,1.49,1.0,2
Sarmiento DLB,3,2,0,1,7,3,4,6,Argentina - Torneo Federal,0.67,0.67,4,2.33,2.0,1.49,1.49,3
SM Formosa,2,2,0,0,4,0,4,6,Argentina - Torneo Federal,1.0,1.0,4,2.0,3.0,1.0,1.0,3
S. Las Parejas,3,2,0,1,6,3,3,6,Argentina - Torneo Federal,0.67,0.67,3,2.0,2.0,1.49,1.49,3
Bartolom√© Mitre,3,2,0,1,4,2,2,6,Argentina - Torneo Federal,0.67,0.67,2,1.33,2.0,1.49,1.49,3
Huracan Las H.,3,2,0,1,4,4,0,6,Argentina - Torneo Federal,0.67,0.67,0,1.33,2.0,1.49,1.49,3
Costa Brava,3,1,2,0,4,1,3,5,Argentina - Torneo Federal,0.33,1.0,3,1.33,1.67,3.03,1.0,4
S. Belgrano,3,1,2,0,4,1,3,5,Argentina - Torneo Federal,0.33,1.0,3,1.33,1.67,3.03,1.0,4
Villa Mitre,3,1,2,0,3,1,2,5,Argentina - Torneo Federal,0.33,1.0,2,1.0,1.67,3.03,1.0,4
Douglas Haig,3,1,2,0,3,2,1,5,Argentina - Torneo Federal,0.33,1.0,1,1.0,1.67,3.03,1.0,4
Sol de America,2,1,1,0,5,3,2,4,Argentina - Torneo Federal,0.5,1.0,2,2.5,2.0,2.0,1.0,5
Ciudad Bolivar,2,1,1,0,3,1,2,4,Argentina - Torneo Federal,0.5,1.0,2,1.5,2.0,2.0,1.0,5
Juventud U. U.,2,1,1,0,2,1,1,4,Argentina - Torneo Federal,0.5,1.0,1,1.0,2.0,2.0,1.0,5
Olimpo Bahia B.,2,1,1,0,1,0,1,4,Argentina - Torneo Federal,0.5,1.0,1,0.5,2.0,2.0,1.0,5
SM Mendoza,3,1,1,1,5,5,0,4,Argentina - Torneo Federal,0.33,0.67,0,1.67,1.33,3.03,1.49,5
Argentino MM,3,1,1,1,3,3,0,4,Argentina - Torneo Federal,0.33,0.67,0,1.0,1.33,3.03,1.49,5
J. Antoniana,3,1,1,1,3,3,0,4,Argentina - Torneo Federal,0.33,0.67,0,1.0,1.33,3.03,1.49,5
9 Julio Rafaela,3,1,1,1,3,4,-1,4,Argentina - Torneo Federal,0.33,0.67,-1,1.0,1.33,3.03,1.49,5
Gimnasia E.,3,1,1,1,1,2,-1,4,Argentina - Torneo Federal,0.33,0.67,-1,0.33,1.33,3.03,1.49,5
Cipolletti,3,1,0,2,6,4,2,3,Argentina - Torneo Federal,0.33,0.33,2,2.0,1.0,3.03,3.03,6
Gutierrez,2,1,0,1,5,5,0,3,Argentina - Torneo Federal,0.5,0.5,0,2.5,1.5,2.0,2.0,6
D. Belgrano VR,3,0,3,0,1,1,0,3,Argentina - Torneo Federal,0.0,1.0,0,0.33,1.0,0.0,1.0,6
Sol de Mayo,2,1,0,1,3,4,-1,3,Argentina - Torneo Federal,0.5,0.5,-1,1.5,1.5,2.0,2.0,6
Kimberley,3,1,0,2,1,2,-1,3,Argentina - Torneo Federal,0.33,0.33,-1,0.33,1.0,3.03,3.03,6
A. Rafaela,3,1,0,2,4,6,-2,3,Argentina - Torneo Federal,0.33,0.33,-2,1.33,1.0,3.03,3.03,6
Sarmiento R.,3,1,0,2,3,5,-2,3,Argentina - Torneo Federal,0.33,0.33,-2,1.0,1.0,3.03,3.03,6
Crucero del N.,3,1,0,2,5,9,-4,3,Argentina - Torneo Federal,0.33,0.33,-4,1.67,1.0,3.03,3.03,6
Noah,8,8,0,0,32,4,28,24,Armenia - Premier League,1.0,1.0,28,4.0,3.0,1.0,1.0,1
Urartu,8,6,0,2,18,9,9,18,Armenia - Premier League,0.75,0.75,9,2.25,2.25,1.33,1.33,2
Van,8,4,3,1,14,8,6,15,Armenia - Premier League,0.5,0.88,6,1.75,1.88,2.0,1.14,3
Ararat-Armenia,8,4,2,2,16,10,6,14,Armenia - Premier League,0.5,0.75,6,2.0,1.75,2.0,1.33,4
BKMA,8,3,3,2,12,10,2,12,Armenia - Premier League,0.38,0.75,2,1.5,1.5,2.63,1.33,5
Pyunik,8,3,0,5,13,13,0,9,Armenia - Premier League,0.38,0.38,0,1.62,1.12,2.63,2.63,6
Shirak,8,2,2,4,5,14,-9,8,Armenia - Premier League,0.25,0.5,-9,0.62,1.0,4.0,2.0,7
Ararat Yerevan,8,1,4,3,6,14,-8,7,Armenia - Premier League,0.12,0.62,-8,0.75,0.88,8.33,1.61,8
West Armenia,8,2,0,6,5,23,-18,6,Armenia - Premier League,0.25,0.25,-18,0.62,0.75,4.0,4.0,9
Alashkert,8,0,3,5,5,16,-11,3,Armenia - Premier League,0.0,0.38,-11,0.62,0.38,0.0,2.63,10
Gandzasar,8,0,1,7,3,23,-20,1,Armenia - Premier League,0.0,0.12,-20,0.38,0.12,0.0,8.33,11
Auckland,8,5,3,0,20,9,11,18,Australia - A-League,0.62,1.0,11,2.5,2.25,1.61,1.0,1
Western United,8,5,2,1,23,11,12,17,Australia - A-League,0.62,0.88,12,2.88,2.12,1.61,1.14,2
WS Wanderers,8,5,2,1,20,10,10,17,Australia - A-League,0.62,0.88,10,2.5,2.12,1.61,1.14,2
Newcastle Jets,8,4,3,1,17,14,3,15,Australia - A-League,0.5,0.88,3,2.12,1.88,2.0,1.14,3
Melbourne V.,8,4,2,2,16,13,3,14,Australia - A-League,0.5,0.75,3,2.0,1.75,2.0,1.33,4
Melbourne City,8,4,1,3,9,7,2,13,Australia - A-League,0.5,0.62,2,1.12,1.62,2.0,1.61,5
Sydney FC,8,2,3,3,15,14,1,9,Australia - A-League,0.25,0.62,1,1.88,1.12,4.0,1.61,6
Brisbane Roar,8,2,3,3,11,13,-2,9,Australia - A-League,0.25,0.62,-2,1.38,1.12,4.0,1.61,6
Macarthur FC,8,2,2,4,13,17,-4,8,Australia - A-League,0.25,0.5,-4,1.62,1.0,4.0,2.0,7
Central Coast,8,1,4,3,11,18,-7,7,Australia - A-League,0.12,0.62,-7,1.38,0.88,8.33,1.61,8
Adelaide Utd,8,1,2,5,15,24,-9,5,Australia - A-League,0.12,0.38,-9,1.88,0.62,8.33,2.63,9
Wellington,8,0,4,4,6,16,-10,4,Australia - A-League,0.0,0.5,-10,0.75,0.5,0.0,2.0,10
Perth Glory,8,0,3,5,6,16,-10,3,Australia - A-League,0.0,0.38,-10,0.75,0.38,0.0,2.63,11
Avondale,8,7,0,1,23,8,15,21,Australia - NPL Victoria,0.88,0.88,15,2.88,2.62,1.14,1.14,1
Oakleigh C.,8,5,1,2,17,8,9,16,Australia - NPL Victoria,0.62,0.75,9,2.12,2.0,1.61,1.33,2
Heidelberg Utd,8,5,1,2,18,10,8,16,Australia - NPL Victoria,0.62,0.75,8,2.25,2.0,1.61,1.33,2
Dandenong T.,8,5,1,2,13,11,2,16,Australia - NPL Victoria,0.62,0.75,2,1.62,2.0,1.61,1.33,2
Preston Lions,8,3,2,3,13,13,0,11,Australia - NPL Victoria,0.38,0.62,0,1.62,1.38,2.63,1.61,3
Hume City,8,3,2,3,11,13,-2,11,Australia - NPL Victoria,0.38,0.62,-2,1.38,1.38,2.63,1.61,3
St. Albans,8,3,1,4,15,15,0,10,Australia - NPL Victoria,0.38,0.5,0,1.88,1.25,2.63,2.0,4
Green Gully,8,2,3,3,8,11,-3,9,Australia - NPL Victoria,0.25,0.62,-3,1.0,1.12,4.0,1.61,5
Melbourne K.,8,3,0,5,12,17,-5,9,Australia - NPL Victoria,0.38,0.38,-5,1.5,1.12,2.63,2.63,5
South Melbourne,7,2,2,3,8,11,-3,8,Australia - NPL Victoria,0.29,0.57,-3,1.14,1.14,3.45,1.75,6
M. Victory B,8,2,2,4,11,15,-4,8,Australia - NPL Victoria,0.25,0.5,-4,1.38,1.0,4.0,2.0,6
Dandenong City,7,1,4,2,13,12,1,7,Australia - NPL Victoria,0.14,0.71,1,1.86,1.0,7.14,1.41,7
Altona Magic,8,1,3,4,4,9,-5,6,Australia - NPL Victoria,0.12,0.5,-5,0.5,0.75,8.33,2.0,8
Port Melbourne,8,2,0,6,5,18,-13,6,Australia - NPL Victoria,0.25,0.25,-13,0.62,0.75,4.0,4.0,8
Gold C. Knights,3,3,0,0,6,1,5,9,Australia - NPL Queensland,1.0,1.0,5,2.0,3.0,1.0,1.0,1
Moreton City E.,3,3,0,0,7,3,4,9,Australia - NPL Queensland,1.0,1.0,4,2.33,3.0,1.0,1.0,1
Peninsula,3,2,1,0,8,2,6,7,Australia - NPL Queensland,0.67,1.0,6,2.67,2.33,1.49,1.0,2
Olympic FC,3,2,0,1,6,2,4,6,Australia - NPL Queensland,0.67,0.67,4,2.0,2.0,1.49,1.49,3
Gold C. Utd,3,2,0,1,5,4,1,6,Australia - NPL Queensland,0.67,0.67,1,1.67,2.0,1.49,1.49,3
Eastern Suburbs,3,1,2,0,6,4,2,5,Australia - NPL Queensland,0.33,1.0,2,2.0,1.67,3.03,1.0,4
Q. Lions,3,1,1,1,5,4,1,4,Australia - NPL Queensland,0.33,0.67,1,1.67,1.33,3.03,1.49,5
St George W.,3,0,2,1,3,5,-2,2,Australia - NPL Queensland,0.0,0.67,-2,1.0,0.67,0.0,1.49,6
Wynnum Wolves,3,0,1,2,3,7,-4,1,Australia - NPL Queensland,0.0,0.33,-4,1.0,0.33,0.0,3.03,7
SC Wanderers,3,0,1,2,2,6,-4,1,Australia - NPL Queensland,0.0,0.33,-4,0.67,0.33,0.0,3.03,7
Brisbane City,3,0,0,3,3,8,-5,0,Australia - NPL Queensland,0.0,0.0,-5,1.0,0.0,0.0,0.0,8
Brisbane Roar B,3,0,0,3,1,9,-8,0,Australia - NPL Queensland,0.0,0.0,-8,0.33,0.0,0.0,0.0,8
Austria Wien,8,6,1,1,16,6,10,19,Austria - Bundesliga,0.75,0.88,10,2.0,2.38,1.33,1.14,1
Wolfsberger AC,8,5,1,2,19,11,8,16,Austria - Bundesliga,0.62,0.75,8,2.38,2.0,1.61,1.33,2
Salzburg,8,4,4,0,12,5,7,16,Austria - Bundesliga,0.5,1.0,7,1.5,2.0,2.0,1.0,2
BW Linz,8,5,1,2,13,9,4,16,Austria - Bundesliga,0.62,0.75,4,1.62,2.0,1.61,1.33,2
Sturm Graz,8,4,2,2,15,13,2,14,Austria - Bundesliga,0.5,0.75,2,1.88,1.75,2.0,1.33,3
LASK Linz,8,3,2,3,10,12,-2,11,Austria - Bundesliga,0.38,0.62,-2,1.25,1.38,2.63,1.61,4
Hartberg,8,2,3,3,7,13,-6,9,Austria - Bundesliga,0.25,0.62,-6,0.88,1.12,4.0,1.61,5
Rapid Wien,8,2,1,5,14,12,2,7,Austria - Bundesliga,0.25,0.38,2,1.75,0.88,4.0,2.63,6
Altach,8,1,4,3,8,15,-7,7,Austria - Bundesliga,0.12,0.62,-7,1.0,0.88,8.33,1.61,6
Tirol,8,1,3,4,9,13,-4,6,Austria - Bundesliga,0.12,0.5,-4,1.12,0.75,8.33,2.0,7
A. Klagenfurt,8,1,3,4,9,14,-5,6,Austria - Bundesliga,0.12,0.5,-5,1.12,0.75,8.33,2.0,7
Grazer AK,8,1,1,6,9,19,-10,4,Austria - Bundesliga,0.12,0.25,-10,1.12,0.5,8.33,4.0,8
Ried,8,7,0,1,15,4,11,21,Austria - 2. Liga,0.88,0.88,11,1.88,2.62,1.14,1.14,1
Admira Wacker,8,5,3,0,19,8,11,18,Austria - 2. Liga,0.62,1.0,11,2.38,2.25,1.61,1.0,2
St. Polten,8,5,3,0,15,7,8,18,Austria - 2. Liga,0.62,1.0,8,1.88,2.25,1.61,1.0,2
Voitsberg,8,5,0,3,14,7,7,15,Austria - 2. Liga,0.62,0.62,7,1.75,1.88,1.61,1.61,3
Bregenz,8,5,0,3,18,12,6,15,Austria - 2. Liga,0.62,0.62,6,2.25,1.88,1.61,1.61,3
Sturm Graz B,8,4,2,2,12,7,5,14,Austria - 2. Liga,0.5,0.75,5,1.5,1.75,2.0,1.33,4
First Vienna,8,4,1,3,15,12,3,13,Austria - 2. Liga,0.5,0.62,3,1.88,1.62,2.0,1.61,5
Kapfenberger,8,3,2,3,13,14,-1,11,Austria - 2. Liga,0.38,0.62,-1,1.62,1.38,2.63,1.61,6
Rapid Wien B,8,3,1,4,12,13,-1,10,Austria - 2. Liga,0.38,0.5,-1,1.5,1.25,2.63,2.0,7
Stripfing,8,2,3,3,11,12,-1,9,Austria - 2. Liga,0.25,0.62,-1,1.38,1.12,4.0,1.61,8
Liefering,8,3,0,5,12,15,-3,9,Austria - 2. Liga,0.38,0.38,-3,1.5,1.12,2.63,2.63,8
A. Lustenau,8,1,3,4,5,9,-4,6,Austria - 2. Liga,0.12,0.5,-4,0.62,0.75,8.33,2.0,9
Floridsdorfer,8,1,3,4,5,14,-9,6,Austria - 2. Liga,0.12,0.5,-9,0.62,0.75,8.33,2.0,9
Amstetten,8,1,2,5,8,15,-7,5,Austria - 2. Liga,0.12,0.38,-7,1.0,0.62,8.33,2.63,10
SV Horn,8,1,2,5,4,12,-8,5,Austria - 2. Liga,0.12,0.38,-8,0.5,0.62,8.33,2.63,10
Lafnitz,8,0,3,5,6,23,-17,3,Austria - 2. Liga,0.0,0.38,-17,0.75,0.38,0.0,2.63,11
Zira,8,6,1,1,16,5,11,19,Azerbaijan - Premier League,0.75,0.88,11,2.0,2.38,1.33,1.14,1
Qarabag,8,5,2,1,18,6,12,17,Azerbaijan - Premier League,0.62,0.88,12,2.25,2.12,1.61,1.14,2
Neftci,8,4,2,2,8,6,2,14,Azerbaijan - Premier League,0.5,0.75,2,1.0,1.75,2.0,1.33,3
Shamakhi,8,3,2,3,6,7,-1,11,Azerbaijan - Premier League,0.38,0.62,-1,0.75,1.38,2.63,1.61,4
Kapaz,8,2,4,2,6,9,-3,10,Azerbaijan - Premier League,0.25,0.75,-3,0.75,1.25,4.0,1.33,5
Sabah,8,1,5,2,11,12,-1,8,Azerbaijan - Premier League,0.12,0.75,-1,1.38,1.0,8.33,1.33,6
Sumqayit,8,2,2,4,8,11,-3,8,Azerbaijan - Premier League,0.25,0.5,-3,1.0,1.0,4.0,2.0,6
Turan,8,2,2,4,7,12,-5,8,Azerbaijan - Premier League,0.25,0.5,-5,0.88,1.0,4.0,2.0,6
Araz,8,0,6,2,5,8,-3,6,Azerbaijan - Premier League,0.0,0.75,-3,0.62,0.75,0.0,1.33,7
Sebail,8,0,4,4,3,12,-9,4,Azerbaijan - Premier League,0.0,0.5,-9,0.38,0.5,0.0,2.0,8
Al-Muharraq,8,7,0,1,20,6,14,21,Bahrain - Premier League,0.88,0.88,14,2.5,2.62,1.14,1.14,1
Khalidiya,8,6,1,1,17,7,10,19,Bahrain - Premier League,0.75,0.88,10,2.12,2.38,1.33,1.14,2
Al-Najma,8,4,1,3,15,11,4,13,Bahrain - Premier League,0.5,0.62,4,1.88,1.62,2.0,1.61,3
Al Riffa,8,4,1,3,10,9,1,13,Bahrain - Premier League,0.5,0.62,1,1.25,1.62,2.0,1.61,3
Malkiya,8,3,4,1,7,7,0,13,Bahrain - Premier League,0.38,0.88,0,0.88,1.62,2.63,1.14,3
Al Shabbab,8,3,2,3,11,10,1,11,Bahrain - Premier League,0.38,0.62,1,1.38,1.38,2.63,1.61,4
Bahrain SC,8,2,3,3,8,11,-3,9,Bahrain - Premier League,0.25,0.62,-3,1.0,1.12,4.0,1.61,5
Al Ahli M.,8,2,2,4,14,15,-1,8,Bahrain - Premier League,0.25,0.5,-1,1.75,1.0,4.0,2.0,6
Manama,8,2,2,4,6,12,-6,8,Bahrain - Premier League,0.25,0.5,-6,0.75,1.0,4.0,2.0,6
Sitra,8,1,4,3,7,10,-3,7,Bahrain - Premier League,0.12,0.62,-3,0.88,0.88,8.33,1.61,7
East Riffa,8,0,4,4,4,11,-7,4,Bahrain - Premier League,0.0,0.5,-7,0.5,0.5,0.0,2.0,8
AAli FC,8,0,2,6,4,19,-15,2,Bahrain - Premier League,0.0,0.25,-15,0.5,0.25,0.0,4.0,9
Mohammedan,8,7,0,1,17,4,13,21,Bangladesh - Premier League,0.88,0.88,13,2.12,2.62,1.14,1.14,1
Bashundhara K.,8,5,2,1,22,5,17,17,Bangladesh - Premier League,0.62,0.88,17,2.75,2.12,1.61,1.14,2
Abahani,8,5,2,1,14,2,12,17,Bangladesh - Premier League,0.62,0.88,12,1.75,2.12,1.61,1.14,2
Fortis,8,3,4,1,10,5,5,13,Bangladesh - Premier League,0.38,0.88,5,1.25,1.62,2.63,1.14,3
Brothers Union,8,3,2,3,11,7,4,11,Bangladesh - Premier League,0.38,0.62,4,1.38,1.38,2.63,1.61,4
B. Police,8,3,1,4,9,13,-4,10,Bangladesh - Premier League,0.38,0.5,-4,1.12,1.25,2.63,2.0,5
Rahmatgonj,8,3,0,5,19,16,3,9,Bangladesh - Premier League,0.38,0.38,3,2.38,1.12,2.63,2.63,6
Fakirerpool,8,3,0,5,10,23,-13,9,Bangladesh - Premier League,0.38,0.38,-13,1.25,1.12,2.63,2.63,6
Dhaka Wanderers,8,1,1,6,5,27,-22,4,Bangladesh - Premier League,0.12,0.25,-22,0.62,0.5,8.33,4.0,7
Chittagong,8,1,0,7,2,17,-15,3,Bangladesh - Premier League,0.12,0.12,-15,0.25,0.38,8.33,8.33,8
Slavia Mozyr,2,1,1,0,6,3,3,4,Belarus - Vysshaya Liga,0.5,1.0,3,3.0,2.0,2.0,1.0,1
Naftan,2,1,1,0,4,3,1,4,Belarus - Vysshaya Liga,0.5,1.0,1,2.0,2.0,2.0,1.0,1
Isloch,2,1,1,0,3,2,1,4,Belarus - Vysshaya Liga,0.5,1.0,1,1.5,2.0,2.0,1.0,1
Maxline,2,1,1,0,3,2,1,4,Belarus - Vysshaya Liga,0.5,1.0,1,1.5,2.0,2.0,1.0,1
Gomel,2,1,1,0,2,1,1,4,Belarus - Vysshaya Liga,0.5,1.0,1,1.0,2.0,2.0,1.0,1
Dinamo Minsk,2,1,1,0,1,0,1,4,Belarus - Vysshaya Liga,0.5,1.0,1,0.5,2.0,2.0,1.0,1
Neman Grodno,2,1,0,1,3,1,2,3,Belarus - Vysshaya Liga,0.5,0.5,2,1.5,1.5,2.0,2.0,2
Slutsk,2,1,0,1,2,1,1,3,Belarus - Vysshaya Liga,0.5,0.5,1,1.0,1.5,2.0,2.0,2
FC Minsk,2,1,0,1,3,3,0,3,Belarus - Vysshaya Liga,0.5,0.5,0,1.5,1.5,2.0,2.0,2
BATE Borisov,2,1,0,1,1,1,0,3,Belarus - Vysshaya Liga,0.5,0.5,0,0.5,1.5,2.0,2.0,2
Arsenal D.,2,0,2,0,3,3,0,2,Belarus - Vysshaya Liga,0.0,1.0,0,1.5,1.0,0.0,1.0,3
Dinamo Brest,2,0,2,0,3,3,0,2,Belarus - Vysshaya Liga,0.0,1.0,0,1.5,1.0,0.0,1.0,3
T. Zhodino,2,0,2,0,1,1,0,2,Belarus - Vysshaya Liga,0.0,1.0,0,0.5,1.0,0.0,1.0,3
Vitebsk,2,0,0,2,1,3,-2,0,Belarus - Vysshaya Liga,0.0,0.0,-2,0.5,0.0,0.0,0.0,4
Smorgon,2,0,0,2,0,3,-3,0,Belarus - Vysshaya Liga,0.0,0.0,-3,0.0,0.0,0.0,0.0,4
Molodechno,2,0,0,2,1,7,-6,0,Belarus - Vysshaya Liga,0.0,0.0,-6,0.5,0.0,0.0,0.0,4
BATE B,1,1,0,0,7,2,5,3,Belarus - First League,1.0,1.0,5,7.0,3.0,1.0,1.0,1
Ostrovets,1,1,0,0,4,1,3,3,Belarus - First League,1.0,1.0,3,4.0,3.0,1.0,1.0,1
Dinamo Minsk B,1,1,0,0,3,1,2,3,Belarus - First League,1.0,1.0,2,3.0,3.0,1.0,1.0,1
ABFF U19,1,1,0,0,2,0,2,3,Belarus - First League,1.0,1.0,2,2.0,3.0,1.0,1.0,1
Volna Pinsk,1,1,0,0,3,2,1,3,Belarus - First League,1.0,1.0,1,3.0,3.0,1.0,1.0,1
Slonim,1,1,0,0,2,1,1,3,Belarus - First League,1.0,1.0,1,2.0,3.0,1.0,1.0,1
Dnepr Mogilev,1,0,1,0,2,2,0,1,Belarus - First League,0.0,1.0,0,2.0,1.0,0.0,1.0,2
Gomel B,1,0,1,0,2,2,0,1,Belarus - First League,0.0,1.0,0,2.0,1.0,0.0,1.0,2
Lokomotiv Gomel,1,0,1,0,2,2,0,1,Belarus - First League,0.0,1.0,0,2.0,1.0,0.0,1.0,2
Niva,1,0,1,0,2,2,0,1,Belarus - First League,0.0,1.0,0,2.0,1.0,0.0,1.0,2
Bumprom,1,0,1,0,1,1,0,1,Belarus - First League,0.0,1.0,0,1.0,1.0,0.0,1.0,2
Osipovichy,1,0,1,0,1,1,0,1,Belarus - First League,0.0,1.0,0,1.0,1.0,0.0,1.0,2
Lida,1,0,0,1,2,3,-1,0,Belarus - First League,0.0,0.0,-1,2.0,0.0,0.0,0.0,3
Baranovichi,1,0,0,1,1,2,-1,0,Belarus - First League,0.0,0.0,-1,1.0,0.0,0.0,0.0,3
Uni X L. Minsk,1,0,0,1,1,3,-2,0,Belarus - First League,0.0,0.0,-2,1.0,0.0,0.0,0.0,3
Belshina,1,0,0,1,0,2,-2,0,Belarus - First League,0.0,0.0,-2,0.0,0.0,0.0,0.0,3
Minsk B,1,0,0,1,1,4,-3,0,Belarus - First League,0.0,0.0,-3,1.0,0.0,0.0,0.0,3
Orsha,1,0,0,1,2,7,-5,0,Belarus - First League,0.0,0.0,-5,2.0,0.0,0.0,0.0,3
KRC Genk,8,6,2,0,11,5,6,20,Belgium - Pro League,0.75,1.0,6,1.38,2.5,1.33,1.0,1
Royale Union SG,8,6,0,2,18,6,12,18,Belgium - Pro League,0.75,0.75,12,2.25,2.25,1.33,1.33,2
Anderlecht,8,5,0,3,12,6,6,15,Belgium - Pro League,0.62,0.62,6,1.5,1.88,1.61,1.61,3
Westerlo,8,4,2,2,13,10,3,14,Belgium - Pro League,0.5,0.75,3,1.62,1.75,2.0,1.33,4
Gent,8,3,4,1,10,8,2,13,Belgium - Pro League,0.38,0.88,2,1.25,1.62,2.63,1.14,5
Club Brugge,8,3,3,2,14,11,3,12,Belgium - Pro League,0.38,0.75,3,1.75,1.5,2.63,1.33,6
OH Leuven,8,3,3,2,9,9,0,12,Belgium - Pro League,0.38,0.75,0,1.12,1.5,2.63,1.33,6
KV Mechelen,8,3,2,3,9,11,-2,11,Belgium - Pro League,0.38,0.62,-2,1.12,1.38,2.63,1.61,7
Antwerp,8,2,4,2,7,8,-1,10,Belgium - Pro League,0.25,0.75,-1,0.88,1.25,4.0,1.33,8
Charleroi,8,2,3,3,13,10,3,9,Belgium - Pro League,0.25,0.62,3,1.62,1.12,4.0,1.61,9
Sint-Truiden,8,2,3,3,14,13,1,9,Belgium - Pro League,0.25,0.62,1,1.75,1.12,4.0,1.61,9
Kortrijk,8,2,2,4,11,13,-2,8,Belgium - Pro League,0.25,0.5,-2,1.38,1.0,4.0,2.0,10
Standard Liege,8,2,2,4,7,13,-6,8,Belgium - Pro League,0.25,0.5,-6,0.88,1.0,4.0,2.0,10
Cercle Brugge,8,0,5,3,6,12,-6,5,Belgium - Pro League,0.0,0.62,-6,0.75,0.62,0.0,1.61,11
Beerschot,8,1,2,5,5,13,-8,5,Belgium - Pro League,0.12,0.38,-8,0.62,0.62,8.33,2.63,11
Dender,8,1,1,6,6,17,-11,4,Belgium - Pro League,0.12,0.25,-11,0.75,0.5,8.33,4.0,12
RWDM,8,7,1,0,10,0,10,22,Belgium - Challenger Pro League,0.88,1.0,10,1.25,2.75,1.14,1.0,1
Beveren,8,6,1,1,16,10,6,19,Belgium - Challenger Pro League,0.75,0.88,6,2.0,2.38,1.33,1.14,2
La Louviere,8,5,3,0,16,4,12,18,Belgium - Challenger Pro League,0.62,1.0,12,2.0,2.25,1.61,1.0,3
Lokeren-Temse,8,5,1,2,9,10,-1,16,Belgium - Challenger Pro League,0.62,0.75,-1,1.12,2.0,1.61,1.33,4
Patro Eisden,8,4,3,1,11,7,4,15,Belgium - Challenger Pro League,0.5,0.88,4,1.38,1.88,2.0,1.14,5
Zulte-Waregem,8,4,2,2,14,9,5,14,Belgium - Challenger Pro League,0.5,0.75,5,1.75,1.75,2.0,1.33,6
Club Brugge B,8,4,0,4,12,9,3,12,Belgium - Challenger Pro League,0.5,0.5,3,1.5,1.5,2.0,2.0,7
Eupen,8,3,3,2,10,10,0,12,Belgium - Challenger Pro League,0.38,0.75,0,1.25,1.5,2.63,1.33,7
RFC Liege,8,3,2,3,13,13,0,11,Belgium - Challenger Pro League,0.38,0.62,0,1.62,1.38,2.63,1.61,8
Francs Borains,8,3,0,5,8,13,-5,9,Belgium - Challenger Pro League,0.38,0.38,-5,1.0,1.12,2.63,2.63,9
Lierse K.,8,2,2,4,8,8,0,8,Belgium - Challenger Pro League,0.25,0.5,0,1.0,1.0,4.0,2.0,10
Anderlecht B,8,1,2,5,14,17,-3,5,Belgium - Challenger Pro League,0.12,0.38,-3,1.75,0.62,8.33,2.63,11
Lommel SK,8,1,1,6,6,16,-10,4,Belgium - Challenger Pro League,0.12,0.25,-10,0.75,0.5,8.33,4.0,12
KRC Genk B,8,0,2,6,6,17,-11,2,Belgium - Challenger Pro League,0.0,0.25,-11,0.75,0.25,0.0,4.0,13
Seraing,8,0,2,6,7,19,-12,2,Belgium - Challenger Pro League,0.0,0.25,-12,0.88,0.25,0.0,4.0,13
Deinze,0,0,0,0,0,0,0,0,Belgium - Challenger Pro League,0.0,0.0,0,0.0,0.0,0.0,0.0,14
Bolivar,8,5,1,2,19,13,6,16,Bolivia - Primera Div. - Apertura,0.62,0.75,6,2.38,2.0,1.61,1.33,1
The Strongest,8,5,1,2,17,15,2,16,Bolivia - Primera Div. - Apertura,0.62,0.75,2,2.12,2.0,1.61,1.33,1
SA Bulo Bulo,8,4,2,2,15,7,8,14,Bolivia - Primera Div. - Apertura,0.5,0.75,8,1.88,1.75,2.0,1.33,2
Aurora,8,4,2,2,14,7,7,14,Bolivia - Primera Div. - Apertura,0.5,0.75,7,1.75,1.75,2.0,1.33,2
Nacional Potosi,8,4,2,2,13,11,2,14,Bolivia - Primera Div. - Apertura,0.5,0.75,2,1.62,1.75,2.0,1.33,2
U. de Vinto,8,4,2,2,8,7,1,14,Bolivia - Primera Div. - Apertura,0.5,0.75,1,1.0,1.75,2.0,1.33,2
Blooming,8,4,2,2,12,12,0,14,Bolivia - Primera Div. - Apertura,0.5,0.75,0,1.5,1.75,2.0,1.33,2
I. Petrolero,8,3,2,3,10,11,-1,11,Bolivia - Primera Div. - Apertura,0.38,0.62,-1,1.25,1.38,2.63,1.61,3
Gualberto V. SJ,8,3,2,3,12,14,-2,11,Bolivia - Primera Div. - Apertura,0.38,0.62,-2,1.5,1.38,2.63,1.61,3
Real Tomayapo,8,3,2,3,10,12,-2,11,Bolivia - Primera Div. - Apertura,0.38,0.62,-2,1.25,1.38,2.63,1.61,3
Guabira,8,3,1,4,12,11,1,10,Bolivia - Primera Div. - Apertura,0.38,0.5,1,1.5,1.25,2.63,2.0,4
Oriente P.,8,3,1,4,9,13,-4,10,Bolivia - Primera Div. - Apertura,0.38,0.5,-4,1.12,1.25,2.63,2.0,4
Royal Pari,8,2,2,4,7,10,-3,8,Bolivia - Primera Div. - Apertura,0.25,0.5,-3,0.88,1.0,4.0,2.0,5
Always Ready,8,1,3,4,6,10,-4,6,Bolivia - Primera Div. - Apertura,0.12,0.5,-4,0.75,0.75,8.33,2.0,6
Wilstermann,8,1,2,5,12,14,-2,5,Bolivia - Primera Div. - Apertura,0.12,0.38,-2,1.5,0.62,8.33,2.63,7
Santa Cruz,8,1,1,6,8,17,-9,4,Bolivia - Primera Div. - Apertura,0.12,0.25,-9,1.0,0.5,8.33,4.0,8
Bolivar,8,6,1,1,28,11,17,19,Bolivia - Primera Div. - Clausura,0.75,0.88,17,3.5,2.38,1.33,1.14,1
The Strongest,8,6,0,2,26,11,15,18,Bolivia - Primera Div. - Clausura,0.75,0.75,15,3.25,2.25,1.33,1.33,2
Always Ready,8,4,1,3,20,13,7,13,Bolivia - Primera Div. - Clausura,0.5,0.62,7,2.5,1.62,2.0,1.61,3
Gualberto V. SJ,8,4,1,3,18,12,6,13,Bolivia - Primera Div. - Clausura,0.5,0.62,6,2.25,1.62,2.0,1.61,3
Nacional Potosi,8,4,1,3,16,12,4,13,Bolivia - Primera Div. - Clausura,0.5,0.62,4,2.0,1.62,2.0,1.61,3
Royal Pari,8,4,1,3,11,10,1,13,Bolivia - Primera Div. - Clausura,0.5,0.62,1,1.38,1.62,2.0,1.61,3
Aurora,8,3,3,2,19,14,5,12,Bolivia - Primera Div. - Clausura,0.38,0.75,5,2.38,1.5,2.63,1.33,4
Real Tomayapo,8,4,0,4,14,12,2,12,Bolivia - Primera Div. - Clausura,0.5,0.5,2,1.75,1.5,2.0,2.0,4
Blooming,8,3,3,2,10,13,-3,12,Bolivia - Primera Div. - Clausura,0.38,0.75,-3,1.25,1.5,2.63,1.33,4
Guabira,8,3,2,3,10,10,0,11,Bolivia - Primera Div. - Clausura,0.38,0.62,0,1.25,1.38,2.63,1.61,5
Wilstermann,8,2,4,2,11,13,-2,10,Bolivia - Primera Div. - Clausura,0.25,0.75,-2,1.38,1.25,4.0,1.33,6
I. Petrolero,8,3,0,5,13,20,-7,9,Bolivia - Primera Div. - Clausura,0.38,0.38,-7,1.62,1.12,2.63,2.63,7
SA Bulo Bulo,8,2,2,4,14,22,-8,8,Bolivia - Primera Div. - Clausura,0.25,0.5,-8,1.75,1.0,4.0,2.0,8
Oriente P.,8,2,1,5,14,23,-9,7,Bolivia - Primera Div. - Clausura,0.25,0.38,-9,1.75,0.88,4.0,2.63,9
U. de Vinto,8,2,1,5,8,17,-9,7,Bolivia - Primera Div. - Clausura,0.25,0.38,-9,1.0,0.88,4.0,2.63,9
Santa Cruz,8,1,0,7,7,27,-20,3,Bolivia - Primera Div. - Clausura,0.12,0.12,-20,0.88,0.38,8.33,8.33,10
Fortaleza,1,1,0,0,2,0,2,3,Brazil - Serie A,1.0,1.0,2,2.0,3.0,1.0,1.0,1
Juventude,1,1,0,0,2,0,2,3,Brazil - Serie A,1.0,1.0,2,2.0,3.0,1.0,1.0,1
Cruzeiro,1,1,0,0,2,1,1,3,Brazil - Serie A,1.0,1.0,1,2.0,3.0,1.0,1.0,1
Gremio,1,1,0,0,2,1,1,3,Brazil - Serie A,1.0,1.0,1,2.0,3.0,1.0,1.0,1
Vasco da Gama,1,1,0,0,2,1,1,3,Brazil - Serie A,1.0,1.0,1,2.0,3.0,1.0,1.0,1
Bahia,1,0,1,0,1,1,0,1,Brazil - Serie A,0.0,1.0,0,1.0,1.0,0.0,1.0,2
Corinthians,1,0,1,0,1,1,0,1,Brazil - Serie A,0.0,1.0,0,1.0,1.0,0.0,1.0,2
Flamengo,1,0,1,0,1,1,0,1,Brazil - Serie A,0.0,1.0,0,1.0,1.0,0.0,1.0,2
Internacional,1,0,1,0,1,1,0,1,Brazil - Serie A,0.0,1.0,0,1.0,1.0,0.0,1.0,2
Botafogo,1,0,1,0,0,0,0,1,Brazil - Serie A,0.0,1.0,0,0.0,1.0,0.0,1.0,2
Palmeiras,1,0,1,0,0,0,0,1,Brazil - Serie A,0.0,1.0,0,0.0,1.0,0.0,1.0,2
Sao Paulo,1,0,1,0,0,0,0,1,Brazil - Serie A,0.0,1.0,0,0.0,1.0,0.0,1.0,2
Sport Recife,1,0,1,0,0,0,0,1,Brazil - Serie A,0.0,1.0,0,0.0,1.0,0.0,1.0,2
Bragantino,0,0,0,0,0,0,0,0,Brazil - Serie A,0.0,0.0,0,0.0,0.0,0.0,0.0,3
Ceara,0,0,0,0,0,0,0,0,Brazil - Serie A,0.0,0.0,0,0.0,0.0,0.0,0.0,3
Atletico MG,1,0,0,1,1,2,-1,0,Brazil - Serie A,0.0,0.0,-1,1.0,0.0,0.0,0.0,3
Mirassol,1,0,0,1,1,2,-1,0,Brazil - Serie A,0.0,0.0,-1,1.0,0.0,0.0,0.0,3
Santos,1,0,0,1,1,2,-1,0,Brazil - Serie A,0.0,0.0,-1,1.0,0.0,0.0,0.0,3
Fluminense,1,0,0,1,0,2,-2,0,Brazil - Serie A,0.0,0.0,-2,0.0,0.0,0.0,0.0,3
Vitoria,1,0,0,1,0,2,-2,0,Brazil - Serie A,0.0,0.0,-2,0.0,0.0,0.0,0.0,3
Amazonas,0,0,0,0,0,0,0,0,Brazil - Serie B,0.0,0.0,0,0.0,0.0,0.0,0.0,1
America MG,0,0,0,0,0,0,0,0,Brazil - Serie B,0.0,0.0,0,0.0,0.0,0.0,0.0,1
Athletic Club,0,0,0,0,0,0,0,0,Brazil - Serie B,0.0,0.0,0,0.0,0.0,0.0,0.0,1
Athletico PR,0,0,0,0,0,0,0,0,Brazil - Serie B,0.0,0.0,0,0.0,0.0,0.0,0.0,1
Atletico GO,0,0,0,0,0,0,0,0,Brazil - Serie B,0.0,0.0,0,0.0,0.0,0.0,0.0,1
Avai,0,0,0,0,0,0,0,0,Brazil - Serie B,0.0,0.0,0,0.0,0.0,0.0,0.0,1
Botafogo SP,0,0,0,0,0,0,0,0,Brazil - Serie B,0.0,0.0,0,0.0,0.0,0.0,0.0,1
Chapecoense,0,0,0,0,0,0,0,0,Brazil - Serie B,0.0,0.0,0,0.0,0.0,0.0,0.0,1
Coritiba,0,0,0,0,0,0,0,0,Brazil - Serie B,0.0,0.0,0,0.0,0.0,0.0,0.0,1
CRB,0,0,0,0,0,0,0,0,Brazil - Serie B,0.0,0.0,0,0.0,0.0,0.0,0.0,1
Criciuma,0,0,0,0,0,0,0,0,Brazil - Serie B,0.0,0.0,0,0.0,0.0,0.0,0.0,1
Cuiaba,0,0,0,0,0,0,0,0,Brazil - Serie B,0.0,0.0,0,0.0,0.0,0.0,0.0,1
Ferroviaria,0,0,0,0,0,0,0,0,Brazil - Serie B,0.0,0.0,0,0.0,0.0,0.0,0.0,1
Goias,0,0,0,0,0,0,0,0,Brazil - Serie B,0.0,0.0,0,0.0,0.0,0.0,0.0,1
Novorizontino,0,0,0,0,0,0,0,0,Brazil - Serie B,0.0,0.0,0,0.0,0.0,0.0,0.0,1
Operario PR,0,0,0,0,0,0,0,0,Brazil - Serie B,0.0,0.0,0,0.0,0.0,0.0,0.0,1
Paysandu,0,0,0,0,0,0,0,0,Brazil - Serie B,0.0,0.0,0,0.0,0.0,0.0,0.0,1
Remo,0,0,0,0,0,0,0,0,Brazil - Serie B,0.0,0.0,0,0.0,0.0,0.0,0.0,1
Vila Nova,0,0,0,0,0,0,0,0,Brazil - Serie B,0.0,0.0,0,0.0,0.0,0.0,0.0,1
Volta Redonda,0,0,0,0,0,0,0,0,Brazil - Serie B,0.0,0.0,0,0.0,0.0,0.0,0.0,1
ABC,0,0,0,0,0,0,0,0,Brazil - Serie C,0.0,0.0,0,0.0,0.0,0.0,0.0,1
Anapolis,0,0,0,0,0,0,0,0,Brazil - Serie C,0.0,0.0,0,0.0,0.0,0.0,0.0,1
Botafogo PB,0,0,0,0,0,0,0,0,Brazil - Serie C,0.0,0.0,0,0.0,0.0,0.0,0.0,1
Brusque,0,0,0,0,0,0,0,0,Brazil - Serie C,0.0,0.0,0,0.0,0.0,0.0,0.0,1
Caxias,0,0,0,0,0,0,0,0,Brazil - Serie C,0.0,0.0,0,0.0,0.0,0.0,0.0,1
Confianca,0,0,0,0,0,0,0,0,Brazil - Serie C,0.0,0.0,0,0.0,0.0,0.0,0.0,1
CSA,0,0,0,0,0,0,0,0,Brazil - Serie C,0.0,0.0,0,0.0,0.0,0.0,0.0,1
Figueirense,0,0,0,0,0,0,0,0,Brazil - Serie C,0.0,0.0,0,0.0,0.0,0.0,0.0,1
Floresta,0,0,0,0,0,0,0,0,Brazil - Serie C,0.0,0.0,0,0.0,0.0,0.0,0.0,1
Guarani,0,0,0,0,0,0,0,0,Brazil - Serie C,0.0,0.0,0,0.0,0.0,0.0,0.0,1
Itabaiana,0,0,0,0,0,0,0,0,Brazil - Serie C,0.0,0.0,0,0.0,0.0,0.0,0.0,1
Ituano,0,0,0,0,0,0,0,0,Brazil - Serie C,0.0,0.0,0,0.0,0.0,0.0,0.0,1
Londrina,0,0,0,0,0,0,0,0,Brazil - Serie C,0.0,0.0,0,0.0,0.0,0.0,0.0,1
Maringa,0,0,0,0,0,0,0,0,Brazil - Serie C,0.0,0.0,0,0.0,0.0,0.0,0.0,1
Nautico,0,0,0,0,0,0,0,0,Brazil - Serie C,0.0,0.0,0,0.0,0.0,0.0,0.0,1
Ponte Preta,0,0,0,0,0,0,0,0,Brazil - Serie C,0.0,0.0,0,0.0,0.0,0.0,0.0,1
Retro,0,0,0,0,0,0,0,0,Brazil - Serie C,0.0,0.0,0,0.0,0.0,0.0,0.0,1
Sao Bernardo,0,0,0,0,0,0,0,0,Brazil - Serie C,0.0,0.0,0,0.0,0.0,0.0,0.0,1
Tombense,0,0,0,0,0,0,0,0,Brazil - Serie C,0.0,0.0,0,0.0,0.0,0.0,0.0,1
Ypiranga,0,0,0,0,0,0,0,0,Brazil - Serie C,0.0,0.0,0,0.0,0.0,0.0,0.0,1
Agua Santa,0,0,0,0,0,0,0,0,Brazil - Serie D,0.0,0.0,0,0.0,0.0,0.0,0.0,1
Aguia de Maraba,0,0,0,0,0,0,0,0,Brazil - Serie D,0.0,0.0,0,0.0,0.0,0.0,0.0,1
Altos,0,0,0,0,0,0,0,0,Brazil - Serie D,0.0,0.0,0,0.0,0.0,0.0,0.0,1
America RN,0,0,0,0,0,0,0,0,Brazil - Serie D,0.0,0.0,0,0.0,0.0,0.0,0.0,1
Aparecidense,0,0,0,0,0,0,0,0,Brazil - Serie D,0.0,0.0,0,0.0,0.0,0.0,0.0,1
ASA,0,0,0,0,0,0,0,0,Brazil - Serie D,0.0,0.0,0,0.0,0.0,0.0,0.0,1
Azuriz,0,0,0,0,0,0,0,0,Brazil - Serie D,0.0,0.0,0,0.0,0.0,0.0,0.0,1
Barcelona BA,0,0,0,0,0,0,0,0,Brazil - Serie D,0.0,0.0,0,0.0,0.0,0.0,0.0,1
Barra FC,0,0,0,0,0,0,0,0,Brazil - Serie D,0.0,0.0,0,0.0,0.0,0.0,0.0,1
Boavista,0,0,0,0,0,0,0,0,Brazil - Serie D,0.0,0.0,0,0.0,0.0,0.0,0.0,1
Brasil de P.,0,0,0,0,0,0,0,0,Brazil - Serie D,0.0,0.0,0,0.0,0.0,0.0,0.0,1
Capital,0,0,0,0,0,0,0,0,Brazil - Serie D,0.0,0.0,0,0.0,0.0,0.0,0.0,1
Cascavel,0,0,0,0,0,0,0,0,Brazil - Serie D,0.0,0.0,0,0.0,0.0,0.0,0.0,1
Ceilandia,0,0,0,0,0,0,0,0,Brazil - Serie D,0.0,0.0,0,0.0,0.0,0.0,0.0,1
Central,0,0,0,0,0,0,0,0,Brazil - Serie D,0.0,0.0,0,0.0,0.0,0.0,0.0,1
CFRJ . Marica,0,0,0,0,0,0,0,0,Brazil - Serie D,0.0,0.0,0,0.0,0.0,0.0,0.0,1
Cianorte,0,0,0,0,0,0,0,0,Brazil - Serie D,0.0,0.0,0,0.0,0.0,0.0,0.0,1
EC Sao Jose,0,0,0,0,0,0,0,0,Brazil - Serie D,0.0,0.0,0,0.0,0.0,0.0,0.0,1
Ferroviario,0,0,0,0,0,0,0,0,Brazil - Serie D,0.0,0.0,0,0.0,0.0,0.0,0.0,1
GAS,0,0,0,0,0,0,0,0,Brazil - Serie D,0.0,0.0,0,0.0,0.0,0.0,0.0,1
Goianesia,0,0,0,0,0,0,0,0,Brazil - Serie D,0.0,0.0,0,0.0,0.0,0.0,0.0,1
Goiania,0,0,0,0,0,0,0,0,Brazil - Serie D,0.0,0.0,0,0.0,0.0,0.0,0.0,1
Goiatuba EC,0,0,0,0,0,0,0,0,Brazil - Serie D,0.0,0.0,0,0.0,0.0,0.0,0.0,1
Guarany de Bage,0,0,0,0,0,0,0,0,Brazil - Serie D,0.0,0.0,0,0.0,0.0,0.0,0.0,1
Horizonte,0,0,0,0,0,0,0,0,Brazil - Serie D,0.0,0.0,0,0.0,0.0,0.0,0.0,1
Humaita,0,0,0,0,0,0,0,0,Brazil - Serie D,0.0,0.0,0,0.0,0.0,0.0,0.0,1
Iguatu,0,0,0,0,0,0,0,0,Brazil - Serie D,0.0,0.0,0,0.0,0.0,0.0,0.0,1
Imperatriz,0,0,0,0,0,0,0,0,Brazil - Serie D,0.0,0.0,0,0.0,0.0,0.0,0.0,1
Independencia,0,0,0,0,0,0,0,0,Brazil - Serie D,0.0,0.0,0,0.0,0.0,0.0,0.0,1
Flamengo,8,7,1,0,22,0,22,22,Brazil - Carioca,0.88,1.0,22,2.75,2.75,1.14,1.0,1
Fluminense,8,4,3,1,12,7,5,15,Brazil - Carioca,0.5,0.88,5,1.5,1.88,2.0,1.14,2
Vasco da Gama,8,4,2,2,11,7,4,14,Brazil - Carioca,0.5,0.75,4,1.38,1.75,2.0,1.33,3
Volta Redonda,8,4,2,2,11,10,1,14,Brazil - Carioca,0.5,0.75,1,1.38,1.75,2.0,1.33,3
Sampaio Correa,8,3,3,2,11,9,2,12,Brazil - Carioca,0.38,0.75,2,1.38,1.5,2.63,1.33,4
Madureira,8,3,2,3,7,5,2,11,Brazil - Carioca,0.38,0.62,2,0.88,1.38,2.63,1.61,5
Boavista,8,1,7,0,7,5,2,10,Brazil - Carioca,0.12,1.0,2,0.88,1.25,8.33,1.0,6
Botafogo,8,3,1,4,7,8,-1,10,Brazil - Carioca,0.38,0.5,-1,0.88,1.25,2.63,2.0,6
Nova Iguacu,8,2,3,3,4,7,-3,9,Brazil - Carioca,0.25,0.62,-3,0.5,1.12,4.0,1.61,7
CFRJ . Marica,8,1,2,5,7,15,-8,5,Brazil - Carioca,0.12,0.38,-8,0.88,0.62,8.33,2.63,8
Portuguesa RJ,8,1,1,6,9,21,-12,4,Brazil - Carioca,0.12,0.25,-12,1.12,0.5,8.33,4.0,9
Bangu,8,0,3,5,4,18,-14,3,Brazil - Carioca,0.0,0.38,-14,0.5,0.38,0.0,2.63,10
Atletico MG,8,4,4,0,9,2,7,16,Brazil - Mineiro,0.5,1.0,7,1.12,2.0,2.0,1.0,1
Tombense,8,5,1,2,8,5,3,16,Brazil - Mineiro,0.62,0.75,3,1.0,2.0,1.61,1.33,1
Betim,8,4,3,1,12,5,7,15,Brazil - Mineiro,0.5,0.88,7,1.5,1.88,2.0,1.14,2
America MG,8,3,4,1,14,5,9,13,Brazil - Mineiro,0.38,0.88,9,1.75,1.62,2.63,1.14,3
Athletic Club,8,4,0,4,12,12,0,12,Brazil - Mineiro,0.5,0.5,0,1.5,1.5,2.0,2.0,4
Cruzeiro,8,3,2,3,11,9,2,11,Brazil - Mineiro,0.38,0.62,2,1.38,1.38,2.63,1.61,5
Democrata GV,8,3,2,3,8,9,-1,11,Brazil - Mineiro,0.38,0.62,-1,1.0,1.38,2.63,1.61,5
Uberlandia,8,2,3,3,10,10,0,9,Brazil - Mineiro,0.25,0.62,0,1.25,1.12,4.0,1.61,6
Itabirito,8,2,2,4,7,11,-4,8,Brazil - Mineiro,0.25,0.5,-4,0.88,1.0,4.0,2.0,7
Pouso Alegre,8,2,2,4,7,15,-8,8,Brazil - Mineiro,0.25,0.5,-8,0.88,1.0,4.0,2.0,7
Aymores,8,1,4,3,3,5,-2,7,Brazil - Mineiro,0.12,0.62,-2,0.38,0.88,8.33,1.61,8
Villa Nova,8,1,1,6,4,17,-13,4,Brazil - Mineiro,0.12,0.25,-13,0.5,0.5,8.33,4.0,9
Anapolis,8,6,0,2,13,6,7,18,Brazil - Goiano,0.75,0.75,7,1.62,2.25,1.33,1.33,1
Vila Nova,8,4,3,1,8,5,3,15,Brazil - Goiano,0.5,0.88,3,1.0,1.88,2.0,1.14,2
Atletico GO,8,4,2,2,10,6,4,14,Brazil - Goiano,0.5,0.75,4,1.25,1.75,2.0,1.33,3
CRAC,8,4,2,2,7,4,3,14,Brazil - Goiano,0.5,0.75,3,0.88,1.75,2.0,1.33,3
Goias,8,4,2,2,7,5,2,14,Brazil - Goiano,0.5,0.75,2,0.88,1.75,2.0,1.33,3
Goianesia,8,2,4,2,11,9,2,10,Brazil - Goiano,0.25,0.75,2,1.38,1.25,4.0,1.33,4
ABECAT Ouvidore,8,3,1,4,8,10,-2,10,Brazil - Goiano,0.38,0.5,-2,1.0,1.25,2.63,2.0,4
Goiatuba EC,8,2,4,2,4,6,-2,10,Brazil - Goiano,0.25,0.75,-2,0.5,1.25,4.0,1.33,4
Jataiense,8,3,0,5,10,10,0,9,Brazil - Goiano,0.38,0.38,0,1.25,1.12,2.63,2.63,5
Goiania,8,2,1,5,8,14,-6,7,Brazil - Goiano,0.25,0.38,-6,1.0,0.88,4.0,2.63,6
Aparecidense,8,1,3,4,4,7,-3,6,Brazil - Goiano,0.12,0.5,-3,0.5,0.75,8.33,2.0,7
Inhumas,8,1,2,5,5,13,-8,5,Brazil - Goiano,0.12,0.38,-8,0.62,0.62,8.33,2.63,8
Santa Cruz,8,6,1,1,13,3,10,19,Brazil - Pernambucano,0.75,0.88,10,1.62,2.38,1.33,1.14,1
Nautico,8,5,0,3,14,8,6,15,Brazil - Pernambucano,0.62,0.62,6,1.75,1.88,1.61,1.61,2
Sport Recife,8,4,2,2,16,7,9,14,Brazil - Pernambucano,0.5,0.75,9,2.0,1.75,2.0,1.33,3
Maguary PE,8,4,2,2,10,9,1,14,Brazil - Pernambucano,0.5,0.75,1,1.25,1.75,2.0,1.33,3
Retro,8,3,3,2,7,7,0,12,Brazil - Pernambucano,0.38,0.75,0,0.88,1.5,2.63,1.33,4
Decisao,8,3,3,2,10,11,-1,12,Brazil - Pernambucano,0.38,0.75,-1,1.25,1.5,2.63,1.33,4
Jaguar,8,3,1,4,10,16,-6,10,Brazil - Pernambucano,0.38,0.5,-6,1.25,1.25,2.63,2.0,5
Central,8,2,2,4,8,9,-1,8,Brazil - Pernambucano,0.25,0.5,-1,1.0,1.0,4.0,2.0,6
Afogados,8,0,4,4,4,12,-8,4,Brazil - Pernambucano,0.0,0.5,-8,0.5,0.5,0.0,2.0,7
Petrolina,8,0,2,6,3,13,-10,2,Brazil - Pernambucano,0.0,0.25,-10,0.38,0.25,0.0,4.0,8
Corinthians,8,5,3,0,13,7,6,18,Brazil - Paulista,0.62,1.0,6,1.62,2.25,1.61,1.0,1
Palmeiras,8,4,4,0,15,6,9,16,Brazil - Paulista,0.5,1.0,9,1.88,2.0,2.0,1.0,2
Ponte Preta,8,5,1,2,9,6,3,16,Brazil - Paulista,0.62,0.75,3,1.12,2.0,1.61,1.33,2
Santos,8,4,2,2,15,8,7,14,Brazil - Paulista,0.5,0.75,7,1.88,1.75,2.0,1.33,3
Bragantino,8,4,2,2,10,5,5,14,Brazil - Paulista,0.5,0.75,5,1.25,1.75,2.0,1.33,3
Sao Bernardo,8,4,2,2,12,11,1,14,Brazil - Paulista,0.5,0.75,1,1.5,1.75,2.0,1.33,3
Novorizontino,8,3,4,1,8,6,2,13,Brazil - Paulista,0.38,0.88,2,1.0,1.62,2.63,1.14,4
Portuguesa,8,2,5,1,12,10,2,11,Brazil - Paulista,0.25,0.88,2,1.5,1.38,4.0,1.14,5
Velo Clube,8,2,4,2,10,10,0,10,Brazil - Paulista,0.25,0.75,0,1.25,1.25,4.0,1.33,6
Sao Paulo,8,2,3,3,12,11,1,9,Brazil - Paulista,0.25,0.62,1,1.5,1.12,4.0,1.61,7
Botafogo SP,8,2,3,3,8,10,-2,9,Brazil - Paulista,0.25,0.62,-2,1.0,1.12,4.0,1.61,7
Mirassol,8,2,1,5,10,17,-7,7,Brazil - Paulista,0.25,0.38,-7,1.25,0.88,4.0,2.63,8
Guarani,8,1,3,4,10,13,-3,6,Brazil - Paulista,0.12,0.5,-3,1.25,0.75,8.33,2.0,9
Agua Santa,8,0,4,4,5,13,-8,4,Brazil - Paulista,0.0,0.5,-8,0.62,0.5,0.0,2.0,10
Noroeste,8,0,3,5,9,16,-7,3,Brazil - Paulista,0.0,0.38,-7,1.12,0.38,0.0,2.63,11
Inter Limeira,8,0,3,5,5,15,-10,3,Brazil - Paulista,0.0,0.38,-10,0.62,0.38,0.0,2.63,11
Treze,8,5,2,1,17,7,10,17,Brazil - Paraibano,0.62,0.88,10,2.12,2.12,1.61,1.14,1
Sousa,8,5,2,1,12,3,9,17,Brazil - Paraibano,0.62,0.88,9,1.5,2.12,1.61,1.14,1
Botafogo PB,8,5,1,2,15,6,9,16,Brazil - Paraibano,0.62,0.75,9,1.88,2.0,1.61,1.33,2
Serra Branca,8,4,2,2,20,8,12,14,Brazil - Paraibano,0.5,0.75,12,2.5,1.75,2.0,1.33,3
Campinense,8,4,2,2,14,9,5,14,Brazil - Paraibano,0.5,0.75,5,1.75,1.75,2.0,1.33,3
Pombal,8,2,3,3,7,8,-1,9,Brazil - Paraibano,0.25,0.62,-1,0.88,1.12,4.0,1.61,4
Nacional Patos,8,2,3,3,13,17,-4,9,Brazil - Paraibano,0.25,0.62,-4,1.62,1.12,4.0,1.61,4
EC de Patos,8,2,1,5,11,16,-5,7,Brazil - Paraibano,0.25,0.38,-5,1.38,0.88,4.0,2.63,5
Auto Esporte,8,1,3,4,8,15,-7,6,Brazil - Paraibano,0.12,0.5,-7,1.0,0.75,8.33,2.0,6
Picuiense,8,0,1,7,5,33,-28,1,Brazil - Paraibano,0.0,0.12,-28,0.62,0.12,0.0,8.33,7
Santa Catarina,8,4,3,1,14,9,5,15,Brazil - Catarinense,0.5,0.88,5,1.75,1.88,2.0,1.14,1
Brusque,8,4,2,2,12,6,6,14,Brazil - Catarinense,0.5,0.75,6,1.5,1.75,2.0,1.33,2
Avai,8,4,1,3,12,6,6,13,Brazil - Catarinense,0.5,0.62,6,1.5,1.62,2.0,1.61,3
Criciuma,8,3,4,1,10,4,6,13,Brazil - Catarinense,0.38,0.88,6,1.25,1.62,2.63,1.14,3
Figueirense,8,4,1,3,16,11,5,13,Brazil - Catarinense,0.5,0.62,5,2.0,1.62,2.0,1.61,3
Barra FC,8,3,3,2,6,7,-1,12,Brazil - Catarinense,0.38,0.75,-1,0.75,1.5,2.63,1.33,4
Marcilio Dias,8,2,4,2,7,8,-1,10,Brazil - Catarinense,0.25,0.75,-1,0.88,1.25,4.0,1.33,5
Concordia,8,3,1,4,8,15,-7,10,Brazil - Catarinense,0.38,0.5,-7,1.0,1.25,2.63,2.0,5
Chapecoense,8,1,6,1,10,9,1,9,Brazil - Catarinense,0.12,0.88,1,1.25,1.12,8.33,1.14,6
Joinville,8,2,3,3,9,14,-5,9,Brazil - Catarinense,0.25,0.62,-5,1.12,1.12,4.0,1.61,6
Caravaggio,8,2,1,5,5,12,-7,7,Brazil - Catarinense,0.25,0.38,-7,0.62,0.88,4.0,2.63,7
Hercilio Luz,8,1,2,5,6,13,-7,5,Brazil - Catarinense,0.12,0.38,-7,0.75,0.62,8.33,2.63,8
Internacional,8,6,2,0,16,4,12,20,Brazil - Gaucho,0.75,1.0,12,2.0,2.5,1.33,1.0,1
Juventude,8,6,1,1,14,6,8,19,Brazil - Gaucho,0.75,0.88,8,1.75,2.38,1.33,1.14,2
Gremio,8,5,2,1,19,3,16,17,Brazil - Gaucho,0.62,0.88,16,2.38,2.12,1.61,1.14,3
Caxias,8,4,2,2,8,9,-1,14,Brazil - Gaucho,0.5,0.75,-1,1.0,1.75,2.0,1.33,4
Ypiranga,8,3,3,2,6,6,0,12,Brazil - Gaucho,0.38,0.75,0,0.75,1.5,2.63,1.33,5
Guarany de Bage,8,2,3,3,6,6,0,9,Brazil - Gaucho,0.25,0.62,0,0.75,1.12,4.0,1.61,6
Sao Luiz,8,2,3,3,7,13,-6,9,Brazil - Gaucho,0.25,0.62,-6,0.88,1.12,4.0,1.61,6
Brasil de P.,8,1,4,3,5,10,-5,7,Brazil - Gaucho,0.12,0.62,-5,0.62,0.88,8.33,1.61,7
Monsoon,8,2,1,5,7,14,-7,7,Brazil - Gaucho,0.25,0.38,-7,0.88,0.88,4.0,2.63,7
Pelotas,8,1,3,4,6,13,-7,6,Brazil - Gaucho,0.12,0.5,-7,0.75,0.75,8.33,2.0,8
EC Sao Jose,8,0,5,3,5,10,-5,5,Brazil - Gaucho,0.0,0.62,-5,0.62,0.62,0.0,1.61,9
Avenida,8,0,3,5,4,9,-5,3,Brazil - Gaucho,0.0,0.38,-5,0.5,0.38,0.0,2.63,10
Levski Sofia,8,4,4,0,17,9,8,16,Bulgaria - Parva Liga,0.5,1.0,8,2.12,2.0,2.0,1.0,1
Slavia Sofia,8,4,4,0,15,10,5,16,Bulgaria - Parva Liga,0.5,1.0,5,1.88,2.0,2.0,1.0,1
CSKA Sofia,8,4,3,1,13,6,7,15,Bulgaria - Parva Liga,0.5,0.88,7,1.62,1.88,2.0,1.14,2
CSKA 1948 Sofia,8,4,2,2,16,10,6,14,Bulgaria - Parva Liga,0.5,0.75,6,2.0,1.75,2.0,1.33,3
Septemvri Sofia,8,4,2,2,14,9,5,14,Bulgaria - Parva Liga,0.5,0.75,5,1.75,1.75,2.0,1.33,3
Ludogorets,8,4,2,2,13,8,5,14,Bulgaria - Parva Liga,0.5,0.75,5,1.62,1.75,2.0,1.33,3
Arda,8,3,4,1,12,8,4,13,Bulgaria - Parva Liga,0.38,0.88,4,1.5,1.62,2.63,1.14,4
Lok. Plovdiv,8,4,1,3,7,6,1,13,Bulgaria - Parva Liga,0.5,0.62,1,0.88,1.62,2.0,1.61,4
Lokomotiv Sofia,8,4,0,4,14,9,5,12,Bulgaria - Parva Liga,0.5,0.5,5,1.75,1.5,2.0,2.0,5
Cherno More,8,2,5,1,10,9,1,11,Bulgaria - Parva Liga,0.25,0.88,1,1.25,1.38,4.0,1.14,6
Beroe,8,3,1,4,10,12,-2,10,Bulgaria - Parva Liga,0.38,0.5,-2,1.25,1.25,2.63,2.0,7
Spartak Varna,8,2,2,4,10,15,-5,8,Bulgaria - Parva Liga,0.25,0.5,-5,1.25,1.0,4.0,2.0,8
Botev Vratsa,8,1,2,5,5,13,-8,5,Bulgaria - Parva Liga,0.12,0.38,-8,0.62,0.62,8.33,2.63,9
L. Krumovgrad,8,0,4,4,2,10,-8,4,Bulgaria - Parva Liga,0.0,0.5,-8,0.25,0.5,0.0,2.0,10
Hebar,8,1,1,6,6,18,-12,4,Bulgaria - Parva Liga,0.12,0.25,-12,0.75,0.5,8.33,4.0,10
Botev Plovdiv,8,0,3,5,7,19,-12,3,Bulgaria - Parva Liga,0.0,0.38,-12,0.88,0.38,0.0,2.63,11
Coquimbo Unido,6,4,2,0,9,3,6,14,Chile - Primera Division,0.67,1.0,6,1.5,2.33,1.49,1.0,1
Huachipato,6,4,1,1,12,5,7,13,Chile - Primera Division,0.67,0.83,7,2.0,2.17,1.49,1.2,2
Palestino,6,4,1,1,11,5,6,13,Chile - Primera Division,0.67,0.83,6,1.83,2.17,1.49,1.2,2
Union La Calera,6,3,1,2,9,5,4,10,Chile - Primera Division,0.5,0.67,4,1.5,1.67,2.0,1.49,3
Audax Italiano,6,3,1,2,12,9,3,10,Chile - Primera Division,0.5,0.67,3,2.0,1.67,2.0,1.49,3
OHiggins,6,2,4,0,7,4,3,10,Chile - Primera Division,0.33,1.0,3,1.17,1.67,3.03,1.0,3
U. Catolica,5,3,1,1,7,4,3,10,Chile - Primera Division,0.6,0.8,3,1.4,2.0,1.67,1.25,3
Cobresal,6,2,2,2,8,7,1,8,Chile - Primera Division,0.33,0.67,1,1.33,1.33,3.03,1.49,4
U. de Chile,5,2,1,2,8,5,3,7,Chile - Primera Division,0.4,0.6,3,1.6,1.4,2.5,1.67,5
Colo-Colo,5,2,1,2,7,5,2,7,Chile - Primera Division,0.4,0.6,2,1.4,1.4,2.5,1.67,5
La Serena,6,2,1,3,6,10,-4,7,Chile - Primera Division,0.33,0.5,-4,1.0,1.17,3.03,2.0,5
Nublense,6,1,3,2,5,11,-6,6,Chile - Primera Division,0.17,0.67,-6,0.83,1.0,5.88,1.49,6
Everton,6,1,2,3,4,9,-5,5,Chile - Primera Division,0.17,0.5,-5,0.67,0.83,5.88,2.0,7
Union Espanola,5,1,0,4,5,10,-5,3,Chile - Primera Division,0.2,0.2,-5,1.0,0.6,5.0,5.0,8
D. Limache,6,0,2,4,7,13,-6,2,Chile - Primera Division,0.0,0.33,-6,1.17,0.33,0.0,3.03,9
D. Iquique,6,0,1,5,4,16,-12,1,Chile - Primera Division,0.0,0.17,-12,0.67,0.17,0.0,5.88,10
S. Wanderers,4,3,1,0,7,1,6,10,Chile - Primera B,0.75,1.0,6,1.75,2.5,1.33,1.0,1
U. Concepcion,5,3,1,1,6,3,3,10,Chile - Primera B,0.6,0.8,3,1.2,2.0,1.67,1.25,1
Recoleta,5,3,1,1,5,5,0,10,Chile - Primera B,0.6,0.8,0,1.0,2.0,1.67,1.25,1
Copiapo,4,2,2,0,7,3,4,8,Chile - Primera B,0.5,1.0,4,1.75,2.0,2.0,1.0,2
Magallanes,5,2,1,2,6,4,2,7,Chile - Primera B,0.4,0.6,2,1.2,1.4,2.5,1.67,3
Cobreloa,5,1,3,1,7,7,0,6,Chile - Primera B,0.2,0.8,0,1.4,1.2,5.0,1.25,4
Curico Unido,5,1,3,1,6,6,0,6,Chile - Primera B,0.2,0.8,0,1.2,1.2,5.0,1.25,4
San Luis,5,1,3,1,5,5,0,6,Chile - Primera B,0.2,0.8,0,1.0,1.2,5.0,1.25,4
Rangers,4,1,2,1,6,6,0,5,Chile - Primera B,0.25,0.75,0,1.5,1.25,4.0,1.33,5
Deportes Temuco,4,1,2,1,5,5,0,5,Chile - Primera B,0.25,0.75,0,1.25,1.25,4.0,1.33,5
S. Morning,4,1,2,1,4,4,0,5,Chile - Primera B,0.25,0.75,0,1.0,1.25,4.0,1.33,5
Antofagasta,5,1,2,2,5,9,-4,5,Chile - Primera B,0.2,0.6,-4,1.0,1.0,5.0,1.67,5
San Marcos,4,1,1,2,4,5,-1,4,Chile - Primera B,0.25,0.5,-1,1.0,1.0,4.0,2.0,6
CD Santa Cruz,5,1,1,3,5,8,-3,4,Chile - Primera B,0.2,0.4,-3,1.0,0.8,5.0,2.5,6
Concepcion,5,1,1,3,6,10,-4,4,Chile - Primera B,0.2,0.4,-4,1.2,0.8,5.0,2.5,6
U. San Felipe,5,0,2,3,2,5,-3,2,Chile - Primera B,0.0,0.4,-3,0.4,0.4,0.0,2.5,7
Shandong T.,3,2,1,0,8,4,4,7,China - Super League,0.67,1.0,4,2.67,2.33,1.49,1.0,1
Shanghai Port,3,2,1,0,8,4,4,7,China - Super League,0.67,1.0,4,2.67,2.33,1.49,1.0,1
S. Shenhua,3,2,1,0,7,4,3,7,China - Super League,0.67,1.0,3,2.33,2.33,1.49,1.0,1
Tianjin T.,3,2,1,0,5,3,2,7,China - Super League,0.67,1.0,2,1.67,2.33,1.49,1.0,1
Zhejiang,3,1,2,0,6,2,4,5,China - Super League,0.33,1.0,4,2.0,1.67,3.03,1.0,2
Qingdao West C.,3,1,2,0,7,5,2,5,China - Super League,0.33,1.0,2,2.33,1.67,3.03,1.0,2
Beijing Guoan,3,1,2,0,5,3,2,5,China - Super League,0.33,1.0,2,1.67,1.67,3.03,1.0,2
Meizhou Hakka,3,1,1,1,7,7,0,4,China - Super League,0.33,0.67,0,2.33,1.33,3.03,1.49,3
Chengdu,3,1,1,1,3,3,0,4,China - Super League,0.33,0.67,0,1.0,1.33,3.03,1.49,3
Yunnan Yukun,3,1,1,1,5,6,-1,4,China - Super League,0.33,0.67,-1,1.67,1.33,3.03,1.49,3
Dalian Yingbo,3,1,1,1,4,5,-1,4,China - Super League,0.33,0.67,-1,1.33,1.33,3.03,1.49,3
Sichuan Jiuniu,3,1,0,2,5,7,-2,3,China - Super League,0.33,0.33,-2,1.67,1.0,3.03,3.03,4
Qingdao Hainiu,3,0,1,2,2,4,-2,1,China - Super League,0.0,0.33,-2,0.67,0.33,0.0,3.03,5
Henan SL,3,0,1,2,2,5,-3,1,China - Super League,0.0,0.33,-3,0.67,0.33,0.0,3.03,5
Changchun Yatai,3,0,0,3,1,6,-5,0,China - Super League,0.0,0.0,-5,0.33,0.0,0.0,0.0,6
Wuhan Three T.,3,0,0,3,0,7,-7,0,China - Super League,0.0,0.0,-7,0.0,0.0,0.0,0.0,6
Guangdong GZP,2,2,0,0,6,0,6,6,China - League One,1.0,1.0,6,3.0,3.0,1.0,1.0,1
S. Gongfu,2,1,1,0,4,2,2,4,China - League One,0.5,1.0,2,2.0,2.0,2.0,1.0,2
Shaanxi Union,2,1,1,0,3,1,2,4,China - League One,0.5,1.0,2,1.5,2.0,2.0,1.0,2
Suzhou Dongwu,2,1,1,0,2,0,2,4,China - League One,0.5,1.0,2,1.0,2.0,2.0,1.0,2
Chongqing T.,2,1,1,0,3,2,1,4,China - League One,0.5,1.0,1,1.5,2.0,2.0,1.0,2
Liaoning Tieren,2,1,0,1,4,2,2,3,China - League One,0.5,0.5,2,2.0,1.5,2.0,2.0,3
Shenzhen J.,2,1,0,1,3,3,0,3,China - League One,0.5,0.5,0,1.5,1.5,2.0,2.0,3
Nanjing City,2,1,0,1,2,2,0,3,China - League One,0.5,0.5,0,1.0,1.5,2.0,2.0,3
Shanghai Jiadin,2,1,0,1,2,2,0,3,China - League One,0.5,0.5,0,1.0,1.5,2.0,2.0,3
Dalian Kuncheng,2,1,0,1,2,3,-1,3,China - League One,0.5,0.5,-1,1.0,1.5,2.0,2.0,3
Nantong Zhiyun,2,1,0,1,1,2,-1,3,China - League One,0.5,0.5,-1,0.5,1.5,2.0,2.0,3
Qingdao RL,2,0,2,0,2,2,0,2,China - League One,0.0,1.0,0,1.0,1.0,0.0,1.0,4
Heilongjiang IC,2,0,1,1,3,5,-2,1,China - League One,0.0,0.5,-2,1.5,0.5,0.0,2.0,5
Yanbian Longdin,2,0,1,1,1,5,-4,1,China - League One,0.0,0.5,-4,0.5,0.5,0.0,2.0,5
Foshan Nanshi,2,0,0,2,1,4,-3,0,China - League One,0.0,0.0,-3,0.5,0.0,0.0,0.0,6
Guangxi Baoyun,2,0,0,2,0,4,-4,0,China - League One,0.0,0.0,-4,0.0,0.0,0.0,0.0,6
Shanghai Port B,2,2,0,0,7,1,6,6,China - League Two,1.0,1.0,6,3.5,3.0,1.0,1.0,1
Chengdu Rongche,2,2,0,0,5,2,3,6,China - League Two,1.0,1.0,3,2.5,3.0,1.0,1.0,1
Changchun Xidu,2,2,0,0,4,1,3,6,China - League Two,1.0,1.0,3,2.0,3.0,1.0,1.0,1
Guizhou Zhuchen,2,1,1,0,2,0,2,4,China - League Two,0.5,1.0,2,1.0,2.0,2.0,1.0,2
Ganzhou Ruishi,2,1,1,0,1,0,1,4,China - League Two,0.5,1.0,1,0.5,2.0,2.0,1.0,2
Wuxi Wugou,2,1,1,0,1,0,1,4,China - League Two,0.5,1.0,1,0.5,2.0,2.0,1.0,2
Guangzhou Dande,2,1,0,1,3,2,1,3,China - League Two,0.5,0.5,1,1.5,1.5,2.0,2.0,3
Shenzhen 2028,2,1,0,1,1,2,-1,3,China - League Two,0.5,0.5,-1,0.5,1.5,2.0,2.0,3
Haikou M.,2,0,2,0,2,2,0,2,China - League Two,0.0,1.0,0,1.0,1.0,0.0,1.0,4
Jiangxi DH,2,0,2,0,2,2,0,2,China - League Two,0.0,1.0,0,1.0,1.0,0.0,1.0,4
Jiangxi Lushan,2,0,2,0,2,2,0,2,China - League Two,0.0,1.0,0,1.0,1.0,0.0,1.0,4
Langfang Glory,2,0,2,0,2,2,0,2,China - League Two,0.0,1.0,0,1.0,1.0,0.0,1.0,4
Nantong Haimen,2,0,2,0,2,2,0,2,China - League Two,0.0,1.0,0,1.0,1.0,0.0,1.0,4
Shandong T. B,2,0,2,0,2,2,0,2,China - League Two,0.0,1.0,0,1.0,1.0,0.0,1.0,4
Wuhan Three Tow,2,0,2,0,2,2,0,2,China - League Two,0.0,1.0,0,1.0,1.0,0.0,1.0,4
Quanzhou Yassin,2,0,2,0,1,1,0,2,China - League Two,0.0,1.0,0,0.5,1.0,0.0,1.0,4
Rizhao Yuqi,2,0,2,0,1,1,0,2,China - League Two,0.0,1.0,0,0.5,1.0,0.0,1.0,4
Taian Tiankuang,2,0,1,1,1,2,-1,1,China - League Two,0.0,0.5,-1,0.5,0.5,0.0,2.0,5
Guangxi Lanhang,2,0,1,1,0,1,-1,1,China - League Two,0.0,0.5,-1,0.0,0.5,0.0,2.0,5
Guangxi H.,2,0,1,1,1,3,-2,1,China - League Two,0.0,0.5,-2,0.5,0.5,0.0,2.0,5
Hubei Istar,2,0,1,1,1,3,-2,1,China - League Two,0.0,0.5,-2,0.5,0.5,0.0,2.0,5
Xian Ronghai,2,0,1,1,1,6,-5,1,China - League Two,0.0,0.5,-5,0.5,0.5,0.0,2.0,5
Beijing IT,2,0,0,2,0,2,-2,0,China - League Two,0.0,0.0,-2,0.0,0.0,0.0,0.0,6
Guangdong Mingt,2,0,0,2,1,4,-3,0,China - League Two,0.0,0.0,-3,0.5,0.0,0.0,0.0,6
America de Cali,8,5,2,1,12,2,10,17,Colombia - Primera A - Apertura,0.62,0.88,10,1.5,2.12,1.61,1.14,1
Junior,8,5,2,1,11,5,6,17,Colombia - Primera A - Apertura,0.62,0.88,6,1.38,2.12,1.61,1.14,1
Deportivo Pasto,8,5,2,1,10,4,6,17,Colombia - Primera A - Apertura,0.62,0.88,6,1.25,2.12,1.61,1.14,1
Santa Fe,8,5,1,2,15,8,7,16,Colombia - Primera A - Apertura,0.62,0.75,7,1.88,2.0,1.61,1.33,2
Millonarios,8,5,0,3,14,9,5,15,Colombia - Primera A - Apertura,0.62,0.62,5,1.75,1.88,1.61,1.61,3
I. Medelin,8,3,5,0,7,2,5,14,Colombia - Primera A - Apertura,0.38,1.0,5,0.88,1.75,2.63,1.0,4
A. Bucaramanga,8,3,4,1,7,4,3,13,Colombia - Primera A - Apertura,0.38,0.88,3,0.88,1.62,2.63,1.14,5
A. Nacional,8,3,3,2,15,12,3,12,Colombia - Primera A - Apertura,0.38,0.75,3,1.88,1.5,2.63,1.33,6
Deportivo Cali,8,2,6,0,8,5,3,12,Colombia - Primera A - Apertura,0.25,1.0,3,1.0,1.5,4.0,1.0,6
Deportes Tolima,8,3,3,2,10,8,2,12,Colombia - Primera A - Apertura,0.38,0.75,2,1.25,1.5,2.63,1.33,6
D. Pereira,8,3,2,3,7,9,-2,11,Colombia - Primera A - Apertura,0.38,0.62,-2,0.88,1.38,2.63,1.61,7
A. Petrolera,8,3,2,3,7,10,-3,11,Colombia - Primera A - Apertura,0.38,0.62,-3,0.88,1.38,2.63,1.61,7
Once Caldas,8,3,1,4,7,9,-2,10,Colombia - Primera A - Apertura,0.38,0.5,-2,0.88,1.25,2.63,2.0,8
Boyaca Chico,8,1,4,3,3,10,-7,7,Colombia - Primera A - Apertura,0.12,0.62,-7,0.38,0.88,8.33,1.61,9
Envigado,8,2,1,5,6,15,-9,7,Colombia - Primera A - Apertura,0.25,0.38,-9,0.75,0.88,4.0,2.63,9
R. Aguilas,8,1,3,4,3,6,-3,6,Colombia - Primera A - Apertura,0.12,0.5,-3,0.38,0.75,8.33,2.0,10
Fortaleza CEIF,8,1,3,4,5,13,-8,6,Colombia - Primera A - Apertura,0.12,0.5,-8,0.62,0.75,8.33,2.0,10
Llaneros,8,1,1,6,3,10,-7,4,Colombia - Primera A - Apertura,0.12,0.25,-7,0.38,0.5,8.33,4.0,11
La Equidad,8,0,3,5,5,10,-5,3,Colombia - Primera A - Apertura,0.0,0.38,-5,0.62,0.38,0.0,2.63,12
Union Magdalena,8,0,3,5,6,12,-6,3,Colombia - Primera A - Apertura,0.0,0.38,-6,0.75,0.38,0.0,2.63,12
I. Medelin,8,5,2,1,15,6,9,17,Colombia - Primera A - Clausura,0.62,0.88,9,1.88,2.12,1.61,1.14,1
Millonarios,8,5,2,1,11,4,7,17,Colombia - Primera A - Clausura,0.62,0.88,7,1.38,2.12,1.61,1.14,1
Junior,8,4,3,1,11,4,7,15,Colombia - Primera A - Clausura,0.5,0.88,7,1.38,1.88,2.0,1.14,2
Santa Fe,8,4,3,1,12,6,6,15,Colombia - Primera A - Clausura,0.5,0.88,6,1.5,1.88,2.0,1.14,2
D. Pereira,8,4,3,1,12,9,3,15,Colombia - Primera A - Clausura,0.5,0.88,3,1.5,1.88,2.0,1.14,2
Deportes Tolima,8,4,2,2,9,4,5,14,Colombia - Primera A - Clausura,0.5,0.75,5,1.12,1.75,2.0,1.33,3
Deportivo Pasto,8,4,1,3,14,11,3,13,Colombia - Primera A - Clausura,0.5,0.62,3,1.75,1.62,2.0,1.61,4
A. Nacional,8,3,4,1,9,7,2,13,Colombia - Primera A - Clausura,0.38,0.88,2,1.12,1.62,2.63,1.14,4
A. Bucaramanga,8,3,3,2,12,7,5,12,Colombia - Primera A - Clausura,0.38,0.75,5,1.5,1.5,2.63,1.33,5
America de Cali,8,3,2,3,10,10,0,11,Colombia - Primera A - Clausura,0.38,0.62,0,1.25,1.38,2.63,1.61,6
Fortaleza CEIF,8,3,1,4,9,8,1,10,Colombia - Primera A - Clausura,0.38,0.5,1,1.12,1.25,2.63,2.0,7
La Equidad,8,2,3,3,12,13,-1,9,Colombia - Primera A - Clausura,0.25,0.62,-1,1.5,1.12,4.0,1.61,8
Patriotas,8,2,2,4,12,14,-2,8,Colombia - Primera A - Clausura,0.25,0.5,-2,1.5,1.0,4.0,2.0,9
Deportivo Cali,8,2,2,4,5,9,-4,8,Colombia - Primera A - Clausura,0.25,0.5,-4,0.62,1.0,4.0,2.0,9
A. Petrolera,8,2,2,4,7,12,-5,8,Colombia - Primera A - Clausura,0.25,0.5,-5,0.88,1.0,4.0,2.0,9
Jaguares de C.,8,2,2,4,7,14,-7,8,Colombia - Primera A - Clausura,0.25,0.5,-7,0.88,1.0,4.0,2.0,9
Envigado,8,2,1,5,5,9,-4,7,Colombia - Primera A - Clausura,0.25,0.38,-4,0.62,0.88,4.0,2.63,10
Boyaca Chico,8,2,1,5,5,15,-10,7,Colombia - Primera A - Clausura,0.25,0.38,-10,0.62,0.88,4.0,2.63,10
Once Caldas,8,1,2,5,4,12,-8,5,Colombia - Primera A - Clausura,0.12,0.38,-8,0.5,0.62,8.33,2.63,11
R. Aguilas,8,1,1,6,4,15,-11,4,Colombia - Primera A - Clausura,0.12,0.25,-11,0.5,0.5,8.33,4.0,12
Saprissa,8,5,2,1,13,7,6,17,Costa Rica - Primera Div. - Apertura,0.62,0.88,6,1.62,2.12,1.61,1.14,1
Alajuelense,8,5,1,2,13,6,7,16,Costa Rica - Primera Div. - Apertura,0.62,0.75,7,1.62,2.0,1.61,1.33,2
Santos Guapiles,8,5,1,2,14,8,6,16,Costa Rica - Primera Div. - Apertura,0.62,0.75,6,1.75,2.0,1.61,1.33,2
Guanacasteca,8,4,1,3,11,11,0,13,Costa Rica - Primera Div. - Apertura,0.5,0.62,0,1.38,1.62,2.0,1.61,3
Herediano,8,3,3,2,11,9,2,12,Costa Rica - Primera Div. - Apertura,0.38,0.75,2,1.38,1.5,2.63,1.33,4
San Carlos,8,2,5,1,11,11,0,11,Costa Rica - Primera Div. - Apertura,0.25,0.88,0,1.38,1.38,4.0,1.14,5
Cartagines,8,3,1,4,15,18,-3,10,Costa Rica - Primera Div. - Apertura,0.38,0.5,-3,1.88,1.25,2.63,2.0,6
Zeledon,8,3,1,4,9,12,-3,10,Costa Rica - Primera Div. - Apertura,0.38,0.5,-3,1.12,1.25,2.63,2.0,6
M. Liberia,8,2,2,4,9,11,-2,8,Costa Rica - Primera Div. - Apertura,0.25,0.5,-2,1.12,1.0,4.0,2.0,7
Sporting SJ,8,2,1,5,10,11,-1,7,Costa Rica - Primera Div. - Apertura,0.25,0.38,-1,1.25,0.88,4.0,2.63,8
Santa Ana,8,2,1,5,7,11,-4,7,Costa Rica - Primera Div. - Apertura,0.25,0.38,-4,0.88,0.88,4.0,2.63,8
Puntarenas,8,2,1,5,8,16,-8,7,Costa Rica - Primera Div. - Apertura,0.25,0.38,-8,1.0,0.88,4.0,2.63,8
Banik Ostrava,8,7,0,1,16,4,12,21,CzechRepublic - 1. Liga,0.88,0.88,12,2.0,2.62,1.14,1.14,1
Slavia Prague,8,6,1,1,12,3,9,19,CzechRepublic - 1. Liga,0.75,0.88,9,1.5,2.38,1.33,1.14,2
Sparta Prague,8,6,0,2,16,9,7,18,CzechRepublic - 1. Liga,0.75,0.75,7,2.0,2.25,1.33,1.33,3
Hradec Kralove,8,4,3,1,12,9,3,15,CzechRepublic - 1. Liga,0.5,0.88,3,1.5,1.88,2.0,1.14,4
Sigma Olomouc,8,4,1,3,12,7,5,13,CzechRepublic - 1. Liga,0.5,0.62,5,1.5,1.62,2.0,1.61,5
Viktoria Plzen,8,4,1,3,13,10,3,13,CzechRepublic - 1. Liga,0.5,0.62,3,1.62,1.62,2.0,1.61,5
Slovan Liberec,8,3,3,2,11,6,5,12,CzechRepublic - 1. Liga,0.38,0.75,5,1.38,1.5,2.63,1.33,6
Jablonec,8,3,3,2,13,9,4,12,CzechRepublic - 1. Liga,0.38,0.75,4,1.62,1.5,2.63,1.33,6
Bohemians,8,3,3,2,7,7,0,12,CzechRepublic - 1. Liga,0.38,0.75,0,0.88,1.5,2.63,1.33,6
Karvina,8,3,3,2,12,13,-1,12,CzechRepublic - 1. Liga,0.38,0.75,-1,1.5,1.5,2.63,1.33,6
Dukla Praha,8,1,6,1,4,5,-1,9,CzechRepublic - 1. Liga,0.12,0.88,-1,0.5,1.12,8.33,1.14,7
Teplice,8,2,3,3,7,9,-2,9,CzechRepublic - 1. Liga,0.25,0.62,-2,0.88,1.12,4.0,1.61,7
Mlada Boleslav,8,2,0,6,9,14,-5,6,CzechRepublic - 1. Liga,0.25,0.25,-5,1.12,0.75,4.0,4.0,8
Slovacko,8,1,1,6,5,17,-12,4,CzechRepublic - 1. Liga,0.12,0.25,-12,0.62,0.5,8.33,4.0,9
C. Budejovice,8,0,1,7,6,16,-10,1,CzechRepublic - 1. Liga,0.0,0.12,-10,0.75,0.12,0.0,8.33,10
Pardubice,8,0,1,7,2,20,-18,1,CzechRepublic - 1. Liga,0.0,0.12,-18,0.25,0.12,0.0,8.33,10
FC Midtjylland,8,6,0,2,15,7,8,18,Denmark - Superligaen,0.75,0.75,8,1.88,2.25,1.33,1.33,1
FC Kobenhavn,8,4,3,1,12,8,4,15,Denmark - Superligaen,0.5,0.88,4,1.5,1.88,2.0,1.14,2
Brondby IF,8,3,4,1,16,12,4,13,Denmark - Superligaen,0.38,0.88,4,2.0,1.62,2.63,1.14,3
AGF Aarhus,8,3,3,2,15,8,7,12,Denmark - Superligaen,0.38,0.75,7,1.88,1.5,2.63,1.33,4
Nordsjaelland,8,4,0,4,11,12,-1,12,Denmark - Superligaen,0.5,0.5,-1,1.38,1.5,2.0,2.0,4
Randers FC,8,3,2,3,12,11,1,11,Denmark - Superligaen,0.38,0.62,1,1.5,1.38,2.63,1.61,5
Viborg,8,3,2,3,14,14,0,11,Denmark - Superligaen,0.38,0.62,0,1.75,1.38,2.63,1.61,5
Vejle BK,8,3,1,4,10,16,-6,10,Denmark - Superligaen,0.38,0.5,-6,1.25,1.25,2.63,2.0,6
Silkeborg,8,2,2,4,11,10,1,8,Denmark - Superligaen,0.25,0.5,1,1.38,1.0,4.0,2.0,7
Lyngby,8,2,2,4,5,8,-3,8,Denmark - Superligaen,0.25,0.5,-3,0.62,1.0,4.0,2.0,7
SonderjyskE,8,2,2,4,11,17,-6,8,Denmark - Superligaen,0.25,0.5,-6,1.38,1.0,4.0,2.0,7
Aalborg BK,8,1,2,5,5,15,-10,5,Denmark - Superligaen,0.12,0.38,-10,0.62,0.62,8.33,2.63,8
Fredericia,8,5,0,3,11,5,6,15,Denmark - 1st Division,0.62,0.62,6,1.38,1.88,1.61,1.61,1
Hillerod,8,3,4,1,14,8,6,13,Denmark - 1st Division,0.38,0.88,6,1.75,1.62,2.63,1.14,2
AC Horsens,8,4,1,3,14,12,2,13,Denmark - 1st Division,0.5,0.62,2,1.75,1.62,2.0,1.61,2
Hvidovre,8,4,1,3,7,8,-1,13,Denmark - 1st Division,0.5,0.62,-1,0.88,1.62,2.0,1.61,2
Esbjerg,8,4,0,4,10,7,3,12,Denmark - 1st Division,0.5,0.5,3,1.25,1.5,2.0,2.0,3
Odense BK,8,2,6,0,11,9,2,12,Denmark - 1st Division,0.25,1.0,2,1.38,1.5,4.0,1.0,3
HB Koge,8,3,3,2,9,12,-3,12,Denmark - 1st Division,0.38,0.75,-3,1.12,1.5,2.63,1.33,3
Kolding IF,8,3,2,3,7,5,2,11,Denmark - 1st Division,0.38,0.62,2,0.88,1.38,2.63,1.61,4
Hobro,8,2,3,3,8,10,-2,9,Denmark - 1st Division,0.25,0.62,-2,1.0,1.12,4.0,1.61,5
Roskilde,8,2,1,5,8,13,-5,7,Denmark - 1st Division,0.25,0.38,-5,1.0,0.88,4.0,2.63,6
B 93,8,1,4,3,12,19,-7,7,Denmark - 1st Division,0.12,0.62,-7,1.5,0.88,8.33,1.61,6
Vendsyssel,8,1,3,4,7,10,-3,6,Denmark - 1st Division,0.12,0.5,-3,0.88,0.75,8.33,2.0,7
Aarhus Fremad,8,5,1,2,10,4,6,16,Denmark - 2nd Division,0.62,0.75,6,1.25,2.0,1.61,1.33,1
Naestved,8,5,1,2,9,6,3,16,Denmark - 2nd Division,0.62,0.75,3,1.12,2.0,1.61,1.33,1
AB Copenhagen,8,4,2,2,16,9,7,14,Denmark - 2nd Division,0.5,0.75,7,2.0,1.75,2.0,1.33,2
Skive,8,4,2,2,8,7,1,14,Denmark - 2nd Division,0.5,0.75,1,1.0,1.75,2.0,1.33,2
Hellerup IK,8,4,1,3,7,11,-4,13,Denmark - 2nd Division,0.5,0.62,-4,0.88,1.62,2.0,1.61,3
Middelfart,8,3,3,2,11,10,1,12,Denmark - 2nd Division,0.38,0.75,1,1.38,1.5,2.63,1.33,4
BK Frem,8,2,4,2,8,7,1,10,Denmark - 2nd Division,0.25,0.75,1,1.0,1.25,4.0,1.33,5
Thisted,8,2,2,4,11,13,-2,8,Denmark - 2nd Division,0.25,0.5,-2,1.38,1.0,4.0,2.0,6
Fremad Amager,8,2,2,4,8,10,-2,8,Denmark - 2nd Division,0.25,0.5,-2,1.0,1.0,4.0,2.0,6
Ishoj,8,2,2,4,6,11,-5,8,Denmark - 2nd Division,0.25,0.5,-5,0.75,1.0,4.0,2.0,6
Helsingor,8,0,6,2,7,10,-3,6,Denmark - 2nd Division,0.0,0.75,-3,0.88,0.75,0.0,1.33,7
Nykobing,8,1,2,5,10,13,-3,5,Denmark - 2nd Division,0.12,0.38,-3,1.25,0.62,8.33,2.63,8
Barcelona SC,6,5,0,1,11,7,4,15,Ecuador - Liga Pro 1st Stage,0.83,0.83,4,1.83,2.5,1.2,1.2,1
LDU Quito,6,3,2,1,10,3,7,11,Ecuador - Liga Pro 1st Stage,0.5,0.83,7,1.67,1.83,2.0,1.2,2
Libertad,6,3,2,1,11,8,3,11,Ecuador - Liga Pro 1st Stage,0.5,0.83,3,1.83,1.83,2.0,1.2,2
Cuniburo,6,3,2,1,10,8,2,11,Ecuador - Liga Pro 1st Stage,0.5,0.83,2,1.67,1.83,2.0,1.2,2
U. Catolica,6,2,3,1,12,6,6,9,Ecuador - Liga Pro 1st Stage,0.33,0.83,6,2.0,1.5,3.03,1.2,3
I. del Valle,6,2,3,1,9,6,3,9,Ecuador - Liga Pro 1st Stage,0.33,0.83,3,1.5,1.5,3.03,1.2,3
Macara,6,2,3,1,5,4,1,9,Ecuador - Liga Pro 1st Stage,0.33,0.83,1,0.83,1.5,3.03,1.2,3
Orense,6,3,0,3,6,11,-5,9,Ecuador - Liga Pro 1st Stage,0.5,0.5,-5,1.0,1.5,2.0,2.0,3
Mushuc Runa,6,2,2,2,8,6,2,8,Ecuador - Liga Pro 1st Stage,0.33,0.67,2,1.33,1.33,3.03,1.49,4
Aucas,6,2,2,2,9,8,1,8,Ecuador - Liga Pro 1st Stage,0.33,0.67,1,1.5,1.33,3.03,1.49,4
D. Cuenca,6,2,1,3,5,6,-1,7,Ecuador - Liga Pro 1st Stage,0.33,0.5,-1,0.83,1.17,3.03,2.0,5
Manta,6,1,2,3,10,14,-4,5,Ecuador - Liga Pro 1st Stage,0.17,0.5,-4,1.67,0.83,5.88,2.0,6
Tecnico U.,6,1,2,3,5,9,-4,5,Ecuador - Liga Pro 1st Stage,0.17,0.5,-4,0.83,0.83,5.88,2.0,6
Delfin,6,1,2,3,4,9,-5,5,Ecuador - Liga Pro 1st Stage,0.17,0.5,-5,0.67,0.83,5.88,2.0,6
Emelec,6,1,2,3,3,9,-6,5,Ecuador - Liga Pro 1st Stage,0.17,0.5,-6,0.5,0.83,5.88,2.0,6
El Nacional,6,0,2,4,4,8,-4,2,Ecuador - Liga Pro 1st Stage,0.0,0.33,-4,0.67,0.33,0.0,3.03,7
Cumbaya,2,2,0,0,3,0,3,6,Ecuador - Serie B,1.0,1.0,3,1.5,3.0,1.0,1.0,1
Leones Norte,2,1,1,0,3,1,2,4,Ecuador - Serie B,0.5,1.0,2,1.5,2.0,2.0,1.0,2
Gualaceo,2,1,1,0,4,3,1,4,Ecuador - Serie B,0.5,1.0,1,2.0,2.0,2.0,1.0,2
Guayaquil City,2,1,0,1,4,2,2,3,Ecuador - Serie B,0.5,0.5,2,2.0,1.5,2.0,2.0,3
Vargas Torres,2,1,0,1,2,2,0,3,Ecuador - Serie B,0.5,0.5,0,1.0,1.5,2.0,2.0,3
Vinotinto,2,1,0,1,2,2,0,3,Ecuador - Serie B,0.5,0.5,0,1.0,1.5,2.0,2.0,3
San Antonio,2,1,0,1,3,4,-1,3,Ecuador - Serie B,0.5,0.5,-1,1.5,1.5,2.0,2.0,3
22 de Julio,2,0,2,0,1,1,0,2,Ecuador - Serie B,0.0,1.0,0,0.5,1.0,0.0,1.0,4
Nueve Octubre,2,0,2,0,1,1,0,2,Ecuador - Serie B,0.0,1.0,0,0.5,1.0,0.0,1.0,4
Chacaritas,2,0,1,1,3,4,-1,1,Ecuador - Serie B,0.0,0.5,-1,1.5,0.5,0.0,2.0,5
Imbabura,2,0,1,1,1,3,-2,1,Ecuador - Serie B,0.0,0.5,-2,0.5,0.5,0.0,2.0,5
I. Juniors,2,0,0,2,0,4,-4,0,Ecuador - Serie B,0.0,0.0,-4,0.0,0.0,0.0,0.0,6
Pyramids FC,8,7,1,0,15,3,12,22,Egypt - Premier League,0.88,1.0,12,1.88,2.75,1.14,1.0,1
Al Ahly,8,6,1,1,14,6,8,19,Egypt - Premier League,0.75,0.88,8,1.75,2.38,1.33,1.14,2
Zamalek,8,4,3,1,12,6,6,15,Egypt - Premier League,0.5,0.88,6,1.5,1.88,2.0,1.14,3
National Bank,8,4,3,1,14,9,5,15,Egypt - Premier League,0.5,0.88,5,1.75,1.88,2.0,1.14,3
El Gouna,8,4,2,2,9,4,5,14,Egypt - Premier League,0.5,0.75,5,1.12,1.75,2.0,1.33,4
Pharco,8,4,2,2,9,7,2,14,Egypt - Premier League,0.5,0.75,2,1.12,1.75,2.0,1.33,4
Al Masry,8,3,4,1,10,5,5,13,Egypt - Premier League,0.38,0.88,5,1.25,1.62,2.63,1.14,5
ZED FC,8,2,5,1,11,7,4,11,Egypt - Premier League,0.25,0.88,4,1.38,1.38,4.0,1.14,6
Haras El Hodood,8,3,1,4,8,10,-2,10,Egypt - Premier League,0.38,0.5,-2,1.0,1.25,2.63,2.0,7
El Geish,8,2,3,3,6,8,-2,9,Egypt - Premier League,0.25,0.62,-2,0.75,1.12,4.0,1.61,8
Ghazl El M.,8,3,0,5,9,12,-3,9,Egypt - Premier League,0.38,0.38,-3,1.12,1.12,2.63,2.63,8
Petrojet,8,2,3,3,9,12,-3,9,Egypt - Premier League,0.25,0.62,-3,1.12,1.12,4.0,1.61,8
Smouha,8,3,0,5,4,11,-7,9,Egypt - Premier League,0.38,0.38,-7,0.5,1.12,2.63,2.63,8
Ceramica C.,8,2,2,4,10,11,-1,8,Egypt - Premier League,0.25,0.5,-1,1.25,1.0,4.0,2.0,9
Modern Sport,8,1,2,5,8,13,-5,5,Egypt - Premier League,0.12,0.38,-5,1.0,0.62,8.33,2.63,10
Al Ittihad,8,1,2,5,6,12,-6,5,Egypt - Premier League,0.12,0.38,-6,0.75,0.62,8.33,2.63,10
ENPPI,8,1,2,5,5,13,-8,5,Egypt - Premier League,0.12,0.38,-8,0.62,0.62,8.33,2.63,10
Ismaily,8,1,2,5,4,14,-10,5,Egypt - Premier League,0.12,0.38,-10,0.5,0.62,8.33,2.63,10
Liverpool,8,6,2,0,19,7,12,20,Premier League,0.75,1.0,12,2.38,2.5,1.33,1.0,1
Crystal Palace,8,6,0,2,15,5,10,18,Premier League,0.75,0.75,10,1.88,2.25,1.33,1.33,3
Brighton,8,5,1,2,16,13,3,16,Premier League,0.62,0.75,3,2.0,2.0,1.61,1.33,4
Arsenal,8,4,3,1,12,5,7,15,Premier League,0.5,0.88,7,1.5,1.88,2.0,1.14,5
Fulham,8,5,0,3,11,8,3,15,Premier League,0.62,0.62,3,1.38,1.88,1.61,1.61,5
Everton,8,3,5,0,14,8,6,14,Premier League,0.38,1.0,6,1.75,1.75,2.63,1.0,6
Manchester City,8,4,1,3,17,11,6,13,Premier League,0.5,0.62,6,2.12,1.62,2.0,1.61,7
Nottm Forest,8,4,1,3,19,15,4,13,Premier League,0.5,0.62,4,2.38,1.62,2.0,1.61,7
Brentford,8,4,1,3,10,8,2,13,Premier League,0.5,0.62,2,1.25,1.62,2.0,1.61,7
Chelsea,8,4,0,4,12,11,1,12,Premier League,0.5,0.5,1,1.5,1.5,2.0,2.0,8
Newcastle Utd,8,4,0,4,13,16,-3,12,Premier League,0.5,0.5,-3,1.62,1.5,2.0,2.0,8
Manchester Utd,8,3,2,3,11,11,0,11,Premier League,0.38,0.62,0,1.38,1.38,2.63,1.61,9
Bournemouth,8,3,1,4,16,11,5,10,Premier League,0.38,0.5,5,2.0,1.25,2.63,2.0,10
Tottenham,8,3,1,4,12,11,1,10,Premier League,0.38,0.5,1,1.5,1.25,2.63,2.0,10
Wolverhampton,8,3,1,4,9,10,-1,10,Premier League,0.38,0.5,-1,1.12,1.25,2.63,2.0,10
Aston Villa,8,2,4,2,10,13,-3,10,Premier League,0.25,0.75,-3,1.25,1.25,4.0,1.33,10
West Ham Utd,8,2,2,4,6,8,-2,8,Premier League,0.25,0.5,-2,0.75,1.0,4.0,2.0,12
Southampton,8,1,0,7,8,23,-15,3,Premier League,0.12,0.12,-15,1.0,0.38,8.33,8.33,17
Leicester City,8,1,0,7,2,19,-17,3,Premier League,0.12,0.12,-17,0.25,0.38,8.33,8.33,17
Ipswich Town,8,0,1,7,8,25,-17,1,Premier League,0.0,0.12,-17,1.0,0.12,0.0,8.33,18
Burnley,8,6,2,0,16,2,14,20,Premier League,0.75,1.0,14,2.0,2.5,1.33,1.0,1
Sheffield Utd,8,6,1,1,13,7,6,19,Premier League,0.75,0.88,6,1.62,2.38,1.33,1.14,2
Coventry City,8,6,0,2,15,11,4,18,Premier League,0.75,0.75,4,1.88,2.25,1.33,1.33,3
Leeds Utd,8,4,3,1,16,8,8,15,Premier League,0.5,0.88,8,2.0,1.88,2.0,1.14,5
Bristol City,8,4,3,1,11,6,5,15,Premier League,0.5,0.88,5,1.38,1.88,2.0,1.14,5
Portsmouth,8,5,0,3,10,7,3,15,Premier League,0.62,0.62,3,1.25,1.88,1.61,1.61,5
Middlesbrough,8,4,1,3,9,7,2,13,Premier League,0.5,0.62,2,1.12,1.62,2.0,1.61,7
Sunderland,8,4,1,3,9,9,0,13,Premier League,0.5,0.62,0,1.12,1.62,2.0,1.61,7
Hull City,8,3,3,2,8,6,2,12,Premier League,0.38,0.75,2,1.0,1.5,2.63,1.33,8
Derby County,8,3,2,3,8,10,-2,11,Premier League,0.38,0.62,-2,1.0,1.38,2.63,1.61,9
Millwall,8,3,2,3,6,8,-2,11,Premier League,0.38,0.62,-2,0.75,1.38,2.63,1.61,9
Watford,8,3,2,3,5,7,-2,11,Premier League,0.38,0.62,-2,0.62,1.38,2.63,1.61,9
Luton Town,8,3,2,3,5,9,-4,11,Premier League,0.38,0.62,-4,0.62,1.38,2.63,1.61,9
West Brom,8,2,4,2,7,7,0,10,Premier League,0.25,0.75,0,0.88,1.25,4.0,1.33,10
Preston,8,2,4,2,6,6,0,10,Premier League,0.25,0.75,0,0.75,1.25,4.0,1.33,10
Stoke City,8,3,1,4,12,13,-1,10,Premier League,0.38,0.5,-1,1.5,1.25,2.63,2.0,10
Sheffield Wed,8,3,1,4,10,12,-2,10,Premier League,0.38,0.5,-2,1.25,1.25,2.63,2.0,10
Norwich City,8,2,3,3,11,11,0,9,Premier League,0.25,0.62,0,1.38,1.12,4.0,1.61,11
Cardiff City,8,2,3,3,9,10,-1,9,Premier League,0.25,0.62,-1,1.12,1.12,4.0,1.61,11
Swansea City,8,2,2,4,7,9,-2,8,Premier League,0.25,0.5,-2,0.88,1.0,4.0,2.0,12
Blackburn,8,2,1,5,7,10,-3,7,Premier League,0.25,0.38,-3,0.88,0.88,4.0,2.63,13
Plymouth,8,1,3,4,6,13,-7,6,Premier League,0.12,0.5,-7,0.75,0.75,8.33,2.0,14
Oxford Utd,8,1,2,5,6,12,-6,5,Premier League,0.12,0.38,-6,0.75,0.62,8.33,2.63,15
QP Rangers,8,1,1,6,10,13,-3,4,Premier League,0.12,0.25,-3,1.25,0.5,8.33,4.0,16
Charlton,8,6,1,1,13,5,8,19,League One,0.75,0.88,8,1.62,2.38,1.33,1.14,1
Wrexham,8,6,1,1,8,3,5,19,League One,0.75,0.88,5,1.0,2.38,1.33,1.14,1
Birmingham City,8,5,2,1,12,6,6,17,League One,0.62,0.88,6,1.5,2.12,1.61,1.14,2
Blackpool,8,5,1,2,14,7,7,16,League One,0.62,0.75,7,1.75,2.0,1.61,1.33,3
Reading,8,4,4,0,11,5,6,16,League One,0.5,1.0,6,1.38,2.0,2.0,1.0,3
Peterborough,8,4,3,1,11,6,5,15,League One,0.5,0.88,5,1.38,1.88,2.0,1.14,4
Wycombe,8,4,2,2,9,5,4,14,League One,0.5,0.75,4,1.12,1.75,2.0,1.33,5
Stockport,8,4,2,2,8,6,2,14,League One,0.5,0.75,2,1.0,1.75,2.0,1.33,5
Bolton,8,4,1,3,13,11,2,13,League One,0.5,0.62,2,1.62,1.62,2.0,1.61,6
Barnsley,8,3,2,3,10,12,-2,11,League One,0.38,0.62,-2,1.25,1.38,2.63,1.61,7
Lincoln City,8,3,1,4,15,8,7,10,League One,0.38,0.5,7,1.88,1.25,2.63,2.0,8
Wigan Athletic,8,2,4,2,7,7,0,10,League One,0.25,0.75,0,0.88,1.25,4.0,1.33,8
Northampton,8,2,4,2,9,10,-1,10,League One,0.25,0.75,-1,1.12,1.25,4.0,1.33,8
Exeter City,8,2,4,2,6,7,-1,10,League One,0.25,0.75,-1,0.75,1.25,4.0,1.33,8
Burton Albion,8,3,1,4,8,10,-2,10,League One,0.38,0.5,-2,1.0,1.25,2.63,2.0,8
Huddersfield,8,3,0,5,9,11,-2,9,League One,0.38,0.38,-2,1.12,1.12,2.63,2.63,9
Leyton Orient,8,3,0,5,8,11,-3,9,League One,0.38,0.38,-3,1.0,1.12,2.63,2.63,9
Mansfield,8,2,3,3,7,11,-4,9,League One,0.25,0.62,-4,0.88,1.12,4.0,1.61,9
Cambridge Utd,8,2,2,4,7,7,0,8,League One,0.25,0.5,0,0.88,1.0,4.0,2.0,10
Stevenage,8,2,2,4,6,8,-2,8,League One,0.25,0.5,-2,0.75,1.0,4.0,2.0,10
Rotherham,8,2,1,5,8,14,-6,7,League One,0.25,0.38,-6,1.0,0.88,4.0,2.63,11
Crawley Town,8,2,1,5,9,16,-7,7,League One,0.25,0.38,-7,1.12,0.88,4.0,2.63,11
Bristol Rovers,8,2,1,5,8,15,-7,7,League One,0.25,0.38,-7,1.0,0.88,4.0,2.63,11
Shrewsbury,8,0,1,7,4,16,-12,1,League One,0.0,0.12,-12,0.5,0.12,0.0,8.33,12
Bradford,8,5,1,2,12,4,8,16,League Two,0.62,0.75,8,1.5,2.0,1.61,1.33,1
Colchester Utd,8,5,1,2,11,8,3,16,League Two,0.62,0.75,3,1.38,2.0,1.61,1.33,1
Doncaster,8,4,2,2,13,7,6,14,League Two,0.5,0.75,6,1.62,1.75,2.0,1.33,2
Grimsby,8,4,2,2,10,8,2,14,League Two,0.5,0.75,2,1.25,1.75,2.0,1.33,2
Chesterfield,8,4,1,3,10,7,3,13,League Two,0.5,0.62,3,1.25,1.62,2.0,1.61,3
Accrington,8,3,3,2,10,5,5,12,League Two,0.38,0.75,5,1.25,1.5,2.63,1.33,4
Port Vale,8,3,3,2,8,5,3,12,League Two,0.38,0.75,3,1.0,1.5,2.63,1.33,4
Fleetwood,8,3,3,2,14,12,2,12,League Two,0.38,0.75,2,1.75,1.5,2.63,1.33,4
Tranmere,8,3,3,2,8,6,2,12,League Two,0.38,0.75,2,1.0,1.5,2.63,1.33,4
Harrogate,8,3,3,2,5,7,-2,12,League Two,0.38,0.75,-2,0.62,1.5,2.63,1.33,4
Notts County,8,3,2,3,10,9,1,11,League Two,0.38,0.62,1,1.25,1.38,2.63,1.61,5
Barrow,8,3,2,3,9,10,-1,11,League Two,0.38,0.62,-1,1.12,1.38,2.63,1.61,5
Crewe Alexandra,8,2,4,2,9,8,1,10,League Two,0.25,0.75,1,1.12,1.25,4.0,1.33,6
Bromley,8,3,1,4,10,10,0,10,League Two,0.38,0.5,0,1.25,1.25,2.63,2.0,6
Swindon Town,8,2,4,2,9,9,0,10,League Two,0.25,0.75,0,1.12,1.25,4.0,1.33,6
Gillingham,8,2,4,2,6,7,-1,10,League Two,0.25,0.75,-1,0.75,1.25,4.0,1.33,6
AFC Wimbledon,8,2,3,3,9,9,0,9,League Two,0.25,0.62,0,1.12,1.12,4.0,1.61,7
Carlisle Utd,8,2,3,3,7,10,-3,9,League Two,0.25,0.62,-3,0.88,1.12,4.0,1.61,7
Walsall,8,1,5,2,9,10,-1,8,League Two,0.12,0.75,-1,1.12,1.0,8.33,1.33,8
Salford City,8,2,2,4,9,14,-5,8,League Two,0.25,0.5,-5,1.12,1.0,4.0,2.0,8
Morecambe,8,2,1,5,5,9,-4,7,League Two,0.25,0.38,-4,0.62,0.88,4.0,2.63,9
Milton Keynes,8,2,1,5,7,15,-8,7,League Two,0.25,0.38,-8,0.88,0.88,4.0,2.63,9
Cheltenham,8,1,3,4,8,14,-6,6,League Two,0.12,0.5,-6,1.0,0.75,8.33,2.0,10
Newport,8,2,0,6,7,17,-10,6,League Two,0.25,0.25,-10,0.88,0.75,4.0,4.0,10
Barnet,8,8,0,0,21,2,19,24,England - National League,1.0,1.0,19,2.62,3.0,1.0,1.0,1
Tamworth,8,5,3,0,17,7,10,18,England - National League,0.62,1.0,10,2.12,2.25,1.61,1.0,2
Boston Utd,8,5,2,1,15,9,6,17,England - National League,0.62,0.88,6,1.88,2.12,1.61,1.14,3
Aldershot Town,8,5,2,1,15,11,4,17,England - National League,0.62,0.88,4,1.88,2.12,1.61,1.14,3
York City,8,5,1,2,15,6,9,16,England - National League,0.62,0.75,9,1.88,2.0,1.61,1.33,4
Rochdale,8,4,2,2,16,10,6,14,England - National League,0.5,0.75,6,2.0,1.75,2.0,1.33,5
Braintree Town,8,4,2,2,13,9,4,14,England - National League,0.5,0.75,4,1.62,1.75,2.0,1.33,5
Southend Utd,8,3,4,1,12,12,0,13,England - National League,0.38,0.88,0,1.5,1.62,2.63,1.14,6
Forest Green,8,3,3,2,10,10,0,12,England - National League,0.38,0.75,0,1.25,1.5,2.63,1.33,7
Halifax Town,8,3,2,3,8,7,1,11,England - National League,0.38,0.62,1,1.0,1.38,2.63,1.61,8
AFC Fylde,8,3,1,4,9,9,0,10,England - National League,0.38,0.5,0,1.12,1.25,2.63,2.0,9
Oldham,8,2,4,2,8,8,0,10,England - National League,0.25,0.75,0,1.0,1.25,4.0,1.33,9
Woking,8,2,4,2,8,8,0,10,England - National League,0.25,0.75,0,1.0,1.25,4.0,1.33,9
Yeovil Town,8,3,1,4,8,12,-4,10,England - National League,0.38,0.5,-4,1.0,1.25,2.63,2.0,9
Wealdstone,8,3,1,4,12,19,-7,10,England - National League,0.38,0.5,-7,1.5,1.25,2.63,2.0,9
Sutton Utd,8,2,3,3,8,11,-3,9,England - National League,0.25,0.62,-3,1.0,1.12,4.0,1.61,10
Dagenham & R.,8,2,3,3,7,10,-3,9,England - National League,0.25,0.62,-3,0.88,1.12,4.0,1.61,10
Hartlepool,8,2,2,4,11,11,0,8,England - National League,0.25,0.5,0,1.38,1.0,4.0,2.0,11
Eastleigh,8,1,3,4,8,12,-4,6,England - National League,0.12,0.5,-4,1.0,0.75,8.33,2.0,12
Ebbsfleet Utd,8,1,3,4,11,16,-5,6,England - National League,0.12,0.5,-5,1.38,0.75,8.33,2.0,12
Solihull Moors,8,1,3,4,7,14,-7,6,England - National League,0.12,0.5,-7,0.88,0.75,8.33,2.0,12
Maidenhead Utd,8,1,2,5,7,12,-5,5,England - National League,0.12,0.38,-5,0.88,0.62,8.33,2.63,13
Altrincham,8,1,2,5,7,13,-6,5,England - National League,0.12,0.38,-6,0.88,0.62,8.33,2.63,13
Gateshead FC,8,0,2,6,5,16,-11,2,England - National League,0.0,0.25,-11,0.62,0.25,0.0,4.0,14
Kidderminster,8,7,1,0,24,2,22,22,England - National L. North,0.88,1.0,22,3.0,2.75,1.14,1.0,1
Marine,8,6,2,0,9,3,6,20,England - National L. North,0.75,1.0,6,1.12,2.5,1.33,1.0,2
Scunthorpe,8,6,1,1,13,3,10,19,England - National L. North,0.75,0.88,10,1.62,2.38,1.33,1.14,3
Brackley Town,8,5,1,2,16,6,10,16,England - National L. North,0.62,0.75,10,2.0,2.0,1.61,1.33,4
Spennymoor,8,5,1,2,14,9,5,16,England - National L. North,0.62,0.75,5,1.75,2.0,1.61,1.33,4
Buxton,8,4,1,3,13,6,7,13,England - National L. North,0.5,0.62,7,1.62,1.62,2.0,1.61,5
Chorley,8,4,1,3,17,11,6,13,England - National L. North,0.5,0.62,6,2.12,1.62,2.0,1.61,5
Hereford Utd,8,4,1,3,13,8,5,13,England - National L. North,0.5,0.62,5,1.62,1.62,2.0,1.61,5
Scarborough,8,4,1,3,10,7,3,13,England - National L. North,0.5,0.62,3,1.25,1.62,2.0,1.61,5
Kings Lynn,8,4,1,3,7,7,0,13,England - National L. North,0.5,0.62,0,0.88,1.62,2.0,1.61,5
Oxford City,8,3,4,1,8,9,-1,13,England - National L. North,0.38,0.88,-1,1.0,1.62,2.63,1.14,5
Chester,8,3,3,2,10,9,1,12,England - National L. North,0.38,0.75,1,1.25,1.5,2.63,1.33,6
Darlington,8,3,3,2,13,13,0,12,England - National L. North,0.38,0.75,0,1.62,1.5,2.63,1.33,6
Curzon,8,3,2,3,10,9,1,11,England - National L. North,0.38,0.62,1,1.25,1.38,2.63,1.61,7
Peterborough S.,8,3,2,3,11,11,0,11,England - National L. North,0.38,0.62,0,1.38,1.38,2.63,1.61,7
Leamington,8,3,1,4,8,7,1,10,England - National L. North,0.38,0.5,1,1.0,1.25,2.63,2.0,8
Rushall,8,2,2,4,7,15,-8,8,England - National L. North,0.25,0.5,-8,0.88,1.0,4.0,2.0,9
Radcliffe,8,2,1,5,11,12,-1,7,England - National L. North,0.25,0.38,-1,1.38,0.88,4.0,2.63,10
Alfreton Town,8,1,4,3,5,10,-5,7,England - National L. North,0.12,0.62,-5,0.62,0.88,8.33,1.61,10
Southport,8,2,1,5,4,9,-5,7,England - National L. North,0.25,0.38,-5,0.5,0.88,4.0,2.63,10
South Shields,8,2,0,6,9,19,-10,6,England - National L. North,0.25,0.25,-10,1.12,0.75,4.0,4.0,11
Warrington,8,1,2,5,8,16,-8,5,England - National L. North,0.12,0.38,-8,1.0,0.62,8.33,2.63,12
Needham Market,8,1,2,5,6,16,-10,5,England - National L. North,0.12,0.38,-10,0.75,0.62,8.33,2.63,12
Farsley Celtic,8,0,0,8,1,26,-25,0,England - National L. North,0.0,0.0,-25,0.12,0.0,0.0,0.0,13
Worthing,8,6,0,2,14,6,8,18,England - National L. South,0.75,0.75,8,1.75,2.25,1.33,1.33,1
Torquay Utd,8,5,3,0,12,6,6,18,England - National L. South,0.62,1.0,6,1.5,2.25,1.61,1.0,1
Eastbourne,8,5,2,1,20,7,13,17,England - National L. South,0.62,0.88,13,2.5,2.12,1.61,1.14,2
Maidstone Utd,8,5,2,1,17,4,13,17,England - National L. South,0.62,0.88,13,2.12,2.12,1.61,1.14,2
Truro City,8,5,2,1,16,8,8,17,England - National L. South,0.62,0.88,8,2.0,2.12,1.61,1.14,2
Weston-s.-Mare,8,4,3,1,13,7,6,15,England - National L. South,0.5,0.88,6,1.62,1.88,2.0,1.14,3
Dorking,8,4,3,1,12,7,5,15,England - National L. South,0.5,0.88,5,1.5,1.88,2.0,1.14,3
Hemel Hempstead,8,4,3,1,13,10,3,15,England - National L. South,0.5,0.88,3,1.62,1.88,2.0,1.14,3
Weymouth,8,3,3,2,15,10,5,12,England - National L. South,0.38,0.75,5,1.88,1.5,2.63,1.33,4
St Albans,8,3,3,2,10,7,3,12,England - National L. South,0.38,0.75,3,1.25,1.5,2.63,1.33,4
Bath City,8,3,3,2,7,4,3,12,England - National L. South,0.38,0.75,3,0.88,1.5,2.63,1.33,4
Tonbridge,8,4,0,4,8,9,-1,12,England - National L. South,0.5,0.5,-1,1.0,1.5,2.0,2.0,4
Enfield Town,8,3,2,3,9,12,-3,11,England - National L. South,0.38,0.62,-3,1.12,1.38,2.63,1.61,5
Chesham Utd,8,3,1,4,9,12,-3,10,England - National L. South,0.38,0.5,-3,1.12,1.25,2.63,2.0,6
Boreham Wood,8,3,1,4,8,11,-3,10,England - National L. South,0.38,0.5,-3,1.0,1.25,2.63,2.0,6
Farnborough,8,3,1,4,7,12,-5,10,England - National L. South,0.38,0.5,-5,0.88,1.25,2.63,2.0,6
Hornchurch,8,2,3,3,11,14,-3,9,England - National L. South,0.25,0.62,-3,1.38,1.12,4.0,1.61,7
Salisbury,8,2,2,4,12,13,-1,8,England - National L. South,0.25,0.5,-1,1.5,1.0,4.0,2.0,8
Chelmsford City,8,2,2,4,9,11,-2,8,England - National L. South,0.25,0.5,-2,1.12,1.0,4.0,2.0,8
Chippenham,8,2,2,4,6,15,-9,8,England - National L. South,0.25,0.5,-9,0.75,1.0,4.0,2.0,8
Slough Town,8,1,3,4,8,16,-8,6,England - National L. South,0.12,0.5,-8,1.0,0.75,8.33,2.0,9
Welling Utd,8,1,2,5,10,16,-6,5,England - National L. South,0.12,0.38,-6,1.25,0.62,8.33,2.63,10
Hampton & R.,8,1,0,7,5,14,-9,3,England - National L. South,0.12,0.12,-9,0.62,0.38,8.33,8.33,11
Aveley,8,0,2,6,5,14,-9,2,England - National L. South,0.0,0.25,-9,0.62,0.25,0.0,4.0,12
Chatham Town,8,6,2,0,15,4,11,20,England - Isthmian league,0.75,1.0,11,1.88,2.5,1.33,1.0,1
Billericay Town,8,6,0,2,25,12,13,18,England - Isthmian league,0.75,0.75,13,3.12,2.25,1.33,1.33,2
Wingate & F.,8,5,2,1,17,6,11,17,England - Isthmian league,0.62,0.88,11,2.12,2.12,1.61,1.14,3
Chichester City,8,5,1,2,16,9,7,16,England - Isthmian league,0.62,0.75,7,2.0,2.0,1.61,1.33,4
Carshalton,8,5,1,2,18,12,6,16,England - Isthmian league,0.62,0.75,6,2.25,2.0,1.61,1.33,4
Dartford,8,5,1,2,13,9,4,16,England - Isthmian league,0.62,0.75,4,1.62,2.0,1.61,1.33,4
Horsham,8,5,1,2,11,8,3,16,England - Isthmian league,0.62,0.75,3,1.38,2.0,1.61,1.33,4
Cray Wanderers,8,5,0,3,19,11,8,15,England - Isthmian league,0.62,0.62,8,2.38,1.88,1.61,1.61,5
Whitehawk,8,4,1,3,14,8,6,13,England - Isthmian league,0.5,0.62,6,1.75,1.62,2.0,1.61,6
Hashtag United,8,3,3,2,19,15,4,12,England - Isthmian league,0.38,0.75,4,2.38,1.5,2.63,1.33,7
Cray Valley PM,8,3,3,2,12,11,1,12,England - Isthmian league,0.38,0.75,1,1.5,1.5,2.63,1.33,7
Cheshunt,8,4,0,4,10,10,0,12,England - Isthmian league,0.5,0.5,0,1.25,1.5,2.0,2.0,7
Lewes,8,4,0,4,15,17,-2,12,England - Isthmian league,0.5,0.5,-2,1.88,1.5,2.0,2.0,7
Dover Athletic,8,3,1,4,7,8,-1,10,England - Isthmian league,0.38,0.5,-1,0.88,1.25,2.63,2.0,8
Bognor Regis,8,2,2,4,11,15,-4,8,England - Isthmian league,0.25,0.5,-4,1.38,1.0,4.0,2.0,9
Dulwich Hamlet,8,2,2,4,7,12,-5,8,England - Isthmian league,0.25,0.5,-5,0.88,1.0,4.0,2.0,9
Potters Bar,8,2,2,4,5,11,-6,8,England - Isthmian league,0.25,0.5,-6,0.62,1.0,4.0,2.0,9
Folkestone,8,2,1,5,11,17,-6,7,England - Isthmian league,0.25,0.38,-6,1.38,0.88,4.0,2.63,10
Canvey Island,8,1,3,4,7,14,-7,6,England - Isthmian league,0.12,0.5,-7,0.88,0.75,8.33,2.0,11
Hastings Utd,8,1,2,5,5,15,-10,5,England - Isthmian league,0.12,0.38,-10,0.62,0.62,8.33,2.63,12
Hendon,8,0,3,5,8,16,-8,3,England - Isthmian league,0.0,0.38,-8,1.0,0.38,0.0,2.63,13
Bowers & Pitsea,8,0,0,8,2,27,-25,0,England - Isthmian league,0.0,0.0,-25,0.25,0.0,0.0,0.0,14
Worksop Town,8,8,0,0,28,7,21,24,England - Northern league,1.0,1.0,21,3.5,3.0,1.0,1.0,1
Macclesfield,8,7,1,0,25,5,20,22,England - Northern league,0.88,1.0,20,3.12,2.75,1.14,1.0,2
Stockton Town,8,5,1,2,10,8,2,16,England - Northern league,0.62,0.75,2,1.25,2.0,1.61,1.33,3
Prescot Cables,8,5,1,2,8,6,2,16,England - Northern league,0.62,0.75,2,1.0,2.0,1.61,1.33,3
Morpeth Town,8,4,3,1,10,8,2,15,England - Northern league,0.5,0.88,2,1.25,1.88,2.0,1.14,4
Workington,8,4,1,3,14,10,4,13,England - Northern league,0.5,0.62,4,1.75,1.62,2.0,1.61,5
Guiseley,8,3,4,1,9,6,3,13,England - Northern league,0.38,0.88,3,1.12,1.62,2.63,1.14,5
FC United,8,4,1,3,10,11,-1,13,England - Northern league,0.5,0.62,-1,1.25,1.62,2.0,1.61,5
Gainsborough,8,3,3,2,8,7,1,12,England - Northern league,0.38,0.75,1,1.0,1.5,2.63,1.33,6
Leek Town,8,3,2,3,13,11,2,11,England - Northern league,0.38,0.62,2,1.62,1.38,2.63,1.61,7
Hyde Utd,8,3,2,3,9,9,0,11,England - Northern league,0.38,0.62,0,1.12,1.38,2.63,1.61,7
Bamber Bridge,8,3,1,4,15,11,4,10,England - Northern league,0.38,0.5,4,1.88,1.25,2.63,2.0,8
Ilkeston Town,8,2,4,2,10,7,3,10,England - Northern league,0.25,0.75,3,1.25,1.25,4.0,1.33,8
Ashton Utd,8,2,3,3,12,11,1,9,England - Northern league,0.25,0.62,1,1.5,1.12,4.0,1.61,9
Rylands,8,2,2,4,10,14,-4,8,England - Northern league,0.25,0.5,-4,1.25,1.0,4.0,2.0,10
Basford Utd,8,2,2,4,6,11,-5,8,England - Northern league,0.25,0.5,-5,0.75,1.0,4.0,2.0,10
Lancaster City,8,2,1,5,8,14,-6,7,England - Northern league,0.25,0.38,-6,1.0,0.88,4.0,2.63,11
Mickleover,8,2,1,5,6,22,-16,7,England - Northern league,0.25,0.38,-16,0.75,0.88,4.0,2.63,11
Matlock,8,1,3,4,8,12,-4,6,England - Northern league,0.12,0.5,-4,1.0,0.75,8.33,2.0,12
Whitby Town,8,1,2,5,9,14,-5,5,England - Northern league,0.12,0.38,-5,1.12,0.62,8.33,2.63,13
Hebburn Town,8,1,2,5,5,13,-8,5,England - Northern league,0.12,0.38,-8,0.62,0.62,8.33,2.63,13
Blyth Spartans,8,0,1,7,6,27,-21,1,England - Northern league,0.0,0.12,-21,0.75,0.12,0.0,8.33,14
Bedford Town,8,6,1,1,16,4,12,19,England - Southern Central,0.75,0.88,12,2.0,2.38,1.33,1.14,1
Harborough Town,8,5,3,0,17,6,11,18,England - Southern Central,0.62,1.0,11,2.12,2.25,1.61,1.0,2
Halesowen Town,8,5,3,0,13,6,7,18,England - Southern Central,0.62,1.0,7,1.62,2.25,1.61,1.0,2
Telford Utd,8,4,4,0,16,8,8,16,England - Southern Central,0.5,1.0,8,2.0,2.0,2.0,1.0,3
Spalding United,8,5,0,3,16,12,4,15,England - Southern Central,0.62,0.62,4,2.0,1.88,1.61,1.61,4
Stamford,8,4,3,1,10,8,2,15,England - Southern Central,0.5,0.88,2,1.25,1.88,2.0,1.14,4
Kettering Town,8,3,4,1,9,6,3,13,England - Southern Central,0.38,0.88,3,1.12,1.62,2.63,1.14,5
Barwell,8,4,1,3,16,15,1,13,England - Southern Central,0.5,0.62,1,2.0,1.62,2.0,1.61,5
B. Stortford,8,3,3,2,11,14,-3,12,England - Southern Central,0.38,0.75,-3,1.38,1.5,2.63,1.33,6
Bromsgrove,8,3,2,3,13,11,2,11,England - Southern Central,0.38,0.62,2,1.62,1.38,2.63,1.61,7
Banbury Utd,8,2,4,2,5,6,-1,10,England - Southern Central,0.25,0.75,-1,0.62,1.25,4.0,1.33,8
Stratford Town,8,2,3,3,8,9,-1,9,England - Southern Central,0.25,0.62,-1,1.0,1.12,4.0,1.61,9
Stourbridge,8,2,3,3,8,10,-2,9,England - Southern Central,0.25,0.62,-2,1.0,1.12,4.0,1.61,9
Alvechurch,8,2,2,4,6,8,-2,8,England - Southern Central,0.25,0.5,-2,0.75,1.0,4.0,2.0,10
Leiston,8,2,2,4,9,14,-5,8,England - Southern Central,0.25,0.5,-5,1.12,1.0,4.0,2.0,10
AFC Sudbury,8,2,2,4,7,13,-6,8,England - Southern Central,0.25,0.5,-6,0.88,1.0,4.0,2.0,10
St. Ives Town,8,1,4,3,14,17,-3,7,England - Southern Central,0.12,0.62,-3,1.75,0.88,8.33,1.61,11
Hitchin Town,8,1,3,4,11,14,-3,6,England - Southern Central,0.12,0.5,-3,1.38,0.75,8.33,2.0,12
Royston,8,0,6,2,6,10,-4,6,England - Southern Central,0.0,0.75,-4,0.75,0.75,0.0,1.33,12
Lowestoft,8,1,3,4,7,15,-8,6,England - Southern Central,0.12,0.5,-8,0.88,0.75,8.33,2.0,12
Redditch Utd,8,1,2,5,4,9,-5,5,England - Southern Central,0.12,0.38,-5,0.5,0.62,8.33,2.63,13
Biggleswade,8,1,1,6,6,13,-7,4,England - Southern Central,0.12,0.25,-7,0.75,0.5,8.33,4.0,14
Levadia,4,4,0,0,12,4,8,12,Estonia - Meistriliiga,1.0,1.0,8,3.0,3.0,1.0,1.0,1
Paide,4,3,0,1,11,2,9,9,Estonia - Meistriliiga,0.75,0.75,9,2.75,2.25,1.33,1.33,2
Flora,4,2,1,1,11,3,8,7,Estonia - Meistriliiga,0.5,0.75,8,2.75,1.75,2.0,1.33,3
Narva Trans,4,2,1,1,6,4,2,7,Estonia - Meistriliiga,0.5,0.75,2,1.5,1.75,2.0,1.33,3
Vaprus,4,2,0,2,7,5,2,6,Estonia - Meistriliiga,0.5,0.5,2,1.75,1.5,2.0,2.0,4
Harju JK,4,2,0,2,4,9,-5,6,Estonia - Meistriliiga,0.5,0.5,-5,1.0,1.5,2.0,2.0,4
Nomme Kalju,4,1,1,2,6,8,-2,4,Estonia - Meistriliiga,0.25,0.5,-2,1.5,1.0,4.0,2.0,5
Tammeka,4,1,1,2,6,11,-5,4,Estonia - Meistriliiga,0.25,0.5,-5,1.5,1.0,4.0,2.0,5
Kuressaare,4,1,0,3,4,9,-5,3,Estonia - Meistriliiga,0.25,0.25,-5,1.0,0.75,4.0,4.0,6
Tallinna Kalev,4,0,0,4,1,13,-12,0,Estonia - Meistriliiga,0.0,0.0,-12,0.25,0.0,0.0,0.0,7
Nomme Utd,4,4,0,0,8,2,6,12,Estonia - Esiliiga,1.0,1.0,6,2.0,3.0,1.0,1.0,1
Elva,4,3,1,0,12,7,5,10,Estonia - Esiliiga,0.75,1.0,5,3.0,2.5,1.33,1.0,2
Viimsi,4,2,1,1,9,5,4,7,Estonia - Esiliiga,0.5,0.75,4,2.25,1.75,2.0,1.33,3
Flora B,4,2,1,1,6,4,2,7,Estonia - Esiliiga,0.5,0.75,2,1.5,1.75,2.0,1.33,3
Tartu Welco,4,2,1,1,8,7,1,7,Estonia - Esiliiga,0.5,0.75,1,2.0,1.75,2.0,1.33,3
Nomme Kalju B,4,2,0,2,4,8,-4,6,Estonia - Esiliiga,0.5,0.5,-4,1.0,1.5,2.0,2.0,4
Levadia B,4,1,1,2,6,6,0,4,Estonia - Esiliiga,0.25,0.5,0,1.5,1.0,4.0,2.0,5
Tallinna K. B,4,0,2,2,5,9,-4,2,Estonia - Esiliiga,0.0,0.5,-4,1.25,0.5,0.0,2.0,6
FC Tallinn,4,0,1,3,3,8,-5,1,Estonia - Esiliiga,0.0,0.25,-5,0.75,0.25,0.0,4.0,7
Tammeka B,4,0,0,4,5,10,-5,0,Estonia - Esiliiga,0.0,0.0,-5,1.25,0.0,0.0,0.0,8
NSI Runavik,3,3,0,0,18,3,15,9,FaroeIslands - Premier League,1.0,1.0,15,6.0,3.0,1.0,1.0,1
HB Torshavn,3,3,0,0,9,3,6,9,FaroeIslands - Premier League,1.0,1.0,6,3.0,3.0,1.0,1.0,1
Klaksvik,3,3,0,0,8,3,5,9,FaroeIslands - Premier League,1.0,1.0,5,2.67,3.0,1.0,1.0,1
Streymur,3,1,1,1,5,4,1,4,FaroeIslands - Premier League,0.33,0.67,1,1.67,1.33,3.03,1.49,2
B36 Torshavn,3,1,0,2,5,7,-2,3,FaroeIslands - Premier League,0.33,0.33,-2,1.67,1.0,3.03,3.03,3
B68 Toftir,3,1,0,2,4,14,-10,3,FaroeIslands - Premier League,0.33,0.33,-10,1.33,1.0,3.03,3.03,3
TB Tvoroyri,3,0,2,1,3,4,-1,2,FaroeIslands - Premier League,0.0,0.67,-1,1.0,0.67,0.0,1.49,4
Vikingur,3,0,2,1,1,4,-3,2,FaroeIslands - Premier League,0.0,0.67,-3,0.33,0.67,0.0,1.49,4
07 Vestur,3,0,1,2,2,5,-3,1,FaroeIslands - Premier League,0.0,0.33,-3,0.67,0.33,0.0,3.03,5
Suduroy,3,0,0,3,0,8,-8,0,FaroeIslands - Premier League,0.0,0.0,-8,0.0,0.0,0.0,0.0,6
B71 Sandur,3,3,0,0,5,0,5,9,FaroeIslands - 1. Deild,1.0,1.0,5,1.67,3.0,1.0,1.0,1
Skala,3,2,1,0,8,0,8,7,FaroeIslands - 1. Deild,0.67,1.0,8,2.67,2.33,1.49,1.0,2
Vikingur B,3,2,0,1,6,4,2,6,FaroeIslands - 1. Deild,0.67,0.67,2,2.0,2.0,1.49,1.49,3
Streymur B,3,2,0,1,3,2,1,6,FaroeIslands - 1. Deild,0.67,0.67,1,1.0,2.0,1.49,1.49,3
AB Argir,3,1,2,0,4,2,2,5,FaroeIslands - 1. Deild,0.33,1.0,2,1.33,1.67,3.03,1.0,4
Klaksvik B,3,1,1,1,3,3,0,4,FaroeIslands - 1. Deild,0.33,0.67,0,1.0,1.33,3.03,1.49,5
IF Fuglafjordur,3,0,2,1,4,6,-2,2,FaroeIslands - 1. Deild,0.0,0.67,-2,1.33,0.67,0.0,1.49,6
B36 Torshavn B,3,0,1,2,3,6,-3,1,FaroeIslands - 1. Deild,0.0,0.33,-3,1.0,0.33,0.0,3.03,7
NSI Runavik B,3,0,1,2,3,8,-5,1,FaroeIslands - 1. Deild,0.0,0.33,-5,1.0,0.33,0.0,3.03,7
07 Vestur B,3,0,0,3,2,10,-8,0,FaroeIslands - 1. Deild,0.0,0.0,-8,0.67,0.0,0.0,0.0,8
Ilves,8,6,1,1,17,4,13,19,Finland - Veikkausliiga,0.75,0.88,13,2.12,2.38,1.33,1.14,1
KuPS,8,6,0,2,12,4,8,18,Finland - Veikkausliiga,0.75,0.75,8,1.5,2.25,1.33,1.33,2
Inter Turku,8,5,1,2,13,7,6,16,Finland - Veikkausliiga,0.62,0.75,6,1.62,2.0,1.61,1.33,3
Gnistan,8,4,2,2,12,11,1,14,Finland - Veikkausliiga,0.5,0.75,1,1.5,1.75,2.0,1.33,4
HJK Helsinki,8,3,2,3,10,7,3,11,Finland - Veikkausliiga,0.38,0.62,3,1.25,1.38,2.63,1.61,5
VPS,8,3,2,3,13,14,-1,11,Finland - Veikkausliiga,0.38,0.62,-1,1.62,1.38,2.63,1.61,5
Mariehamn,8,3,0,5,10,12,-2,9,Finland - Veikkausliiga,0.38,0.38,-2,1.25,1.12,2.63,2.63,6
Lahti,8,1,5,2,6,10,-4,8,Finland - Veikkausliiga,0.12,0.75,-4,0.75,1.0,8.33,1.33,7
Oulu,8,2,1,5,7,9,-2,7,Finland - Veikkausliiga,0.25,0.38,-2,0.88,0.88,4.0,2.63,8
Haka,8,2,1,5,9,15,-6,7,Finland - Veikkausliiga,0.25,0.38,-6,1.12,0.88,4.0,2.63,8
Ekenas IF,8,1,4,3,6,15,-9,7,Finland - Veikkausliiga,0.12,0.62,-9,0.75,0.88,8.33,1.61,8
SJK,8,1,2,5,7,16,-9,5,Finland - Veikkausliiga,0.12,0.38,-9,0.88,0.62,8.33,2.63,9
JaPS,8,5,1,2,17,13,4,16,Finland - Ykkosliga,0.62,0.75,4,2.12,2.0,1.61,1.33,1
JIPPO,8,5,0,3,17,9,8,15,Finland - Ykkosliga,0.62,0.62,8,2.12,1.88,1.61,1.61,2
PK-35,8,4,3,1,8,5,3,15,Finland - Ykkosliga,0.5,0.88,3,1.0,1.88,2.0,1.14,2
Jaro,8,5,0,3,15,14,1,15,Finland - Ykkosliga,0.62,0.62,1,1.88,1.88,1.61,1.61,2
KTP,8,4,2,2,26,14,12,14,Finland - Ykkosliga,0.5,0.75,12,3.25,1.75,2.0,1.33,3
KaPa,8,3,1,4,20,25,-5,10,Finland - Ykkosliga,0.38,0.5,-5,2.5,1.25,2.63,2.0,4
TPS,8,2,3,3,13,11,2,9,Finland - Ykkosliga,0.25,0.62,2,1.62,1.12,4.0,1.61,5
SalPa,8,2,1,5,8,18,-10,7,Finland - Ykkosliga,0.25,0.38,-10,1.0,0.88,4.0,2.63,6
SJK Akatemia,8,0,5,3,13,18,-5,5,Finland - Ykkosliga,0.0,0.62,-5,1.62,0.62,0.0,1.61,7
Mikkelin,8,1,2,5,9,19,-10,5,Finland - Ykkosliga,0.12,0.38,-10,1.12,0.62,8.33,2.63,7
KPV Kokkola,8,6,1,1,16,7,9,19,Finland - Ykkonen,0.75,0.88,9,2.0,2.38,1.33,1.14,1
Klubi-04,8,5,0,3,16,11,5,15,Finland - Ykkonen,0.62,0.62,5,2.0,1.88,1.61,1.61,2
JJK,8,5,0,3,14,15,-1,15,Finland - Ykkonen,0.62,0.62,-1,1.75,1.88,1.61,1.61,2
Atlantis,8,4,2,2,22,18,4,14,Finland - Ykkonen,0.5,0.75,4,2.75,1.75,2.0,1.33,3
OLS Oulu,8,4,2,2,21,19,2,14,Finland - Ykkonen,0.5,0.75,2,2.62,1.75,2.0,1.33,3
PKKU,8,4,1,3,24,18,6,13,Finland - Ykkonen,0.5,0.62,6,3.0,1.62,2.0,1.61,4
Rovaniemi,8,3,1,4,13,12,1,10,Finland - Ykkonen,0.38,0.5,1,1.62,1.25,2.63,2.0,5
VIFK,8,3,1,4,18,18,0,10,Finland - Ykkonen,0.38,0.5,0,2.25,1.25,2.63,2.0,5
Jazz Pori,8,3,1,4,18,20,-2,10,Finland - Ykkonen,0.38,0.5,-2,2.25,1.25,2.63,2.0,5
EPS,8,3,1,4,17,20,-3,10,Finland - Ykkonen,0.38,0.5,-3,2.12,1.25,2.63,2.0,5
KuPS Ak.,8,2,0,6,12,20,-8,6,Finland - Ykkonen,0.25,0.25,-8,1.5,0.75,4.0,4.0,6
Vaajakoski,8,0,2,6,10,23,-13,2,Finland - Ykkonen,0.0,0.25,-13,1.25,0.25,0.0,4.0,7
PEPO,8,4,4,0,15,9,6,16,Finland - Kakkonen Group A,0.5,1.0,6,1.88,2.0,2.0,1.0,1
Reipas,8,4,2,2,18,10,8,14,Finland - Kakkonen Group A,0.5,0.75,8,2.25,1.75,2.0,1.33,2
PPJ,8,4,1,3,17,12,5,13,Finland - Kakkonen Group A,0.5,0.62,5,2.12,1.62,2.0,1.61,3
NJS,8,3,4,1,16,12,4,13,Finland - Kakkonen Group A,0.38,0.88,4,2.0,1.62,2.63,1.14,3
Atlantis B,8,4,1,3,13,13,0,13,Finland - Kakkonen Group A,0.5,0.62,0,1.62,1.62,2.0,1.61,3
MYPA,8,3,3,2,13,13,0,12,Finland - Kakkonen Group A,0.38,0.75,0,1.62,1.5,2.63,1.33,4
Kiffen,8,3,2,3,12,9,3,11,Finland - Kakkonen Group A,0.38,0.62,3,1.5,1.38,2.63,1.61,5
JaPS B,8,2,1,5,11,19,-8,7,Finland - Kakkonen Group A,0.25,0.38,-8,1.38,0.88,4.0,2.63,6
GrIFK,8,1,3,4,9,15,-6,6,Finland - Kakkonen Group A,0.12,0.5,-6,1.12,0.75,8.33,2.0,7
Futura,8,1,1,6,7,19,-12,4,Finland - Kakkonen Group A,0.12,0.25,-12,0.88,0.5,8.33,4.0,8
Inter Turku B,8,7,1,0,30,7,23,22,Finland - Kakkonen Group B,0.88,1.0,23,3.75,2.75,1.14,1.0,1
HJS Akatemia,8,6,1,1,20,6,14,19,Finland - Kakkonen Group B,0.75,0.88,14,2.5,2.38,1.33,1.14,2
Tampere Utd,8,5,1,2,21,10,11,16,Finland - Kakkonen Group B,0.62,0.75,11,2.62,2.0,1.61,1.33,3
VJS,8,5,0,3,21,13,8,15,Finland - Kakkonen Group B,0.62,0.62,8,2.62,1.88,1.61,1.61,4
Ilves B,8,4,0,4,17,17,0,12,Finland - Kakkonen Group B,0.5,0.5,0,2.12,1.5,2.0,2.0,5
P-Iirot,8,4,0,4,11,11,0,12,Finland - Kakkonen Group B,0.5,0.5,0,1.38,1.5,2.0,2.0,5
TPV,8,2,3,3,16,19,-3,9,Finland - Kakkonen Group B,0.25,0.62,-3,2.0,1.12,4.0,1.61,6
Honka,8,2,3,3,14,17,-3,9,Finland - Kakkonen Group B,0.25,0.62,-3,1.75,1.12,4.0,1.61,6
Ilves-Kissat,8,2,1,5,17,30,-13,7,Finland - Kakkonen Group B,0.25,0.38,-13,2.12,0.88,4.0,2.63,7
Poxyt,8,1,0,7,10,22,-12,3,Finland - Kakkonen Group B,0.12,0.12,-12,1.25,0.38,8.33,8.33,8
EBK,8,0,0,8,8,35,-27,0,Finland - Kakkonen Group B,0.0,0.0,-27,1.0,0.0,0.0,0.0,9
TP-47,8,6,2,0,25,9,16,20,Finland - Kakkonen Group C,0.75,1.0,16,3.12,2.5,1.33,1.0,1
Narpes Kraft,8,6,0,2,26,15,11,18,Finland - Kakkonen Group C,0.75,0.75,11,3.25,2.25,1.33,1.33,2
GBK,8,5,0,3,15,13,2,15,Finland - Kakkonen Group C,0.62,0.62,2,1.88,1.88,1.61,1.61,3
JBK,8,4,2,2,14,10,4,14,Finland - Kakkonen Group C,0.5,0.75,4,1.75,1.75,2.0,1.33,4
Kuopion Elo,8,3,2,3,19,18,1,11,Finland - Kakkonen Group C,0.38,0.62,1,2.38,1.38,2.63,1.61,5
JS Hercules,8,3,2,3,18,18,0,11,Finland - Kakkonen Group C,0.38,0.62,0,2.25,1.38,2.63,1.61,5
SJK Akatemia B,8,2,1,5,16,21,-5,7,Finland - Kakkonen Group C,0.25,0.38,-5,2.0,0.88,4.0,2.63,6
OPS,8,2,1,5,14,23,-9,7,Finland - Kakkonen Group C,0.25,0.38,-9,1.75,0.88,4.0,2.63,6
JPS,8,1,3,4,19,17,2,6,Finland - Kakkonen Group C,0.12,0.5,2,2.38,0.75,8.33,2.0,7
OTP,8,1,0,7,12,33,-21,3,Finland - Kakkonen Group C,0.12,0.12,-21,1.5,0.38,8.33,8.33,8
Paris SG,8,8,0,0,30,9,21,24,France - Ligue 1,1.0,1.0,21,3.75,3.0,1.0,1.0,1
Strasbourg,8,6,1,1,12,4,8,19,France - Ligue 1,0.75,0.88,8,1.5,2.38,1.33,1.14,2
Monaco,8,5,1,2,21,11,10,16,France - Ligue 1,0.62,0.75,10,2.62,2.0,1.61,1.33,3
Lyon,8,5,0,3,22,14,8,15,France - Ligue 1,0.62,0.62,8,2.75,1.88,1.61,1.61,4
Rennes,8,5,0,3,12,7,5,15,France - Ligue 1,0.62,0.62,5,1.5,1.88,1.61,1.61,4
Lille,8,5,0,3,12,9,3,15,France - Ligue 1,0.62,0.62,3,1.5,1.88,1.61,1.61,4
Nice,8,4,2,2,13,8,5,14,France - Ligue 1,0.5,0.75,5,1.62,1.75,2.0,1.33,5
Auxerre,8,3,3,2,13,10,3,12,France - Ligue 1,0.38,0.75,3,1.62,1.5,2.63,1.33,6
Brest,8,3,3,2,13,11,2,12,France - Ligue 1,0.38,0.75,2,1.62,1.5,2.63,1.33,6
Marseille,8,4,0,4,14,13,1,12,France - Ligue 1,0.5,0.5,1,1.75,1.5,2.0,2.0,6
Le Havre,8,3,2,3,15,19,-4,11,France - Ligue 1,0.38,0.62,-4,1.88,1.38,2.63,1.61,7
Toulouse,8,2,3,3,15,12,3,9,France - Ligue 1,0.25,0.62,3,1.88,1.12,4.0,1.61,8
Lens,8,3,0,5,8,12,-4,9,France - Ligue 1,0.38,0.38,-4,1.0,1.12,2.63,2.63,8
Nantes,8,3,0,5,9,17,-8,9,France - Ligue 1,0.38,0.38,-8,1.12,1.12,2.63,2.63,8
Angers,8,1,2,5,5,17,-12,5,France - Ligue 1,0.12,0.38,-12,0.62,0.62,8.33,2.63,9
Reims,8,1,1,6,4,14,-10,4,France - Ligue 1,0.12,0.25,-10,0.5,0.5,8.33,4.0,10
Montpellier,8,1,0,7,3,17,-14,3,France - Ligue 1,0.12,0.12,-14,0.38,0.38,8.33,8.33,11
Saint-Etienne,8,0,3,5,9,25,-16,3,France - Ligue 1,0.0,0.38,-16,1.12,0.38,0.0,2.63,11
Metz,8,6,1,1,19,8,11,19,France - Ligue 2,0.75,0.88,11,2.38,2.38,1.33,1.14,1
Lorient,8,6,0,2,17,8,9,18,France - Ligue 2,0.75,0.75,9,2.12,2.25,1.33,1.33,2
Paris FC,8,6,0,2,15,10,5,18,France - Ligue 2,0.75,0.75,5,1.88,2.25,1.33,1.33,2
SC Bastia,8,4,2,2,8,8,0,14,France - Ligue 2,0.5,0.75,0,1.0,1.75,2.0,1.33,3
Martigues,8,4,1,3,9,6,3,13,France - Ligue 2,0.5,0.62,3,1.12,1.62,2.0,1.61,4
Guingamp,8,4,1,3,11,9,2,13,France - Ligue 2,0.5,0.62,2,1.38,1.62,2.0,1.61,4
AC Ajaccio,8,4,1,3,10,10,0,13,France - Ligue 2,0.5,0.62,0,1.25,1.62,2.0,1.61,4
Troyes,8,4,0,4,10,6,4,12,France - Ligue 2,0.5,0.5,4,1.25,1.5,2.0,2.0,5
USL Dunkerque,8,4,0,4,11,12,-1,12,France - Ligue 2,0.5,0.5,-1,1.38,1.5,2.0,2.0,5
Red Star,8,3,2,3,9,7,2,11,France - Ligue 2,0.38,0.62,2,1.12,1.38,2.63,1.61,6
Grenoble,8,2,4,2,10,8,2,10,France - Ligue 2,0.25,0.75,2,1.25,1.25,4.0,1.33,7
Laval,8,3,1,4,6,8,-2,10,France - Ligue 2,0.38,0.5,-2,0.75,1.25,2.63,2.0,7
Rodez Aveyron,8,2,3,3,15,11,4,9,France - Ligue 2,0.25,0.62,4,1.88,1.12,4.0,1.61,8
Pau FC,8,2,3,3,8,15,-7,9,France - Ligue 2,0.25,0.62,-7,1.0,1.12,4.0,1.61,8
Amiens,8,2,2,4,8,14,-6,8,France - Ligue 2,0.25,0.5,-6,1.0,1.0,4.0,2.0,9
Annecy,8,2,1,5,6,13,-7,7,France - Ligue 2,0.25,0.38,-7,0.75,0.88,4.0,2.63,10
Caen,8,1,1,6,4,12,-8,4,France - Ligue 2,0.12,0.25,-8,0.5,0.5,8.33,4.0,11
Clermont,8,0,3,5,4,13,-9,3,France - Ligue 2,0.0,0.38,-9,0.5,0.38,0.0,2.63,12
Le Mans,8,6,1,1,13,4,9,19,France - National,0.75,0.88,9,1.62,2.38,1.33,1.14,1
Boulogne,8,5,2,1,13,7,6,17,France - National,0.62,0.88,6,1.62,2.12,1.61,1.14,2
Nancy,8,5,0,3,11,8,3,15,France - National,0.62,0.62,3,1.38,1.88,1.61,1.61,3
Villefranche,8,4,2,2,12,8,4,14,France - National,0.5,0.75,4,1.5,1.75,2.0,1.33,4
Versailles,8,3,4,1,13,11,2,13,France - National,0.38,0.88,2,1.62,1.62,2.63,1.14,5
Valenciennes,8,3,3,2,9,7,2,12,France - National,0.38,0.75,2,1.12,1.5,2.63,1.33,6
Bourg-en-Bresse,8,3,3,2,6,4,2,12,France - National,0.38,0.75,2,0.75,1.5,2.63,1.33,6
Chateauroux,8,3,2,3,9,10,-1,11,France - National,0.38,0.62,-1,1.12,1.38,2.63,1.61,7
Orleans,8,2,4,2,11,11,0,10,France - National,0.25,0.75,0,1.38,1.25,4.0,1.33,8
Dijon,8,2,4,2,6,10,-4,10,France - National,0.25,0.75,-4,0.75,1.25,4.0,1.33,8
Rouen,8,2,3,3,9,11,-2,9,France - National,0.25,0.62,-2,1.12,1.12,4.0,1.61,9
Nimes,8,2,2,4,8,9,-1,8,France - National,0.25,0.5,-1,1.0,1.0,4.0,2.0,10
Paris 13 A.,8,2,2,4,5,8,-3,8,France - National,0.25,0.5,-3,0.62,1.0,4.0,2.0,10
Quevilly Rouen,8,2,2,4,6,10,-4,8,France - National,0.25,0.5,-4,0.75,1.0,4.0,2.0,10
Aubagne,8,2,1,5,5,10,-5,7,France - National,0.25,0.38,-5,0.62,0.88,4.0,2.63,11
Concarneau,8,1,3,4,11,15,-4,6,France - National,0.12,0.5,-4,1.38,0.75,8.33,2.0,12
Sochaux,8,1,3,4,6,10,-4,6,France - National,0.12,0.5,-4,0.75,0.75,8.33,2.0,12
Iberia,5,3,2,0,6,1,5,11,Georgia - Erovnuli Liga,0.6,1.0,5,1.2,2.2,1.67,1.0,1
Dinamo Batumi,4,2,2,0,4,2,2,8,Georgia - Erovnuli Liga,0.5,1.0,2,1.0,2.0,2.0,1.0,2
Dinamo Tbilisi,4,2,2,0,4,2,2,8,Georgia - Erovnuli Liga,0.5,1.0,2,1.0,2.0,2.0,1.0,2
Dila Gori,4,2,1,1,8,3,5,7,Georgia - Erovnuli Liga,0.5,0.75,5,2.0,1.75,2.0,1.33,3
Samgurali,4,2,1,1,6,3,3,7,Georgia - Erovnuli Liga,0.5,0.75,3,1.5,1.75,2.0,1.33,3
Telavi,5,2,1,2,5,10,-5,7,Georgia - Erovnuli Liga,0.4,0.6,-5,1.0,1.4,2.5,1.67,3
Gagra,5,1,1,3,4,6,-2,4,Georgia - Erovnuli Liga,0.2,0.4,-2,0.8,0.8,5.0,2.5,4
Gareji Sagarejo,4,1,1,2,2,4,-2,4,Georgia - Erovnuli Liga,0.25,0.5,-2,0.5,1.0,4.0,2.0,4
Torpedo Kutaisi,5,1,0,4,4,8,-4,3,Georgia - Erovnuli Liga,0.2,0.2,-4,0.8,0.6,5.0,5.0,5
Kolkheti Poti,4,0,1,3,0,4,-4,1,Georgia - Erovnuli Liga,0.0,0.25,-4,0.0,0.25,0.0,4.0,6
Rustavi,3,2,1,0,6,3,3,7,Georgia - Erovnuli Liga 2,0.67,1.0,3,2.0,2.33,1.49,1.0,1
Spaeri,3,1,2,0,6,5,1,5,Georgia - Erovnuli Liga 2,0.33,1.0,1,2.0,1.67,3.03,1.0,2
Samtredia,3,1,2,0,3,2,1,5,Georgia - Erovnuli Liga 2,0.33,1.0,1,1.0,1.67,3.03,1.0,2
Bolnisi,3,1,1,1,4,2,2,4,Georgia - Erovnuli Liga 2,0.33,0.67,2,1.33,1.33,3.03,1.49,3
Merani Martvili,3,1,1,1,5,5,0,4,Georgia - Erovnuli Liga 2,0.33,0.67,0,1.67,1.33,3.03,1.49,3
Iberia B,3,1,1,1,4,4,0,4,Georgia - Erovnuli Liga 2,0.33,0.67,0,1.33,1.33,3.03,1.49,3
Gonio,3,0,2,1,3,4,-1,2,Georgia - Erovnuli Liga 2,0.0,0.67,-1,1.0,0.67,0.0,1.49,4
L. Tbilisi,3,0,2,1,3,4,-1,2,Georgia - Erovnuli Liga 2,0.0,0.67,-1,1.0,0.67,0.0,1.49,4
D. Tbilisi B,3,0,2,1,5,7,-2,2,Georgia - Erovnuli Liga 2,0.0,0.67,-2,1.67,0.67,0.0,1.49,4
Meshakhte,3,0,2,1,2,5,-3,2,Georgia - Erovnuli Liga 2,0.0,0.67,-3,0.67,0.67,0.0,1.49,4
Bayern Munich,8,5,2,1,20,10,10,17,Germany - Bundesliga,0.62,0.88,10,2.5,2.12,1.61,1.14,1
Leverkusen,8,5,2,1,16,8,8,17,Germany - Bundesliga,0.62,0.88,8,2.0,2.12,1.61,1.14,1
Monchengladbach,8,5,1,2,14,11,3,16,Germany - Bundesliga,0.62,0.75,3,1.75,2.0,1.61,1.33,2
Freiburg,8,4,3,1,11,4,7,15,Germany - Bundesliga,0.5,0.88,7,1.38,1.88,2.0,1.14,3
FC Augsburg,8,3,5,0,7,2,5,14,Germany - Bundesliga,0.38,1.0,5,0.88,1.75,2.63,1.0,4
FSV Mainz,8,4,2,2,12,8,4,14,Germany - Bundesliga,0.5,0.75,4,1.5,1.75,2.0,1.33,4
Dortmund,8,4,0,4,14,9,5,12,Germany - Bundesliga,0.5,0.5,5,1.75,1.5,2.0,2.0,5
Union Berlin,8,3,2,3,10,12,-2,11,Germany - Bundesliga,0.38,0.62,-2,1.25,1.38,2.63,1.61,6
E. Frankfurt,8,3,2,3,11,14,-3,11,Germany - Bundesliga,0.38,0.62,-3,1.38,1.38,2.63,1.61,6
RB Leipzig,8,2,4,2,7,5,2,10,Germany - Bundesliga,0.25,0.75,2,0.88,1.25,4.0,1.33,7
Wolfsburg,8,2,4,2,7,7,0,10,Germany - Bundesliga,0.25,0.75,0,0.88,1.25,4.0,1.33,7
Hoffenheim,8,2,3,3,8,12,-4,9,Germany - Bundesliga,0.25,0.62,-4,1.0,1.12,4.0,1.61,8
Werder Bremen,8,3,0,5,10,17,-7,9,Germany - Bundesliga,0.38,0.38,-7,1.25,1.12,2.63,2.63,8
Bochum,8,2,2,4,10,13,-3,8,Germany - Bundesliga,0.25,0.5,-3,1.25,1.0,4.0,2.0,9
Heidenheim,8,2,2,4,8,12,-4,8,Germany - Bundesliga,0.25,0.5,-4,1.0,1.0,4.0,2.0,9
Stuttgart,8,1,2,5,11,16,-5,5,Germany - Bundesliga,0.12,0.38,-5,1.38,0.62,8.33,2.63,10
Sankt Pauli,8,1,2,5,5,12,-7,5,Germany - Bundesliga,0.12,0.38,-7,0.62,0.62,8.33,2.63,10
Holstein Kiel,8,1,2,5,10,19,-9,5,Germany - Bundesliga,0.12,0.38,-9,1.25,0.62,8.33,2.63,10
FC Nurnberg,8,5,1,2,13,7,6,16,Germany - 2. Bundesliga,0.62,0.75,6,1.62,2.0,1.61,1.33,1
FC Koln,8,5,1,2,9,8,1,16,Germany - 2. Bundesliga,0.62,0.75,1,1.12,2.0,1.61,1.33,1
Hamburger SV,8,4,3,1,15,7,8,15,Germany - 2. Bundesliga,0.5,0.88,8,1.88,1.88,2.0,1.14,2
Paderborn,8,4,2,2,14,8,6,14,Germany - 2. Bundesliga,0.5,0.75,6,1.75,1.75,2.0,1.33,3
Kaiserslautern,8,4,2,2,13,11,2,14,Germany - 2. Bundesliga,0.5,0.75,2,1.62,1.75,2.0,1.33,3
Greuther Furth,8,4,2,2,13,12,1,14,Germany - 2. Bundesliga,0.5,0.75,1,1.62,1.75,2.0,1.33,3
Elversberg,8,3,4,1,12,4,8,13,Germany - 2. Bundesliga,0.38,0.88,8,1.5,1.62,2.63,1.14,4
Hannover 96,8,2,6,0,9,7,2,12,Germany - 2. Bundesliga,0.25,1.0,2,1.12,1.5,4.0,1.0,5
Magdeburg,8,3,2,3,17,14,3,11,Germany - 2. Bundesliga,0.38,0.62,3,2.12,1.38,2.63,1.61,6
Dusseldorf,8,3,2,3,11,14,-3,11,Germany - 2. Bundesliga,0.38,0.62,-3,1.38,1.38,2.63,1.61,6
Schalke 04,8,3,1,4,11,15,-4,10,Germany - 2. Bundesliga,0.38,0.5,-4,1.38,1.25,2.63,2.0,7
Braunschweig,8,2,3,3,8,13,-5,9,Germany - 2. Bundesliga,0.25,0.62,-5,1.0,1.12,4.0,1.61,8
Regensburg,8,2,2,4,6,10,-4,8,Germany - 2. Bundesliga,0.25,0.5,-4,0.75,1.0,4.0,2.0,9
Karlsruher SC,8,2,2,4,8,13,-5,8,Germany - 2. Bundesliga,0.25,0.5,-5,1.0,1.0,4.0,2.0,9
Hertha Berlin,8,2,1,5,10,13,-3,7,Germany - 2. Bundesliga,0.25,0.38,-3,1.25,0.88,4.0,2.63,10
Preuss. Munster,8,2,1,5,6,9,-3,7,Germany - 2. Bundesliga,0.25,0.38,-3,0.75,0.88,4.0,2.63,10
Darmstadt,8,2,0,6,8,13,-5,6,Germany - 2. Bundesliga,0.25,0.25,-5,1.0,0.75,4.0,4.0,11
Ulm,8,1,3,4,5,10,-5,6,Germany - 2. Bundesliga,0.12,0.5,-5,0.62,0.75,8.33,2.0,11
Bielefeld,8,5,1,2,16,8,8,16,Germany - 3. Liga,0.62,0.75,8,2.0,2.0,1.61,1.33,1
Osnabruck,8,5,1,2,12,6,6,16,Germany - 3. Liga,0.62,0.75,6,1.5,2.0,1.61,1.33,1
VfB Stuttgart B,8,5,1,2,13,10,3,16,Germany - 3. Liga,0.62,0.75,3,1.62,2.0,1.61,1.33,1
Dynamo Dresden,8,4,2,2,13,6,7,14,Germany - 3. Liga,0.5,0.75,7,1.62,1.75,2.0,1.33,2
Mannheim,8,4,2,2,13,7,6,14,Germany - 3. Liga,0.5,0.75,6,1.62,1.75,2.0,1.33,2
Hansa Rostock,8,4,2,2,11,9,2,14,Germany - 3. Liga,0.5,0.75,2,1.38,1.75,2.0,1.33,2
RW Essen,8,4,2,2,9,7,2,14,Germany - 3. Liga,0.5,0.75,2,1.12,1.75,2.0,1.33,2
Saarbrucken,8,4,1,3,11,11,0,13,Germany - 3. Liga,0.5,0.62,0,1.38,1.62,2.0,1.61,3
Energie Cottbus,8,4,1,3,9,9,0,13,Germany - 3. Liga,0.5,0.62,0,1.12,1.62,2.0,1.61,3
Verl,8,4,1,3,10,11,-1,13,Germany - 3. Liga,0.5,0.62,-1,1.25,1.62,2.0,1.61,3
Alemannia A.,8,3,2,3,12,10,2,11,Germany - 3. Liga,0.38,0.62,2,1.5,1.38,2.63,1.61,4
FC Ingolstadt,8,3,2,3,11,12,-1,11,Germany - 3. Liga,0.38,0.62,-1,1.38,1.38,2.63,1.61,4
1860 Munchen,8,3,2,3,9,12,-3,11,Germany - 3. Liga,0.38,0.62,-3,1.12,1.38,2.63,1.61,4
Erzgebirge Aue,8,3,1,4,8,10,-2,10,Germany - 3. Liga,0.38,0.5,-2,1.0,1.25,2.63,2.0,5
Viktoria Koln,8,2,3,3,10,11,-1,9,Germany - 3. Liga,0.25,0.62,-1,1.25,1.12,4.0,1.61,6
Dortmund B,8,1,4,3,4,6,-2,7,Germany - 3. Liga,0.12,0.62,-2,0.5,0.88,8.33,1.61,7
Wehen Wiesbaden,8,2,1,5,6,12,-6,7,Germany - 3. Liga,0.25,0.38,-6,0.75,0.88,4.0,2.63,7
Unterhaching,8,1,2,5,9,13,-4,5,Germany - 3. Liga,0.12,0.38,-4,1.12,0.62,8.33,2.63,8
Hannover 96 B,8,1,2,5,11,21,-10,5,Germany - 3. Liga,0.12,0.38,-10,1.38,0.62,8.33,2.63,8
Sandhausen,8,1,1,6,7,12,-5,4,Germany - 3. Liga,0.12,0.25,-5,0.88,0.5,8.33,4.0,9
Dreams,8,5,2,1,8,6,2,17,Ghana - Premier League,0.62,0.88,2,1.0,2.12,1.61,1.14,1
Asante Kotoko,8,4,3,1,10,4,6,15,Ghana - Premier League,0.5,0.88,6,1.25,1.88,2.0,1.14,2
Bibiani GS,8,4,2,2,8,4,4,14,Ghana - Premier League,0.5,0.75,4,1.0,1.75,2.0,1.33,3
Samartex,8,3,5,0,6,3,3,14,Ghana - Premier League,0.38,1.0,3,0.75,1.75,2.63,1.0,3
Young Apostles,8,4,2,2,6,4,2,14,Ghana - Premier League,0.5,0.75,2,0.75,1.75,2.0,1.33,3
Bechem Utd,8,4,1,3,10,6,4,13,Ghana - Premier League,0.5,0.62,4,1.25,1.62,2.0,1.61,4
Berekum Chelsea,8,4,1,3,11,8,3,13,Ghana - Premier League,0.5,0.62,3,1.38,1.62,2.0,1.61,4
Hearts of Oak,8,3,3,2,5,3,2,12,Ghana - Premier League,0.38,0.75,2,0.62,1.5,2.63,1.33,5
Aduana Stars,8,3,2,3,6,6,0,11,Ghana - Premier League,0.38,0.62,0,0.75,1.38,2.63,1.61,6
Medeama,8,3,1,4,10,9,1,10,Ghana - Premier League,0.38,0.5,1,1.25,1.25,2.63,2.0,7
Legon Cities,8,3,1,4,8,8,0,10,Ghana - Premier League,0.38,0.5,0,1.0,1.25,2.63,2.0,7
Heart of Lions,8,3,1,4,8,9,-1,10,Ghana - Premier League,0.38,0.5,-1,1.0,1.25,2.63,2.0,7
Nations,8,3,1,4,7,8,-1,10,Ghana - Premier League,0.38,0.5,-1,0.88,1.25,2.63,2.0,7
Vision,8,2,3,3,6,10,-4,9,Ghana - Premier League,0.25,0.62,-4,0.75,1.12,4.0,1.61,8
Karela,8,2,2,4,5,8,-3,8,Ghana - Premier League,0.25,0.5,-3,0.62,1.0,4.0,2.0,9
Accra Lions,8,2,1,5,5,11,-6,7,Ghana - Premier League,0.25,0.38,-6,0.62,0.88,4.0,2.63,10
Nsoatreman,8,2,1,5,3,12,-9,7,Ghana - Premier League,0.25,0.38,-9,0.38,0.88,4.0,2.63,10
Holy Stars,8,1,3,4,7,9,-2,6,Ghana - Premier League,0.12,0.5,-2,0.88,0.75,8.33,2.0,11
St Josephs,8,7,1,0,26,6,20,22,Gibraltar - Premier Division,0.88,1.0,20,3.25,2.75,1.14,1.0,1
Lincoln RI,8,6,1,1,21,5,16,19,Gibraltar - Premier Division,0.75,0.88,16,2.62,2.38,1.33,1.14,2
Europa FC,8,5,1,2,18,8,10,16,Gibraltar - Premier Division,0.62,0.75,10,2.25,2.0,1.61,1.33,3
Lions FC,8,5,1,2,14,11,3,16,Gibraltar - Premier Division,0.62,0.75,3,1.75,2.0,1.61,1.33,3
Manchester 62,8,4,2,2,22,10,12,14,Gibraltar - Premier Division,0.5,0.75,12,2.75,1.75,2.0,1.33,4
Magpies,8,4,0,4,17,12,5,12,Gibraltar - Premier Division,0.5,0.5,5,2.12,1.5,2.0,2.0,5
College 1975,8,3,1,4,13,13,0,10,Gibraltar - Premier Division,0.38,0.5,0,1.62,1.25,2.63,2.0,6
Lynx,8,3,1,4,10,22,-12,10,Gibraltar - Premier Division,0.38,0.5,-12,1.25,1.25,2.63,2.0,6
Glacis Utd,8,2,0,6,13,24,-11,6,Gibraltar - Premier Division,0.25,0.25,-11,1.62,0.75,4.0,4.0,7
Europa Point,8,0,2,6,7,28,-21,2,Gibraltar - Premier Division,0.0,0.25,-21,0.88,0.25,0.0,4.0,8
Mons Calpe,8,0,1,7,7,25,-18,1,Gibraltar - Premier Division,0.0,0.12,-18,0.88,0.12,0.0,8.33,9
Olympiakos,8,6,2,0,15,5,10,20,Greece - Super League,0.75,1.0,10,1.88,2.5,1.33,1.0,1
AEK Athens,8,5,1,2,15,6,9,16,Greece - Super League,0.62,0.75,9,1.88,2.0,1.61,1.33,2
PAOK,8,5,0,3,21,8,13,15,Greece - Super League,0.62,0.62,13,2.62,1.88,1.61,1.61,3
Aris,8,4,3,1,9,6,3,15,Greece - Super League,0.5,0.88,3,1.12,1.88,2.0,1.14,3
Levadiakos,8,4,1,3,11,7,4,13,Greece - Super League,0.5,0.62,4,1.38,1.62,2.0,1.61,4
Atromitos,8,4,1,3,9,8,1,13,Greece - Super League,0.5,0.62,1,1.12,1.62,2.0,1.61,4
OFI Crete,8,4,0,4,13,14,-1,12,Greece - Super League,0.5,0.5,-1,1.62,1.5,2.0,2.0,5
Panathinaikos,8,3,2,3,12,14,-2,11,Greece - Super League,0.38,0.62,-2,1.5,1.38,2.63,1.61,6
Asteras T.,8,3,1,4,7,11,-4,10,Greece - Super League,0.38,0.5,-4,0.88,1.25,2.63,2.0,7
Panserraikos,8,2,2,4,8,17,-9,8,Greece - Super League,0.25,0.5,-9,1.0,1.0,4.0,2.0,8
Panaitolikos,8,2,1,5,5,8,-3,7,Greece - Super League,0.25,0.38,-3,0.62,0.88,4.0,2.63,9
A. Kallithea,8,2,1,5,7,12,-5,7,Greece - Super League,0.25,0.38,-5,0.88,0.88,4.0,2.63,9
Lamia,8,2,1,5,5,17,-12,7,Greece - Super League,0.25,0.38,-12,0.62,0.88,4.0,2.63,9
Volos,8,0,3,5,5,10,-5,3,Greece - Super League,0.0,0.38,-5,0.62,0.38,0.0,2.63,10
Malacateco,8,6,0,2,15,5,10,18,Guatemala - Liga Nacional - Apertura,0.75,0.75,10,1.88,2.25,1.33,1.33,1
Xelaju,8,5,2,1,16,5,11,17,Guatemala - Liga Nacional - Apertura,0.62,0.88,11,2.0,2.12,1.61,1.14,2
Municipal,8,4,2,2,13,13,0,14,Guatemala - Liga Nacional - Apertura,0.5,0.75,0,1.62,1.75,2.0,1.33,3
Coban Imperial,8,4,1,3,13,9,4,13,Guatemala - Liga Nacional - Apertura,0.5,0.62,4,1.62,1.62,2.0,1.61,4
Antigua GFC,8,3,3,2,14,11,3,12,Guatemala - Liga Nacional - Apertura,0.38,0.75,3,1.75,1.5,2.63,1.33,5
Xinabajul,8,3,2,3,15,14,1,11,Guatemala - Liga Nacional - Apertura,0.38,0.62,1,1.88,1.38,2.63,1.61,6
Comunicaciones,8,3,2,3,12,13,-1,11,Guatemala - Liga Nacional - Apertura,0.38,0.62,-1,1.5,1.38,2.63,1.61,6
Guastatoya,8,2,4,2,12,10,2,10,Guatemala - Liga Nacional - Apertura,0.25,0.75,2,1.5,1.25,4.0,1.33,7
Mixco,8,3,1,4,7,11,-4,10,Guatemala - Liga Nacional - Apertura,0.38,0.5,-4,0.88,1.25,2.63,2.0,7
Achuapa,8,2,3,3,6,10,-4,9,Guatemala - Liga Nacional - Apertura,0.25,0.62,-4,0.75,1.12,4.0,1.61,8
Marquense,8,0,3,5,4,16,-12,3,Guatemala - Liga Nacional - Apertura,0.0,0.38,-12,0.5,0.38,0.0,2.63,9
Zacapa Tellioz,8,0,2,6,3,14,-11,2,Guatemala - Liga Nacional - Apertura,0.0,0.25,-11,0.38,0.25,0.0,4.0,10
Olimpia,8,6,2,0,16,4,12,20,Honduras - Liga Nacional - Apertura,0.75,1.0,12,2.0,2.5,1.33,1.0,1
Genesis,8,4,3,1,16,8,8,15,Honduras - Liga Nacional - Apertura,0.5,0.88,8,2.0,1.88,2.0,1.14,2
Motagua,8,4,2,2,18,14,4,14,Honduras - Liga Nacional - Apertura,0.5,0.75,4,2.25,1.75,2.0,1.33,3
Olancho,8,3,4,1,15,10,5,13,Honduras - Liga Nacional - Apertura,0.38,0.88,5,1.88,1.62,2.63,1.14,4
Marathon,8,2,4,2,9,8,1,10,Honduras - Liga Nacional - Apertura,0.25,0.75,1,1.12,1.25,4.0,1.33,5
Juticalpa,8,2,2,4,7,14,-7,8,Honduras - Liga Nacional - Apertura,0.25,0.5,-7,0.88,1.0,4.0,2.0,6
UPNFM,8,2,2,4,6,16,-10,8,Honduras - Liga Nacional - Apertura,0.25,0.5,-10,0.75,1.0,4.0,2.0,6
Real Espana,8,1,4,3,6,7,-1,7,Honduras - Liga Nacional - Apertura,0.12,0.62,-1,0.75,0.88,8.33,1.61,7
Real Sociedad,8,1,3,4,10,17,-7,6,Honduras - Liga Nacional - Apertura,0.12,0.5,-7,1.25,0.75,8.33,2.0,8
Victoria,8,1,2,5,13,18,-5,5,Honduras - Liga Nacional - Apertura,0.12,0.38,-5,1.62,0.62,8.33,2.63,9
LM Warriors,8,6,1,1,21,17,4,19,Hong Kong - Premier League,0.75,0.88,4,2.62,2.38,1.33,1.14,1
Kitchee,8,6,0,2,20,8,12,18,Hong Kong - Premier League,0.75,0.75,12,2.5,2.25,1.33,1.33,2
Tai Po,8,6,0,2,24,13,11,18,Hong Kong - Premier League,0.75,0.75,11,3.0,2.25,1.33,1.33,2
Eastern,8,5,1,2,19,12,7,16,Hong Kong - Premier League,0.62,0.75,7,2.38,2.0,1.61,1.33,3
North District,8,3,0,5,15,23,-8,9,Hong Kong - Premier League,0.38,0.38,-8,1.88,1.12,2.63,2.63,4
HK Rangers,8,2,2,4,13,15,-2,8,Hong Kong - Premier League,0.25,0.5,-2,1.62,1.0,4.0,2.0,5
Kowloon City,8,2,2,4,14,21,-7,8,Hong Kong - Premier League,0.25,0.5,-7,1.75,1.0,4.0,2.0,5
Southern D.,8,2,1,5,10,13,-3,7,Hong Kong - Premier League,0.25,0.38,-3,1.25,0.88,4.0,2.63,6
Hong Kong FC,8,0,2,6,3,16,-13,2,Hong Kong - Premier League,0.0,0.25,-13,0.38,0.25,0.0,4.0,7
Paks,8,5,3,0,20,8,12,18,Hungary - NB I,0.62,1.0,12,2.5,2.25,1.61,1.0,1
Gyor,8,5,3,0,12,4,8,18,Hungary - NB I,0.62,1.0,8,1.5,2.25,1.61,1.0,1
Puskas A.,8,5,1,2,13,8,5,16,Hungary - NB I,0.62,0.75,5,1.62,2.0,1.61,1.33,2
Ferencvaros,8,3,3,2,13,9,4,12,Hungary - NB I,0.38,0.75,4,1.62,1.5,2.63,1.33,3
MTK Budapest,8,3,2,3,14,11,3,11,Hungary - NB I,0.38,0.62,3,1.75,1.38,2.63,1.61,4
Debrecen,8,3,1,4,13,11,2,10,Hungary - NB I,0.38,0.5,2,1.62,1.25,2.63,2.0,5
Zalaegerszegi,8,2,4,2,9,10,-1,10,Hungary - NB I,0.25,0.75,-1,1.12,1.25,4.0,1.33,5
Kecskemeti TE,8,2,3,3,13,15,-2,9,Hungary - NB I,0.25,0.62,-2,1.62,1.12,4.0,1.61,6
Fehervar,8,2,3,3,8,11,-3,9,Hungary - NB I,0.25,0.62,-3,1.0,1.12,4.0,1.61,6
DVTK,8,1,3,4,6,13,-7,6,Hungary - NB I,0.12,0.5,-7,0.75,0.75,8.33,2.0,7
Nyiregyhaza,8,1,3,4,3,10,-7,6,Hungary - NB I,0.12,0.5,-7,0.38,0.75,8.33,2.0,7
Ujpest,8,0,4,4,7,20,-13,4,Hungary - NB I,0.0,0.5,-13,0.88,0.5,0.0,2.0,8
Kisvarda,8,6,2,0,18,8,10,20,Hungary - NB II,0.75,1.0,10,2.25,2.5,1.33,1.0,1
Honved,8,5,0,3,16,10,6,15,Hungary - NB II,0.62,0.62,6,2.0,1.88,1.61,1.61,2
Kazincbarcika,8,3,5,0,9,4,5,14,Hungary - NB II,0.38,1.0,5,1.12,1.75,2.63,1.0,3
Vasas,8,4,2,2,9,5,4,14,Hungary - NB II,0.5,0.75,4,1.12,1.75,2.0,1.33,3
Szentlorinc,8,3,4,1,11,6,5,13,Hungary - NB II,0.38,0.88,5,1.38,1.62,2.63,1.14,4
Csakvari,8,4,1,3,13,11,2,13,Hungary - NB II,0.5,0.62,2,1.62,1.62,2.0,1.61,4
Szeged,8,3,3,2,10,8,2,12,Hungary - NB II,0.38,0.75,2,1.25,1.5,2.63,1.33,5
Ajka,8,4,0,4,11,12,-1,12,Hungary - NB II,0.5,0.5,-1,1.38,1.5,2.0,2.0,5
Mezokovesd,8,3,2,3,9,7,2,11,Hungary - NB II,0.38,0.62,2,1.12,1.38,2.63,1.61,6
Bekescsaba,8,3,2,3,8,9,-1,11,Hungary - NB II,0.38,0.62,-1,1.0,1.38,2.63,1.61,6
Kozarmisleny,8,3,1,4,10,14,-4,10,Hungary - NB II,0.38,0.5,-4,1.25,1.25,2.63,2.0,7
Gyirmot,8,1,5,2,9,11,-2,8,Hungary - NB II,0.12,0.75,-2,1.12,1.0,8.33,1.33,8
BVSC,8,1,4,3,6,9,-3,7,Hungary - NB II,0.12,0.62,-3,0.75,0.88,8.33,1.61,9
Soroksar,8,1,3,4,10,16,-6,6,Hungary - NB II,0.12,0.5,-6,1.25,0.75,8.33,2.0,10
Budafoki,8,2,0,6,9,16,-7,6,Hungary - NB II,0.25,0.25,-7,1.12,0.75,4.0,4.0,10
Tatabanya,8,2,0,6,7,16,-9,6,Hungary - NB II,0.25,0.25,-9,0.88,0.75,4.0,4.0,10
Breidablik,8,7,1,0,20,9,11,22,Iceland - Besta deild,0.88,1.0,11,2.5,2.75,1.14,1.0,1
Vikingur R.,8,6,1,1,24,12,12,19,Iceland - Besta deild,0.75,0.88,12,3.0,2.38,1.33,1.14,2
Stjarnan,8,5,2,1,17,8,9,17,Iceland - Besta deild,0.62,0.88,9,2.12,2.12,1.61,1.14,3
KR Reykjavik,8,5,1,2,26,12,14,16,Iceland - Besta deild,0.62,0.75,14,3.25,2.0,1.61,1.33,4
KA Akureyri,8,4,1,3,16,15,1,13,Iceland - Besta deild,0.5,0.62,1,2.0,1.62,2.0,1.61,5
Valur,8,3,3,2,22,14,8,12,Iceland - Besta deild,0.38,0.75,8,2.75,1.5,2.63,1.33,6
Vestri,8,2,2,4,11,14,-3,8,Iceland - Besta deild,0.25,0.5,-3,1.38,1.0,4.0,2.0,7
HK Kopavogur,8,2,2,4,12,22,-10,8,Iceland - Besta deild,0.25,0.5,-10,1.5,1.0,4.0,2.0,7
IA Akranes,8,2,0,6,12,22,-10,6,Iceland - Besta deild,0.25,0.25,-10,1.5,0.75,4.0,4.0,8
Hafnarfjordur,8,1,2,5,10,20,-10,5,Iceland - Besta deild,0.12,0.38,-10,1.25,0.62,8.33,2.63,9
Fylkir,8,1,2,5,8,18,-10,5,Iceland - Besta deild,0.12,0.38,-10,1.0,0.62,8.33,2.63,9
Fram,8,1,1,6,11,23,-12,4,Iceland - Besta deild,0.12,0.25,-12,1.38,0.5,8.33,4.0,10
Afturelding,8,6,1,1,18,7,11,19,Iceland - 1. Deild,0.75,0.88,11,2.25,2.38,1.33,1.14,1
Keflavik,8,5,2,1,17,9,8,17,Iceland - 1. Deild,0.62,0.88,8,2.12,2.12,1.61,1.14,2
Leiknir R.,8,4,4,0,18,10,8,16,Iceland - 1. Deild,0.5,1.0,8,2.25,2.0,2.0,1.0,3
IBV,8,4,2,2,22,12,10,14,Iceland - 1. Deild,0.5,0.75,10,2.75,1.75,2.0,1.33,4
IR Reykjavik,8,3,4,1,10,10,0,13,Iceland - 1. Deild,0.38,0.88,0,1.25,1.62,2.63,1.14,5
Throttur R.,8,3,2,3,15,12,3,11,Iceland - 1. Deild,0.38,0.62,3,1.88,1.38,2.63,1.61,6
Grindavik,8,2,3,3,18,19,-1,9,Iceland - 1. Deild,0.25,0.62,-1,2.25,1.12,4.0,1.61,7
Thor Akureyri,8,2,3,3,11,16,-5,9,Iceland - 1. Deild,0.25,0.62,-5,1.38,1.12,4.0,1.61,7
Njardvik,8,1,5,2,8,11,-3,8,Iceland - 1. Deild,0.12,0.75,-3,1.0,1.0,8.33,1.33,8
Fjolnir,8,1,3,4,6,14,-8,6,Iceland - 1. Deild,0.12,0.5,-8,0.75,0.75,8.33,2.0,9
Dalvik / Reynir,8,1,1,6,10,25,-15,4,Iceland - 1. Deild,0.12,0.25,-15,1.25,0.5,8.33,4.0,10
Grotta,8,1,0,7,9,17,-8,3,Iceland - 1. Deild,0.12,0.12,-8,1.12,0.38,8.33,8.33,11
Throttur Vogar,8,6,2,0,29,7,22,20,Iceland - 2. Deild,0.75,1.0,22,3.62,2.5,1.33,1.0,1
Selfoss,8,6,1,1,22,12,10,19,Iceland - 2. Deild,0.75,0.88,10,2.75,2.38,1.33,1.14,2
Volsungur,8,5,3,0,21,7,14,18,Iceland - 2. Deild,0.62,1.0,14,2.62,2.25,1.61,1.0,3
V. Olafsvik,8,5,1,2,19,13,6,16,Iceland - 2. Deild,0.62,0.75,6,2.38,2.0,1.61,1.33,4
Haukar,8,3,1,4,16,14,2,10,Iceland - 2. Deild,0.38,0.5,2,2.0,1.25,2.63,2.0,5
Fjardabyggd/L.,8,3,1,4,23,24,-1,10,Iceland - 2. Deild,0.38,0.5,-1,2.88,1.25,2.63,2.0,5
AEggir,8,2,4,2,9,12,-3,10,Iceland - 2. Deild,0.25,0.75,-3,1.12,1.25,4.0,1.33,5
Hottur/Huginn,8,3,0,5,11,23,-12,9,Iceland - 2. Deild,0.38,0.38,-12,1.38,1.12,2.63,2.63,6
KFG,8,2,2,4,12,16,-4,8,Iceland - 2. Deild,0.25,0.5,-4,1.5,1.0,4.0,2.0,7
Reynir,8,2,1,5,11,16,-5,7,Iceland - 2. Deild,0.25,0.38,-5,1.38,0.88,4.0,2.63,8
Fjallabyggd,8,2,1,5,12,22,-10,7,Iceland - 2. Deild,0.25,0.38,-10,1.5,0.88,4.0,2.63,8
Kormakur/Hvot,8,0,1,7,5,24,-19,1,Iceland - 2. Deild,0.0,0.12,-19,0.62,0.12,0.0,8.33,9
Mohun Bagan,8,6,2,0,16,2,14,20,India - Super League,0.75,1.0,14,2.0,2.5,1.33,1.0,1
Goa,8,6,0,2,13,7,6,18,India - Super League,0.75,0.75,6,1.62,2.25,1.33,1.33,2
NorthEast Utd,8,4,2,2,15,7,8,14,India - Super League,0.5,0.75,8,1.88,1.75,2.0,1.33,3
East Bengal,8,4,2,2,11,11,0,14,India - Super League,0.5,0.75,0,1.38,1.75,2.0,1.33,3
Mumbai City,8,3,3,2,10,6,4,12,India - Super League,0.38,0.75,4,1.25,1.5,2.63,1.33,4
Odisha FC,8,3,3,2,13,11,2,12,India - Super League,0.38,0.75,2,1.62,1.5,2.63,1.33,4
Bengaluru,8,3,1,4,11,10,1,10,India - Super League,0.38,0.5,1,1.38,1.25,2.63,2.0,5
Chennaiyin,8,3,1,4,11,12,-1,10,India - Super League,0.38,0.5,-1,1.38,1.25,2.63,2.0,5
Jamshedpur,8,3,1,4,12,16,-4,10,India - Super League,0.38,0.5,-4,1.5,1.25,2.63,2.0,5
Kerala Blasters,8,2,3,3,7,10,-3,9,India - Super League,0.25,0.62,-3,0.88,1.12,4.0,1.61,6
Punjab,8,2,2,4,11,15,-4,8,India - Super League,0.25,0.5,-4,1.38,1.0,4.0,2.0,7
Hyderabad,8,2,2,4,10,16,-6,8,India - Super League,0.25,0.5,-6,1.25,1.0,4.0,2.0,7
Mohammedan,8,0,2,6,4,19,-15,2,India - Super League,0.0,0.25,-15,0.5,0.25,0.0,4.0,8
Gokulam,8,6,0,2,20,11,9,18,India - I-League,0.75,0.75,9,2.5,2.25,1.33,1.33,1
Real Kashmir,8,5,1,2,12,11,1,16,India - I-League,0.62,0.75,1,1.5,2.0,1.61,1.33,2
Inter Kashi,8,4,3,1,14,10,4,15,India - I-League,0.5,0.88,4,1.75,1.88,2.0,1.14,3
Churchill B.,8,3,5,0,19,10,9,14,India - I-League,0.38,1.0,9,2.38,1.75,2.63,1.0,4
Rajasthan,8,4,1,3,17,12,5,13,India - I-League,0.5,0.62,5,2.12,1.62,2.0,1.61,5
Sreenidi Deccan,8,3,2,3,9,12,-3,11,India - I-League,0.38,0.62,-3,1.12,1.38,2.63,1.61,6
Dempo,8,2,3,3,22,16,6,9,India - I-League,0.25,0.62,6,2.75,1.12,4.0,1.61,7
Namdhari,8,2,2,4,10,13,-3,8,India - I-League,0.25,0.5,-3,1.25,1.0,4.0,2.0,8
Aizawl,8,2,2,4,13,18,-5,8,India - I-League,0.25,0.5,-5,1.62,1.0,4.0,2.0,8
Shillong Lajong,8,2,2,4,16,23,-7,8,India - I-League,0.25,0.5,-7,2.0,1.0,4.0,2.0,8
SC Bengaluru,8,2,2,4,11,18,-7,8,India - I-League,0.25,0.5,-7,1.38,1.0,4.0,2.0,8
Delhi FC,8,1,1,6,9,18,-9,4,India - I-League,0.12,0.25,-9,1.12,0.5,8.33,4.0,9
Dewa Utd,8,6,0,2,20,9,11,18,Indonesia - Liga 1,0.75,0.75,11,2.5,2.25,1.33,1.33,1
Malut United,8,5,3,0,13,6,7,18,Indonesia - Liga 1,0.62,1.0,7,1.62,2.25,1.61,1.0,1
Persib,8,5,2,1,16,9,7,17,Indonesia - Liga 1,0.62,0.88,7,2.0,2.12,1.61,1.14,2
Arema,8,4,2,2,19,13,6,14,Indonesia - Liga 1,0.5,0.75,6,2.38,1.75,2.0,1.33,3
Barito Putera,8,4,2,2,15,11,4,14,Indonesia - Liga 1,0.5,0.75,4,1.88,1.75,2.0,1.33,3
Persis Solo,8,3,4,1,13,10,3,13,Indonesia - Liga 1,0.38,0.88,3,1.62,1.62,2.63,1.14,4
Madura Utd,8,3,3,2,11,10,1,12,Indonesia - Liga 1,0.38,0.75,1,1.38,1.5,2.63,1.33,5
Borneo,8,4,0,4,8,10,-2,12,Indonesia - Liga 1,0.5,0.5,-2,1.0,1.5,2.0,2.0,5
Persebaya S.,8,3,2,3,9,10,-1,11,Indonesia - Liga 1,0.38,0.62,-1,1.12,1.38,2.63,1.61,6
PSBS Biak N.,8,2,4,2,8,8,0,10,Indonesia - Liga 1,0.25,0.75,0,1.0,1.25,4.0,1.33,7
Persija,8,2,3,3,13,13,0,9,Indonesia - Liga 1,0.25,0.62,0,1.62,1.12,4.0,1.61,8
PSM,8,2,3,3,10,10,0,9,Indonesia - Liga 1,0.25,0.62,0,1.25,1.12,4.0,1.61,8
Bali Utd,8,2,3,3,10,13,-3,9,Indonesia - Liga 1,0.25,0.62,-3,1.25,1.12,4.0,1.61,8
Semen Padang,8,2,3,3,11,17,-6,9,Indonesia - Liga 1,0.25,0.62,-6,1.38,1.12,4.0,1.61,8
Persita,8,1,3,4,7,11,-4,6,Indonesia - Liga 1,0.12,0.5,-4,0.88,0.75,8.33,2.0,9
PSIS Semarang,8,1,3,4,9,14,-5,6,Indonesia - Liga 1,0.12,0.5,-5,1.12,0.75,8.33,2.0,9
Persik Kediri,8,0,4,4,7,13,-6,4,Indonesia - Liga 1,0.0,0.5,-6,0.88,0.5,0.0,2.0,10
PSS Sleman,8,1,0,7,9,21,-12,3,Indonesia - Liga 1,0.12,0.12,-12,1.12,0.38,8.33,8.33,11
Tractor Sazi,8,6,1,1,14,4,10,19,Iran - Pro League,0.75,0.88,10,1.75,2.38,1.33,1.14,1
Persepolis,8,5,2,1,12,6,6,17,Iran - Pro League,0.62,0.88,6,1.5,2.12,1.61,1.14,2
Sepahan,8,3,5,0,12,5,7,14,Iran - Pro League,0.38,1.0,7,1.5,1.75,2.63,1.0,3
Malavan,8,4,2,2,8,5,3,14,Iran - Pro League,0.5,0.75,3,1.0,1.75,2.0,1.33,3
Foolad,8,4,1,3,10,10,0,13,Iran - Pro League,0.5,0.62,0,1.25,1.62,2.0,1.61,4
Shams A. Qazvin,8,3,2,3,11,10,1,11,Iran - Pro League,0.38,0.62,1,1.38,1.38,2.63,1.61,5
K. Khorramabad,8,3,2,3,8,8,0,11,Iran - Pro League,0.38,0.62,0,1.0,1.38,2.63,1.61,5
Gol Gohar,8,3,2,3,7,7,0,11,Iran - Pro League,0.38,0.62,0,0.88,1.38,2.63,1.61,5
Esteghlal,8,2,4,2,6,5,1,10,Iran - Pro League,0.25,0.75,1,0.75,1.25,4.0,1.33,6
Zob Ahan,8,2,3,3,9,10,-1,9,Iran - Pro League,0.25,0.62,-1,1.12,1.12,4.0,1.61,7
E. Khuzestan,8,2,3,3,6,9,-3,9,Iran - Pro League,0.25,0.62,-3,0.75,1.12,4.0,1.61,7
Chadormalu,8,2,2,4,6,7,-1,8,Iran - Pro League,0.25,0.5,-1,0.75,1.0,4.0,2.0,8
Aluminium Arak,8,2,2,4,6,8,-2,8,Iran - Pro League,0.25,0.5,-2,0.75,1.0,4.0,2.0,8
Mes Rafsanjan,8,1,4,3,4,9,-5,7,Iran - Pro League,0.12,0.62,-5,0.5,0.88,8.33,1.61,9
Havadar,8,2,1,5,6,15,-9,7,Iran - Pro League,0.25,0.38,-9,0.75,0.88,4.0,2.63,9
N. Mazandaran,8,1,2,5,4,9,-5,5,Iran - Pro League,0.12,0.38,-5,0.5,0.62,8.33,2.63,10
St. Patricks,7,4,1,2,12,7,5,13,Ireland - Premier Division,0.57,0.71,5,1.71,1.86,1.75,1.41,1
Galway Utd,7,3,4,0,10,6,4,13,Ireland - Premier Division,0.43,1.0,4,1.43,1.86,2.33,1.0,1
Drogheda Utd,7,3,3,1,8,4,4,12,Ireland - Premier Division,0.43,0.86,4,1.14,1.71,2.33,1.16,2
Shelbourne,7,3,3,1,9,6,3,12,Ireland - Premier Division,0.43,0.86,3,1.29,1.71,2.33,1.16,2
Waterford,7,3,0,4,8,11,-3,9,Ireland - Premier Division,0.43,0.43,-3,1.14,1.29,2.33,2.33,3
Shamrock Rovers,6,2,2,2,5,5,0,8,Ireland - Premier Division,0.33,0.67,0,0.83,1.33,3.03,1.49,4
Derry City,7,2,2,3,5,8,-3,8,Ireland - Premier Division,0.29,0.57,-3,0.71,1.14,3.45,1.75,4
Cork City,6,1,4,1,8,8,0,7,Ireland - Premier Division,0.17,0.83,0,1.33,1.17,5.88,1.2,5
Bohemians,7,2,0,5,5,9,-4,6,Ireland - Premier Division,0.29,0.29,-4,0.71,0.86,3.45,3.45,6
Sligo Rovers,7,1,1,5,9,15,-6,4,Ireland - Premier Division,0.14,0.29,-6,1.29,0.57,7.14,3.45,7
Dundalk,7,6,1,0,13,4,9,19,Ireland - First Division,0.86,1.0,9,1.86,2.71,1.16,1.0,1
Cobh Ramblers,7,4,2,1,14,6,8,14,Ireland - First Division,0.57,0.86,8,2.0,2.0,1.75,1.16,2
Wexford,6,3,0,3,7,6,1,9,Ireland - First Division,0.5,0.5,1,1.17,1.5,2.0,2.0,3
Bray Wanderers,6,3,0,3,5,11,-6,9,Ireland - First Division,0.5,0.5,-6,0.83,1.5,2.0,2.0,3
Treaty Utd,7,2,2,3,12,9,3,8,Ireland - First Division,0.29,0.57,3,1.71,1.14,3.45,1.75,4
Finn Harps,7,2,1,4,9,9,0,7,Ireland - First Division,0.29,0.43,0,1.29,1.0,3.45,2.33,5
Kerry,7,2,1,4,6,7,-1,7,Ireland - First Division,0.29,0.43,-1,0.86,1.0,3.45,2.33,5
Longford Town,6,2,1,3,7,11,-4,7,Ireland - First Division,0.33,0.5,-4,1.17,1.17,3.03,2.0,5
Athlone Town,7,2,1,4,4,11,-7,7,Ireland - First Division,0.29,0.43,-7,0.57,1.0,3.45,2.33,5
UC Dublin,6,1,3,2,4,7,-3,6,Ireland - First Division,0.17,0.67,-3,0.67,1.0,5.88,1.49,6
M. Tel Aviv,8,6,1,1,17,6,11,19,Israel - Ligat HaAl,0.75,0.88,11,2.12,2.38,1.33,1.14,1
H. Beer Sheva,8,5,2,1,15,6,9,17,Israel - Ligat HaAl,0.62,0.88,9,1.88,2.12,1.61,1.14,2
H. Jerusalem,8,3,4,1,16,8,8,13,Israel - Ligat HaAl,0.38,0.88,8,2.0,1.62,2.63,1.14,3
Maccabi Haifa,8,3,4,1,17,13,4,13,Israel - Ligat HaAl,0.38,0.88,4,2.12,1.62,2.63,1.14,3
Kiryat Shmona,8,4,1,3,11,10,1,13,Israel - Ligat HaAl,0.5,0.62,1,1.38,1.62,2.0,1.61,3
B. Jerusalem,8,2,5,1,11,10,1,11,Israel - Ligat HaAl,0.25,0.88,1,1.38,1.38,4.0,1.14,4
Maccabi Netanya,8,3,2,3,8,8,0,11,Israel - Ligat HaAl,0.38,0.62,0,1.0,1.38,2.63,1.61,4
Ashdod,8,2,4,2,11,10,1,10,Israel - Ligat HaAl,0.25,0.75,1,1.38,1.25,4.0,1.33,5
M. Bnei Raina,8,3,1,4,8,10,-2,10,Israel - Ligat HaAl,0.38,0.5,-2,1.0,1.25,2.63,2.0,5
Hapoel Haifa,8,3,1,4,11,17,-6,10,Israel - Ligat HaAl,0.38,0.5,-6,1.38,1.25,2.63,2.0,5
Hapoel Hadera,8,2,2,4,8,14,-6,8,Israel - Ligat HaAl,0.25,0.5,-6,1.0,1.0,4.0,2.0,6
Ironi Tiberias,8,2,2,4,7,15,-8,8,Israel - Ligat HaAl,0.25,0.5,-8,0.88,1.0,4.0,2.0,6
M. Petah Tikva,8,2,1,5,10,12,-2,7,Israel - Ligat HaAl,0.25,0.38,-2,1.25,0.88,4.0,2.63,7
Sakhnin,8,2,0,6,7,14,-7,6,Israel - Ligat HaAl,0.25,0.25,-7,0.88,0.75,4.0,4.0,8
Hapoel Tel Aviv,8,8,0,0,20,2,18,24,Israel - Leumit League,1.0,1.0,18,2.5,3.0,1.0,1.0,1
H. Petah Tikva,8,7,1,0,15,2,13,22,Israel - Leumit League,0.88,1.0,13,1.88,2.75,1.14,1.0,2
Hapoel Raanana,8,4,2,2,8,6,2,14,Israel - Leumit League,0.5,0.75,2,1.0,1.75,2.0,1.33,3
H. Ironi Rishon,8,4,1,3,15,11,4,13,Israel - Leumit League,0.5,0.62,4,1.88,1.62,2.0,1.61,4
Bnei Yehuda,8,4,1,3,9,8,1,13,Israel - Leumit League,0.5,0.62,1,1.12,1.62,2.0,1.61,4
H. Kfar Shalem,8,4,0,4,13,10,3,12,Israel - Leumit League,0.5,0.5,3,1.62,1.5,2.0,2.0,5
Maccabi Jaffa,8,3,3,2,8,9,-1,12,Israel - Leumit League,0.38,0.75,-1,1.0,1.5,2.63,1.33,5
Hapoel Akko,8,3,2,3,8,11,-3,11,Israel - Leumit League,0.38,0.62,-3,1.0,1.38,2.63,1.61,6
Kafr Qasim,8,3,1,4,8,8,0,10,Israel - Leumit League,0.38,0.5,0,1.0,1.25,2.63,2.0,7
H. Kfar Saba,8,3,1,4,8,9,-1,10,Israel - Leumit League,0.38,0.5,-1,1.0,1.25,2.63,2.0,7
M. Herziliya,8,3,1,4,7,12,-5,10,Israel - Leumit League,0.38,0.5,-5,0.88,1.25,2.63,2.0,7
H. Umm al-Fahm,8,2,2,4,6,11,-5,8,Israel - Leumit League,0.25,0.5,-5,0.75,1.0,4.0,2.0,8
Hapoel Afula,8,2,2,4,6,11,-5,8,Israel - Leumit League,0.25,0.5,-5,0.75,1.0,4.0,2.0,8
H. Ramat Gan,8,1,3,4,11,8,3,6,Israel - Leumit League,0.12,0.5,3,1.38,0.75,8.33,2.0,9
Ramat Hasharon,8,1,2,5,4,20,-16,5,Israel - Leumit League,0.12,0.38,-16,0.5,0.62,8.33,2.63,10
H. Nof Hagalil,8,0,2,6,1,9,-8,2,Israel - Leumit League,0.0,0.25,-8,0.12,0.25,0.0,4.0,11
AS Roma,8,7,1,0,12,2,10,22,Italy - Serie A,0.88,1.0,10,1.5,2.75,1.14,1.0,1
Bologna,8,6,1,1,15,7,8,19,Italy - Serie A,0.75,0.88,8,1.88,2.38,1.33,1.14,2
Juventus,8,6,0,2,11,9,2,18,Italy - Serie A,0.75,0.75,2,1.38,2.25,1.33,1.33,3
Inter Milan,8,5,1,2,11,9,2,16,Italy - Serie A,0.62,0.75,2,1.38,2.0,1.61,1.33,4
Torino,8,4,3,1,13,8,5,15,Italy - Serie A,0.5,0.88,5,1.62,1.88,2.0,1.14,5
Udinese,8,4,2,2,11,7,4,14,Italy - Serie A,0.5,0.75,4,1.38,1.75,2.0,1.33,6
Atalanta,8,3,3,2,15,4,11,12,Italy - Serie A,0.38,0.75,11,1.88,1.5,2.63,1.33,7
Fiorentina,8,4,0,4,10,7,3,12,Italy - Serie A,0.5,0.5,3,1.25,1.5,2.0,2.0,7
AC Milan,8,4,0,4,12,11,1,12,Italy - Serie A,0.5,0.5,1,1.5,1.5,2.0,2.0,7
Lazio,8,3,3,2,13,13,0,12,Italy - Serie A,0.38,0.75,0,1.62,1.5,2.63,1.33,7
Napoli,8,2,5,1,10,9,1,11,Italy - Serie A,0.25,0.88,1,1.25,1.38,4.0,1.14,8
Hellas Verona,8,3,1,4,5,11,-6,10,Italy - Serie A,0.38,0.5,-6,0.62,1.25,2.63,2.0,9
Genoa,8,2,3,3,8,8,0,9,Italy - Serie A,0.25,0.62,0,1.0,1.12,4.0,1.61,10
Cagliari,8,2,2,4,8,8,0,8,Italy - Serie A,0.25,0.5,0,1.0,1.0,4.0,2.0,11
Como,8,2,2,4,9,11,-2,8,Italy - Serie A,0.25,0.5,-2,1.12,1.0,4.0,2.0,11
Lecce,8,1,2,5,6,9,-3,5,Italy - Serie A,0.12,0.38,-3,0.75,0.62,8.33,2.63,12
Parma,8,1,2,5,9,13,-4,5,Italy - Serie A,0.12,0.38,-4,1.12,0.62,8.33,2.63,12
Venezia,8,0,4,4,3,8,-5,4,Italy - Serie A,0.0,0.5,-5,0.38,0.5,0.0,2.0,13
Monza,8,0,2,6,4,19,-15,2,Italy - Serie A,0.0,0.25,-15,0.5,0.25,0.0,4.0,14
Empoli,8,0,2,6,3,18,-15,2,Italy - Serie A,0.0,0.25,-15,0.38,0.25,0.0,4.0,14
Sassuolo,8,6,2,0,16,3,13,20,Italy - Serie B,0.75,1.0,13,2.0,2.5,1.33,1.0,1
Frosinone,8,4,3,1,12,7,5,15,Italy - Serie B,0.5,0.88,5,1.5,1.88,2.0,1.14,2
Catanzaro,8,4,2,2,13,10,3,14,Italy - Serie B,0.5,0.75,3,1.62,1.75,2.0,1.33,3
Pisa,8,4,1,3,14,9,5,13,Italy - Serie B,0.5,0.62,5,1.75,1.62,2.0,1.61,4
Juve Stabia,8,4,1,3,12,10,2,13,Italy - Serie B,0.5,0.62,2,1.5,1.62,2.0,1.61,4
Cremonese,8,3,3,2,16,11,5,12,Italy - Serie B,0.38,0.75,5,2.0,1.5,2.63,1.33,5
Palermo,8,3,3,2,14,11,3,12,Italy - Serie B,0.38,0.75,3,1.75,1.5,2.63,1.33,5
Sudtirol,8,3,3,2,13,10,3,12,Italy - Serie B,0.38,0.75,3,1.62,1.5,2.63,1.33,5
Cesena,8,3,3,2,10,9,1,12,Italy - Serie B,0.38,0.75,1,1.25,1.5,2.63,1.33,5
Modena,8,3,2,3,10,8,2,11,Italy - Serie B,0.38,0.62,2,1.25,1.38,2.63,1.61,6
Spezia,8,2,4,2,9,8,1,10,Italy - Serie B,0.25,0.75,1,1.12,1.25,4.0,1.33,7
Bari,8,2,4,2,8,9,-1,10,Italy - Serie B,0.25,0.75,-1,1.0,1.25,4.0,1.33,7
Sampdoria,8,2,4,2,7,9,-2,10,Italy - Serie B,0.25,0.75,-2,0.88,1.25,4.0,1.33,7
Carrarese,8,2,3,3,12,13,-1,9,Italy - Serie B,0.25,0.62,-1,1.5,1.12,4.0,1.61,8
Salernitana,8,2,3,3,6,8,-2,9,Italy - Serie B,0.25,0.62,-2,0.75,1.12,4.0,1.61,8
Brescia,8,2,3,3,5,7,-2,9,Italy - Serie B,0.25,0.62,-2,0.62,1.12,4.0,1.61,8
Cittadella,8,2,1,5,6,14,-8,7,Italy - Serie B,0.25,0.38,-8,0.75,0.88,4.0,2.63,9
Cosenza,8,2,1,5,3,15,-12,7,Italy - Serie B,0.25,0.38,-12,0.38,0.88,4.0,2.63,9
Mantova,8,1,2,5,8,15,-7,5,Italy - Serie B,0.12,0.38,-7,1.0,0.62,8.33,2.63,10
Reggiana,8,0,4,4,7,15,-8,4,Italy - Serie B,0.0,0.5,-8,0.88,0.5,0.0,2.0,11
Renate,8,6,1,1,13,7,6,19,Italy - Serie C - Group A,0.75,0.88,6,1.62,2.38,1.33,1.14,1
Vicenza,8,5,3,0,13,5,8,18,Italy - Serie C - Group A,0.62,1.0,8,1.62,2.25,1.61,1.0,2
FeralpiSalo,8,5,2,1,12,8,4,17,Italy - Serie C - Group A,0.62,0.88,4,1.5,2.12,1.61,1.14,3
Giana Erminio,8,5,1,2,11,7,4,16,Italy - Serie C - Group A,0.62,0.75,4,1.38,2.0,1.61,1.33,4
Trento,8,3,4,1,11,7,4,13,Italy - Serie C - Group A,0.38,0.88,4,1.38,1.62,2.63,1.14,5
Virtus Verona,8,3,3,2,13,9,4,12,Italy - Serie C - Group A,0.38,0.75,4,1.62,1.5,2.63,1.33,6
AlbinoLeffe,8,3,3,2,10,11,-1,12,Italy - Serie C - Group A,0.38,0.75,-1,1.25,1.5,2.63,1.33,6
Arzignano,8,4,0,4,8,10,-2,12,Italy - Serie C - Group A,0.5,0.5,-2,1.0,1.5,2.0,2.0,6
Padova,8,3,2,3,13,9,4,11,Italy - Serie C - Group A,0.38,0.62,4,1.62,1.38,2.63,1.61,7
Lecco,8,2,5,1,6,5,1,11,Italy - Serie C - Group A,0.25,0.88,1,0.75,1.38,4.0,1.14,7
Pro Patria,8,3,2,3,7,7,0,11,Italy - Serie C - Group A,0.38,0.62,0,0.88,1.38,2.63,1.61,7
Triestina,8,3,2,3,6,9,-3,11,Italy - Serie C - Group A,0.38,0.62,-3,0.75,1.38,2.63,1.61,7
Novara,8,3,1,4,7,9,-2,10,Italy - Serie C - Group A,0.38,0.5,-2,0.88,1.25,2.63,2.0,8
Alcione,8,2,2,4,6,7,-1,8,Italy - Serie C - Group A,0.25,0.5,-1,0.75,1.0,4.0,2.0,9
Atalanta B,8,1,4,3,9,11,-2,7,Italy - Serie C - Group A,0.12,0.62,-2,1.12,0.88,8.33,1.61,10
Pergolettese,8,1,3,4,5,9,-4,6,Italy - Serie C - Group A,0.12,0.5,-4,0.62,0.75,8.33,2.0,11
Caldiero Terme,8,1,3,4,12,17,-5,6,Italy - Serie C - Group A,0.12,0.5,-5,1.5,0.75,8.33,2.0,11
Pro Vercelli,8,1,3,4,3,8,-5,6,Italy - Serie C - Group A,0.12,0.5,-5,0.38,0.75,8.33,2.0,11
Clodiense,8,2,0,6,9,16,-7,6,Italy - Serie C - Group A,0.25,0.25,-7,1.12,0.75,4.0,4.0,11
Lumezzane,8,0,4,4,6,12,-6,4,Italy - Serie C - Group A,0.0,0.5,-6,0.75,0.5,0.0,2.0,12
Entella,8,6,2,0,16,5,11,20,Italy - Serie C - Group B,0.75,1.0,11,2.0,2.5,1.33,1.0,1
Ternana,8,5,1,2,12,6,6,16,Italy - Serie C - Group B,0.62,0.75,6,1.5,2.0,1.61,1.33,2
Pescara,8,4,2,2,17,12,5,14,Italy - Serie C - Group B,0.5,0.75,5,2.12,1.75,2.0,1.33,3
Perugia,8,4,2,2,9,5,4,14,Italy - Serie C - Group B,0.5,0.75,4,1.12,1.75,2.0,1.33,3
Pineto,8,4,2,2,12,11,1,14,Italy - Serie C - Group B,0.5,0.75,1,1.5,1.75,2.0,1.33,3
Lucchese,8,3,4,1,15,12,3,13,Italy - Serie C - Group B,0.38,0.88,3,1.88,1.62,2.63,1.14,4
Gubbio,8,4,1,3,8,9,-1,13,Italy - Serie C - Group B,0.5,0.62,-1,1.0,1.62,2.0,1.61,4
Rimini,8,4,0,4,11,9,2,12,Italy - Serie C - Group B,0.5,0.5,2,1.38,1.5,2.0,2.0,5
Arezzo,8,4,0,4,7,6,1,12,Italy - Serie C - Group B,0.5,0.5,1,0.88,1.5,2.0,2.0,5
Campobasso,8,4,0,4,10,12,-2,12,Italy - Serie C - Group B,0.5,0.5,-2,1.25,1.5,2.0,2.0,5
Athletic Carpi,8,3,2,3,9,9,0,11,Italy - Serie C - Group B,0.38,0.62,0,1.12,1.38,2.63,1.61,6
Torres,8,3,2,3,6,6,0,11,Italy - Serie C - Group B,0.38,0.62,0,0.75,1.38,2.63,1.61,6
Legnago Salus,8,2,4,2,10,9,1,10,Italy - Serie C - Group B,0.25,0.75,1,1.25,1.25,4.0,1.33,7
Pianese,8,3,0,5,4,9,-5,9,Italy - Serie C - Group B,0.38,0.38,-5,0.5,1.12,2.63,2.63,8
Vis Pesaro,8,1,5,2,7,7,0,8,Italy - Serie C - Group B,0.12,0.75,0,0.88,1.0,8.33,1.33,9
Pontedera,8,2,2,4,8,12,-4,8,Italy - Serie C - Group B,0.25,0.5,-4,1.0,1.0,4.0,2.0,9
Sestri Levante,8,2,2,4,8,12,-4,8,Italy - Serie C - Group B,0.25,0.5,-4,1.0,1.0,4.0,2.0,9
Ascoli,8,2,2,4,5,10,-5,8,Italy - Serie C - Group B,0.25,0.5,-5,0.62,1.0,4.0,2.0,9
AC Milan B,8,1,2,5,8,12,-4,5,Italy - Serie C - Group B,0.12,0.38,-4,1.0,0.62,8.33,2.63,10
SPAL,8,1,2,5,6,15,-9,5,Italy - Serie C - Group B,0.12,0.38,-9,0.75,0.62,8.33,2.63,10
Avellino,8,7,0,1,12,5,7,21,Italy - Serie C - Group C,0.88,0.88,7,1.5,2.62,1.14,1.14,1
A. Cerignola,8,6,1,1,10,4,6,19,Italy - Serie C - Group C,0.75,0.88,6,1.25,2.38,1.33,1.14,2
Crotone,8,5,2,1,17,7,10,17,Italy - Serie C - Group C,0.62,0.88,10,2.12,2.12,1.61,1.14,3
Catania,8,4,4,0,13,5,8,16,Italy - Serie C - Group C,0.5,1.0,8,1.62,2.0,2.0,1.0,4
Monopoli,8,4,2,2,9,7,2,14,Italy - Serie C - Group C,0.5,0.75,2,1.12,1.75,2.0,1.33,5
Cavese,8,3,4,1,11,9,2,13,Italy - Serie C - Group C,0.38,0.88,2,1.38,1.62,2.63,1.14,6
Picerno,8,2,6,0,9,5,4,12,Italy - Serie C - Group C,0.25,1.0,4,1.12,1.5,4.0,1.0,7
Juventus U23,8,3,2,3,10,8,2,11,Italy - Serie C - Group C,0.38,0.62,2,1.25,1.38,2.63,1.61,8
Giugliano,8,3,2,3,16,15,1,11,Italy - Serie C - Group C,0.38,0.62,1,2.0,1.38,2.63,1.61,8
Potenza,8,2,4,2,17,18,-1,10,Italy - Serie C - Group C,0.25,0.75,-1,2.12,1.25,4.0,1.33,9
Altamura,8,2,3,3,9,11,-2,9,Italy - Serie C - Group C,0.25,0.62,-2,1.12,1.12,4.0,1.61,10
Casertana,8,2,2,4,11,8,3,8,Italy - Serie C - Group C,0.25,0.5,3,1.38,1.0,4.0,2.0,11
ACR Messina,8,2,2,4,10,11,-1,8,Italy - Serie C - Group C,0.25,0.5,-1,1.25,1.0,4.0,2.0,11
Foggia,8,2,1,5,9,16,-7,7,Italy - Serie C - Group C,0.25,0.38,-7,1.12,0.88,4.0,2.63,12
Benevento,8,0,6,2,5,8,-3,6,Italy - Serie C - Group C,0.0,0.75,-3,0.62,0.75,0.0,1.33,13
Latina,8,1,3,4,9,20,-11,6,Italy - Serie C - Group C,0.12,0.5,-11,1.12,0.75,8.33,2.0,13
Trapani,8,1,1,6,3,11,-8,4,Italy - Serie C - Group C,0.12,0.25,-8,0.38,0.5,8.33,4.0,14
Sorrento,8,0,3,5,3,12,-9,3,Italy - Serie C - Group C,0.0,0.38,-9,0.38,0.38,0.0,2.63,15
Taranto,0,0,0,0,0,0,0,0,Italy - Serie C - Group C,0.0,0.0,0,0.0,0.0,0.0,0.0,16
Turris,0,0,0,0,0,0,0,0,Italy - Serie C - Group C,0.0,0.0,0,0.0,0.0,0.0,0.0,16
NovaRomentin,8,6,1,1,14,5,9,19,Italy - Serie D - Group A,0.75,0.88,9,1.75,2.38,1.33,1.14,1
Lavagnese,8,5,2,1,14,5,9,17,Italy - Serie D - Group A,0.62,0.88,9,1.75,2.12,1.61,1.14,2
Ligorna,8,5,2,1,13,9,4,17,Italy - Serie D - Group A,0.62,0.88,4,1.62,2.12,1.61,1.14,2
Saluzzo,8,4,3,1,12,5,7,15,Italy - Serie D - Group A,0.5,0.88,7,1.5,1.88,2.0,1.14,3
Bra,8,4,2,2,12,9,3,14,Italy - Serie D - Group A,0.5,0.75,3,1.5,1.75,2.0,1.33,4
Gozzano,8,3,4,1,8,5,3,13,Italy - Serie D - Group A,0.38,0.88,3,1.0,1.62,2.63,1.14,5
Derthona,8,4,1,3,9,8,1,13,Italy - Serie D - Group A,0.5,0.62,1,1.12,1.62,2.0,1.61,5
Vado,8,3,3,2,9,6,3,12,Italy - Serie D - Group A,0.38,0.75,3,1.12,1.5,2.63,1.33,6
Oltrepo,8,3,2,3,7,7,0,11,Italy - Serie D - Group A,0.38,0.62,0,0.88,1.38,2.63,1.61,7
Vogherese,8,2,5,1,5,6,-1,11,Italy - Serie D - Group A,0.25,0.88,-1,0.62,1.38,4.0,1.14,7
Sanremese,8,2,4,2,7,6,1,10,Italy - Serie D - Group A,0.25,0.75,1,0.88,1.25,4.0,1.33,8
Citta di Varese,8,3,1,4,6,8,-2,10,Italy - Serie D - Group A,0.38,0.5,-2,0.75,1.25,2.63,2.0,8
Chisola,8,2,3,3,8,10,-2,9,Italy - Serie D - Group A,0.25,0.62,-2,1.0,1.12,4.0,1.61,9
Chieri,8,2,3,3,7,9,-2,9,Italy - Serie D - Group A,0.25,0.62,-2,0.88,1.12,4.0,1.61,9
Fossano,8,3,0,5,7,13,-6,9,Italy - Serie D - Group A,0.38,0.38,-6,0.88,1.12,2.63,2.63,9
Asti,8,1,4,3,6,8,-2,7,Italy - Serie D - Group A,0.12,0.62,-2,0.75,0.88,8.33,1.61,10
Borgaro Nobis,8,1,1,6,4,11,-7,4,Italy - Serie D - Group A,0.12,0.25,-7,0.5,0.5,8.33,4.0,11
Pro Imperia,8,1,1,6,9,19,-10,4,Italy - Serie D - Group A,0.12,0.25,-10,1.12,0.5,8.33,4.0,11
Cairese,8,0,2,6,4,12,-8,2,Italy - Serie D - Group A,0.0,0.25,-8,0.5,0.25,0.0,4.0,12
Albenga,0,0,0,0,0,0,0,0,Italy - Serie D - Group A,0.0,0.0,0,0.0,0.0,0.0,0.0,13
Varesina,8,6,1,1,16,8,8,19,Italy - Serie D - Group B,0.75,0.88,8,2.0,2.38,1.33,1.14,1
USD Casatese,8,5,2,1,16,6,10,17,Italy - Serie D - Group B,0.62,0.88,10,2.0,2.12,1.61,1.14,2
Sondrio,8,5,2,1,12,5,7,17,Italy - Serie D - Group B,0.62,0.88,7,1.5,2.12,1.61,1.14,2
Pro Palazzolo,8,5,1,2,17,9,8,16,Italy - Serie D - Group B,0.62,0.75,8,2.12,2.0,1.61,1.33,3
F. Caratese,8,4,3,1,14,8,6,15,Italy - Serie D - Group B,0.5,0.88,6,1.75,1.88,2.0,1.14,4
Crema,8,3,3,2,15,11,4,12,Italy - Serie D - Group B,0.38,0.75,4,1.88,1.5,2.63,1.33,5
Breno,8,3,3,2,14,15,-1,12,Italy - Serie D - Group B,0.38,0.75,-1,1.75,1.5,2.63,1.33,5
Vigasio,8,3,2,3,6,8,-2,11,Italy - Serie D - Group B,0.38,0.62,-2,0.75,1.38,2.63,1.61,6
Ospitaletto,8,2,4,2,9,10,-1,10,Italy - Serie D - Group B,0.25,0.75,-1,1.12,1.25,4.0,1.33,7
Club Milano,8,3,1,4,10,14,-4,10,Italy - Serie D - Group B,0.38,0.5,-4,1.25,1.25,2.63,2.0,7
Fanfulla,8,2,3,3,7,10,-3,9,Italy - Serie D - Group B,0.25,0.62,-3,0.88,1.12,4.0,1.61,8
Ciliverghe,8,3,0,5,12,22,-10,9,Italy - Serie D - Group B,0.38,0.38,-10,1.5,1.12,2.63,2.63,8
Desenxano,8,2,2,4,9,9,0,8,Italy - Serie D - Group B,0.25,0.5,0,1.12,1.0,4.0,2.0,9
Chievo,8,2,2,4,8,9,-1,8,Italy - Serie D - Group B,0.25,0.5,-1,1.0,1.0,4.0,2.0,9
Castellanzese,8,1,5,2,11,13,-2,8,Italy - Serie D - Group B,0.12,0.75,-2,1.38,1.0,8.33,1.33,9
Sangiuliano C.,8,2,2,4,8,12,-4,8,Italy - Serie D - Group B,0.25,0.5,-4,1.0,1.0,4.0,2.0,9
Pro Sesto,8,2,2,4,6,10,-4,8,Italy - Serie D - Group B,0.25,0.5,-4,0.75,1.0,4.0,2.0,9
SantAngelo,8,1,4,3,9,10,-1,7,Italy - Serie D - Group B,0.12,0.62,-1,1.12,0.88,8.33,1.61,10
Arconatese,8,1,4,3,6,8,-2,7,Italy - Serie D - Group B,0.12,0.62,-2,0.75,0.88,8.33,1.61,10
Magenta,8,1,2,5,7,14,-7,5,Italy - Serie D - Group B,0.12,0.38,-7,0.88,0.62,8.33,2.63,11
D. Bellunesi,8,5,2,1,15,10,5,17,Italy - Serie D - Group C,0.62,0.88,5,1.88,2.12,1.61,1.14,1
Mestre,8,5,2,1,10,5,5,17,Italy - Serie D - Group C,0.62,0.88,5,1.25,2.12,1.61,1.14,1
Real Calepina,8,4,4,0,12,6,6,16,Italy - Serie D - Group C,0.5,1.0,6,1.5,2.0,2.0,1.0,2
Luparense,8,4,3,1,12,7,5,15,Italy - Serie D - Group C,0.5,0.88,5,1.5,1.88,2.0,1.14,3
Este,8,4,1,3,10,10,0,13,Italy - Serie D - Group C,0.5,0.62,0,1.25,1.62,2.0,1.61,4
Brian Lignano,8,2,6,0,11,5,6,12,Italy - Serie D - Group C,0.25,1.0,6,1.38,1.5,4.0,1.0,5
Cjarlins Muzane,8,3,3,2,13,10,3,12,Italy - Serie D - Group C,0.38,0.75,3,1.62,1.5,2.63,1.33,5
Brusaporto,8,3,3,2,7,5,2,12,Italy - Serie D - Group C,0.38,0.75,2,0.88,1.5,2.63,1.33,5
Treviso,8,4,0,4,8,8,0,12,Italy - Serie D - Group C,0.5,0.5,0,1.0,1.5,2.0,2.0,5
Adriese,8,3,3,2,8,9,-1,12,Italy - Serie D - Group C,0.38,0.75,-1,1.0,1.5,2.63,1.33,5
Portogruaro,8,3,2,3,8,5,3,11,Italy - Serie D - Group C,0.38,0.62,3,1.0,1.38,2.63,1.61,6
Campodarsego,8,2,5,1,9,8,1,11,Italy - Serie D - Group C,0.25,0.88,1,1.12,1.38,4.0,1.14,6
Bassano Virtus,8,2,3,3,9,7,2,9,Italy - Serie D - Group C,0.25,0.62,2,1.12,1.12,4.0,1.61,7
Chions,8,2,3,3,8,9,-1,9,Italy - Serie D - Group C,0.25,0.62,-1,1.0,1.12,4.0,1.61,7
Villa Alme,8,2,2,4,13,15,-2,8,Italy - Serie D - Group C,0.25,0.5,-2,1.62,1.0,4.0,2.0,8
Ciserano,8,1,5,2,4,6,-2,8,Italy - Serie D - Group C,0.12,0.75,-2,0.5,1.0,8.33,1.33,8
Calvi Noale,8,2,2,4,8,13,-5,8,Italy - Serie D - Group C,0.25,0.5,-5,1.0,1.0,4.0,2.0,8
Montecchio M.,8,1,3,4,6,11,-5,6,Italy - Serie D - Group C,0.12,0.5,-5,0.75,0.75,8.33,2.0,9
Lavis,8,1,0,7,3,17,-14,3,Italy - Serie D - Group C,0.12,0.12,-14,0.38,0.38,8.33,8.33,10
Caravaggio,8,0,2,6,8,16,-8,2,Italy - Serie D - Group C,0.0,0.25,-8,1.0,0.25,0.0,4.0,11
Forli,8,8,0,0,16,3,13,24,Italy - Serie D - Group D,1.0,1.0,13,2.0,3.0,1.0,1.0,1
Ravenna,8,6,1,1,21,8,13,19,Italy - Serie D - Group D,0.75,0.88,13,2.62,2.38,1.33,1.14,2
Pistoiese,8,5,3,0,10,3,7,18,Italy - Serie D - Group D,0.62,1.0,7,1.25,2.25,1.61,1.0,3
Zenith Prato,8,4,1,3,12,6,6,13,Italy - Serie D - Group D,0.5,0.62,6,1.5,1.62,2.0,1.61,4
Progresso,8,4,1,3,9,7,2,13,Italy - Serie D - Group D,0.5,0.62,2,1.12,1.62,2.0,1.61,4
Lentigione,8,3,3,2,12,9,3,12,Italy - Serie D - Group D,0.38,0.75,3,1.5,1.5,2.63,1.33,5
Prato,8,4,0,4,8,10,-2,12,Italy - Serie D - Group D,0.5,0.5,-2,1.0,1.5,2.0,2.0,5
Cittadella Vis,8,3,2,3,8,9,-1,11,Italy - Serie D - Group D,0.38,0.62,-1,1.0,1.38,2.63,1.61,6
Corticella,8,3,2,3,7,12,-5,11,Italy - Serie D - Group D,0.38,0.62,-5,0.88,1.38,2.63,1.61,6
Imolese,8,3,1,4,6,11,-5,10,Italy - Serie D - Group D,0.38,0.5,-5,0.75,1.25,2.63,2.0,7
Tau Altopascio,8,2,3,3,7,7,0,9,Italy - Serie D - Group D,0.25,0.62,0,0.88,1.12,4.0,1.61,8
Sammaurese,8,2,3,3,5,5,0,9,Italy - Serie D - Group D,0.25,0.62,0,0.62,1.12,4.0,1.61,8
Piacenza,8,2,3,3,4,5,-1,9,Italy - Serie D - Group D,0.25,0.62,-1,0.5,1.12,4.0,1.61,8
Tuttocuoio,8,2,2,4,10,11,-1,8,Italy - Serie D - Group D,0.25,0.5,-1,1.25,1.0,4.0,2.0,9
Sasso Marconi,8,2,1,5,8,14,-6,7,Italy - Serie D - Group D,0.25,0.38,-6,1.0,0.88,4.0,2.63,10
San Marino C.,8,1,3,4,10,12,-2,6,Italy - Serie D - Group D,0.12,0.5,-2,1.25,0.75,8.33,2.0,11
Fiorenzuola,8,2,0,6,6,13,-7,6,Italy - Serie D - Group D,0.25,0.25,-7,0.75,0.75,4.0,4.0,11
United Riccione,8,1,1,6,3,17,-14,4,Italy - Serie D - Group D,0.12,0.25,-14,0.38,0.5,8.33,4.0,12
Livorno,8,6,0,2,17,13,4,18,Italy - Serie D - Group E,0.75,0.75,4,2.12,2.25,1.33,1.33,1
Fulgens Foligno,8,4,3,1,18,11,7,15,Italy - Serie D - Group E,0.5,0.88,7,2.25,1.88,2.0,1.14,2
Ostia Mare,8,4,3,1,13,10,3,15,Italy - Serie D - Group E,0.5,0.88,3,1.62,1.88,2.0,1.14,2
Flaminia,8,4,2,2,15,7,8,14,Italy - Serie D - Group E,0.5,0.75,8,1.88,1.75,2.0,1.33,3
Gavorrano,8,3,5,0,10,7,3,14,Italy - Serie D - Group E,0.38,1.0,3,1.25,1.75,2.63,1.0,3
Ghiviborgo,8,4,1,3,19,13,6,13,Italy - Serie D - Group E,0.5,0.62,6,2.38,1.62,2.0,1.61,4
Orvietana,8,2,4,2,11,12,-1,10,Italy - Serie D - Group E,0.25,0.75,-1,1.38,1.25,4.0,1.33,5
T. Traiana,8,2,4,2,7,8,-1,10,Italy - Serie D - Group E,0.25,0.75,-1,0.88,1.25,4.0,1.33,5
San Donato,8,3,1,4,6,7,-1,10,Italy - Serie D - Group E,0.38,0.5,-1,0.75,1.25,2.63,2.0,5
Seravezza,8,2,3,3,10,12,-2,9,Italy - Serie D - Group E,0.25,0.62,-2,1.25,1.12,4.0,1.61,6
Grosseto,8,2,3,3,8,10,-2,9,Italy - Serie D - Group E,0.25,0.62,-2,1.0,1.12,4.0,1.61,6
Poggibonsi,8,2,3,3,5,8,-3,9,Italy - Serie D - Group E,0.25,0.62,-3,0.62,1.12,4.0,1.61,6
Figline,8,2,2,4,8,8,0,8,Italy - Serie D - Group E,0.25,0.5,0,1.0,1.0,4.0,2.0,7
Fezzanese,8,1,5,2,6,8,-2,8,Italy - Serie D - Group E,0.12,0.75,-2,0.75,1.0,8.33,1.33,7
FC Siena,8,1,5,2,5,8,-3,8,Italy - Serie D - Group E,0.12,0.75,-3,0.62,1.0,8.33,1.33,7
S. Trestina,8,2,2,4,7,15,-8,8,Italy - Serie D - Group E,0.25,0.5,-8,0.88,1.0,4.0,2.0,7
Montevarchi,8,0,6,2,5,8,-3,6,Italy - Serie D - Group E,0.0,0.75,-3,0.62,0.75,0.0,1.33,8
Sangiovannese,8,0,4,4,8,13,-5,4,Italy - Serie D - Group E,0.0,0.5,-5,1.0,0.5,0.0,2.0,9
San Nicolo,8,6,1,1,12,6,6,19,Italy - Serie D - Group F,0.75,0.88,6,1.5,2.38,1.33,1.14,1
Teramo,8,6,0,2,16,6,10,18,Italy - Serie D - Group F,0.75,0.75,10,2.0,2.25,1.33,1.33,2
Chieti,8,4,2,2,11,9,2,14,Italy - Serie D - Group F,0.5,0.75,2,1.38,1.75,2.0,1.33,3
Fossombrone,8,3,4,1,11,7,4,13,Italy - Serie D - Group F,0.38,0.88,4,1.38,1.62,2.63,1.14,4
Sambenedettese,8,3,4,1,9,5,4,13,Italy - Serie D - Group F,0.38,0.88,4,1.12,1.62,2.63,1.14,4
Avezzano,8,3,4,1,10,10,0,13,Italy - Serie D - Group F,0.38,0.88,0,1.25,1.62,2.63,1.14,4
Recanatese,8,3,3,2,11,13,-2,12,Italy - Serie D - Group F,0.38,0.75,-2,1.38,1.5,2.63,1.33,5
Termoli Calcio,8,2,5,1,10,11,-1,11,Italy - Serie D - Group F,0.25,0.88,-1,1.25,1.38,4.0,1.14,6
LAquila,8,2,4,2,9,7,2,10,Italy - Serie D - Group F,0.25,0.75,2,1.12,1.25,4.0,1.33,7
Castelfidardo,8,2,3,3,8,7,1,9,Italy - Serie D - Group F,0.25,0.62,1,1.0,1.12,4.0,1.61,8
Civitanovese,8,2,3,3,7,6,1,9,Italy - Serie D - Group F,0.25,0.62,1,0.88,1.12,4.0,1.61,8
Sora,8,2,3,3,9,9,0,9,Italy - Serie D - Group F,0.25,0.62,0,1.12,1.12,4.0,1.61,8
Atletico Ascoli,8,2,3,3,8,9,-1,9,Italy - Serie D - Group F,0.25,0.62,-1,1.0,1.12,4.0,1.61,8
V. Senigallia,8,2,3,3,6,9,-3,9,Italy - Serie D - Group F,0.25,0.62,-3,0.75,1.12,4.0,1.61,8
Isernia,8,2,2,4,6,13,-7,8,Italy - Serie D - Group F,0.25,0.5,-7,0.75,1.0,4.0,2.0,9
Roma City,8,1,4,3,8,10,-2,7,Italy - Serie D - Group F,0.12,0.62,-2,1.0,0.88,8.33,1.61,10
Ancona 1905,8,0,4,4,6,12,-6,4,Italy - Serie D - Group F,0.0,0.5,-6,0.75,0.5,0.0,2.0,11
Fermana,8,0,2,6,6,14,-8,2,Italy - Serie D - Group F,0.0,0.25,-8,0.75,0.25,0.0,4.0,12
Sarnese,8,6,2,0,18,7,11,20,Italy - Serie D - Group G,0.75,1.0,11,2.25,2.5,1.33,1.0,1
Guidonia,8,6,1,1,20,9,11,19,Italy - Serie D - Group G,0.75,0.88,11,2.5,2.38,1.33,1.14,2
Savoia,8,6,1,1,17,10,7,19,Italy - Serie D - Group G,0.75,0.88,7,2.12,2.38,1.33,1.14,2
CynthiAlbalonga,8,6,0,2,13,7,6,18,Italy - Serie D - Group G,0.75,0.75,6,1.62,2.25,1.33,1.33,3
Gelbison,8,5,2,1,14,7,7,17,Italy - Serie D - Group G,0.62,0.88,7,1.75,2.12,1.61,1.14,4
Ilvamaddalena,8,5,1,2,15,5,10,16,Italy - Serie D - Group G,0.62,0.75,10,1.88,2.0,1.61,1.33,5
Paganese,8,5,1,2,13,7,6,16,Italy - Serie D - Group G,0.62,0.75,6,1.62,2.0,1.61,1.33,5
Olbia,8,3,3,2,8,4,4,12,Italy - Serie D - Group G,0.38,0.75,4,1.0,1.5,2.63,1.33,6
Cassino,8,3,2,3,10,7,3,11,Italy - Serie D - Group G,0.38,0.62,3,1.25,1.38,2.63,1.61,7
Trastevere,8,3,0,5,10,13,-3,9,Italy - Serie D - Group G,0.38,0.38,-3,1.25,1.12,2.63,2.63,8
A. Lodigiani,8,2,2,4,12,13,-1,8,Italy - Serie D - Group G,0.25,0.5,-1,1.5,1.0,4.0,2.0,9
Atletico Uri,8,2,2,4,11,12,-1,8,Italy - Serie D - Group G,0.25,0.5,-1,1.38,1.0,4.0,2.0,9
S. Ogliastra,8,2,2,4,11,17,-6,8,Italy - Serie D - Group G,0.25,0.5,-6,1.38,1.0,4.0,2.0,9
R. Monterotondo,8,1,3,4,6,13,-7,6,Italy - Serie D - Group G,0.12,0.5,-7,0.75,0.75,8.33,2.0,10
Puteolana,8,1,2,5,6,14,-8,5,Italy - Serie D - Group G,0.12,0.38,-8,0.75,0.62,8.33,2.63,11
Latte Dolce,8,1,1,6,6,17,-11,4,Italy - Serie D - Group G,0.12,0.25,-11,0.75,0.5,8.33,4.0,12
Terracina,8,1,1,6,7,19,-12,4,Italy - Serie D - Group G,0.12,0.25,-12,0.88,0.5,8.33,4.0,12
Anzio,8,0,2,6,5,21,-16,2,Italy - Serie D - Group G,0.0,0.25,-16,0.62,0.25,0.0,4.0,13
Casarano,8,6,2,0,20,5,15,20,Italy - Serie D - Group H,0.75,1.0,15,2.5,2.5,1.33,1.0,1
Francavilla,8,6,0,2,11,5,6,18,Italy - Serie D - Group H,0.75,0.75,6,1.38,2.25,1.33,1.33,2
Nocerina,8,4,4,0,11,3,8,16,Italy - Serie D - Group H,0.5,1.0,8,1.38,2.0,2.0,1.0,3
Manfredonia,8,3,4,1,8,4,4,13,Italy - Serie D - Group H,0.38,0.88,4,1.0,1.62,2.63,1.14,4
Martina Franca,8,3,4,1,7,6,1,13,Italy - Serie D - Group H,0.38,0.88,1,0.88,1.62,2.63,1.14,4
Citta di Fasano,8,3,3,2,12,6,6,12,Italy - Serie D - Group H,0.38,0.75,6,1.5,1.5,2.63,1.33,5
Brindisi,8,3,3,2,14,11,3,12,Italy - Serie D - Group H,0.38,0.75,3,1.75,1.5,2.63,1.33,5
Fidelis Andria,8,3,2,3,7,8,-1,11,Italy - Serie D - Group H,0.38,0.62,-1,0.88,1.38,2.63,1.61,6
Ischia,8,2,4,2,7,7,0,10,Italy - Serie D - Group H,0.25,0.75,0,0.88,1.25,4.0,1.33,7
Gravina,8,2,3,3,9,10,-1,9,Italy - Serie D - Group H,0.25,0.62,-1,1.12,1.12,4.0,1.61,8
Angri Calcio,8,2,3,3,8,11,-3,9,Italy - Serie D - Group H,0.25,0.62,-3,1.0,1.12,4.0,1.61,8
USD Palmese,8,2,3,3,8,11,-3,9,Italy - Serie D - Group H,0.25,0.62,-3,1.0,1.12,4.0,1.61,8
V. Francavilla,8,1,5,2,9,10,-1,8,Italy - Serie D - Group H,0.12,0.75,-1,1.12,1.0,8.33,1.33,9
Ugento,8,2,2,4,8,12,-4,8,Italy - Serie D - Group H,0.25,0.5,-4,1.0,1.0,4.0,2.0,9
Nardo,8,2,2,4,5,9,-4,8,Italy - Serie D - Group H,0.25,0.5,-4,0.62,1.0,4.0,2.0,9
Real Acerrana,8,1,3,4,8,13,-5,6,Italy - Serie D - Group H,0.12,0.5,-5,1.0,0.75,8.33,2.0,10
Matera,8,1,3,4,6,17,-11,6,Italy - Serie D - Group H,0.12,0.5,-11,0.75,0.75,8.33,2.0,10
Costa DAmalfi,8,0,2,6,2,12,-10,2,Italy - Serie D - Group H,0.0,0.25,-10,0.25,0.25,0.0,4.0,11
Siracusa,8,7,0,1,21,5,16,21,Italy - Serie D - Group I,0.88,0.88,16,2.62,2.62,1.14,1.14,1
Reggina,8,7,0,1,17,3,14,21,Italy - Serie D - Group I,0.88,0.88,14,2.12,2.62,1.14,1.14,1
Pompei,8,5,1,2,7,6,1,16,Italy - Serie D - Group I,0.62,0.75,1,0.88,2.0,1.61,1.33,2
Nissa,8,4,3,1,13,9,4,15,Italy - Serie D - Group I,0.5,0.88,4,1.62,1.88,2.0,1.14,3
Scafatese,8,4,2,2,9,5,4,14,Italy - Serie D - Group I,0.5,0.75,4,1.12,1.75,2.0,1.33,4
Igea Virtus,8,4,1,3,12,9,3,13,Italy - Serie D - Group I,0.5,0.62,3,1.5,1.62,2.0,1.61,5
Ragusa,8,4,0,4,12,8,4,12,Italy - Serie D - Group I,0.5,0.5,4,1.5,1.5,2.0,2.0,6
Sambiase,8,3,2,3,8,7,1,11,Italy - Serie D - Group I,0.38,0.62,1,1.0,1.38,2.63,1.61,7
Vibonese,8,3,1,4,11,10,1,10,Italy - Serie D - Group I,0.38,0.5,1,1.38,1.25,2.63,2.0,8
Paterno,8,2,4,2,6,7,-1,10,Italy - Serie D - Group I,0.25,0.75,-1,0.75,1.25,4.0,1.33,8
Acireale,8,2,4,2,8,11,-3,10,Italy - Serie D - Group I,0.25,0.75,-3,1.0,1.25,4.0,1.33,8
Sancataldese,8,2,2,4,7,11,-4,8,Italy - Serie D - Group I,0.25,0.5,-4,0.88,1.0,4.0,2.0,9
CD S. Agata,8,1,4,3,11,12,-1,7,Italy - Serie D - Group I,0.12,0.62,-1,1.38,0.88,8.33,1.61,10
CastrumFavara,8,1,3,4,6,13,-7,6,Italy - Serie D - Group I,0.12,0.5,-7,0.75,0.75,8.33,2.0,11
Licata,8,1,2,5,5,18,-13,5,Italy - Serie D - Group I,0.12,0.38,-13,0.62,0.62,8.33,2.63,12
Enna,8,0,4,4,2,9,-7,4,Italy - Serie D - Group I,0.0,0.5,-7,0.25,0.5,0.0,2.0,13
Locri 1909,8,0,2,6,6,19,-13,2,Italy - Serie D - Group I,0.0,0.25,-13,0.75,0.25,0.0,4.0,14
Akragas,0,0,0,0,0,0,0,0,Italy - Serie D - Group I,0.0,0.0,0,0.0,0.0,0.0,0.0,15
Inter Milan U20,8,6,2,0,18,4,14,20,Italy - Primavera 1,0.75,1.0,14,2.25,2.5,1.33,1.0,1
Juventus U20,8,6,0,2,19,14,5,18,Italy - Primavera 1,0.75,0.75,5,2.38,2.25,1.33,1.33,2
H. Verona U20,8,5,1,2,17,5,12,16,Italy - Primavera 1,0.62,0.75,12,2.12,2.0,1.61,1.33,3
Roma U20,8,5,0,3,14,11,3,15,Italy - Primavera 1,0.62,0.62,3,1.75,1.88,1.61,1.61,4
Milan U20,8,4,2,2,13,10,3,14,Italy - Primavera 1,0.5,0.75,3,1.62,1.75,2.0,1.33,5
Lazio U20,8,4,2,2,11,9,2,14,Italy - Primavera 1,0.5,0.75,2,1.38,1.75,2.0,1.33,5
Sassuolo U20,8,4,2,2,8,7,1,14,Italy - Primavera 1,0.5,0.75,1,1.0,1.75,2.0,1.33,5
Cesena U20,8,4,1,3,19,16,3,13,Italy - Primavera 1,0.5,0.62,3,2.38,1.62,2.0,1.61,6
Atalanta U20,8,4,0,4,11,7,4,12,Italy - Primavera 1,0.5,0.5,4,1.38,1.5,2.0,2.0,7
Genoa U20,8,4,0,4,14,11,3,12,Italy - Primavera 1,0.5,0.5,3,1.75,1.5,2.0,2.0,7
Fiorentina U20,8,4,0,4,12,12,0,12,Italy - Primavera 1,0.5,0.5,0,1.5,1.5,2.0,2.0,7
Cagliari U20,8,3,3,2,7,8,-1,12,Italy - Primavera 1,0.38,0.75,-1,0.88,1.5,2.63,1.33,7
Lecce U20,8,3,2,3,9,12,-3,11,Italy - Primavera 1,0.38,0.62,-3,1.12,1.38,2.63,1.61,8
Bologna U20,8,2,3,3,6,9,-3,9,Italy - Primavera 1,0.25,0.62,-3,0.75,1.12,4.0,1.61,9
Monza U20,8,3,0,5,15,22,-7,9,Italy - Primavera 1,0.38,0.38,-7,1.88,1.12,2.63,2.63,9
Torino U20,8,2,2,4,10,13,-3,8,Italy - Primavera 1,0.25,0.5,-3,1.25,1.0,4.0,2.0,10
Cremonese U20,8,1,4,3,8,9,-1,7,Italy - Primavera 1,0.12,0.62,-1,1.0,0.88,8.33,1.61,11
Empoli U20,8,1,2,5,7,15,-8,5,Italy - Primavera 1,0.12,0.38,-8,0.88,0.62,8.33,2.63,12
Udinese U20,8,1,1,6,6,18,-12,4,Italy - Primavera 1,0.12,0.25,-12,0.75,0.5,8.33,4.0,13
Sampdoria U20,8,0,3,5,8,16,-8,3,Italy - Primavera 1,0.0,0.38,-8,1.0,0.38,0.0,2.63,14
Arnett Gardens,8,5,3,0,20,5,15,18,Jamaica - Premier League,0.62,1.0,15,2.5,2.25,1.61,1.0,1
Tivoli Gardens,8,5,2,1,18,11,7,17,Jamaica - Premier League,0.62,0.88,7,2.25,2.12,1.61,1.14,2
Mount Pleasant,8,5,1,2,18,6,12,16,Jamaica - Premier League,0.62,0.75,12,2.25,2.0,1.61,1.33,3
Montego Bay,8,4,4,0,12,4,8,16,Jamaica - Premier League,0.5,1.0,8,1.5,2.0,2.0,1.0,3
Racing United,8,4,3,1,12,6,6,15,Jamaica - Premier League,0.5,0.88,6,1.5,1.88,2.0,1.14,4
Cavalier,8,4,3,1,10,5,5,15,Jamaica - Premier League,0.5,0.88,5,1.25,1.88,2.0,1.14,4
Portmore Utd,8,3,3,2,6,4,2,12,Jamaica - Premier League,0.38,0.75,2,0.75,1.5,2.63,1.33,5
Humble Lions,8,3,2,3,10,11,-1,11,Jamaica - Premier League,0.38,0.62,-1,1.25,1.38,2.63,1.61,6
Waterhouse,8,3,1,4,10,11,-1,10,Jamaica - Premier League,0.38,0.5,-1,1.25,1.25,2.63,2.0,7
Harbour View,8,2,2,4,6,9,-3,8,Jamaica - Premier League,0.25,0.5,-3,0.75,1.0,4.0,2.0,8
Chapelton,8,2,1,5,5,14,-9,7,Jamaica - Premier League,0.25,0.38,-9,0.62,0.88,4.0,2.63,9
Molynes Utd,8,1,3,4,7,19,-12,6,Jamaica - Premier League,0.12,0.5,-12,0.88,0.75,8.33,2.0,10
Vere Utd,8,1,1,6,6,12,-6,4,Jamaica - Premier League,0.12,0.25,-6,0.75,0.5,8.33,4.0,11
Dunbeholden,8,1,1,6,6,16,-10,4,Jamaica - Premier League,0.12,0.25,-10,0.75,0.5,8.33,4.0,11
Kashima Antlers,7,5,1,1,13,4,9,16,Japan - J1 League,0.71,0.86,9,1.86,2.29,1.41,1.16,1
Machida Zelvia,7,4,1,2,9,6,3,13,Japan - J1 League,0.57,0.71,3,1.29,1.86,1.75,1.41,2
Kashiwa Reysol,7,3,3,1,8,6,2,12,Japan - J1 League,0.43,0.86,2,1.14,1.71,2.33,1.16,3
K. Frontale,6,3,2,1,10,3,7,11,Japan - J1 League,0.5,0.83,7,1.67,1.83,2.0,1.2,4
Shimizu S-Pulse,7,3,2,2,9,5,4,11,Japan - J1 League,0.43,0.71,4,1.29,1.57,2.33,1.41,4
Fagiano Okayama,7,3,2,2,6,3,3,11,Japan - J1 League,0.43,0.71,3,0.86,1.57,2.33,1.41,4
S. Hiroshima,6,3,2,1,6,4,2,11,Japan - J1 League,0.5,0.83,2,1.0,1.83,2.0,1.2,4
Kyoto Sanga,7,3,2,2,6,6,0,11,Japan - J1 League,0.43,0.71,0,0.86,1.57,2.33,1.41,4
Shonan Bellmare,7,3,2,2,7,8,-1,11,Japan - J1 League,0.43,0.71,-1,1.0,1.57,2.33,1.41,4
Avispa Fukuoka,7,3,1,3,7,7,0,10,Japan - J1 League,0.43,0.57,0,1.0,1.43,2.33,1.75,5
Gamba Osaka,7,3,1,3,9,13,-4,10,Japan - J1 League,0.43,0.57,-4,1.29,1.43,2.33,1.75,5
Tokyo Verdy,7,2,2,3,5,9,-4,8,Japan - J1 League,0.29,0.57,-4,0.71,1.14,3.45,1.75,6
Urawa RD,7,1,4,2,5,7,-2,7,Japan - J1 League,0.14,0.71,-2,0.71,1.0,7.14,1.41,7
Yokohama FC,7,2,1,4,4,6,-2,7,Japan - J1 League,0.29,0.43,-2,0.57,1.0,3.45,2.33,7
FC Tokyo,7,2,1,4,4,8,-4,7,Japan - J1 League,0.29,0.43,-4,0.57,1.0,3.45,2.33,7
Yokohama M.,6,1,3,2,4,4,0,6,Japan - J1 League,0.17,0.67,0,0.67,1.0,5.88,1.49,8
Cerezo Osaka,7,1,3,3,11,12,-1,6,Japan - J1 League,0.14,0.57,-1,1.57,0.86,7.14,1.75,8
Vissel Kobe,6,1,3,2,5,6,-1,6,Japan - J1 League,0.17,0.67,-1,0.83,1.0,5.88,1.49,8
Nagoya G.,7,1,2,4,8,15,-7,5,Japan - J1 League,0.14,0.43,-7,1.14,0.71,7.14,2.33,9
Albirex Niigata,7,0,4,3,9,13,-4,4,Japan - J1 League,0.0,0.57,-4,1.29,0.57,0.0,1.75,10
JEF Utd Chiba,7,6,0,1,17,6,11,18,Japan - J2 League,0.86,0.86,11,2.43,2.57,1.16,1.16,1
Omiya Ardija,7,5,0,2,11,4,7,15,Japan - J2 League,0.71,0.71,7,1.57,2.14,1.41,1.41,2
Jubilo Iwata,7,5,0,2,11,9,2,15,Japan - J2 League,0.71,0.71,2,1.57,2.14,1.41,1.41,2
V-V. Nagasaki,7,4,2,1,15,9,6,14,Japan - J2 League,0.57,0.86,6,2.14,2.0,1.75,1.16,3
FC Imabari,7,3,3,1,10,6,4,12,Japan - J2 League,0.43,0.86,4,1.43,1.71,2.33,1.16,4
Tokushima V.,7,3,3,1,5,2,3,12,Japan - J2 League,0.43,0.86,3,0.71,1.71,2.33,1.16,4
Fujieda MYFC,7,3,3,1,11,9,2,12,Japan - J2 League,0.43,0.86,2,1.57,1.71,2.33,1.16,4
Vegalta Sendai,7,3,2,2,9,7,2,11,Japan - J2 League,0.43,0.71,2,1.29,1.57,2.33,1.41,5
Kataller Toyama,7,3,1,3,6,5,1,10,Japan - J2 League,0.43,0.57,1,0.86,1.43,2.33,1.75,6
Oita Trinita,7,2,4,1,5,4,1,10,Japan - J2 League,0.29,0.86,1,0.71,1.43,3.45,1.16,6
R. Kumamoto,7,3,1,3,10,11,-1,10,Japan - J2 League,0.43,0.57,-1,1.43,1.43,2.33,1.75,6
Mito Hollyhock,7,2,3,2,10,9,1,9,Japan - J2 League,0.29,0.71,1,1.43,1.29,3.45,1.41,7
Blaublitz Akita,7,3,0,4,9,15,-6,9,Japan - J2 League,0.43,0.43,-6,1.29,1.29,2.33,2.33,7
M. Yamagata,7,2,2,3,12,11,1,8,Japan - J2 League,0.29,0.57,1,1.71,1.14,3.45,1.75,8
Ventforet Kofu,7,2,1,4,7,10,-3,7,Japan - J2 League,0.29,0.43,-3,1.0,1.0,3.45,2.33,9
Sagan Tosu,7,2,1,4,5,10,-5,7,Japan - J2 League,0.29,0.43,-5,0.71,1.0,3.45,2.33,9
C. Sapporo,7,2,0,5,6,13,-7,6,Japan - J2 League,0.29,0.29,-7,0.86,0.86,3.45,3.45,10
R. Yamaguchi,7,1,2,4,6,8,-2,5,Japan - J2 League,0.14,0.43,-2,0.86,0.71,7.14,2.33,11
Iwaki,7,0,3,4,3,11,-8,3,Japan - J2 League,0.0,0.43,-8,0.43,0.43,0.0,2.33,12
Ehime FC,7,0,1,6,6,15,-9,1,Japan - J2 League,0.0,0.14,-9,0.86,0.14,0.0,7.14,13
Osaka,7,5,1,1,9,4,5,16,Japan - J3 League,0.71,0.86,5,1.29,2.29,1.41,1.16,1
Tochigi City,7,4,2,1,9,7,2,14,Japan - J3 League,0.57,0.86,2,1.29,2.0,1.75,1.16,2
Kagoshima Utd,7,3,3,1,13,8,5,12,Japan - J3 League,0.43,0.86,5,1.86,1.71,2.33,1.16,3
G. Kitakyushu,6,4,0,2,8,3,5,12,Japan - J3 League,0.67,0.67,5,1.33,2.0,1.49,1.49,3
Nara Club,7,3,3,1,11,9,2,12,Japan - J3 League,0.43,0.86,2,1.57,1.71,2.33,1.16,3
T. Miyazaki,7,3,2,2,9,7,2,11,Japan - J3 League,0.43,0.71,2,1.29,1.57,2.33,1.41,4
Z. Kanazawa,6,3,1,2,9,7,2,10,Japan - J3 League,0.5,0.67,2,1.5,1.67,2.0,1.49,5
Fukushima Utd,6,3,1,2,11,10,1,10,Japan - J3 League,0.5,0.67,1,1.83,1.67,2.0,1.49,5
Kamatamare S.,7,2,3,2,6,6,0,9,Japan - J3 League,0.29,0.71,0,0.86,1.29,3.45,1.41,6
Nagano Parceiro,6,3,0,3,8,9,-1,9,Japan - J3 League,0.5,0.5,-1,1.33,1.5,2.0,2.0,6
V. Hachinohe,6,2,2,2,7,7,0,8,Japan - J3 League,0.33,0.67,0,1.17,1.33,3.03,1.49,7
Tochigi SC,7,2,2,3,5,6,-1,8,Japan - J3 League,0.29,0.57,-1,0.71,1.14,3.45,1.75,7
SC Sagamihara,7,2,2,3,6,9,-3,8,Japan - J3 League,0.29,0.57,-3,0.86,1.14,3.45,1.75,7
Kusatsu,7,2,1,4,9,13,-4,7,Japan - J3 League,0.29,0.43,-4,1.29,1.0,3.45,2.33,8
Matsumoto Y.,5,1,3,1,5,4,1,6,Japan - J3 League,0.2,0.8,1,1.0,1.2,5.0,1.25,9
AC Numazu,6,1,3,2,5,5,0,6,Japan - J3 League,0.17,0.67,0,0.83,1.0,5.88,1.49,9
Kochi United,7,1,3,3,8,10,-2,6,Japan - J3 League,0.14,0.57,-2,1.14,0.86,7.14,1.75,9
FC Ryukyu,7,1,2,4,4,7,-3,5,Japan - J3 League,0.14,0.43,-3,0.57,0.71,7.14,2.33,10
Gifu,7,1,2,4,8,13,-5,5,Japan - J3 League,0.14,0.43,-5,1.14,0.71,7.14,2.33,10
Gainare Tottori,7,1,2,4,4,10,-6,5,Japan - J3 League,0.14,0.43,-6,0.57,0.71,7.14,2.33,10
Al Hussein,8,7,1,0,23,7,16,22,Jordan - Premier League,0.88,1.0,16,2.88,2.75,1.14,1.0,1
Al Jazeera,8,7,0,1,19,9,10,21,Jordan - Premier League,0.88,0.88,10,2.38,2.62,1.14,1.14,2
Al Wihdat,8,6,0,2,16,5,11,18,Jordan - Premier League,0.75,0.75,11,2.0,2.25,1.33,1.33,3
Al Faysali,8,4,4,0,13,6,7,16,Jordan - Premier League,0.5,1.0,7,1.62,2.0,2.0,1.0,4
Al Ramtha,8,4,2,2,7,8,-1,14,Jordan - Premier League,0.5,0.75,-1,0.88,1.75,2.0,1.33,5
Al Salt,8,3,2,3,14,8,6,11,Jordan - Premier League,0.38,0.62,6,1.75,1.38,2.63,1.61,6
Aqaba,8,3,2,3,9,14,-5,11,Jordan - Premier League,0.38,0.62,-5,1.12,1.38,2.63,1.61,6
Shabab Al Ordon,8,2,1,5,8,12,-4,7,Jordan - Premier League,0.25,0.38,-4,1.0,0.88,4.0,2.63,7
Al Sareeh,8,1,3,4,6,12,-6,6,Jordan - Premier League,0.12,0.5,-6,0.75,0.75,8.33,2.0,8
Maan,8,2,0,6,8,20,-12,6,Jordan - Premier League,0.25,0.25,-12,1.0,0.75,4.0,4.0,8
Al Ahli,8,0,2,6,2,11,-9,2,Jordan - Premier League,0.0,0.25,-9,0.25,0.25,0.0,4.0,9
Moghayer Al S.,8,0,1,7,3,16,-13,1,Jordan - Premier League,0.0,0.12,-13,0.38,0.12,0.0,8.33,10
Kairat Almaty,3,2,1,0,7,2,5,7,Kazakhstan - Premier League,0.67,1.0,5,2.33,2.33,1.49,1.0,1
Aktobe,3,2,1,0,6,1,5,7,Kazakhstan - Premier League,0.67,1.0,5,2.0,2.33,1.49,1.0,1
FC Astana,3,2,1,0,6,1,5,7,Kazakhstan - Premier League,0.67,1.0,5,2.0,2.33,1.49,1.0,1
Tobol,3,1,2,0,3,1,2,5,Kazakhstan - Premier League,0.33,1.0,2,1.0,1.67,3.03,1.0,2
Yelimay Semey,3,1,1,1,4,3,1,4,Kazakhstan - Premier League,0.33,0.67,1,1.33,1.33,3.03,1.49,3
Okzhetpes,3,1,1,1,4,5,-1,4,Kazakhstan - Premier League,0.33,0.67,-1,1.33,1.33,3.03,1.49,3
Turan,3,1,0,2,4,4,0,3,Kazakhstan - Premier League,0.33,0.33,0,1.33,1.0,3.03,3.03,4
Zhenys,3,0,3,0,1,1,0,3,Kazakhstan - Premier League,0.0,1.0,0,0.33,1.0,0.0,1.0,4
Atyrau,3,1,0,2,3,7,-4,3,Kazakhstan - Premier League,0.33,0.33,-4,1.0,1.0,3.03,3.03,4
Kaisar K.,3,0,2,1,2,4,-2,2,Kazakhstan - Premier League,0.0,0.67,-2,0.67,0.67,0.0,1.49,5
Kyzylzhar,3,0,2,1,1,3,-2,2,Kazakhstan - Premier League,0.0,0.67,-2,0.33,0.67,0.0,1.49,5
Ulytau,3,0,2,1,1,3,-2,2,Kazakhstan - Premier League,0.0,0.67,-2,0.33,0.67,0.0,1.49,5
Zhetysu,3,0,2,1,1,4,-3,2,Kazakhstan - Premier League,0.0,0.67,-3,0.33,0.67,0.0,1.49,5
Ordabasy,3,0,2,1,0,4,-4,2,Kazakhstan - Premier League,0.0,0.67,-4,0.0,0.67,0.0,1.49,5
Drita,8,5,2,1,14,6,8,17,Kosovo - Superliga,0.62,0.88,8,1.75,2.12,1.61,1.14,1
Ferizaj,8,5,0,3,14,11,3,15,Kosovo - Superliga,0.62,0.62,3,1.75,1.88,1.61,1.61,2
Gjilani,8,4,2,2,9,10,-1,14,Kosovo - Superliga,0.5,0.75,-1,1.12,1.75,2.0,1.33,3
Ballkani,8,4,1,3,11,9,2,13,Kosovo - Superliga,0.5,0.62,2,1.38,1.62,2.0,1.61,4
Llapi,8,3,3,2,7,3,4,12,Kosovo - Superliga,0.38,0.75,4,0.88,1.5,2.63,1.33,5
Malisheva,8,3,3,2,10,7,3,12,Kosovo - Superliga,0.38,0.75,3,1.25,1.5,2.63,1.33,5
Dukagjini,8,3,3,2,5,4,1,12,Kosovo - Superliga,0.38,0.75,1,0.62,1.5,2.63,1.33,5
Prishtina,8,0,6,2,7,9,-2,6,Kosovo - Superliga,0.0,0.75,-2,0.88,0.75,0.0,1.33,6
Suhareka,8,1,1,6,7,16,-9,4,Kosovo - Superliga,0.12,0.25,-9,0.88,0.5,8.33,4.0,7
Feronikeli,8,1,1,6,4,13,-9,4,Kosovo - Superliga,0.12,0.25,-9,0.5,0.5,8.33,4.0,7
Al Kuwait,8,6,2,0,24,4,20,20,Kuwait - Premier League,0.75,1.0,20,3.0,2.5,1.33,1.0,1
Al Arabi SC,8,5,3,0,12,5,7,18,Kuwait - Premier League,0.62,1.0,7,1.5,2.25,1.61,1.0,2
Al Qadsia,8,5,1,2,16,13,3,16,Kuwait - Premier League,0.62,0.75,3,2.0,2.0,1.61,1.33,3
Al Salmiyah,8,3,3,2,12,10,2,12,Kuwait - Premier League,0.38,0.75,2,1.5,1.5,2.63,1.33,4
Al Fahaheel,8,3,2,3,13,13,0,11,Kuwait - Premier League,0.38,0.62,0,1.62,1.38,2.63,1.61,5
Kazma,8,2,3,3,12,10,2,9,Kuwait - Premier League,0.25,0.62,2,1.5,1.12,4.0,1.61,6
Al Nasar,8,2,2,4,11,15,-4,8,Kuwait - Premier League,0.25,0.5,-4,1.38,1.0,4.0,2.0,7
Khaitan,8,1,3,4,5,8,-3,6,Kuwait - Premier League,0.12,0.5,-3,0.62,0.75,8.33,2.0,8
Al Tadhamon,8,2,0,6,5,16,-11,6,Kuwait - Premier League,0.25,0.25,-11,0.62,0.75,4.0,4.0,8
Yarmouk,8,0,3,5,4,20,-16,3,Kuwait - Premier League,0.0,0.38,-16,0.5,0.38,0.0,2.63,9
RFS,4,4,0,0,9,3,6,12,Latvia - Virsliga,1.0,1.0,6,2.25,3.0,1.0,1.0,1
Liepaja,4,2,1,1,9,5,4,7,Latvia - Virsliga,0.5,0.75,4,2.25,1.75,2.0,1.33,2
Auda,4,2,1,1,6,4,2,7,Latvia - Virsliga,0.5,0.75,2,1.5,1.75,2.0,1.33,2
Daugavpils,4,2,0,2,8,6,2,6,Latvia - Virsliga,0.5,0.5,2,2.0,1.5,2.0,2.0,3
Metta,4,2,0,2,7,12,-5,6,Latvia - Virsliga,0.5,0.5,-5,1.75,1.5,2.0,2.0,3
Riga FC,4,1,2,1,6,5,1,5,Latvia - Virsliga,0.25,0.75,1,1.5,1.25,4.0,1.33,4
Grobina,4,1,1,2,7,11,-4,4,Latvia - Virsliga,0.25,0.5,-4,1.75,1.0,4.0,2.0,5
Super Nova,3,1,0,2,4,3,1,3,Latvia - Virsliga,0.33,0.33,1,1.33,1.0,3.03,3.03,6
FS Jelgava,4,0,2,2,2,5,-3,2,Latvia - Virsliga,0.0,0.5,-3,0.5,0.5,0.0,2.0,7
Tukums,3,0,1,2,2,6,-4,1,Latvia - Virsliga,0.0,0.33,-4,0.67,0.33,0.0,3.03,8
Suduva,4,3,0,1,6,5,1,9,Lithuania - A Lyga,0.75,0.75,1,1.5,2.25,1.33,1.33,1
Hegelmann L.,4,3,0,1,5,4,1,9,Lithuania - A Lyga,0.75,0.75,1,1.25,2.25,1.33,1.33,1
Zalgiris,4,2,2,0,7,5,2,8,Lithuania - A Lyga,0.5,1.0,2,1.75,2.0,2.0,1.0,2
Kauno Zalgiris,4,2,1,1,7,5,2,7,Lithuania - A Lyga,0.5,0.75,2,1.75,1.75,2.0,1.33,3
Dziugas Telsiai,4,2,0,2,5,4,1,6,Lithuania - A Lyga,0.5,0.5,1,1.25,1.5,2.0,2.0,4
Banga,4,1,2,1,4,3,1,5,Lithuania - A Lyga,0.25,0.75,1,1.0,1.25,4.0,1.33,5
Siauliai,4,1,1,2,7,7,0,4,Lithuania - A Lyga,0.25,0.5,0,1.75,1.0,4.0,2.0,6
Panevezys,4,1,1,2,5,6,-1,4,Lithuania - A Lyga,0.25,0.5,-1,1.25,1.0,4.0,2.0,6
Riteriai,4,0,2,2,7,9,-2,2,Lithuania - A Lyga,0.0,0.5,-2,1.75,0.5,0.0,2.0,7
Dainava,4,0,1,3,3,8,-5,1,Lithuania - A Lyga,0.0,0.25,-5,0.75,0.25,0.0,4.0,8
Neptuna K.,3,3,0,0,11,1,10,9,Lithuania - 1st League,1.0,1.0,10,3.67,3.0,1.0,1.0,1
TransINVEST,3,3,0,0,11,2,9,9,Lithuania - 1st League,1.0,1.0,9,3.67,3.0,1.0,1.0,1
BFA Vilnius,3,3,0,0,5,0,5,9,Lithuania - 1st League,1.0,1.0,5,1.67,3.0,1.0,1.0,1
Tauras,3,2,1,0,9,0,9,7,Lithuania - 1st League,0.67,1.0,9,3.0,2.33,1.49,1.0,2
Hegelmann B,3,1,2,0,4,3,1,5,Lithuania - 1st League,0.33,1.0,1,1.33,1.67,3.03,1.0,3
Nevezis,3,1,1,1,6,5,1,4,Lithuania - 1st League,0.33,0.67,1,2.0,1.33,3.03,1.49,4
Siauliai B,3,1,1,1,5,7,-2,4,Lithuania - 1st League,0.33,0.67,-2,1.67,1.33,3.03,1.49,4
Atmosfera,3,1,1,1,3,5,-2,4,Lithuania - 1st League,0.33,0.67,-2,1.0,1.33,3.03,1.49,4
Babrungas,3,1,1,1,5,8,-3,4,Lithuania - 1st League,0.33,0.67,-3,1.67,1.33,3.03,1.49,4
Kauno Z. B,3,1,0,2,1,3,-2,3,Lithuania - 1st League,0.33,0.33,-2,0.33,1.0,3.03,3.03,5
Panevezys B,3,1,0,2,4,10,-6,3,Lithuania - 1st League,0.33,0.33,-6,1.33,1.0,3.03,3.03,5
Zalgiris B,3,0,2,1,3,5,-2,2,Lithuania - 1st League,0.0,0.67,-2,1.0,0.67,0.0,1.49,6
Be1 NFA,3,0,2,1,1,5,-4,2,Lithuania - 1st League,0.0,0.67,-4,0.33,0.67,0.0,1.49,6
Jonava,3,0,1,2,0,2,-2,1,Lithuania - 1st League,0.0,0.33,-2,0.0,0.33,0.0,3.03,7
Ekranas,3,0,0,3,1,5,-4,0,Lithuania - 1st League,0.0,0.0,-4,0.33,0.0,0.0,0.0,8
Minija,3,0,0,3,0,8,-8,0,Lithuania - 1st League,0.0,0.0,-8,0.0,0.0,0.0,0.0,8
Differdange,8,7,0,1,18,1,17,21,Luxembourg - National Division,0.88,0.88,17,2.25,2.62,1.14,1.14,1
UNA Strassen,8,5,2,1,19,9,10,17,Luxembourg - National Division,0.62,0.88,10,2.38,2.12,1.61,1.14,2
Hostert,8,5,1,2,17,14,3,16,Luxembourg - National Division,0.62,0.75,3,2.12,2.0,1.61,1.33,3
Dudelange,8,4,2,2,14,8,6,14,Luxembourg - National Division,0.5,0.75,6,1.75,1.75,2.0,1.33,4
Petange,8,4,2,2,11,5,6,14,Luxembourg - National Division,0.5,0.75,6,1.38,1.75,2.0,1.33,4
Hesperange,8,3,4,1,11,7,4,13,Luxembourg - National Division,0.38,0.88,4,1.38,1.62,2.63,1.14,5
Jeunesse Esch,8,3,3,2,16,12,4,12,Luxembourg - National Division,0.38,0.75,4,2.0,1.5,2.63,1.33,6
Niedercorn,8,3,3,2,10,9,1,12,Luxembourg - National Division,0.38,0.75,1,1.25,1.5,2.63,1.33,6
Racing,8,3,1,4,7,7,0,10,Luxembourg - National Division,0.38,0.5,0,0.88,1.25,2.63,2.0,7
Mondorf,8,3,1,4,10,12,-2,10,Luxembourg - National Division,0.38,0.5,-2,1.25,1.25,2.63,2.0,7
Bettembourg,8,3,0,5,10,14,-4,9,Luxembourg - National Division,0.38,0.38,-4,1.25,1.12,2.63,2.63,8
Wiltz,8,3,0,5,10,16,-6,9,Luxembourg - National Division,0.38,0.38,-6,1.25,1.12,2.63,2.63,8
V. Rosport,8,1,5,2,7,12,-5,8,Luxembourg - National Division,0.12,0.75,-5,0.88,1.0,8.33,1.33,9
Mondercange,8,2,2,4,7,13,-6,8,Luxembourg - National Division,0.25,0.5,-6,0.88,1.0,4.0,2.0,9
Rodange,8,1,3,4,13,17,-4,6,Luxembourg - National Division,0.12,0.5,-4,1.62,0.75,8.33,2.0,10
Fola Esch,8,0,0,8,5,27,-22,0,Luxembourg - National Division,0.0,0.0,-22,0.62,0.0,0.0,0.0,11
Johor Darul,8,8,0,0,26,2,24,24,Malaysia - Super League,1.0,1.0,24,3.25,3.0,1.0,1.0,1
Kuching,8,5,3,0,16,5,11,18,Malaysia - Super League,0.62,1.0,11,2.0,2.25,1.61,1.0,2
Selangor,8,5,2,1,18,4,14,17,Malaysia - Super League,0.62,0.88,14,2.25,2.12,1.61,1.14,3
Terengganu,8,4,2,2,15,9,6,14,Malaysia - Super League,0.5,0.75,6,1.88,1.75,2.0,1.33,4
Kuala Lumpur,8,4,2,2,11,11,0,14,Malaysia - Super League,0.5,0.75,0,1.38,1.75,2.0,1.33,4
Sabah,8,3,4,1,13,12,1,13,Malaysia - Super League,0.38,0.88,1,1.62,1.62,2.63,1.14,5
Pulau Pinang,8,2,3,3,13,11,2,9,Malaysia - Super League,0.25,0.62,2,1.62,1.12,4.0,1.61,6
Perak,8,1,4,3,13,14,-1,7,Malaysia - Super League,0.12,0.62,-1,1.62,0.88,8.33,1.61,7
PDRM,8,2,1,5,10,15,-5,7,Malaysia - Super League,0.25,0.38,-5,1.25,0.88,4.0,2.63,7
Negeri Sembilan,8,2,1,5,7,13,-6,7,Malaysia - Super League,0.25,0.38,-6,0.88,0.88,4.0,2.63,7
Kedah,8,2,1,5,6,16,-10,7,Malaysia - Super League,0.25,0.38,-10,0.75,0.88,4.0,2.63,7
Pahang,8,1,2,5,9,18,-9,5,Malaysia - Super League,0.12,0.38,-9,1.12,0.62,8.33,2.63,8
Kelantan United,8,0,0,8,3,35,-32,0,Malaysia - Super League,0.0,0.0,-32,0.38,0.0,0.0,0.0,9
Mosta,8,5,1,2,11,9,2,16,Malta - Premier League,0.62,0.75,2,1.38,2.0,1.61,1.33,1
Floriana,8,4,3,1,11,7,4,15,Malta - Premier League,0.5,0.88,4,1.38,1.88,2.0,1.14,2
Birkirkara,8,4,2,2,12,5,7,14,Malta - Premier League,0.5,0.75,7,1.5,1.75,2.0,1.33,3
Hibernians,8,4,2,2,13,12,1,14,Malta - Premier League,0.5,0.75,1,1.62,1.75,2.0,1.33,3
Marsaxlokk,8,4,1,3,13,6,7,13,Malta - Premier League,0.5,0.62,7,1.62,1.62,2.0,1.61,4
Sliema,8,4,0,4,13,12,1,12,Malta - Premier League,0.5,0.5,1,1.62,1.5,2.0,2.0,5
Naxxar Lions,8,3,1,4,11,12,-1,10,Malta - Premier League,0.38,0.5,-1,1.38,1.25,2.63,2.0,6
Zabbar,8,2,2,4,10,9,1,8,Malta - Premier League,0.25,0.5,1,1.25,1.0,4.0,2.0,7
Hamrun Spartans,8,2,2,4,3,6,-3,8,Malta - Premier League,0.25,0.5,-3,0.38,1.0,4.0,2.0,7
Gzira Utd,8,2,2,4,5,13,-8,8,Malta - Premier League,0.25,0.5,-8,0.62,1.0,4.0,2.0,7
Balzan,8,1,4,3,6,8,-2,7,Malta - Premier League,0.12,0.62,-2,0.75,0.88,8.33,1.61,8
Melita,8,1,3,4,10,20,-10,6,Malta - Premier League,0.12,0.5,-10,1.25,0.75,8.33,2.0,9
Cruz Azul,8,6,2,0,20,6,14,20,Mexico - Liga MX - Apertura,0.75,1.0,14,2.5,2.5,1.33,1.0,1
Toluca,8,5,2,1,21,7,14,17,Mexico - Liga MX - Apertura,0.62,0.88,14,2.62,2.12,1.61,1.14,2
A. San Luis,8,5,1,2,12,8,4,16,Mexico - Liga MX - Apertura,0.62,0.75,4,1.5,2.0,1.61,1.33,3
Pumas UNAM,8,4,3,1,8,3,5,15,Mexico - Liga MX - Apertura,0.5,0.88,5,1.0,1.88,2.0,1.14,4
Tijuana,8,4,3,1,10,9,1,15,Mexico - Liga MX - Apertura,0.5,0.88,1,1.25,1.88,2.0,1.14,4
CF America,8,4,2,2,15,10,5,14,Mexico - Liga MX - Apertura,0.5,0.75,5,1.88,1.75,2.0,1.33,5
Tigres,8,4,2,2,13,11,2,14,Mexico - Liga MX - Apertura,0.5,0.75,2,1.62,1.75,2.0,1.33,5
Juarez,8,4,1,3,13,15,-2,13,Mexico - Liga MX - Apertura,0.5,0.62,-2,1.62,1.62,2.0,1.61,6
Monterrey,8,3,3,2,12,7,5,12,Mexico - Liga MX - Apertura,0.38,0.75,5,1.5,1.5,2.63,1.33,7
Club Leon,8,2,5,1,13,9,4,11,Mexico - Liga MX - Apertura,0.25,0.88,4,1.62,1.38,4.0,1.14,8
Guadalajara,8,3,2,3,10,8,2,11,Mexico - Liga MX - Apertura,0.38,0.62,2,1.25,1.38,2.63,1.61,8
Queretaro,8,2,2,4,7,13,-6,8,Mexico - Liga MX - Apertura,0.25,0.5,-6,0.88,1.0,4.0,2.0,9
Atlas,8,1,5,2,6,12,-6,8,Mexico - Liga MX - Apertura,0.12,0.75,-6,0.75,1.0,8.33,1.33,9
Mazatlan,8,1,4,3,4,9,-5,7,Mexico - Liga MX - Apertura,0.12,0.62,-5,0.5,0.88,8.33,1.61,10
Pachuca,8,1,1,6,12,16,-4,4,Mexico - Liga MX - Apertura,0.12,0.25,-4,1.5,0.5,8.33,4.0,11
Necaxa,8,0,3,5,7,18,-11,3,Mexico - Liga MX - Apertura,0.0,0.38,-11,0.88,0.38,0.0,2.63,12
Puebla,8,1,0,7,7,18,-11,3,Mexico - Liga MX - Apertura,0.12,0.12,-11,0.88,0.38,8.33,8.33,12
Santos Laguna,8,0,2,6,4,16,-12,2,Mexico - Liga MX - Apertura,0.0,0.25,-12,0.5,0.25,0.0,4.0,13
Toluca,8,6,1,1,25,11,14,19,Mexico - Liga MX - Clausura,0.75,0.88,14,3.12,2.38,1.33,1.14,1
Necaxa,8,6,0,2,20,13,7,18,Mexico - Liga MX - Clausura,0.75,0.75,7,2.5,2.25,1.33,1.33,2
CF America,8,5,2,1,16,6,10,17,Mexico - Liga MX - Clausura,0.62,0.88,10,2.0,2.12,1.61,1.14,3
Cruz Azul,8,5,2,1,11,5,6,17,Mexico - Liga MX - Clausura,0.62,0.88,6,1.38,2.12,1.61,1.14,3
Tigres,8,5,0,3,10,8,2,15,Mexico - Liga MX - Clausura,0.62,0.62,2,1.25,1.88,1.61,1.61,4
Juarez,8,4,2,2,10,10,0,14,Mexico - Liga MX - Clausura,0.5,0.75,0,1.25,1.75,2.0,1.33,5
Monterrey,8,4,1,3,17,12,5,13,Mexico - Liga MX - Clausura,0.5,0.62,5,2.12,1.62,2.0,1.61,6
Pachuca,8,3,2,3,15,13,2,11,Mexico - Liga MX - Clausura,0.38,0.62,2,1.88,1.38,2.63,1.61,7
Club Leon,8,3,2,3,12,12,0,11,Mexico - Liga MX - Clausura,0.38,0.62,0,1.5,1.38,2.63,1.61,7
Guadalajara,8,3,2,3,8,9,-1,11,Mexico - Liga MX - Clausura,0.38,0.62,-1,1.0,1.38,2.63,1.61,7
Mazatlan,8,2,3,3,8,10,-2,9,Mexico - Liga MX - Clausura,0.25,0.62,-2,1.0,1.12,4.0,1.61,8
Pumas UNAM,8,3,0,5,10,14,-4,9,Mexico - Liga MX - Clausura,0.38,0.38,-4,1.25,1.12,2.63,2.63,8
A. San Luis,8,3,0,5,10,15,-5,9,Mexico - Liga MX - Clausura,0.38,0.38,-5,1.25,1.12,2.63,2.63,8
Atlas,8,3,0,5,14,20,-6,9,Mexico - Liga MX - Clausura,0.38,0.38,-6,1.75,1.12,2.63,2.63,8
Queretaro,8,3,0,5,6,13,-7,9,Mexico - Liga MX - Clausura,0.38,0.38,-7,0.75,1.12,2.63,2.63,8
Santos Laguna,8,2,1,5,11,16,-5,7,Mexico - Liga MX - Clausura,0.25,0.38,-5,1.38,0.88,4.0,2.63,9
Tijuana,8,2,0,6,13,19,-6,6,Mexico - Liga MX - Clausura,0.25,0.25,-6,1.62,0.75,4.0,4.0,10
Puebla,8,1,0,7,7,17,-10,3,Mexico - Liga MX - Clausura,0.12,0.12,-10,0.88,0.38,8.33,8.33,11
Buducnost,8,7,1,0,28,10,18,22,Montenegro - First League,0.88,1.0,18,3.5,2.75,1.14,1.0,1
Petrovac,8,5,2,1,14,6,8,17,Montenegro - First League,0.62,0.88,8,1.75,2.12,1.61,1.14,2
Mornar Bar,8,4,2,2,9,7,2,14,Montenegro - First League,0.5,0.75,2,1.12,1.75,2.0,1.33,3
Sutjeska,8,4,2,2,10,9,1,14,Montenegro - First League,0.5,0.75,1,1.25,1.75,2.0,1.33,3
Decic,8,2,4,2,6,6,0,10,Montenegro - First League,0.25,0.75,0,0.75,1.25,4.0,1.33,4
Arsenal Tivat,8,2,2,4,6,12,-6,8,Montenegro - First League,0.25,0.5,-6,0.75,1.0,4.0,2.0,5
Jezero,8,2,1,5,12,15,-3,7,Montenegro - First League,0.25,0.38,-3,1.5,0.88,4.0,2.63,6
Jedinstvo,8,1,4,3,9,12,-3,7,Montenegro - First League,0.12,0.62,-3,1.12,0.88,8.33,1.61,6
Otrant,8,2,0,6,6,14,-8,6,Montenegro - First League,0.25,0.25,-8,0.75,0.75,4.0,4.0,7
Bokelj,8,2,0,6,5,14,-9,6,Montenegro - First League,0.25,0.25,-9,0.62,0.75,4.0,4.0,7
Berkane,8,6,2,0,14,2,12,20,morocco,0.75,1.0,12,1.75,2.5,1.33,1.0,1
Wydad,8,4,4,0,14,5,9,16,morocco,0.5,1.0,9,1.75,2.0,2.0,1.0,2
FUS Rabat,8,4,2,2,13,8,5,14,morocco,0.5,0.75,5,1.62,1.75,2.0,1.33,3
FAR Rabat,8,4,2,2,11,9,2,14,morocco,0.5,0.75,2,1.38,1.75,2.0,1.33,3
Raja Casablanca,8,3,4,1,9,6,3,13,morocco,0.38,0.88,3,1.12,1.62,2.63,1.14,4
Union Touarga,8,3,3,2,10,8,2,12,morocco,0.38,0.75,2,1.25,1.5,2.63,1.33,5
Meknes,8,3,3,2,9,7,2,12,morocco,0.38,0.75,2,1.12,1.5,2.63,1.33,5
Difaa El Jadida,8,3,3,2,8,7,1,12,morocco,0.38,0.75,1,1.0,1.5,2.63,1.33,5
Olympic Safi,8,2,5,1,9,8,1,11,morocco,0.25,0.88,1,1.12,1.38,4.0,1.14,6
Maghreb de Fes,8,2,4,2,9,11,-2,10,morocco,0.25,0.75,-2,1.12,1.25,4.0,1.33,7
Ittihad Tanger,8,2,3,3,11,13,-2,9,morocco,0.25,0.62,-2,1.38,1.12,4.0,1.61,8
R. Zemamra,8,3,0,5,7,10,-3,9,morocco,0.38,0.38,-3,0.88,1.12,2.63,2.63,8
Hassania Agadir,8,1,3,4,9,11,-2,6,morocco,0.12,0.5,-2,1.12,0.75,8.33,2.0,9
Moghreb Tetouan,8,1,3,4,7,11,-4,6,morocco,0.12,0.5,-4,0.88,0.75,8.33,2.0,9
JS Sousalem,8,0,2,6,5,17,-12,2,morocco,0.0,0.25,-12,0.62,0.25,0.0,4.0,10
C. Mohammedia,8,0,1,7,4,18,-14,1,morocco,0.0,0.12,-14,0.5,0.12,0.0,8.33,11
Shan Utd,8,7,1,0,24,2,22,22,myanmar,0.88,1.0,22,3.0,2.75,1.14,1.0,1
Yangon Utd,8,5,2,1,21,6,15,17,myanmar,0.62,0.88,15,2.62,2.12,1.61,1.14,2
Sagaing Utd,8,4,2,2,16,13,3,14,myanmar,0.5,0.75,3,2.0,1.75,2.0,1.33,3
Thitsar Arman,8,4,1,3,15,12,3,13,myanmar,0.5,0.62,3,1.88,1.62,2.0,1.61,4
Yadanarbon,8,3,3,2,18,15,3,12,myanmar,0.38,0.75,3,2.25,1.5,2.63,1.33,5
Dagon,8,3,2,3,10,11,-1,11,myanmar,0.38,0.62,-1,1.25,1.38,2.63,1.61,6
Hantharwady,8,3,2,3,7,11,-4,11,myanmar,0.38,0.62,-4,0.88,1.38,2.63,1.61,6
Rakhine Utd,8,3,2,3,10,16,-6,11,myanmar,0.38,0.62,-6,1.25,1.38,2.63,1.61,6
Ayeyawady,8,2,0,6,9,16,-7,6,myanmar,0.25,0.25,-7,1.12,0.75,4.0,4.0,7
Ispe FC,8,1,3,4,4,14,-10,6,myanmar,0.12,0.5,-10,0.5,0.75,8.33,2.0,7
Dagon Port,8,1,2,5,12,21,-9,5,myanmar,0.12,0.38,-9,1.5,0.62,8.33,2.63,8
Myawady,8,1,2,5,11,20,-9,5,myanmar,0.12,0.38,-9,1.38,0.62,8.33,2.63,8
Ajax Amsterdam,8,7,1,0,16,3,13,22,netherlands,0.88,1.0,13,2.0,2.75,1.14,1.0,1
Feyenoord,8,4,3,1,16,8,8,15,netherlands,0.5,0.88,8,2.0,1.88,2.0,1.14,2
FC Groningen,8,4,3,1,10,6,4,15,netherlands,0.5,0.88,4,1.25,1.88,2.0,1.14,2
Sparta,8,4,2,2,12,7,5,14,netherlands,0.5,0.75,5,1.5,1.75,2.0,1.33,3
Go Ahead Eagles,8,4,1,3,14,15,-1,13,netherlands,0.5,0.62,-1,1.75,1.62,2.0,1.61,4
PSV Eindhoven,8,3,3,2,16,14,2,12,netherlands,0.38,0.75,2,2.0,1.5,2.63,1.33,5
AZ Alkmaar,8,3,3,2,12,10,2,12,netherlands,0.38,0.75,2,1.5,1.5,2.63,1.33,5
FC Utrecht,8,3,3,2,12,10,2,12,netherlands,0.38,0.75,2,1.5,1.5,2.63,1.33,5
FC Twente,8,3,3,2,14,14,0,12,netherlands,0.38,0.75,0,1.75,1.5,2.63,1.33,5
Heracles Almelo,8,3,3,2,13,13,0,12,netherlands,0.38,0.75,0,1.62,1.5,2.63,1.33,5
RKC Waalwijk,8,3,1,4,13,11,2,10,netherlands,0.38,0.5,2,1.62,1.25,2.63,2.0,6
PEC Zwolle,8,2,3,3,13,13,0,9,netherlands,0.25,0.62,0,1.62,1.12,4.0,1.61,7
Almere City,8,2,2,4,8,11,-3,8,netherlands,0.25,0.5,-3,1.0,1.0,4.0,2.0,8
Heerenveen,8,1,4,3,11,13,-2,7,netherlands,0.12,0.62,-2,1.38,0.88,8.33,1.61,9
NEC Nijmegen,8,1,4,3,12,15,-3,7,netherlands,0.12,0.62,-3,1.5,0.88,8.33,1.61,9
Fortuna Sittard,8,2,1,5,6,14,-8,7,netherlands,0.25,0.38,-8,0.75,0.88,4.0,2.63,9
NAC Breda,8,0,5,3,6,13,-7,5,netherlands,0.0,0.62,-7,0.75,0.62,0.0,1.61,10
Willem II,8,0,1,7,4,18,-14,1,netherlands,0.0,0.12,-14,0.5,0.12,0.0,8.33,11
ADO Den Haag,8,7,0,1,13,7,6,21,netherlands2,0.88,0.88,6,1.62,2.62,1.14,1.14,1
Telstar,8,6,0,2,19,8,11,18,netherlands2,0.75,0.75,11,2.38,2.25,1.33,1.33,2
FC Volendam,8,6,0,2,18,9,9,18,netherlands2,0.75,0.75,9,2.25,2.25,1.33,1.33,2
Cambuur,8,5,2,1,18,9,9,17,netherlands2,0.62,0.88,9,2.25,2.12,1.61,1.14,3
De Graafschap,8,5,1,2,14,8,6,16,netherlands2,0.62,0.75,6,1.75,2.0,1.61,1.33,4
FC Emmen,8,5,0,3,13,8,5,15,netherlands2,0.62,0.62,5,1.62,1.88,1.61,1.61,5
FC Dordrecht,8,5,0,3,13,10,3,15,netherlands2,0.62,0.62,3,1.62,1.88,1.61,1.61,5
Excelsior,8,4,2,2,16,10,6,14,netherlands2,0.5,0.75,6,2.0,1.75,2.0,1.33,6
Jong AZ,8,4,1,3,18,13,5,13,netherlands2,0.5,0.62,5,2.25,1.62,2.0,1.61,7
Vitesse Arnhem,8,4,1,3,10,8,2,13,netherlands2,0.5,0.62,2,1.25,1.62,2.0,1.61,7
Helmond Sport,8,2,3,3,15,12,3,9,netherlands2,0.25,0.62,3,1.88,1.12,4.0,1.61,8
FC Eindhoven,8,2,3,3,14,13,1,9,netherlands2,0.25,0.62,1,1.75,1.12,4.0,1.61,8
Roda JC,8,2,3,3,12,16,-4,9,netherlands2,0.25,0.62,-4,1.5,1.12,4.0,1.61,8
VVV,8,2,2,4,8,18,-10,8,netherlands2,0.25,0.5,-10,1.0,1.0,4.0,2.0,9
FC Den Bosch,8,2,1,5,8,10,-2,7,netherlands2,0.25,0.38,-2,1.0,0.88,4.0,2.63,10
Jong Ajax,8,2,1,5,7,13,-6,7,netherlands2,0.25,0.38,-6,0.88,0.88,4.0,2.63,10
MVV Maastricht,8,1,2,5,4,12,-8,5,netherlands2,0.12,0.38,-8,0.5,0.62,8.33,2.63,11
TOP Oss,8,0,4,4,5,16,-11,4,netherlands2,0.0,0.5,-11,0.62,0.5,0.0,2.0,12
Jong Utrecht,8,1,1,6,5,22,-17,4,netherlands2,0.12,0.25,-17,0.62,0.5,8.33,4.0,12
Jong PSV,8,0,2,6,10,19,-9,2,netherlands2,0.0,0.25,-9,1.25,0.25,0.0,4.0,13
Diriangen,8,7,1,0,29,1,28,22,nicaragua,0.88,1.0,28,3.62,2.75,1.14,1.0,1
Matagalpa,8,6,1,1,16,6,10,19,nicaragua,0.75,0.88,10,2.0,2.38,1.33,1.14,2
Real Esteli,8,4,3,1,13,9,4,15,nicaragua,0.5,0.88,4,1.62,1.88,2.0,1.14,3
Walter Ferreti,8,3,3,2,7,6,1,12,nicaragua,0.38,0.75,1,0.88,1.5,2.63,1.33,4
Managua FC,8,3,1,4,11,10,1,10,nicaragua,0.38,0.5,1,1.38,1.25,2.63,2.0,5
UNAN Managua,8,3,1,4,9,15,-6,10,nicaragua,0.38,0.5,-6,1.12,1.25,2.63,2.0,5
Jalapa,8,2,3,3,6,13,-7,9,nicaragua,0.25,0.62,-7,0.75,1.12,4.0,1.61,6
Export Sebaco,8,2,2,4,9,10,-1,8,nicaragua,0.25,0.5,-1,1.12,1.0,4.0,2.0,7
Rancho Santana,8,1,1,6,6,20,-14,4,nicaragua,0.12,0.25,-14,0.75,0.5,8.33,4.0,8
D. Ocotal,8,1,1,6,6,21,-15,4,nicaragua,0.12,0.25,-15,0.75,0.5,8.33,4.0,8
Real Esteli,8,6,1,1,20,6,14,19,nicaragua2,0.75,0.88,14,2.5,2.38,1.33,1.14,1
Diriangen,8,6,1,1,17,5,12,19,nicaragua2,0.75,0.88,12,2.12,2.38,1.33,1.14,1
Managua FC,8,4,3,1,9,5,4,15,nicaragua2,0.5,0.88,4,1.12,1.88,2.0,1.14,2
UNAN Managua,8,3,2,3,10,15,-5,11,nicaragua2,0.38,0.62,-5,1.25,1.38,2.63,1.61,3
Matagalpa,8,2,3,3,14,15,-1,9,nicaragua2,0.25,0.62,-1,1.75,1.12,4.0,1.61,4
CS Sebaco,8,2,3,3,7,9,-2,9,nicaragua2,0.25,0.62,-2,0.88,1.12,4.0,1.61,4
Jalapa,8,2,3,3,8,11,-3,9,nicaragua2,0.25,0.62,-3,1.0,1.12,4.0,1.61,4
Walter Ferreti,8,2,2,4,4,6,-2,8,nicaragua2,0.25,0.5,-2,0.5,1.0,4.0,2.0,5
D. Ocotal,8,2,2,4,7,15,-8,8,nicaragua2,0.25,0.5,-8,0.88,1.0,4.0,2.0,5
Rancho Santana,8,1,2,5,5,11,-6,5,nicaragua2,0.12,0.38,-6,0.62,0.62,8.33,2.63,6
Linfield,8,6,1,1,13,5,8,19,northernireland,0.75,0.88,8,1.62,2.38,1.33,1.14,1
Coleraine,8,5,2,1,11,5,6,17,northernireland,0.62,0.88,6,1.38,2.12,1.61,1.14,2
Crusaders,8,5,1,2,11,8,3,16,northernireland,0.62,0.75,3,1.38,2.0,1.61,1.33,3
Larne,8,4,2,2,11,7,4,14,northernireland,0.5,0.75,4,1.38,1.75,2.0,1.33,4
Cliftonville,8,3,2,3,13,10,3,11,northernireland,0.38,0.62,3,1.62,1.38,2.63,1.61,5
Dungannon,8,3,2,3,8,10,-2,11,northernireland,0.38,0.62,-2,1.0,1.38,2.63,1.61,5
Ballymena Utd,8,3,1,4,10,9,1,10,northernireland,0.38,0.5,1,1.25,1.25,2.63,2.0,6
Glentoran,8,2,4,2,9,10,-1,10,northernireland,0.25,0.75,-1,1.12,1.25,4.0,1.33,6
Portadown,8,2,3,3,7,9,-2,9,northernireland,0.25,0.62,-2,0.88,1.12,4.0,1.61,7
Glenavon,8,2,2,4,9,10,-1,8,northernireland,0.25,0.5,-1,1.12,1.0,4.0,2.0,8
Loughgall,8,1,2,5,5,12,-7,5,northernireland,0.12,0.38,-7,0.62,0.62,8.33,2.63,9
Carrick Rangers,8,1,2,5,2,11,-9,5,northernireland,0.12,0.38,-9,0.25,0.62,8.33,2.63,9
Bangor,8,5,2,1,18,5,13,17,northernireland2,0.62,0.88,13,2.25,2.12,1.61,1.14,1
Ards,8,5,2,1,11,6,5,17,northernireland2,0.62,0.88,5,1.38,2.12,1.61,1.14,1
Limavady,8,4,3,1,12,7,5,15,northernireland2,0.5,0.88,5,1.5,1.88,2.0,1.14,2
HW Welders,8,4,2,2,12,7,5,14,northernireland2,0.5,0.75,5,1.5,1.75,2.0,1.33,3
Annagh Utd,8,4,1,3,17,11,6,13,northernireland2,0.5,0.62,6,2.12,1.62,2.0,1.61,4
Institute,8,3,3,2,12,13,-1,12,northernireland2,0.38,0.75,-1,1.5,1.5,2.63,1.33,5
Newington,8,3,1,4,15,15,0,10,northernireland2,0.38,0.5,0,1.88,1.25,2.63,2.0,6
Ballinamallard,8,3,1,4,8,10,-2,10,northernireland2,0.38,0.5,-2,1.0,1.25,2.63,2.0,6
Armagh City,8,2,1,5,10,20,-10,7,northernireland2,0.25,0.38,-10,1.25,0.88,4.0,2.63,7
Newry City,8,1,3,4,7,15,-8,6,northernireland2,0.12,0.5,-8,0.88,0.75,8.33,2.0,8
Dundela,8,1,2,5,9,15,-6,5,northernireland2,0.12,0.38,-6,1.12,0.62,8.33,2.63,9
Ballyclare,8,1,1,6,5,19,-14,4,northernireland2,0.12,0.25,-14,0.62,0.5,8.33,4.0,10
Shkendija,8,5,2,1,10,7,3,17,northmacedonia,0.62,0.88,3,1.25,2.12,1.61,1.14,1
Sileks,8,4,3,1,15,7,8,15,northmacedonia,0.5,0.88,8,1.88,1.88,2.0,1.14,2
Shkupi,8,5,0,3,13,8,5,15,northmacedonia,0.62,0.62,5,1.62,1.88,1.61,1.61,2
Rabotnicki,8,4,2,2,9,6,3,14,northmacedonia,0.5,0.75,3,1.12,1.75,2.0,1.33,3
Vardar,8,3,3,2,10,6,4,12,northmacedonia,0.38,0.75,4,1.25,1.5,2.63,1.33,4
Tikves,8,3,2,3,8,7,1,11,northmacedonia,0.38,0.62,1,1.0,1.38,2.63,1.61,5
Gostivar,8,2,5,1,5,4,1,11,northmacedonia,0.25,0.88,1,0.62,1.38,4.0,1.14,5
Pelister,8,3,1,4,6,11,-5,10,northmacedonia,0.38,0.5,-5,0.75,1.25,2.63,2.0,6
Struga,8,3,0,5,10,13,-3,9,northmacedonia,0.38,0.38,-3,1.25,1.12,2.63,2.63,7
Besa,8,2,2,4,6,13,-7,8,northmacedonia,0.25,0.5,-7,0.75,1.0,4.0,2.0,8
Voska Sport,8,2,1,5,7,8,-1,7,northmacedonia,0.25,0.38,-1,0.88,0.88,4.0,2.63,9
Brera Strumica,8,0,2,6,5,15,-10,2,northmacedonia,0.0,0.25,-10,0.62,0.25,0.0,4.0,10
Fredrikstad,1,1,0,0,3,0,3,3,norway,1.0,1.0,3,3.0,3.0,1.0,1.0,1
KFUM Oslo,1,1,0,0,3,1,2,3,norway,1.0,1.0,2,3.0,3.0,1.0,1.0,1
Valerenga,1,1,0,0,3,1,2,3,norway,1.0,1.0,2,3.0,3.0,1.0,1.0,1
Sarpsborg 08,1,1,0,0,2,0,2,3,norway,1.0,1.0,2,2.0,3.0,1.0,1.0,1
HamKam,1,1,0,0,2,1,1,3,norway,1.0,1.0,1,2.0,3.0,1.0,1.0,1
Rosenborg,1,1,0,0,2,1,1,3,norway,1.0,1.0,1,2.0,3.0,1.0,1.0,1
Bodo.Glimt,1,1,0,0,1,0,1,3,norway,1.0,1.0,1,1.0,3.0,1.0,1.0,1
Tromso,1,1,0,0,1,0,1,3,norway,1.0,1.0,1,1.0,3.0,1.0,1.0,1
Kristiansund,1,0,0,1,1,2,-1,0,norway,0.0,0.0,-1,1.0,0.0,0.0,0.0,2
Stromsgodset,1,0,0,1,1,2,-1,0,norway,0.0,0.0,-1,1.0,0.0,0.0,0.0,2
Bryne,1,0,0,1,0,1,-1,0,norway,0.0,0.0,-1,0.0,0.0,0.0,0.0,2
Haugesund,1,0,0,1,0,1,-1,0,norway,0.0,0.0,-1,0.0,0.0,0.0,0.0,2
Sandefjord,1,0,0,1,1,3,-2,0,norway,0.0,0.0,-2,1.0,0.0,0.0,0.0,2
Viking,1,0,0,1,1,3,-2,0,norway,0.0,0.0,-2,1.0,0.0,0.0,0.0,2
Molde,1,0,0,1,0,2,-2,0,norway,0.0,0.0,-2,0.0,0.0,0.0,0.0,2
Brann,1,0,0,1,0,3,-3,0,norway,0.0,0.0,-3,0.0,0.0,0.0,0.0,2
Aalesund,0,0,0,0,0,0,0,0,norway2,0.0,0.0,0,0.0,0.0,0.0,0.0,1
Asane,0,0,0,0,0,0,0,0,norway2,0.0,0.0,0,0.0,0.0,0.0,0.0,1
Egersund,0,0,0,0,0,0,0,0,norway2,0.0,0.0,0,0.0,0.0,0.0,0.0,1
Hodd,0,0,0,0,0,0,0,0,norway2,0.0,0.0,0,0.0,0.0,0.0,0.0,1
Kongsvinger,0,0,0,0,0,0,0,0,norway2,0.0,0.0,0,0.0,0.0,0.0,0.0,1
Lillestrom,0,0,0,0,0,0,0,0,norway2,0.0,0.0,0,0.0,0.0,0.0,0.0,1
Lyn,0,0,0,0,0,0,0,0,norway2,0.0,0.0,0,0.0,0.0,0.0,0.0,1
Mjondalen,0,0,0,0,0,0,0,0,norway2,0.0,0.0,0,0.0,0.0,0.0,0.0,1
Moss,0,0,0,0,0,0,0,0,norway2,0.0,0.0,0,0.0,0.0,0.0,0.0,1
Odd,0,0,0,0,0,0,0,0,norway2,0.0,0.0,0,0.0,0.0,0.0,0.0,1
Ranheim,0,0,0,0,0,0,0,0,norway2,0.0,0.0,0,0.0,0.0,0.0,0.0,1
Raufoss,0,0,0,0,0,0,0,0,norway2,0.0,0.0,0,0.0,0.0,0.0,0.0,1
Skeid,0,0,0,0,0,0,0,0,norway2,0.0,0.0,0,0.0,0.0,0.0,0.0,1
Sogndal,0,0,0,0,0,0,0,0,norway2,0.0,0.0,0,0.0,0.0,0.0,0.0,1
Stabaek,0,0,0,0,0,0,0,0,norway2,0.0,0.0,0,0.0,0.0,0.0,0.0,1
Start,0,0,0,0,0,0,0,0,norway2,0.0,0.0,0,0.0,0.0,0.0,0.0,1
Sandnes Ulf,1,1,0,0,3,1,2,3,norway3,1.0,1.0,2,3.0,3.0,1.0,1.0,1
Brann B,1,1,0,0,4,3,1,3,norway3,1.0,1.0,1,4.0,3.0,1.0,1.0,1
Brattvag,1,1,0,0,2,1,1,3,norway3,1.0,1.0,1,2.0,3.0,1.0,1.0,1
Notodden,1,1,0,0,2,1,1,3,norway3,1.0,1.0,1,2.0,3.0,1.0,1.0,1
Arendal,1,0,1,0,1,1,0,1,norway3,0.0,1.0,0,1.0,1.0,0.0,1.0,2
Flekkeroy,1,0,1,0,1,1,0,1,norway3,0.0,1.0,0,1.0,1.0,0.0,1.0,2
Jerv,1,0,1,0,1,1,0,1,norway3,0.0,1.0,0,1.0,1.0,0.0,1.0,2
Pors Grenland,1,0,1,0,1,1,0,1,norway3,0.0,1.0,0,1.0,1.0,0.0,1.0,2
Lysekloster,1,0,1,0,0,0,0,1,norway3,0.0,1.0,0,0.0,1.0,0.0,1.0,2
Sotra,1,0,1,0,0,0,0,1,norway3,0.0,1.0,0,0.0,1.0,0.0,1.0,2
Traef,1,0,0,1,3,4,-1,0,norway3,0.0,0.0,-1,3.0,0.0,0.0,0.0,3
Sandviken,1,0,0,1,1,2,-1,0,norway3,0.0,0.0,-1,1.0,0.0,0.0,0.0,3
V. Haugesund,1,0,0,1,1,2,-1,0,norway3,0.0,0.0,-1,1.0,0.0,0.0,0.0,3
Eik Tonsberg,1,0,0,1,1,3,-2,0,norway3,0.0,0.0,-2,1.0,0.0,0.0,0.0,3
Strommen,1,1,0,0,4,1,3,3,norway4,1.0,1.0,3,4.0,3.0,1.0,1.0,1
Honefoss,1,1,0,0,3,0,3,3,norway4,1.0,1.0,3,3.0,3.0,1.0,1.0,1
Tromsdalen,1,1,0,0,3,0,3,3,norway4,1.0,1.0,3,3.0,3.0,1.0,1.0,1
Eidsvold,1,1,0,0,3,2,1,3,norway4,1.0,1.0,1,3.0,3.0,1.0,1.0,1
Kjelsas,1,1,0,0,2,1,1,3,norway4,1.0,1.0,1,2.0,3.0,1.0,1.0,1
Asker,1,0,1,0,2,2,0,1,norway4,0.0,1.0,0,2.0,1.0,0.0,1.0,2
Follo,1,0,1,0,2,2,0,1,norway4,0.0,1.0,0,2.0,1.0,0.0,1.0,2
Alta,0,0,0,0,0,0,0,0,norway4,0.0,0.0,0,0.0,0.0,0.0,0.0,3
Levanger,0,0,0,0,0,0,0,0,norway4,0.0,0.0,0,0.0,0.0,0.0,0.0,3
Ull/Kisa,1,0,0,1,2,3,-1,0,norway4,0.0,0.0,-1,2.0,0.0,0.0,0.0,3
Strindheim,1,0,0,1,1,2,-1,0,norway4,0.0,0.0,-1,1.0,0.0,0.0,0.0,3
Rana,1,0,0,1,1,4,-3,0,norway4,0.0,0.0,-3,1.0,0.0,0.0,0.0,3
Grorud,1,0,0,1,0,3,-3,0,norway4,0.0,0.0,-3,0.0,0.0,0.0,0.0,3
Stjordals-Blink,1,0,0,1,0,3,-3,0,norway4,0.0,0.0,-3,0.0,0.0,0.0,0.0,3
Harstad,1,1,0,0,5,2,3,3,norway5,1.0,1.0,3,5.0,3.0,1.0,1.0,1
Floya,1,1,0,0,5,3,2,3,norway5,1.0,1.0,2,5.0,3.0,1.0,1.0,1
Junkeren,1,1,0,0,2,1,1,3,norway5,1.0,1.0,1,2.0,3.0,1.0,1.0,1
Ulfstind,1,1,0,0,1,0,1,3,norway5,1.0,1.0,1,1.0,3.0,1.0,1.0,1
Funnefoss/V,1,0,1,0,3,3,0,1,norway5,0.0,1.0,0,3.0,1.0,0.0,1.0,2
Skjervoy,1,0,1,0,3,3,0,1,norway5,0.0,1.0,0,3.0,1.0,0.0,1.0,2
Alta B,1,0,1,0,2,2,0,1,norway5,0.0,1.0,0,2.0,1.0,0.0,1.0,2
Frigg,1,0,1,0,2,2,0,1,norway5,0.0,1.0,0,2.0,1.0,0.0,1.0,2
Gamle Oslo,1,0,1,0,2,2,0,1,norway5,0.0,1.0,0,2.0,1.0,0.0,1.0,2
Sortland,1,0,1,0,2,2,0,1,norway5,0.0,1.0,0,2.0,1.0,0.0,1.0,2
Ullern,1,0,0,1,1,2,-1,0,norway5,0.0,0.0,-1,1.0,0.0,0.0,0.0,3
Baerum,1,0,0,1,0,1,-1,0,norway5,0.0,0.0,-1,0.0,0.0,0.0,0.0,3
KFUM B,1,0,0,1,3,5,-2,0,norway5,0.0,0.0,-2,3.0,0.0,0.0,0.0,3
Tromso B,1,0,0,1,2,5,-3,0,norway5,0.0,0.0,-3,2.0,0.0,0.0,0.0,3
Spjelkavik,1,1,0,0,7,1,6,3,norway6,1.0,1.0,6,7.0,3.0,1.0,1.0,1
Aalesund B,1,1,0,0,5,2,3,3,norway6,1.0,1.0,3,5.0,3.0,1.0,1.0,1
Volda,1,1,0,0,2,0,2,3,norway6,1.0,1.0,2,2.0,3.0,1.0,1.0,1
Melhus,1,1,0,0,1,0,1,3,norway6,1.0,1.0,1,1.0,3.0,1.0,1.0,1
Byasen,1,0,1,0,0,0,0,1,norway6,0.0,1.0,0,0.0,1.0,0.0,1.0,2
Tiller,1,0,1,0,0,0,0,1,norway6,0.0,1.0,0,0.0,1.0,0.0,1.0,2
Kristiansund B,0,0,0,0,0,0,0,0,norway6,0.0,0.0,0,0.0,0.0,0.0,0.0,3
Molde B,0,0,0,0,0,0,0,0,norway6,0.0,0.0,0,0.0,0.0,0.0,0.0,3
Nardo,0,0,0,0,0,0,0,0,norway6,0.0,0.0,0,0.0,0.0,0.0,0.0,3
Rosenborg B,0,0,0,0,0,0,0,0,norway6,0.0,0.0,0,0.0,0.0,0.0,0.0,3
Trygg/Lade,1,0,0,1,0,1,-1,0,norway6,0.0,0.0,-1,0.0,0.0,0.0,0.0,3
Ranheim B,1,0,0,1,0,2,-2,0,norway6,0.0,0.0,-2,0.0,0.0,0.0,0.0,3
Kvik Trondheim,1,0,0,1,2,5,-3,0,norway6,0.0,0.0,-3,2.0,0.0,0.0,0.0,3
Surnadal,1,0,0,1,1,7,-6,0,norway6,0.0,0.0,-6,1.0,0.0,0.0,0.0,3
Skjetten,1,1,0,0,5,0,5,3,norway7,1.0,1.0,5,5.0,3.0,1.0,1.0,1
Lorenskog,1,1,0,0,6,2,4,3,norway7,1.0,1.0,4,6.0,3.0,1.0,1.0,1
Assiden IF,1,0,1,0,2,2,0,1,norway7,0.0,1.0,0,2.0,1.0,0.0,1.0,2
Bjorkelangen,1,0,1,0,2,2,0,1,norway7,0.0,1.0,0,2.0,1.0,0.0,1.0,2
Gjovik-Lyn,1,0,1,0,1,1,0,1,norway7,0.0,1.0,0,1.0,1.0,0.0,1.0,2
Nordstrand,1,0,1,0,1,1,0,1,norway7,0.0,1.0,0,1.0,1.0,0.0,1.0,2
Elverum,0,0,0,0,0,0,0,0,norway7,0.0,0.0,0,0.0,0.0,0.0,0.0,3
HamKam B,0,0,0,0,0,0,0,0,norway7,0.0,0.0,0,0.0,0.0,0.0,0.0,3
Kongsvinger B,0,0,0,0,0,0,0,0,norway7,0.0,0.0,0,0.0,0.0,0.0,0.0,3
Lillehammer,0,0,0,0,0,0,0,0,norway7,0.0,0.0,0,0.0,0.0,0.0,0.0,3
Lillestrom B,0,0,0,0,0,0,0,0,norway7,0.0,0.0,0,0.0,0.0,0.0,0.0,3
Stromsgodset B,0,0,0,0,0,0,0,0,norway7,0.0,0.0,0,0.0,0.0,0.0,0.0,3
Skedsmo,1,0,0,1,2,6,-4,0,norway7,0.0,0.0,-4,2.0,0.0,0.0,0.0,3
Ull/Kisa B,1,0,0,1,0,5,-5,0,norway7,0.0,0.0,-5,0.0,0.0,0.0,0.0,3
Fana,1,1,0,0,8,0,8,3,norway8,1.0,1.0,8,8.0,3.0,1.0,1.0,1
Bjarg,1,1,0,0,5,0,5,3,norway8,1.0,1.0,5,5.0,3.0,1.0,1.0,1
Fyllingsdalen,1,1,0,0,3,1,2,3,norway8,1.0,1.0,2,3.0,3.0,1.0,1.0,1
Forde,1,1,0,0,2,0,2,3,norway8,1.0,1.0,2,2.0,3.0,1.0,1.0,1
Sandefjord B,1,1,0,0,4,3,1,3,norway8,1.0,1.0,1,4.0,3.0,1.0,1.0,1
Gneist,1,1,0,0,3,2,1,3,norway8,1.0,1.0,1,3.0,3.0,1.0,1.0,1
Lyn B,0,0,0,0,0,0,0,0,norway8,0.0,0.0,0,0.0,0.0,0.0,0.0,2
Valerenga B,0,0,0,0,0,0,0,0,norway8,0.0,0.0,0,0.0,0.0,0.0,0.0,2
Asane B,1,0,0,1,3,4,-1,0,norway8,0.0,0.0,-1,3.0,0.0,0.0,0.0,2
OS,1,0,0,1,2,3,-1,0,norway8,0.0,0.0,-1,2.0,0.0,0.0,0.0,2
Lyngbo,1,0,0,1,1,3,-2,0,norway8,0.0,0.0,-2,1.0,0.0,0.0,0.0,2
Fjora,1,0,0,1,0,2,-2,0,norway8,0.0,0.0,-2,0.0,0.0,0.0,0.0,2
Askoy,1,0,0,1,0,5,-5,0,norway8,0.0,0.0,-5,0.0,0.0,0.0,0.0,2
Loddefjord,1,0,0,1,0,8,-8,0,norway8,0.0,0.0,-8,0.0,0.0,0.0,0.0,2
Torvastad,1,1,0,0,4,0,4,3,norway9,1.0,1.0,4,4.0,3.0,1.0,1.0,1
Vidar,1,1,0,0,3,1,2,3,norway9,1.0,1.0,2,3.0,3.0,1.0,1.0,1
Brodd,1,1,0,0,3,2,1,3,norway9,1.0,1.0,1,3.0,3.0,1.0,1.0,1
Stord,1,0,1,0,1,1,0,1,norway9,0.0,1.0,0,1.0,1.0,0.0,1.0,2
Vindbjart,1,0,1,0,1,1,0,1,norway9,0.0,1.0,0,1.0,1.0,0.0,1.0,2
Haugesund B,0,0,0,0,0,0,0,0,norway9,0.0,0.0,0,0.0,0.0,0.0,0.0,3
Hinna,0,0,0,0,0,0,0,0,norway9,0.0,0.0,0,0.0,0.0,0.0,0.0,3
Madla,0,0,0,0,0,0,0,0,norway9,0.0,0.0,0,0.0,0.0,0.0,0.0,3
Sandnes Ulf B,0,0,0,0,0,0,0,0,norway9,0.0,0.0,0,0.0,0.0,0.0,0.0,3
Sola,0,0,0,0,0,0,0,0,norway9,0.0,0.0,0,0.0,0.0,0.0,0.0,3
Viking B,0,0,0,0,0,0,0,0,norway9,0.0,0.0,0,0.0,0.0,0.0,0.0,3
Staal Jorpeland,1,0,0,1,2,3,-1,0,norway9,0.0,0.0,-1,2.0,0.0,0.0,0.0,3
Djerv,1,0,0,1,1,3,-2,0,norway9,0.0,0.0,-2,1.0,0.0,0.0,0.0,3
Vag,1,0,0,1,0,4,-4,0,norway9,0.0,0.0,-4,0.0,0.0,0.0,0.0,3
Fram,1,1,0,0,4,0,4,3,norway10,1.0,1.0,4,4.0,3.0,1.0,1.0,1
Flint,1,1,0,0,3,0,3,3,norway10,1.0,1.0,3,3.0,3.0,1.0,1.0,1
Oppsal,1,1,0,0,2,1,1,3,norway10,1.0,1.0,1,2.0,3.0,1.0,1.0,1
Pors Grenland B,1,1,0,0,2,1,1,3,norway10,1.0,1.0,1,2.0,3.0,1.0,1.0,1
Drobak-Frogn,1,0,1,0,1,1,0,1,norway10,0.0,1.0,0,1.0,1.0,0.0,1.0,2
Grei,1,0,1,0,1,1,0,1,norway10,0.0,1.0,0,1.0,1.0,0.0,1.0,2
Odd B,0,0,0,0,0,0,0,0,norway10,0.0,0.0,0,0.0,0.0,0.0,0.0,3
Orn Horten,0,0,0,0,0,0,0,0,norway10,0.0,0.0,0,0.0,0.0,0.0,0.0,3
Sarpsborg 08 B,0,0,0,0,0,0,0,0,norway10,0.0,0.0,0,0.0,0.0,0.0,0.0,3
Stabaek B,0,0,0,0,0,0,0,0,norway10,0.0,0.0,0,0.0,0.0,0.0,0.0,3
Fredrikstad B,1,0,0,1,1,2,-1,0,norway10,0.0,0.0,-1,1.0,0.0,0.0,0.0,3
Kvik Halden,1,0,0,1,1,2,-1,0,norway10,0.0,0.0,-1,1.0,0.0,0.0,0.0,3
IF Ready,1,0,0,1,0,3,-3,0,norway10,0.0,0.0,-3,0.0,0.0,0.0,0.0,3
Lokomotiv Oslo,1,0,0,1,0,4,-4,0,norway10,0.0,0.0,-4,0.0,0.0,0.0,0.0,3
Plaza Amador,8,5,2,1,12,7,5,17,panama,0.62,0.88,5,1.5,2.12,1.61,1.14,1
Universitario,8,4,3,1,11,6,5,15,panama,0.5,0.88,5,1.38,1.88,2.0,1.14,2
San Francisco,8,4,2,2,8,5,3,14,panama,0.5,0.75,3,1.0,1.75,2.0,1.33,3
Independiente,8,3,4,1,9,4,5,13,panama,0.38,0.88,5,1.12,1.62,2.63,1.14,4
Tauro,8,3,3,2,15,9,6,12,panama,0.38,0.75,6,1.88,1.5,2.63,1.33,5
Arabe Unido,8,3,3,2,7,6,1,12,panama,0.38,0.75,1,0.88,1.5,2.63,1.33,5
San Miguelito,8,3,2,3,7,9,-2,11,panama,0.38,0.62,-2,0.88,1.38,2.63,1.61,6
UMECIT,8,2,4,2,9,10,-1,10,panama,0.25,0.75,-1,1.12,1.25,4.0,1.33,7
Costa del Este,8,2,3,3,8,9,-1,9,panama,0.25,0.62,-1,1.0,1.12,4.0,1.61,8
Veraguas,8,2,2,4,8,12,-4,8,panama,0.25,0.5,-4,1.0,1.0,4.0,2.0,9
Alianza,8,1,3,4,6,11,-5,6,panama,0.12,0.5,-5,0.75,0.75,8.33,2.0,10
Herrera,8,0,3,5,3,10,-7,3,panama,0.0,0.38,-7,0.38,0.38,0.0,2.63,11
San Miguelito,8,5,2,1,8,4,4,17,panama2,0.62,0.88,4,1.0,2.12,1.61,1.14,1
Independiente,8,5,1,2,14,11,3,16,panama2,0.62,0.75,3,1.75,2.0,1.61,1.33,2
Plaza Amador,8,4,3,1,9,6,3,15,panama2,0.5,0.88,3,1.12,1.88,2.0,1.14,3
Tauro,8,4,3,1,9,6,3,15,panama2,0.5,0.88,3,1.12,1.88,2.0,1.14,3
Veraguas,8,3,3,2,11,7,4,12,panama2,0.38,0.75,4,1.38,1.5,2.63,1.33,4
Arabe Unido,8,2,5,1,7,6,1,11,panama2,0.25,0.88,1,0.88,1.38,4.0,1.14,5
Universitario,8,3,2,3,6,5,1,11,panama2,0.38,0.62,1,0.75,1.38,2.63,1.61,5
UMECIT,8,3,1,4,8,8,0,10,panama2,0.38,0.5,0,1.0,1.25,2.63,2.0,6
Costa del Este,8,2,3,3,10,15,-5,9,panama2,0.25,0.62,-5,1.25,1.12,4.0,1.61,7
Alianza,8,2,0,6,8,12,-4,6,panama2,0.25,0.25,-4,1.0,0.75,4.0,4.0,8
San Francisco,8,1,2,5,4,10,-6,5,panama2,0.12,0.38,-6,0.5,0.62,8.33,2.63,9
Herrera,8,1,1,6,4,8,-4,4,panama2,0.12,0.25,-4,0.5,0.5,8.33,4.0,10
Libertad,8,6,2,0,17,4,13,20,paraguay,0.75,1.0,13,2.12,2.5,1.33,1.0,1
Olimpia,8,4,2,2,12,9,3,14,paraguay,0.5,0.75,3,1.5,1.75,2.0,1.33,2
Cerro Porteno,8,4,1,3,8,6,2,13,paraguay,0.5,0.62,2,1.0,1.62,2.0,1.61,3
D. Recoleta,8,3,3,2,11,9,2,12,paraguay,0.38,0.75,2,1.38,1.5,2.63,1.33,4
S. Trinidense,8,2,5,1,10,9,1,11,paraguay,0.25,0.88,1,1.25,1.38,4.0,1.14,5
Nacional,8,3,1,4,7,8,-1,10,paraguay,0.38,0.5,-1,0.88,1.25,2.63,2.0,6
Guarani,8,3,1,4,6,10,-4,10,paraguay,0.38,0.5,-4,0.75,1.25,2.63,2.0,6
S. Ameliano,8,2,3,3,8,10,-2,9,paraguay,0.25,0.62,-2,1.0,1.12,4.0,1.61,7
A. Tembetary,8,2,2,4,6,8,-2,8,paraguay,0.25,0.5,-2,0.75,1.0,4.0,2.0,8
G. Caballero,8,2,2,4,5,9,-4,8,paraguay,0.25,0.5,-4,0.62,1.0,4.0,2.0,8
S. Luqueno,8,2,2,4,5,11,-6,8,paraguay,0.25,0.5,-6,0.62,1.0,4.0,2.0,8
2 de Mayo,8,0,6,2,6,8,-2,6,paraguay,0.0,0.75,-2,0.75,0.75,0.0,1.33,9
Olimpia,8,4,3,1,10,4,6,15,paraguay2,0.5,0.88,6,1.25,1.88,2.0,1.14,1
Guarani,8,3,5,0,10,7,3,14,paraguay2,0.38,1.0,3,1.25,1.75,2.63,1.0,2
S. Ameliano,8,4,1,3,7,6,1,13,paraguay2,0.5,0.62,1,0.88,1.62,2.0,1.61,3
Sol de America,8,3,3,2,12,9,3,12,paraguay2,0.38,0.75,3,1.5,1.5,2.63,1.33,4
S. Luqueno,8,3,3,2,10,8,2,12,paraguay2,0.38,0.75,2,1.25,1.5,2.63,1.33,4
S. Trinidense,8,3,3,2,10,9,1,12,paraguay2,0.38,0.75,1,1.25,1.5,2.63,1.33,4
2 de Mayo,8,2,4,2,7,5,2,10,paraguay2,0.25,0.75,2,0.88,1.25,4.0,1.33,5
G. Caballero,8,2,3,3,7,7,0,9,paraguay2,0.25,0.62,0,0.88,1.12,4.0,1.61,6
Nacional,8,1,5,2,8,9,-1,8,paraguay2,0.12,0.75,-1,1.0,1.0,8.33,1.33,7
Cerro Porteno,8,2,2,4,11,15,-4,8,paraguay2,0.25,0.5,-4,1.38,1.0,4.0,2.0,7
Libertad,8,2,1,5,8,12,-4,7,paraguay2,0.25,0.38,-4,1.0,0.88,4.0,2.63,8
Tacuary,8,1,3,4,5,14,-9,6,paraguay2,0.12,0.5,-9,0.62,0.75,8.33,2.0,9
FBC Melgar,5,5,0,0,10,3,7,15,peru,1.0,1.0,7,2.0,3.0,1.0,1.0,1
D. Garcilaso,6,4,2,0,13,5,8,14,peru,0.67,1.0,8,2.17,2.33,1.49,1.0,2
Universitario,5,4,1,0,13,4,9,13,peru,0.8,1.0,9,2.6,2.6,1.25,1.0,3
Alianza Lima,6,4,0,2,9,7,2,12,peru,0.67,0.67,2,1.5,2.0,1.49,1.49,4
ADT,6,3,2,1,15,11,4,11,peru,0.5,0.83,4,2.5,1.83,2.0,1.2,5
S. Cristal,6,3,1,2,11,6,5,10,peru,0.5,0.67,5,1.83,1.67,2.0,1.49,6
Sport Huancayo,6,3,1,2,7,7,0,10,peru,0.5,0.67,0,1.17,1.67,2.0,1.49,6
Alianza A.,6,2,1,3,11,10,1,7,peru,0.33,0.5,1,1.83,1.17,3.03,2.0,7
Atletico Grau,5,2,1,2,8,9,-1,7,peru,0.4,0.6,-1,1.6,1.4,2.5,1.67,7
Cusco,5,2,1,2,7,8,-1,7,peru,0.4,0.6,-1,1.4,1.4,2.5,1.67,7
Sport Boys,6,2,1,3,6,11,-5,7,peru,0.33,0.5,-5,1.0,1.17,3.03,2.0,7
Los Chankas,5,1,3,1,7,6,1,6,peru,0.2,0.8,1,1.4,1.2,5.0,1.25,8
Binacional,5,2,0,3,8,11,-3,6,peru,0.4,0.4,-3,1.6,1.2,2.5,2.5,8
Cienciano,5,1,2,2,9,10,-1,5,peru,0.2,0.6,-1,1.8,1.0,5.0,1.67,9
Ayacucho,6,1,1,4,7,11,-4,4,peru,0.17,0.33,-4,1.17,0.67,5.88,3.03,10
Comerciantes U.,5,0,3,2,7,9,-2,3,peru,0.0,0.6,-2,1.4,0.6,0.0,1.67,11
Juan Pablo II C,5,1,0,4,4,7,-3,3,peru,0.2,0.2,-3,0.8,0.6,5.0,5.0,11
A. Huanuco,6,0,2,4,7,15,-8,2,peru,0.0,0.33,-8,1.17,0.33,0.0,3.03,12
Cajamarca,5,0,2,3,3,12,-9,2,peru,0.0,0.4,-9,0.6,0.4,0.0,2.5,12
Manila Digger,8,7,0,1,25,3,22,21,philippines,0.88,0.88,22,3.12,2.62,1.14,1.14,1
Kaya FC,8,6,0,2,19,8,11,18,philippines,0.75,0.75,11,2.38,2.25,1.33,1.33,2
DH Cebu,8,4,1,3,16,9,7,13,philippines,0.5,0.62,7,2.0,1.62,2.0,1.61,3
Stallion,8,3,3,2,21,11,10,12,philippines,0.38,0.75,10,2.62,1.5,2.63,1.33,4
Davao Aguilas,8,3,2,3,8,5,3,11,philippines,0.38,0.62,3,1.0,1.38,2.63,1.61,5
One Taguig,8,3,2,3,10,8,2,11,philippines,0.38,0.62,2,1.25,1.38,2.63,1.61,5
Maharlika,8,3,1,4,9,10,-1,10,philippines,0.38,0.5,-1,1.12,1.25,2.63,2.0,6
Loyola,8,3,1,4,8,13,-5,10,philippines,0.38,0.5,-5,1.0,1.25,2.63,2.0,6
Mendiola,8,1,1,6,7,40,-33,4,philippines,0.12,0.25,-33,0.88,0.5,8.33,4.0,7
PFF Development,8,0,3,5,8,30,-22,3,philippines,0.0,0.38,-22,1.0,0.38,0.0,2.63,8
Pogon Szczecin,8,5,2,1,16,7,9,17,poland,0.62,0.88,9,2.0,2.12,1.61,1.14,1
Rakow C.,8,5,2,1,14,7,7,17,poland,0.62,0.88,7,1.75,2.12,1.61,1.14,1
Jagiellonia,8,5,1,2,15,6,9,16,poland,0.62,0.75,9,1.88,2.0,1.61,1.33,2
Korona Kielce,8,4,3,1,10,7,3,15,poland,0.5,0.88,3,1.25,1.88,2.0,1.14,3
Radomiak Radom,8,4,2,2,14,14,0,14,poland,0.5,0.75,0,1.75,1.75,2.0,1.33,4
Katowice,8,4,1,3,8,7,1,13,poland,0.5,0.62,1,1.0,1.62,2.0,1.61,5
Lech Poznan,8,4,0,4,15,10,5,12,poland,0.5,0.5,5,1.88,1.5,2.0,2.0,6
Slask Wroclaw,8,3,2,3,14,12,2,11,poland,0.38,0.62,2,1.75,1.38,2.63,1.61,7
Piast Gliwice,8,3,2,3,8,10,-2,11,poland,0.38,0.62,-2,1.0,1.38,2.63,1.61,7
Motor Lublin,8,3,2,3,12,15,-3,11,poland,0.38,0.62,-3,1.5,1.38,2.63,1.61,7
Gornik Zabrze,8,3,1,4,11,11,0,10,poland,0.38,0.5,0,1.38,1.25,2.63,2.0,8
Cracovia Krakow,8,2,4,2,11,12,-1,10,poland,0.25,0.75,-1,1.38,1.25,4.0,1.33,8
Lechia Gdansk,8,3,1,4,9,11,-2,10,poland,0.38,0.5,-2,1.12,1.25,2.63,2.0,8
Legia Warsaw,8,2,3,3,12,12,0,9,poland,0.25,0.62,0,1.5,1.12,4.0,1.61,9
Widzew Lodz,8,2,2,4,6,14,-8,8,poland,0.25,0.5,-8,0.75,1.0,4.0,2.0,10
Puszcza Niepolo,8,2,1,5,8,12,-4,7,poland,0.25,0.38,-4,1.0,0.88,4.0,2.63,11
Zaglebie Lubin,8,1,1,6,5,14,-9,4,poland,0.12,0.25,-9,0.62,0.5,8.33,4.0,12
Stal Mielec,8,1,1,6,8,18,-10,4,poland,0.12,0.25,-10,1.0,0.5,8.33,4.0,12
Arka Gdynia,8,6,2,0,11,3,8,20,poland2,0.75,1.0,8,1.38,2.5,1.33,1.0,1
Tychy,8,6,1,1,23,8,15,19,poland2,0.75,0.88,15,2.88,2.38,1.33,1.14,2
Polonia Warszaw,8,5,2,1,16,10,6,17,poland2,0.62,0.88,6,2.0,2.12,1.61,1.14,3
Wisla Plock,8,4,3,1,14,6,8,15,poland2,0.5,0.88,8,1.75,1.88,2.0,1.14,4
Znicz Pruszkow,8,4,2,2,9,7,2,14,poland2,0.5,0.75,2,1.12,1.75,2.0,1.33,5
T. Nieciecza,8,3,4,1,14,14,0,13,poland2,0.38,0.88,0,1.75,1.62,2.63,1.14,6
Wisla Krakow,8,3,2,3,12,9,3,11,poland2,0.38,0.62,3,1.5,1.38,2.63,1.61,7
Miedz Legnica,8,3,2,3,12,12,0,11,poland2,0.38,0.62,0,1.5,1.38,2.63,1.61,7
Gornik Leczna,8,3,1,4,11,8,3,10,poland2,0.38,0.5,3,1.38,1.25,2.63,2.0,8
Ruch Chorzow,8,2,3,3,12,13,-1,9,poland2,0.25,0.62,-1,1.5,1.12,4.0,1.61,9
Stal Rzeszow,8,2,3,3,9,13,-4,9,poland2,0.25,0.62,-4,1.12,1.12,4.0,1.61,9
Odra Opole,8,2,3,3,8,17,-9,9,poland2,0.25,0.62,-9,1.0,1.12,4.0,1.61,9
LKS Lodz,8,2,2,4,9,11,-2,8,poland2,0.25,0.5,-2,1.12,1.0,4.0,2.0,10
Chrobry Glogow,8,2,2,4,9,12,-3,8,poland2,0.25,0.5,-3,1.12,1.0,4.0,2.0,10
K. Kolobrzeg,8,1,4,3,6,10,-4,7,poland2,0.12,0.62,-4,0.75,0.88,8.33,1.61,11
Pogon Siedlce,8,1,3,4,7,11,-4,6,poland2,0.12,0.5,-4,0.88,0.75,8.33,2.0,12
Stalowa Wola,8,0,5,3,4,10,-6,5,poland2,0.0,0.62,-6,0.5,0.62,0.0,1.61,13
Warta Poznan,8,0,2,6,3,14,-11,2,poland2,0.0,0.25,-11,0.38,0.25,0.0,4.0,14
Pogon Grodzisk,8,7,0,1,16,7,9,21,poland3,0.88,0.88,9,2.0,2.62,1.14,1.14,1
Chojniczanka,8,6,0,2,12,6,6,18,poland3,0.75,0.75,6,1.5,2.25,1.33,1.33,2
Wieczysta K.,8,5,1,2,17,8,9,16,poland3,0.62,0.75,9,2.12,2.0,1.61,1.33,3
LKS Lodz B,8,5,1,2,12,6,6,16,poland3,0.62,0.75,6,1.5,2.0,1.61,1.33,3
Polonia Bytom,8,4,3,1,13,7,6,15,poland3,0.5,0.88,6,1.62,1.88,2.0,1.14,4
Z. Sosnowiec,8,4,2,2,15,10,5,14,poland3,0.5,0.75,5,1.88,1.75,2.0,1.33,5
Zaglebie L. B,8,4,1,3,19,15,4,13,poland3,0.5,0.62,4,2.38,1.62,2.0,1.61,6
Kalisz,8,4,1,3,12,8,4,13,poland3,0.5,0.62,4,1.5,1.62,2.0,1.61,6
Podbeskidzie,8,3,2,3,7,7,0,11,poland3,0.38,0.62,0,0.88,1.38,2.63,1.61,7
Swit Skolwin,8,3,1,4,16,16,0,10,poland3,0.38,0.5,0,2.0,1.25,2.63,2.0,8
Rekord Bielsko,8,2,4,2,10,10,0,10,poland3,0.25,0.75,0,1.25,1.25,4.0,1.33,8
Hutnik Krakow,8,3,1,4,7,13,-6,10,poland3,0.38,0.5,-6,0.88,1.25,2.63,2.0,8
O. Grudziadz,8,2,2,4,6,11,-5,8,poland3,0.25,0.5,-5,0.75,1.0,4.0,2.0,9
Resovia Rzeszow,8,2,1,5,11,15,-4,7,poland3,0.25,0.38,-4,1.38,0.88,4.0,2.63,10
Jastrzebie,8,2,1,5,5,9,-4,7,poland3,0.25,0.38,-4,0.62,0.88,4.0,2.63,10
SKRA Czestochow,8,2,1,5,4,11,-7,7,poland3,0.25,0.38,-7,0.5,0.88,4.0,2.63,10
Olimpia Elblag,8,1,1,6,6,14,-8,4,poland3,0.12,0.25,-8,0.75,0.5,8.33,4.0,11
Wisla Pulawy,8,1,1,6,6,21,-15,4,poland3,0.12,0.25,-15,0.75,0.5,8.33,4.0,11
Benfica,8,7,0,1,20,9,11,21,portugal,0.88,0.88,11,2.5,2.62,1.14,1.14,1
Sporting Braga,8,6,1,1,10,4,6,19,portugal,0.75,0.88,6,1.25,2.38,1.33,1.14,2
Sporting CP,8,5,3,0,20,9,11,18,portugal,0.62,1.0,11,2.5,2.25,1.61,1.0,3
Famalicao,8,5,1,2,13,6,7,16,portugal,0.62,0.75,7,1.62,2.0,1.61,1.33,4
Guimaraes,8,4,4,0,10,4,6,16,portugal,0.5,1.0,6,1.25,2.0,2.0,1.0,4
FC Porto,8,4,3,1,11,6,5,15,portugal,0.5,0.88,5,1.38,1.88,2.0,1.14,5
Santa Clara,8,4,2,2,7,5,2,14,portugal,0.5,0.75,2,0.88,1.75,2.0,1.33,6
Estoril,8,3,3,2,13,13,0,12,portugal,0.38,0.75,0,1.62,1.5,2.63,1.33,7
Arouca,8,2,4,2,10,11,-1,10,portugal,0.25,0.75,-1,1.25,1.25,4.0,1.33,8
Nacional,8,3,1,4,10,11,-1,10,portugal,0.38,0.5,-1,1.25,1.25,2.63,2.0,8
Moreirense,8,2,3,3,11,13,-2,9,portugal,0.25,0.62,-2,1.38,1.12,4.0,1.61,9
Casa Pia,8,3,0,5,9,13,-4,9,portugal,0.38,0.38,-4,1.12,1.12,2.63,2.63,9
Rio Ave,8,1,3,4,10,13,-3,6,portugal,0.12,0.5,-3,1.25,0.75,8.33,2.0,10
Estrela Amadora,8,1,3,4,5,11,-6,6,portugal,0.12,0.5,-6,0.62,0.75,8.33,2.0,10
AVS,8,1,2,5,6,14,-8,5,portugal,0.12,0.38,-8,0.75,0.62,8.33,2.63,11
Boavista,8,1,0,7,3,14,-11,3,portugal,0.12,0.12,-11,0.38,0.38,8.33,8.33,12
Farense,8,0,2,6,6,14,-8,2,portugal,0.0,0.25,-8,0.75,0.25,0.0,4.0,13
Gil Vicente,8,0,1,7,2,13,-11,1,portugal,0.0,0.12,-11,0.25,0.12,0.0,8.33,14
Vizela,8,7,1,0,20,6,14,22,portugal2,0.88,1.0,14,2.5,2.75,1.14,1.0,1
Tondela,8,5,2,1,12,6,6,17,portugal2,0.62,0.88,6,1.5,2.12,1.61,1.14,2
Alverca,8,4,3,1,17,9,8,15,portugal2,0.5,0.88,8,2.12,1.88,2.0,1.14,3
Uniao de Leiria,8,4,3,1,11,7,4,15,portugal2,0.5,0.88,4,1.38,1.88,2.0,1.14,3
Feirense,8,5,0,3,11,12,-1,15,portugal2,0.62,0.62,-1,1.38,1.88,1.61,1.61,3
Chaves,8,4,2,2,11,6,5,14,portugal2,0.5,0.75,5,1.38,1.75,2.0,1.33,4
Maritimo,8,3,3,2,7,9,-2,12,portugal2,0.38,0.75,-2,0.88,1.5,2.63,1.33,5
Academico Viseu,8,2,5,1,10,9,1,11,portugal2,0.25,0.88,1,1.25,1.38,4.0,1.14,6
FC Porto B,8,3,2,3,10,9,1,11,portugal2,0.38,0.62,1,1.25,1.38,2.63,1.61,6
Oliveirense,8,3,1,4,8,14,-6,10,portugal2,0.38,0.5,-6,1.0,1.25,2.63,2.0,7
Torreense,8,2,3,3,14,15,-1,9,portugal2,0.25,0.62,-1,1.75,1.12,4.0,1.61,8
Felgueiras,8,2,3,3,6,8,-2,9,portugal2,0.25,0.62,-2,0.75,1.12,4.0,1.61,8
Pacos Ferreira,8,2,2,4,6,9,-3,8,portugal2,0.25,0.5,-3,0.75,1.0,4.0,2.0,9
Portimonense,8,2,1,5,8,13,-5,7,portugal2,0.25,0.38,-5,1.0,0.88,4.0,2.63,10
Penafiel,8,2,0,6,9,12,-3,6,portugal2,0.25,0.25,-3,1.12,0.75,4.0,4.0,11
Benfica B,8,1,3,4,6,9,-3,6,portugal2,0.12,0.5,-3,0.75,0.75,8.33,2.0,11
Leixoes,8,1,3,4,4,7,-3,6,portugal2,0.12,0.5,-3,0.5,0.75,8.33,2.0,11
Mafra,8,0,3,5,2,12,-10,3,portugal2,0.0,0.38,-10,0.25,0.38,0.0,2.63,12
Al Sadd,8,7,0,1,19,2,17,21,qatar,0.88,0.88,17,2.38,2.62,1.14,1.14,1
Al Duhail,8,6,1,1,16,7,9,19,qatar,0.75,0.88,9,2.0,2.38,1.33,1.14,2
Al Gharafa,8,5,1,2,14,12,2,16,qatar,0.62,0.75,2,1.75,2.0,1.61,1.33,3
Al Rayyan,8,4,2,2,20,9,11,14,qatar,0.5,0.75,11,2.5,1.75,2.0,1.33,4
Al Arabi,8,4,1,3,17,15,2,13,qatar,0.5,0.62,2,2.12,1.62,2.0,1.61,5
Qatar SC,8,3,3,2,12,12,0,12,qatar,0.38,0.75,0,1.5,1.5,2.63,1.33,6
Al Shahaniya,8,4,0,4,10,17,-7,12,qatar,0.5,0.5,-7,1.25,1.5,2.0,2.0,6
Al Shamal,8,3,1,4,12,7,5,10,qatar,0.38,0.5,5,1.5,1.25,2.63,2.0,7
Al Ahli Doha,8,3,1,4,13,17,-4,10,qatar,0.38,0.5,-4,1.62,1.25,2.63,2.0,7
Al Wakrah,8,2,1,5,11,21,-10,7,qatar,0.25,0.38,-10,1.38,0.88,4.0,2.63,8
Al Khor,8,1,0,7,10,20,-10,3,qatar,0.12,0.12,-10,1.25,0.38,8.33,8.33,9
Umm Salal,8,0,1,7,7,22,-15,1,qatar,0.0,0.12,-15,0.88,0.12,0.0,8.33,10
CFR Cluj,8,5,3,0,19,5,14,18,romania,0.62,1.0,14,2.38,2.25,1.61,1.0,1
FCSB,8,5,3,0,10,2,8,18,romania,0.62,1.0,8,1.25,2.25,1.61,1.0,1
Univ. Craiova,8,5,1,2,11,6,5,16,romania,0.62,0.75,5,1.38,2.0,1.61,1.33,2
Din. Bucharest,8,4,2,2,10,6,4,14,romania,0.5,0.75,4,1.25,1.75,2.0,1.33,3
Rapid Bucharest,8,4,2,2,9,6,3,14,romania,0.5,0.75,3,1.12,1.75,2.0,1.33,3
Hermannstadt,8,4,2,2,9,7,2,14,romania,0.5,0.75,2,1.12,1.75,2.0,1.33,3
U. Cluj,8,3,3,2,9,8,1,12,romania,0.38,0.75,1,1.12,1.5,2.63,1.33,4
Botosani,8,3,3,2,8,7,1,12,romania,0.38,0.75,1,1.0,1.5,2.63,1.33,4
Sepsi OSK,8,3,2,3,8,9,-1,11,romania,0.38,0.62,-1,1.0,1.38,2.63,1.61,5
Farul Constanta,8,3,1,4,8,10,-2,10,romania,0.38,0.5,-2,1.0,1.25,2.63,2.0,6
P. Iasi,8,2,3,3,8,12,-4,9,romania,0.25,0.62,-4,1.0,1.12,4.0,1.61,7
Petrolul,8,2,2,4,6,8,-2,8,romania,0.25,0.5,-2,0.75,1.0,4.0,2.0,8
UTA Arad,8,2,2,4,5,10,-5,8,romania,0.25,0.5,-5,0.62,1.0,4.0,2.0,8
Otelul,8,2,1,5,7,11,-4,7,romania,0.25,0.38,-4,0.88,0.88,4.0,2.63,9
FC Buzau,8,1,1,6,6,16,-10,4,romania,0.12,0.25,-10,0.75,0.5,8.33,4.0,10
Unirea Slobozia,8,0,1,7,4,14,-10,1,romania,0.0,0.12,-10,0.5,0.12,0.0,8.33,11
Spartak Moscow,8,6,1,1,20,5,15,19,russia,0.75,0.88,15,2.5,2.38,1.33,1.14,1
Rostov,8,5,2,1,16,7,9,17,russia,0.62,0.88,9,2.0,2.12,1.61,1.14,2
CSKA Moscow,8,5,2,1,11,6,5,17,russia,0.62,0.88,5,1.38,2.12,1.61,1.14,2
Dinamo Moscow,8,4,3,1,20,8,12,15,russia,0.5,0.88,12,2.5,1.88,2.0,1.14,3
Rubin Kazan,8,4,2,2,13,12,1,14,russia,0.5,0.75,1,1.62,1.75,2.0,1.33,4
FC Krasnodar,8,3,4,1,13,7,6,13,russia,0.38,0.88,6,1.62,1.62,2.63,1.14,5
Zenit,8,4,1,3,13,8,5,13,russia,0.5,0.62,5,1.62,1.62,2.0,1.61,5
Akron,8,4,0,4,9,12,-3,12,russia,0.5,0.5,-3,1.12,1.5,2.0,2.0,6
Khimki,8,3,2,3,11,12,-1,11,russia,0.38,0.62,-1,1.38,1.38,2.63,1.61,7
Akhmat Grozny,8,2,4,2,8,8,0,10,russia,0.25,0.75,0,1.0,1.25,4.0,1.33,8
Krylya Sovetov,8,3,1,4,13,16,-3,10,russia,0.38,0.5,-3,1.62,1.25,2.63,2.0,8
Makhachkala,8,2,3,3,9,11,-2,9,russia,0.25,0.62,-2,1.12,1.12,4.0,1.61,9
Lokomotiv M.,8,2,3,3,10,17,-7,9,russia,0.25,0.62,-7,1.25,1.12,4.0,1.61,9
Nizhny Novgorod,8,1,1,6,3,17,-14,4,russia,0.12,0.25,-14,0.38,0.5,8.33,4.0,10
Orenburg,8,1,0,7,4,14,-10,3,russia,0.12,0.12,-10,0.5,0.38,8.33,8.33,11
Fakel Voronezh,8,0,2,6,2,13,-11,2,russia,0.0,0.25,-11,0.25,0.25,0.0,4.0,12
Baltika,8,6,2,0,17,1,16,20,russia2,0.75,1.0,16,2.12,2.5,1.33,1.0,1
PFC Sochi,8,5,2,1,12,5,7,17,russia2,0.62,0.88,7,1.5,2.12,1.61,1.14,2
Chernomorets,8,5,2,1,11,5,6,17,russia2,0.62,0.88,6,1.38,2.12,1.61,1.14,2
SKA Khabarovsk,8,5,2,1,7,3,4,17,russia2,0.62,0.88,4,0.88,2.12,1.61,1.14,2
Torpedo Moscow,8,4,3,1,7,5,2,15,russia2,0.5,0.88,2,0.88,1.88,2.0,1.14,3
Yenisey,8,4,2,2,9,6,3,14,russia2,0.5,0.75,3,1.12,1.75,2.0,1.33,4
Ural,8,3,4,1,8,6,2,13,russia2,0.38,0.88,2,1.0,1.62,2.63,1.14,5
Shinnik,8,2,5,1,5,4,1,11,russia2,0.25,0.88,1,0.62,1.38,4.0,1.14,6
Rotor Volgograd,8,2,4,2,7,6,1,10,russia2,0.25,0.75,1,0.88,1.25,4.0,1.33,7
Tyumen,8,3,1,4,6,7,-1,10,russia2,0.38,0.5,-1,0.75,1.25,2.63,2.0,7
Kamaz,8,3,0,5,9,11,-2,9,russia2,0.38,0.38,-2,1.12,1.12,2.63,2.63,8
Neftekhimik,8,2,2,4,9,9,0,8,russia2,0.25,0.5,0,1.12,1.0,4.0,2.0,9
Rodina Moskva,8,2,2,4,6,7,-1,8,russia2,0.25,0.5,-1,0.75,1.0,4.0,2.0,9
Chayka,8,0,5,3,3,11,-8,5,russia2,0.0,0.62,-8,0.38,0.62,0.0,1.61,10
Ufa,8,1,2,5,6,16,-10,5,russia2,0.12,0.38,-10,0.75,0.62,8.33,2.63,10
A. Vladikavkaz,8,1,2,5,4,14,-10,5,russia2,0.12,0.38,-10,0.5,0.62,8.33,2.63,10
Arsenal Tula,8,0,4,4,4,9,-5,4,russia2,0.0,0.5,-5,0.5,0.5,0.0,2.0,11
Sokol Saratov,8,0,3,5,5,12,-7,3,russia2,0.0,0.38,-7,0.62,0.38,0.0,2.63,12
Al Ittihad,8,5,3,0,19,10,9,18,saudiarabia,0.62,1.0,9,2.38,2.25,1.61,1.0,1
Al Ahli Jeddah,8,5,1,2,18,10,8,16,saudiarabia,0.62,0.75,8,2.25,2.0,1.61,1.33,2
Al Nassr,8,5,1,2,18,11,7,16,saudiarabia,0.62,0.75,7,2.25,2.0,1.61,1.33,2
Al Ittifaq,8,5,1,2,13,9,4,16,saudiarabia,0.62,0.75,4,1.62,2.0,1.61,1.33,2
Al Shabab,8,4,2,2,22,12,10,14,saudiarabia,0.5,0.75,10,2.75,1.75,2.0,1.33,3
Al Hilal,8,4,2,2,19,11,8,14,saudiarabia,0.5,0.75,8,2.38,1.75,2.0,1.33,3
Al Quadisiya,8,4,2,2,11,9,2,14,saudiarabia,0.5,0.75,2,1.38,1.75,2.0,1.33,3
Al Fateh,8,4,1,3,12,10,2,13,saudiarabia,0.5,0.62,2,1.5,1.62,2.0,1.61,4
Al Orubah,8,4,0,4,11,15,-4,12,saudiarabia,0.5,0.5,-4,1.38,1.5,2.0,2.0,5
Al Kholood,8,4,0,4,13,18,-5,12,saudiarabia,0.5,0.5,-5,1.62,1.5,2.0,2.0,5
Al Taawon,8,3,2,3,9,8,1,11,saudiarabia,0.38,0.62,1,1.12,1.38,2.63,1.61,6
Al Feiha,8,2,4,2,4,5,-1,10,saudiarabia,0.25,0.75,-1,0.5,1.25,4.0,1.33,7
Al Riyadh,8,2,2,4,7,10,-3,8,saudiarabia,0.25,0.5,-3,0.88,1.0,4.0,2.0,8
Al Wahda,8,2,1,5,8,13,-5,7,saudiarabia,0.25,0.38,-5,1.0,0.88,4.0,2.63,9
Damak,8,1,3,4,5,12,-7,6,saudiarabia,0.12,0.5,-7,0.62,0.75,8.33,2.0,10
Al Akhdoud,8,1,2,5,4,14,-10,5,saudiarabia,0.12,0.38,-10,0.5,0.62,8.33,2.63,11
Al Raed,8,1,1,6,8,16,-8,4,saudiarabia,0.12,0.25,-8,1.0,0.5,8.33,4.0,12
Al Khaleej,8,0,4,4,6,14,-8,4,saudiarabia,0.0,0.5,-8,0.75,0.5,0.0,2.0,12
Neom SC,8,6,2,0,16,5,11,20,saudiarabia2,0.75,1.0,11,2.0,2.5,1.33,1.0,1
Al Najma,8,5,2,1,15,8,7,17,saudiarabia2,0.62,0.88,7,1.88,2.12,1.61,1.14,2
Al Bukayriyah,8,4,3,1,13,4,9,15,saudiarabia2,0.5,0.88,9,1.62,1.88,2.0,1.14,3
Al Tai,8,4,3,1,11,6,5,15,saudiarabia2,0.5,0.88,5,1.38,1.88,2.0,1.14,3
Al Hazm,8,4,2,2,12,9,3,14,saudiarabia2,0.5,0.75,3,1.5,1.75,2.0,1.33,4
Abha,8,3,4,1,12,8,4,13,saudiarabia2,0.38,0.88,4,1.5,1.62,2.63,1.14,5
Al Adalha,8,3,4,1,14,11,3,13,saudiarabia2,0.38,0.88,3,1.75,1.62,2.63,1.14,5
Jeddah,8,4,1,3,7,6,1,13,saudiarabia2,0.5,0.62,1,0.88,1.62,2.0,1.61,5
Al Jandal,8,3,3,2,10,7,3,12,saudiarabia2,0.38,0.75,3,1.25,1.5,2.63,1.33,6
Al Jabalain,8,3,3,2,10,10,0,12,saudiarabia2,0.38,0.75,0,1.25,1.5,2.63,1.33,6
Al Zulfi,8,2,4,2,8,7,1,10,saudiarabia2,0.25,0.75,1,1.0,1.25,4.0,1.33,7
Al Jubail,8,1,5,2,10,15,-5,8,saudiarabia2,0.12,0.75,-5,1.25,1.0,8.33,1.33,8
Al Ain,8,2,2,4,10,17,-7,8,saudiarabia2,0.25,0.5,-7,1.25,1.0,4.0,2.0,8
Al Faisaly,8,1,4,3,8,13,-5,7,saudiarabia2,0.12,0.62,-5,1.0,0.88,8.33,1.61,9
Al Batin,8,1,3,4,7,11,-4,6,saudiarabia2,0.12,0.5,-4,0.88,0.75,8.33,2.0,10
Al Arabi,8,1,1,6,11,17,-6,4,saudiarabia2,0.12,0.25,-6,1.38,0.5,8.33,4.0,11
Ohod,8,1,1,6,7,13,-6,4,saudiarabia2,0.12,0.25,-6,0.88,0.5,8.33,4.0,11
Al Safa,8,0,1,7,3,19,-16,1,saudiarabia2,0.0,0.12,-16,0.38,0.12,0.0,8.33,12
Celtic,8,6,0,2,28,9,19,18,scotland,0.75,0.75,19,3.5,2.25,1.33,1.33,1
Rangers,8,6,0,2,22,13,9,18,scotland,0.75,0.75,9,2.75,2.25,1.33,1.33,1
Hibernian,8,5,3,0,14,5,9,18,scotland,0.62,1.0,9,1.75,2.25,1.61,1.0,1
Hearts,8,5,0,3,18,12,6,15,scotland,0.62,0.62,6,2.25,1.88,1.61,1.61,2
St. Mirren,8,3,2,3,15,12,3,11,scotland,0.38,0.62,3,1.88,1.38,2.63,1.61,3
St. Johnstone,8,3,2,3,7,10,-3,11,scotland,0.38,0.62,-3,0.88,1.38,2.63,1.61,3
Aberdeen,8,3,2,3,10,14,-4,11,scotland,0.38,0.62,-4,1.25,1.38,2.63,1.61,3
Ross County,8,3,1,4,8,10,-2,10,scotland,0.38,0.5,-2,1.0,1.25,2.63,2.0,4
Kilmarnock,8,2,1,5,10,16,-6,7,scotland,0.25,0.38,-6,1.25,0.88,4.0,2.63,5
Motherwell,8,2,1,5,9,17,-8,7,scotland,0.25,0.38,-8,1.12,0.88,4.0,2.63,5
Dundee Utd,8,2,1,5,8,16,-8,7,scotland,0.25,0.38,-8,1.0,0.88,4.0,2.63,5
Dundee FC,8,1,1,6,11,26,-15,4,scotland,0.12,0.25,-15,1.38,0.5,8.33,4.0,6
Falkirk,8,5,2,1,16,5,11,17,scotland2,0.62,0.88,11,2.0,2.12,1.61,1.14,1
Livingston,8,4,4,0,12,8,4,16,scotland2,0.5,1.0,4,1.5,2.0,2.0,1.0,2
Raith Rovers,8,3,3,2,10,8,2,12,scotland2,0.38,0.75,2,1.25,1.5,2.63,1.33,3
Partick Thistle,8,3,3,2,9,10,-1,12,scotland2,0.38,0.75,-1,1.12,1.5,2.63,1.33,3
Ayr Utd,8,3,2,3,15,12,3,11,scotland2,0.38,0.62,3,1.88,1.38,2.63,1.61,4
Greenock Morton,8,3,1,4,12,13,-1,10,scotland2,0.38,0.5,-1,1.5,1.25,2.63,2.0,5
Airdrieonians,8,2,3,3,10,16,-6,9,scotland2,0.25,0.62,-6,1.25,1.12,4.0,1.61,6
Dunfermline,8,2,2,4,5,9,-4,8,scotland2,0.25,0.5,-4,0.62,1.0,4.0,2.0,7
Hamilton,8,1,2,5,5,14,-9,5,scotland2,0.12,0.38,-9,0.62,0.62,8.33,2.63,8
Queens Park,8,1,1,6,9,15,-6,4,scotland2,0.12,0.25,-6,1.12,0.5,8.33,4.0,9
Arbroath,8,5,2,1,13,8,5,17,scotland3,0.62,0.88,5,1.62,2.12,1.61,1.14,1
Cove Rangers,8,4,2,2,15,8,7,14,scotland3,0.5,0.75,7,1.88,1.75,2.0,1.33,2
Stenhousemuir,8,4,2,2,12,9,3,14,scotland3,0.5,0.75,3,1.5,1.75,2.0,1.33,2
Montrose,8,3,4,1,13,12,1,13,scotland3,0.38,0.88,1,1.62,1.62,2.63,1.14,3
Alloa Athletic,8,3,2,3,17,16,1,11,scotland3,0.38,0.62,1,2.12,1.38,2.63,1.61,4
Inverness,8,3,2,3,9,11,-2,11,scotland3,0.38,0.62,-2,1.12,1.38,2.63,1.61,4
Queen of South,8,3,1,4,12,12,0,10,scotland3,0.38,0.5,0,1.5,1.25,2.63,2.0,5
Annan Athletic,8,3,0,5,10,17,-7,9,scotland3,0.38,0.38,-7,1.25,1.12,2.63,2.63,6
Kelty Hearts,8,1,3,4,4,10,-6,6,scotland3,0.12,0.5,-6,0.5,0.75,8.33,2.0,7
Dumbarton,8,1,2,5,9,14,-5,5,scotland3,0.12,0.38,-5,1.12,0.62,8.33,2.63,8
Peterhead,8,4,4,0,12,6,6,16,scotland4,0.5,1.0,6,1.5,2.0,2.0,1.0,1
Edinburgh City,8,5,0,3,15,8,7,15,scotland4,0.62,0.62,7,1.88,1.88,1.61,1.61,2
Spartans,8,4,2,2,13,8,5,14,scotland4,0.5,0.75,5,1.62,1.75,2.0,1.33,3
Stirling Albion,8,4,2,2,11,9,2,14,scotland4,0.5,0.75,2,1.38,1.75,2.0,1.33,3
Forfar Athletic,8,4,2,2,7,5,2,14,scotland4,0.5,0.75,2,0.88,1.75,2.0,1.33,3
Stranraer,8,4,1,3,10,5,5,13,scotland4,0.5,0.62,5,1.25,1.62,2.0,1.61,4
Clyde,8,4,1,3,11,10,1,13,scotland4,0.5,0.62,1,1.38,1.62,2.0,1.61,4
East Fife,8,3,2,3,10,13,-3,11,scotland4,0.38,0.62,-3,1.25,1.38,2.63,1.61,5
Elgin City,8,3,0,5,6,9,-3,9,scotland4,0.38,0.38,-3,0.75,1.12,2.63,2.63,6
Bonnyrigg Rose,8,0,2,6,7,16,-9,2,scotland4,0.0,0.25,-9,0.88,0.25,0.0,4.0,7
Red Star,8,7,1,0,30,8,22,22,serbia,0.88,1.0,22,3.75,2.75,1.14,1.0,1
Partizan,8,5,3,0,17,7,10,18,serbia,0.62,1.0,10,2.12,2.25,1.61,1.0,2
Novi Pazar,8,4,2,2,11,8,3,14,serbia,0.5,0.75,3,1.38,1.75,2.0,1.33,3
OFK Beograd,8,4,1,3,12,10,2,13,serbia,0.5,0.62,2,1.5,1.62,2.0,1.61,4
S. Subotica,8,3,3,2,8,6,2,12,serbia,0.38,0.75,2,1.0,1.5,2.63,1.33,5
Cukaricki,8,3,2,3,8,8,0,11,serbia,0.38,0.62,0,1.0,1.38,2.63,1.61,6
IMT N. Beograd,8,3,2,3,8,11,-3,11,serbia,0.38,0.62,-3,1.0,1.38,2.63,1.61,6
Radnicki 1923,8,3,2,3,8,13,-5,11,serbia,0.38,0.62,-5,1.0,1.38,2.63,1.61,6
Backa Topola,8,3,1,4,13,16,-3,10,serbia,0.38,0.5,-3,1.62,1.25,2.63,2.0,7
Napredak,8,3,1,4,8,13,-5,10,serbia,0.38,0.5,-5,1.0,1.25,2.63,2.0,7
Z. Pancevo,8,2,3,3,10,11,-1,9,serbia,0.25,0.62,-1,1.25,1.12,4.0,1.61,8
Mladost Lucani,8,2,3,3,7,9,-2,9,serbia,0.25,0.62,-2,0.88,1.12,4.0,1.61,8
Vojvodina,8,2,2,4,11,14,-3,8,serbia,0.25,0.5,-3,1.38,1.0,4.0,2.0,9
Jedinstvo U.,8,2,1,5,10,11,-1,7,serbia,0.25,0.38,-1,1.25,0.88,4.0,2.63,10
Tekstilac Odzac,8,2,1,5,7,14,-7,7,serbia,0.25,0.38,-7,0.88,0.88,4.0,2.63,10
Radnicki Nis,8,1,2,5,8,17,-9,5,serbia,0.12,0.38,-9,1.0,0.62,8.33,2.63,11
R. Surdulica,8,7,0,1,19,3,16,21,serbia2,0.88,0.88,16,2.38,2.62,1.14,1.14,1
Zemun,8,4,3,1,14,6,8,15,serbia2,0.5,0.88,8,1.75,1.88,2.0,1.14,2
Sloven Ruma,8,3,5,0,12,8,4,14,serbia2,0.38,1.0,4,1.5,1.75,2.63,1.0,3
Graficar,8,3,3,2,11,12,-1,12,serbia2,0.38,0.75,-1,1.38,1.5,2.63,1.33,4
Macva Sabac,8,2,5,1,7,5,2,11,serbia2,0.25,0.88,2,0.88,1.38,4.0,1.14,5
Borac Cacak,8,3,2,3,8,10,-2,11,serbia2,0.38,0.62,-2,1.0,1.38,2.63,1.61,5
Trajal Krusevac,8,2,4,2,7,6,1,10,serbia2,0.25,0.75,1,0.88,1.25,4.0,1.33,6
Dubocica,8,3,1,4,14,14,0,10,serbia2,0.38,0.5,0,1.75,1.25,2.63,2.0,6
Javor Ivanjica,8,2,4,2,7,9,-2,10,serbia2,0.25,0.75,-2,0.88,1.25,4.0,1.33,6
Mladost,8,2,4,2,4,8,-4,10,serbia2,0.25,0.75,-4,0.5,1.25,4.0,1.33,6
Vozdovac,8,1,6,1,6,6,0,9,serbia2,0.12,0.88,0,0.75,1.12,8.33,1.14,7
S. Mitrovica,8,2,3,3,6,9,-3,9,serbia2,0.25,0.62,-3,0.75,1.12,4.0,1.61,7
Smederevo,8,1,5,2,7,8,-1,8,serbia2,0.12,0.75,-1,0.88,1.0,8.33,1.33,8
Vrsac,8,1,3,4,3,9,-6,6,serbia2,0.12,0.5,-6,0.38,0.75,8.33,2.0,9
Indija,8,1,2,5,7,13,-6,5,serbia2,0.12,0.38,-6,0.88,0.62,8.33,2.63,10
Sloboda Uzice,8,1,2,5,5,11,-6,5,serbia2,0.12,0.38,-6,0.62,0.62,8.33,2.63,10
Lion City,8,7,1,0,26,7,19,22,singapore,0.88,1.0,19,3.25,2.75,1.14,1.0,1
Tampines Rovers,8,6,0,2,23,7,16,18,singapore,0.75,0.75,16,2.88,2.25,1.33,1.33,2
Geylang,8,4,1,3,19,12,7,13,singapore,0.5,0.62,7,2.38,1.62,2.0,1.61,3
A. Niigata (S),8,4,1,3,12,16,-4,13,singapore,0.5,0.62,-4,1.5,1.62,2.0,1.61,3
Hougang,8,3,2,3,21,14,7,11,singapore,0.38,0.62,7,2.62,1.38,2.63,1.61,4
Young Lions,8,2,3,3,12,17,-5,9,singapore,0.25,0.62,-5,1.5,1.12,4.0,1.61,5
Khalsa,8,3,0,5,17,23,-6,9,singapore,0.38,0.38,-6,2.12,1.12,2.63,2.63,5
DPMM FC,8,2,1,5,10,17,-7,7,singapore,0.25,0.38,-7,1.25,0.88,4.0,2.63,6
Tanjong Pagar,8,1,1,6,6,28,-22,4,singapore,0.12,0.25,-22,0.75,0.5,8.33,4.0,7
S. Bratislava,8,4,3,1,16,9,7,15,slovakia,0.5,0.88,7,2.0,1.88,2.0,1.14,1
Komarno,8,4,2,2,9,5,4,14,slovakia,0.5,0.75,4,1.12,1.75,2.0,1.33,2
DAC Streda,8,3,4,1,15,9,6,13,slovakia,0.38,0.88,6,1.88,1.62,2.63,1.14,3
FC Kosice,8,4,1,3,15,10,5,13,slovakia,0.5,0.62,5,1.88,1.62,2.0,1.61,3
Spartak Trnava,8,3,4,1,12,9,3,13,slovakia,0.38,0.88,3,1.5,1.62,2.63,1.14,3
Z. Michalovce,8,3,3,2,11,10,1,12,slovakia,0.38,0.75,1,1.38,1.5,2.63,1.33,4
Trencin,8,3,3,2,9,8,1,12,slovakia,0.38,0.75,1,1.12,1.5,2.63,1.33,4
Skalica,8,3,3,2,7,6,1,12,slovakia,0.38,0.75,1,0.88,1.5,2.63,1.33,4
Podbrezova,8,2,4,2,10,10,0,10,slovakia,0.25,0.75,0,1.25,1.25,4.0,1.33,5
Zilina,8,2,3,3,8,10,-2,9,slovakia,0.25,0.62,-2,1.0,1.12,4.0,1.61,6
Ruzomberok,8,2,0,6,7,17,-10,6,slovakia,0.25,0.25,-10,0.88,0.75,4.0,4.0,7
Banska Bystrica,8,0,0,8,5,21,-16,0,slovakia,0.0,0.0,-16,0.62,0.0,0.0,0.0,8
Presov,8,6,1,1,12,3,9,19,slovakia2,0.75,0.88,9,1.5,2.38,1.33,1.14,1
Zlate Moravce,8,5,2,1,12,4,8,17,slovakia2,0.62,0.88,8,1.5,2.12,1.61,1.14,2
P. Bystrica,8,5,2,1,15,8,7,17,slovakia2,0.62,0.88,7,1.88,2.12,1.61,1.14,2
Petrzalka,8,4,2,2,11,6,5,14,slovakia2,0.5,0.75,5,1.38,1.75,2.0,1.33,3
L. Mikulas,8,4,2,2,15,11,4,14,slovakia2,0.5,0.75,4,1.88,1.75,2.0,1.33,3
S. Bratislava B,8,4,1,3,11,9,2,13,slovakia2,0.5,0.62,2,1.38,1.62,2.0,1.61,4
Zilina B,8,4,0,4,14,14,0,12,slovakia2,0.5,0.5,0,1.75,1.5,2.0,2.0,5
Pohronie,8,4,0,4,11,14,-3,12,slovakia2,0.5,0.5,-3,1.38,1.5,2.0,2.0,5
Puchov,8,3,1,4,13,14,-1,10,slovakia2,0.38,0.5,-1,1.62,1.25,2.63,2.0,6
S. Lubovna,8,2,2,4,12,10,2,8,slovakia2,0.25,0.5,2,1.5,1.0,4.0,2.0,7
Zvolen,8,2,1,5,5,11,-6,7,slovakia2,0.25,0.38,-6,0.62,0.88,4.0,2.63,8
Humenne,8,2,1,5,6,18,-12,7,slovakia2,0.25,0.38,-12,0.75,0.88,4.0,2.63,8
Malzenice,8,2,0,6,5,12,-7,6,slovakia2,0.25,0.25,-7,0.62,0.75,4.0,4.0,9
Samorin,8,2,0,6,9,18,-9,6,slovakia2,0.25,0.25,-9,1.12,0.75,4.0,4.0,9
NK Olimpija,8,6,0,2,16,6,10,18,slovenia,0.75,0.75,10,2.0,2.25,1.33,1.33,1
Maribor,8,6,0,2,18,9,9,18,slovenia,0.75,0.75,9,2.25,2.25,1.33,1.33,1
Bravo,8,3,3,2,13,14,-1,12,slovenia,0.38,0.75,-1,1.62,1.5,2.63,1.33,2
NK Celje,8,3,2,3,18,12,6,11,slovenia,0.38,0.62,6,2.25,1.38,2.63,1.61,3
Mura,8,3,2,3,8,7,1,11,slovenia,0.38,0.62,1,1.0,1.38,2.63,1.61,3
Koper,8,3,2,3,11,12,-1,11,slovenia,0.38,0.62,-1,1.38,1.38,2.63,1.61,3
Nafta,8,2,4,2,10,12,-2,10,slovenia,0.25,0.75,-2,1.25,1.25,4.0,1.33,4
Domzale,8,2,1,5,11,13,-2,7,slovenia,0.25,0.38,-2,1.38,0.88,4.0,2.63,5
Primorje,8,1,4,3,10,14,-4,7,slovenia,0.12,0.62,-4,1.25,0.88,8.33,1.61,5
Radomlje,8,2,1,5,6,21,-15,7,slovenia,0.25,0.38,-15,0.75,0.88,4.0,2.63,5
Mamelodi S.,8,5,1,2,16,8,8,16,southafrica,0.62,0.75,8,2.0,2.0,1.61,1.33,1
Orlando Pirates,8,5,1,2,9,9,0,16,southafrica,0.62,0.75,0,1.12,2.0,1.61,1.33,1
Stellenbosch,8,4,3,1,10,7,3,15,southafrica,0.5,0.88,3,1.25,1.88,2.0,1.14,2
Magesi,8,5,0,3,6,6,0,15,southafrica,0.62,0.62,0,0.75,1.88,1.61,1.61,2
Richards Bay,8,4,2,2,10,7,3,14,southafrica,0.5,0.75,3,1.25,1.75,2.0,1.33,3
Chippa Utd,8,4,1,3,10,5,5,13,southafrica,0.5,0.62,5,1.25,1.62,2.0,1.61,4
TS Galaxy,8,4,1,3,13,12,1,13,southafrica,0.5,0.62,1,1.62,1.62,2.0,1.61,4
AmaZulu,8,3,1,4,11,10,1,10,southafrica,0.38,0.5,1,1.38,1.25,2.63,2.0,5
Sekhukhune,8,3,1,4,13,14,-1,10,southafrica,0.38,0.5,-1,1.62,1.25,2.63,2.0,5
Marumo G.,8,3,1,4,7,9,-2,10,southafrica,0.38,0.5,-2,0.88,1.25,2.63,2.0,5
Golden Arrows,8,2,3,3,6,11,-5,9,southafrica,0.25,0.62,-5,0.75,1.12,4.0,1.61,6
Kaizer Chiefs,8,2,2,4,6,11,-5,8,southafrica,0.25,0.5,-5,0.75,1.0,4.0,2.0,7
SuperSport Utd,8,1,3,4,7,11,-4,6,southafrica,0.12,0.5,-4,0.88,0.75,8.33,2.0,8
Polokwane,8,1,3,4,4,8,-4,6,southafrica,0.12,0.5,-4,0.5,0.75,8.33,2.0,8
Royal AM,8,1,2,5,9,13,-4,5,southafrica,0.12,0.38,-4,1.12,0.62,8.33,2.63,9
Cape Town City,8,0,3,5,2,10,-8,3,southafrica,0.0,0.38,-8,0.25,0.38,0.0,2.63,10
Casric Stars,8,4,3,1,14,7,7,15,southafrica2,0.5,0.88,7,1.75,1.88,2.0,1.14,1
Kruger United,8,4,2,2,11,8,3,14,southafrica2,0.5,0.75,3,1.38,1.75,2.0,1.33,2
Durban City,8,4,2,2,6,4,2,14,southafrica2,0.5,0.75,2,0.75,1.75,2.0,1.33,2
Highbury,8,3,3,2,11,7,4,12,southafrica2,0.38,0.75,4,1.38,1.5,2.63,1.33,3
Black Leopards,8,3,3,2,12,9,3,12,southafrica2,0.38,0.75,3,1.5,1.5,2.63,1.33,3
Venda FC,8,3,2,3,10,5,5,11,southafrica2,0.38,0.62,5,1.25,1.38,2.63,1.61,4
Pretoria C.,8,3,2,3,7,8,-1,11,southafrica2,0.38,0.62,-1,0.88,1.38,2.63,1.61,4
Cape Town Spurs,8,2,4,2,10,11,-1,10,southafrica2,0.25,0.75,-1,1.25,1.25,4.0,1.33,5
Leruma United,8,2,4,2,6,7,-1,10,southafrica2,0.25,0.75,-1,0.75,1.25,4.0,1.33,5
JDR Stars,8,2,4,2,8,11,-3,10,southafrica2,0.25,0.75,-3,1.0,1.25,4.0,1.33,5
Pretoria U.,8,2,3,3,6,8,-2,9,southafrica2,0.25,0.62,-2,0.75,1.12,4.0,1.61,6
Milford,8,2,3,3,9,14,-5,9,southafrica2,0.25,0.62,-5,1.12,1.12,4.0,1.61,6
Hungry Lions,8,2,2,4,9,9,0,8,southafrica2,0.25,0.5,0,1.12,1.0,4.0,2.0,7
Orbit College,8,1,5,2,6,7,-1,8,southafrica2,0.12,0.75,-1,0.75,1.0,8.33,1.33,7
Upington City,8,2,2,4,6,9,-3,8,southafrica2,0.25,0.5,-3,0.75,1.0,4.0,2.0,7
Baroka,8,1,4,3,7,14,-7,7,southafrica2,0.12,0.62,-7,0.88,0.88,8.33,1.61,8
Daejeon Citizen,6,4,1,1,10,5,5,13,southkorea,0.67,0.83,5,1.67,2.17,1.49,1.2,1
Gimcheon Sangmu,6,3,2,1,8,5,3,11,southkorea,0.5,0.83,3,1.33,1.83,2.0,1.2,2
Seoul,6,3,2,1,6,5,1,11,southkorea,0.5,0.83,1,1.0,1.83,2.0,1.2,2
Ulsan,6,3,1,2,6,3,3,10,southkorea,0.5,0.67,3,1.0,1.67,2.0,1.49,3
Jeonbuk Motors,6,2,2,2,7,7,0,8,southkorea,0.33,0.67,0,1.17,1.33,3.03,1.49,4
Pohang Steelers,6,2,2,2,7,9,-2,8,southkorea,0.33,0.67,-2,1.17,1.33,3.03,1.49,4
Daegu,6,2,1,3,8,8,0,7,southkorea,0.33,0.5,0,1.33,1.17,3.03,2.0,5
Gwangju,6,1,4,1,7,7,0,7,southkorea,0.17,0.83,0,1.17,1.17,5.88,1.2,5
Gangwon,6,2,1,3,4,5,-1,7,southkorea,0.33,0.5,-1,0.67,1.17,3.03,2.0,5
Jeju Utd,6,2,1,3,6,8,-2,7,southkorea,0.33,0.5,-2,1.0,1.17,3.03,2.0,5
Anyang,6,2,0,4,5,8,-3,6,southkorea,0.33,0.33,-3,0.83,1.0,3.03,3.03,6
Suwon City,6,0,3,3,2,6,-4,3,southkorea,0.0,0.5,-4,0.33,0.5,0.0,2.0,7
Incheon Utd,5,3,1,1,7,3,4,10,southkorea2,0.6,0.8,4,1.4,2.0,1.67,1.25,1
Seoul E-Land,5,3,1,1,10,7,3,10,southkorea2,0.6,0.8,3,2.0,2.0,1.67,1.25,1
Seongnam,5,2,3,0,6,3,3,9,southkorea2,0.4,1.0,3,1.2,1.8,2.5,1.0,2
Bucheon FC,5,3,0,2,10,8,2,9,southkorea2,0.6,0.6,2,2.0,1.8,1.67,1.67,2
Gimpo,5,2,2,1,6,3,3,8,southkorea2,0.4,0.8,3,1.2,1.6,2.5,1.25,3
Gyeongnam,5,2,2,1,7,5,2,8,southkorea2,0.4,0.8,2,1.4,1.6,2.5,1.25,3
Jeonnam,5,2,2,1,7,5,2,8,southkorea2,0.4,0.8,2,1.4,1.6,2.5,1.25,3
Busan IPark,5,2,2,1,5,3,2,8,southkorea2,0.4,0.8,2,1.0,1.6,2.5,1.25,3
Suwon Bluewings,5,2,1,2,5,7,-2,7,southkorea2,0.4,0.6,-2,1.0,1.4,2.5,1.67,4
Hwaseong,5,1,3,1,7,8,-1,6,southkorea2,0.2,0.8,-1,1.4,1.2,5.0,1.25,5
Cheongju,5,1,1,3,6,11,-5,4,southkorea2,0.2,0.4,-5,1.2,0.8,5.0,2.5,6
Asan,5,0,3,2,3,5,-2,3,southkorea2,0.0,0.6,-2,0.6,0.6,0.0,1.67,7
Cheonan City,5,1,0,4,3,8,-5,3,southkorea2,0.2,0.2,-5,0.6,0.6,5.0,5.0,7
Ansan Greeners,5,0,1,4,4,10,-6,1,southkorea2,0.0,0.2,-6,0.8,0.2,0.0,5.0,8
FC Barcelona,8,8,0,0,23,4,19,24,spain,1.0,1.0,19,2.88,3.0,1.0,1.0,1
Real Betis,8,6,1,1,17,10,7,19,spain,0.75,0.88,7,2.12,2.38,1.33,1.14,2
Celta Vigo,8,4,3,1,12,9,3,15,spain,0.5,0.88,3,1.5,1.88,2.0,1.14,3
Valencia,8,4,3,1,12,10,2,15,spain,0.5,0.88,2,1.5,1.88,2.0,1.14,3
Villarreal,8,4,2,2,13,8,5,14,spain,0.5,0.75,5,1.62,1.75,2.0,1.33,4
Real Madrid,8,4,2,2,12,9,3,14,spain,0.5,0.75,3,1.5,1.75,2.0,1.33,4
Athletic Bilbao,8,3,4,1,15,6,9,13,spain,0.38,0.88,9,1.88,1.62,2.63,1.14,5
Getafe,8,4,1,3,9,8,1,13,spain,0.5,0.62,1,1.12,1.62,2.0,1.61,5
Atletico Madrid,8,3,3,2,12,9,3,12,spain,0.38,0.75,3,1.5,1.5,2.63,1.33,6
Rayo Vallecano,8,3,2,3,8,7,1,11,spain,0.38,0.62,1,1.0,1.38,2.63,1.61,7
Mallorca,8,2,4,2,9,9,0,10,spain,0.25,0.75,0,1.12,1.25,4.0,1.33,8
Espanyol,8,2,4,2,8,8,0,10,spain,0.25,0.75,0,1.0,1.25,4.0,1.33,8
Real Sociedad,8,3,1,4,10,14,-4,10,spain,0.38,0.5,-4,1.25,1.25,2.63,2.0,8
Sevilla FC,8,2,3,3,9,9,0,9,spain,0.25,0.62,0,1.12,1.12,4.0,1.61,9
Osasuna,8,1,4,3,8,12,-4,7,spain,0.12,0.62,-4,1.0,0.88,8.33,1.61,10
Alaves,8,1,3,4,7,11,-4,6,spain,0.12,0.5,-4,0.88,0.75,8.33,2.0,11
Girona,8,1,3,4,8,16,-8,6,spain,0.12,0.5,-8,1.0,0.75,8.33,2.0,11
Leganes,8,1,1,6,9,17,-8,4,spain,0.12,0.25,-8,1.12,0.5,8.33,4.0,12
Las Palmas,8,0,3,5,7,14,-7,3,spain,0.0,0.38,-7,0.88,0.38,0.0,2.63,13
Valladolid,8,0,1,7,5,23,-18,1,spain,0.0,0.12,-18,0.62,0.12,0.0,8.33,14
Elche,8,5,2,1,13,7,6,17,spain2,0.62,0.88,6,1.62,2.12,1.61,1.14,1
Levante,8,5,2,1,12,6,6,17,spain2,0.62,0.88,6,1.5,2.12,1.61,1.14,1
Burgos,8,5,1,2,9,5,4,16,spain2,0.62,0.75,4,1.12,2.0,1.61,1.33,2
Albacete,8,5,0,3,12,6,6,15,spain2,0.62,0.62,6,1.5,1.88,1.61,1.61,3
Mirandes,8,4,2,2,13,8,5,14,spain2,0.5,0.75,5,1.62,1.75,2.0,1.33,4
Cadiz,8,4,2,2,12,9,3,14,spain2,0.5,0.75,3,1.5,1.75,2.0,1.33,4
Deportivo,8,3,4,1,11,9,2,13,spain2,0.38,0.88,2,1.38,1.62,2.63,1.14,5
Cordoba,8,3,3,2,14,9,5,12,spain2,0.38,0.75,5,1.75,1.5,2.63,1.33,6
Castellon,8,3,3,2,14,12,2,12,spain2,0.38,0.75,2,1.75,1.5,2.63,1.33,6
Eldense,8,3,3,2,10,8,2,12,spain2,0.38,0.75,2,1.25,1.5,2.63,1.33,6
Eibar,8,3,3,2,7,6,1,12,spain2,0.38,0.75,1,0.88,1.5,2.63,1.33,6
Racing,8,3,2,3,13,11,2,11,spain2,0.38,0.62,2,1.62,1.38,2.63,1.61,7
Huesca,8,3,2,3,11,11,0,11,spain2,0.38,0.62,0,1.38,1.38,2.63,1.61,7
Real Oviedo,8,3,2,3,7,7,0,11,spain2,0.38,0.62,0,0.88,1.38,2.63,1.61,7
Malaga,8,3,2,3,8,9,-1,11,spain2,0.38,0.62,-1,1.0,1.38,2.63,1.61,7
Almeria,8,2,3,3,11,12,-1,9,spain2,0.25,0.62,-1,1.38,1.12,4.0,1.61,8
Tenerife,8,3,0,5,9,12,-3,9,spain2,0.38,0.38,-3,1.12,1.12,2.63,2.63,8
Granada,8,2,3,3,8,11,-3,9,spain2,0.25,0.62,-3,1.0,1.12,4.0,1.61,8
Sporting Gijon,8,0,6,2,6,9,-3,6,spain2,0.0,0.75,-3,0.75,0.75,0.0,1.33,9
Real Zaragoza,8,0,3,5,8,17,-9,3,spain2,0.0,0.38,-9,1.0,0.38,0.0,2.63,10
Cartagena,8,0,2,6,7,18,-11,2,spain2,0.0,0.25,-11,0.88,0.25,0.0,4.0,11
Racing Ferrol,8,0,1,7,2,15,-13,1,spain2,0.0,0.12,-13,0.25,0.12,0.0,8.33,12
Ourense CF,8,6,0,2,10,5,5,18,spain3,0.75,0.75,5,1.25,2.25,1.33,1.33,1
FC Andorra,8,4,3,1,12,8,4,15,spain3,0.5,0.88,4,1.5,1.88,2.0,1.14,2
Zamora,8,4,3,1,9,6,3,15,spain3,0.5,0.88,3,1.12,1.88,2.0,1.14,2
Athletic B. B,8,3,4,1,12,9,3,13,spain3,0.38,0.88,3,1.5,1.62,2.63,1.14,3
Lugo,8,4,1,3,12,12,0,13,spain3,0.5,0.62,0,1.5,1.62,2.0,1.61,3
Gimnastic T.,8,3,3,2,12,9,3,12,spain3,0.38,0.75,3,1.5,1.5,2.63,1.33,4
Leonesa,8,2,5,1,10,9,1,11,spain3,0.25,0.88,1,1.25,1.38,4.0,1.14,5
Osasuna B,8,2,5,1,12,12,0,11,spain3,0.25,0.88,0,1.5,1.38,4.0,1.14,5
Celta Vigo B,8,3,2,3,8,10,-2,11,spain3,0.38,0.62,-2,1.0,1.38,2.63,1.61,5
Sestao River,8,2,4,2,11,9,2,10,spain3,0.25,0.75,2,1.38,1.25,4.0,1.33,6
Tarazona,8,2,4,2,8,7,1,10,spain3,0.25,0.75,1,1.0,1.25,4.0,1.33,6
Ponferradina,8,3,1,4,10,11,-1,10,spain3,0.38,0.5,-1,1.25,1.25,2.63,2.0,6
Unionistas,8,3,1,4,10,11,-1,10,spain3,0.38,0.5,-1,1.25,1.25,2.63,2.0,6
Amorebieta,8,2,3,3,8,8,0,9,spain3,0.25,0.62,0,1.0,1.12,4.0,1.61,7
Arenteiro,8,2,3,3,10,11,-1,9,spain3,0.25,0.62,-1,1.25,1.12,4.0,1.61,7
Real Sociedad B,8,2,3,3,7,8,-1,9,spain3,0.25,0.62,-1,0.88,1.12,4.0,1.61,7
Barakaldo,8,2,2,4,12,13,-1,8,spain3,0.25,0.5,-1,1.5,1.0,4.0,2.0,8
Real Union,8,2,2,4,6,8,-2,8,spain3,0.25,0.5,-2,0.75,1.0,4.0,2.0,8
Gimnastica,8,1,4,3,8,15,-7,7,spain3,0.12,0.62,-7,1.0,0.88,8.33,1.61,9
FC Barcelona B,8,1,3,4,11,14,-3,6,spain3,0.12,0.5,-3,1.38,0.75,8.33,2.0,10
Ceuta,8,4,4,0,13,5,8,16,spain4,0.5,1.0,8,1.62,2.0,2.0,1.0,1
UD Ibiza,8,5,1,2,18,12,6,16,spain4,0.62,0.75,6,2.25,2.0,1.61,1.33,1
Sevilla FC B,8,5,1,2,8,3,5,16,spain4,0.62,0.75,5,1.0,2.0,1.61,1.33,1
Real Murcia,8,4,1,3,14,8,6,13,spain4,0.5,0.62,6,1.75,1.62,2.0,1.61,2
Merida,8,4,1,3,12,16,-4,13,spain4,0.5,0.62,-4,1.5,1.62,2.0,1.61,2
Real Madrid B,8,2,6,0,8,5,3,12,spain4,0.25,1.0,3,1.0,1.5,4.0,1.0,3
Atletico M. B,8,3,3,2,7,6,1,12,spain4,0.38,0.75,1,0.88,1.5,2.63,1.33,3
Villarreal B,8,3,2,3,13,8,5,11,spain4,0.38,0.62,5,1.62,1.38,2.63,1.61,4
Alcorcon,8,3,2,3,9,7,2,11,spain4,0.38,0.62,2,1.12,1.38,2.63,1.61,4
Intercity,8,3,2,3,11,11,0,11,spain4,0.38,0.62,0,1.38,1.38,2.63,1.61,4
Hercules,8,3,2,3,9,9,0,11,spain4,0.38,0.62,0,1.12,1.38,2.63,1.61,4
Sanluqueno,8,2,3,3,10,12,-2,9,spain4,0.25,0.62,-2,1.25,1.12,4.0,1.61,5
Real Betis B,8,2,3,3,8,12,-4,9,spain4,0.25,0.62,-4,1.0,1.12,4.0,1.61,5
Algeciras,8,2,3,3,6,10,-4,9,spain4,0.25,0.62,-4,0.75,1.12,4.0,1.61,5
Fuenlabrada,8,2,2,4,8,9,-1,8,spain4,0.25,0.5,-1,1.0,1.0,4.0,2.0,6
Recreativo H.,8,1,5,2,6,10,-4,8,spain4,0.12,0.75,-4,0.75,1.0,8.33,1.33,6
Marbella,8,2,2,4,8,13,-5,8,spain4,0.25,0.5,-5,1.0,1.0,4.0,2.0,6
Yeclano,8,1,4,3,7,8,-1,7,spain4,0.12,0.62,-1,0.88,0.88,8.33,1.61,7
Antequera,8,1,4,3,11,16,-5,7,spain4,0.12,0.62,-5,1.38,0.88,8.33,1.61,7
Alcoyano,8,1,3,4,5,11,-6,6,spain4,0.12,0.5,-6,0.62,0.75,8.33,2.0,8
Bergantinos,8,6,1,1,12,5,7,19,spain5,0.75,0.88,7,1.5,2.38,1.33,1.14,1
Llanera,8,4,4,0,12,6,6,16,spain5,0.5,1.0,6,1.5,2.0,2.0,1.0,2
D. Fabril,8,4,2,2,9,4,5,14,spain5,0.5,0.75,5,1.12,1.75,2.0,1.33,3
Real Aviles,8,3,5,0,10,6,4,14,spain5,0.38,1.0,4,1.25,1.75,2.63,1.0,3
Pontevedra,8,4,2,2,7,4,3,14,spain5,0.5,0.75,3,0.88,1.75,2.0,1.33,3
Rayo Cantabria,8,4,2,2,9,10,-1,14,spain5,0.5,0.75,-1,1.12,1.75,2.0,1.33,3
Langreo,8,4,1,3,8,7,1,13,spain5,0.5,0.62,1,1.0,1.62,2.0,1.61,4
Valladolid B,8,3,2,3,13,10,3,11,spain5,0.38,0.62,3,1.62,1.38,2.63,1.61,5
Real Avila,8,2,4,2,7,4,3,10,spain5,0.25,0.75,3,0.88,1.25,4.0,1.33,6
Numancia,8,2,3,3,9,7,2,9,spain5,0.25,0.62,2,1.12,1.12,4.0,1.61,7
Marino de L.,8,2,3,3,6,8,-2,9,spain5,0.25,0.62,-2,0.75,1.12,4.0,1.61,7
Torrelavega,8,1,5,2,6,8,-2,8,spain5,0.12,0.75,-2,0.75,1.0,8.33,1.33,8
Coruxo,8,2,2,4,6,9,-3,8,spain5,0.25,0.5,-3,0.75,1.0,4.0,2.0,8
Guijuelo,8,2,2,4,5,12,-7,8,spain5,0.25,0.5,-7,0.62,1.0,4.0,2.0,8
Salamanca CF,8,2,1,5,10,12,-2,7,spain5,0.25,0.38,-2,1.25,0.88,4.0,2.63,9
Escobedo,8,1,4,3,2,5,-3,7,spain5,0.12,0.62,-3,0.25,0.88,8.33,1.61,9
Laredo,8,0,4,4,4,12,-8,4,spain5,0.0,0.5,-8,0.5,0.5,0.0,2.0,10
Compostela,8,0,3,5,3,12,-9,3,spain5,0.0,0.38,-9,0.38,0.38,0.0,2.63,11
Teruel,8,7,1,0,15,3,12,22,spain6,0.88,1.0,12,1.88,2.75,1.14,1.0,1
SD Logrones,8,6,2,0,17,6,11,20,spain6,0.75,1.0,11,2.12,2.5,1.33,1.0,2
Utebo,8,4,3,1,10,4,6,15,spain6,0.5,0.88,6,1.25,1.88,2.0,1.14,3
Eibar B,8,4,2,2,13,5,8,14,spain6,0.5,0.75,8,1.62,1.75,2.0,1.33,4
Arenas Club,8,4,2,2,8,5,3,14,spain6,0.5,0.75,3,1.0,1.75,2.0,1.33,4
Alaves B,8,4,2,2,9,7,2,14,spain6,0.5,0.75,2,1.12,1.75,2.0,1.33,4
Ejea,8,3,4,1,11,7,4,13,spain6,0.38,0.88,4,1.38,1.62,2.63,1.14,5
Calahorra,8,3,2,3,5,8,-3,11,spain6,0.38,0.62,-3,0.62,1.38,2.63,1.61,6
Barbastro,8,3,1,4,9,9,0,10,spain6,0.38,0.5,0,1.12,1.25,2.63,2.0,7
Subiza,8,3,1,4,9,10,-1,10,spain6,0.38,0.5,-1,1.12,1.25,2.63,2.0,7
Real Sociedad C,8,3,1,4,9,11,-2,10,spain6,0.38,0.5,-2,1.12,1.25,2.63,2.0,7
Gernika,8,3,1,4,8,13,-5,10,spain6,0.38,0.5,-5,1.0,1.25,2.63,2.0,7
Tudelano,8,2,2,4,8,10,-2,8,spain6,0.25,0.5,-2,1.0,1.0,4.0,2.0,8
Alfaro,8,2,2,4,4,10,-6,8,spain6,0.25,0.5,-6,0.5,1.0,4.0,2.0,8
Real Zaragoza B,8,2,1,5,6,11,-5,7,spain6,0.25,0.38,-5,0.75,0.88,4.0,2.63,9
UD Logrones,8,1,3,4,6,8,-2,6,spain6,0.12,0.5,-2,0.75,0.75,8.33,2.0,10
Anguiano,8,2,0,6,7,17,-10,6,spain6,0.25,0.25,-10,0.88,0.75,4.0,4.0,10
Izarra,8,1,0,7,4,14,-10,3,spain6,0.12,0.12,-10,0.5,0.38,8.33,8.33,11
Andratx,8,7,0,1,12,8,4,21,spain7,0.88,0.88,4,1.5,2.62,1.14,1.14,1
A. Baleares,8,5,3,0,12,4,8,18,spain7,0.62,1.0,8,1.5,2.25,1.61,1.0,2
Sant Andreu,8,5,2,1,18,5,13,17,spain7,0.62,0.88,13,2.25,2.12,1.61,1.14,3
SD Ibiza,8,5,2,1,15,8,7,17,spain7,0.62,0.88,7,1.88,2.12,1.61,1.14,3
Europa,8,4,3,1,9,6,3,15,spain7,0.5,0.88,3,1.12,1.88,2.0,1.14,4
Sabadell,8,4,2,2,15,10,5,14,spain7,0.5,0.75,5,1.88,1.75,2.0,1.33,5
Valencia B,8,4,2,2,8,4,4,14,spain7,0.5,0.75,4,1.0,1.75,2.0,1.33,5
Espanyol B,8,3,3,2,11,9,2,12,spain7,0.38,0.75,2,1.38,1.5,2.63,1.33,6
Olot,8,3,3,2,7,8,-1,12,spain7,0.38,0.75,-1,0.88,1.5,2.63,1.33,6
Elche B,8,3,2,3,13,9,4,11,spain7,0.38,0.62,4,1.62,1.38,2.63,1.61,7
Torrent,8,2,4,2,9,9,0,10,spain7,0.25,0.75,0,1.12,1.25,4.0,1.33,8
Lleida,8,1,5,2,6,7,-1,8,spain7,0.12,0.75,-1,0.75,1.0,8.33,1.33,9
Terrassa,8,2,2,4,6,7,-1,8,spain7,0.25,0.5,-1,0.75,1.0,4.0,2.0,9
Cornella,8,2,2,4,13,17,-4,8,spain7,0.25,0.5,-4,1.62,1.0,4.0,2.0,9
Pena Deportiva,8,1,3,4,9,14,-5,6,spain7,0.12,0.5,-5,1.12,0.75,8.33,2.0,10
Alzira,8,0,2,6,7,20,-13,2,spain7,0.0,0.25,-13,0.88,0.25,0.0,4.0,11
Mallorca B,8,0,1,7,8,19,-11,1,spain7,0.0,0.12,-11,1.0,0.12,0.0,8.33,12
Badalona,8,0,1,7,3,17,-14,1,spain7,0.0,0.12,-14,0.38,0.12,0.0,8.33,12
La Union,8,6,2,0,12,3,9,20,spain8,0.75,1.0,9,1.5,2.5,1.33,1.0,1
Torremolinos,8,6,2,0,12,4,8,20,spain8,0.75,1.0,8,1.5,2.5,1.33,1.0,1
CD Estepona,8,5,3,0,14,5,9,18,spain8,0.62,1.0,9,1.75,2.25,1.61,1.0,2
Aguilas CF,8,5,2,1,10,7,3,17,spain8,0.62,0.88,3,1.25,2.12,1.61,1.14,3
Orihuela,8,4,3,1,8,5,3,15,spain8,0.5,0.88,3,1.0,1.88,2.0,1.14,4
Almeria B,8,4,1,3,10,9,1,13,spain8,0.5,0.62,1,1.25,1.62,2.0,1.61,5
Xerez D. FC,8,4,1,3,8,9,-1,13,spain8,0.5,0.62,-1,1.0,1.62,2.0,1.61,5
Antoniano,8,4,1,3,8,11,-3,13,spain8,0.5,0.62,-3,1.0,1.62,2.0,1.61,5
UCAM Murcia,8,3,2,3,9,6,3,11,spain8,0.38,0.62,3,1.12,1.38,2.63,1.61,6
Xerez CD,8,3,2,3,9,7,2,11,spain8,0.38,0.62,2,1.12,1.38,2.63,1.61,6
Linares,8,2,3,3,13,11,2,9,spain8,0.25,0.62,2,1.62,1.12,4.0,1.61,7
Villanovense,8,2,2,4,5,7,-2,8,spain8,0.25,0.5,-2,0.62,1.0,4.0,2.0,8
San Fernando,8,1,4,3,7,9,-2,7,spain8,0.12,0.62,-2,0.88,0.88,8.33,1.61,9
Cadiz B,8,1,3,4,7,13,-6,6,spain8,0.12,0.5,-6,0.88,0.75,8.33,2.0,10
Granada B,8,1,2,5,7,13,-6,5,spain8,0.12,0.38,-6,0.88,0.62,8.33,2.63,11
Don Benito,8,1,2,5,4,10,-6,5,spain8,0.12,0.38,-6,0.5,0.62,8.33,2.63,11
Linense,8,1,2,5,4,10,-6,5,spain8,0.12,0.38,-6,0.5,0.62,8.33,2.63,11
D. Minera,8,1,1,6,9,15,-6,4,spain8,0.12,0.25,-6,1.12,0.5,8.33,4.0,12
Navalcarnero,8,7,0,1,14,5,9,21,spain9,0.88,0.88,9,1.75,2.62,1.14,1.14,1
CD Coria,8,5,3,0,16,7,9,18,spain9,0.62,1.0,9,2.0,2.25,1.61,1.0,2
Guadalajara,8,5,3,0,9,3,6,18,spain9,0.62,1.0,6,1.12,2.25,1.61,1.0,2
Cacereno,8,5,2,1,14,7,7,17,spain9,0.62,0.88,7,1.75,2.12,1.61,1.14,3
Conquense,8,5,0,3,8,6,2,15,spain9,0.62,0.62,2,1.0,1.88,1.61,1.61,4
Talavera CF,8,4,2,2,15,7,8,14,spain9,0.5,0.75,8,1.88,1.75,2.0,1.33,5
S. Sebastian R.,8,4,1,3,9,10,-1,13,spain9,0.5,0.62,-1,1.12,1.62,2.0,1.61,6
CD Mostoles,8,4,0,4,13,12,1,12,spain9,0.5,0.5,1,1.62,1.5,2.0,2.0,7
R. Majadahonda,8,2,4,2,7,6,1,10,spain9,0.25,0.75,1,0.88,1.25,4.0,1.33,8
Atletico Paso,8,2,4,2,8,8,0,10,spain9,0.25,0.75,0,1.0,1.25,4.0,1.33,8
Real Madrid C,8,2,3,3,7,8,-1,9,spain9,0.25,0.62,-1,0.88,1.12,4.0,1.61,9
Getafe B,8,2,2,4,7,12,-5,8,spain9,0.25,0.5,-5,0.88,1.0,4.0,2.0,10
Colonia M.,8,2,2,4,6,13,-7,8,spain9,0.25,0.5,-7,0.75,1.0,4.0,2.0,10
Melilla,8,1,3,4,5,8,-3,6,spain9,0.12,0.5,-3,0.62,0.75,8.33,2.0,11
Yaiza,8,1,3,4,6,13,-7,6,spain9,0.12,0.5,-7,0.75,0.75,8.33,2.0,11
Union Adarve,8,1,2,5,4,8,-4,5,spain9,0.12,0.38,-4,0.5,0.62,8.33,2.63,12
Tenerife B,8,1,2,5,9,16,-7,5,spain9,0.12,0.38,-7,1.12,0.62,8.33,2.63,12
Illescas,8,1,0,7,7,15,-8,3,spain9,0.12,0.12,-8,0.88,0.38,8.33,8.33,13
Degerfors,1,1,0,0,5,0,5,3,sweden,1.0,1.0,5,5.0,3.0,1.0,1.0,1
Hammarby,1,1,0,0,4,0,4,3,sweden,1.0,1.0,4,4.0,3.0,1.0,1.0,1
Hacken,1,1,0,0,2,0,2,3,sweden,1.0,1.0,2,2.0,3.0,1.0,1.0,1
Norrkoping,1,1,0,0,4,3,1,3,sweden,1.0,1.0,1,4.0,3.0,1.0,1.0,1
Malmo FF,1,1,0,0,1,0,1,3,sweden,1.0,1.0,1,1.0,3.0,1.0,1.0,1
Elfsborg,1,0,1,0,2,2,0,1,sweden,0.0,1.0,0,2.0,1.0,0.0,1.0,2
Mjallby,1,0,1,0,2,2,0,1,sweden,0.0,1.0,0,2.0,1.0,0.0,1.0,2
AIK,0,0,0,0,0,0,0,0,sweden,0.0,0.0,0,0.0,0.0,0.0,0.0,3
GAIS,0,0,0,0,0,0,0,0,sweden,0.0,0.0,0,0.0,0.0,0.0,0.0,3
Sirius,0,0,0,0,0,0,0,0,sweden,0.0,0.0,0,0.0,0.0,0.0,0.0,3
Varnamo,0,0,0,0,0,0,0,0,sweden,0.0,0.0,0,0.0,0.0,0.0,0.0,3
Oster,1,0,0,1,3,4,-1,0,sweden,0.0,0.0,-1,3.0,0.0,0.0,0.0,3
Djurgarden,1,0,0,1,0,1,-1,0,sweden,0.0,0.0,-1,0.0,0.0,0.0,0.0,3
Brommapojkarna,1,0,0,1,0,2,-2,0,sweden,0.0,0.0,-2,0.0,0.0,0.0,0.0,3
IFK Goteborg,1,0,0,1,0,4,-4,0,sweden,0.0,0.0,-4,0.0,0.0,0.0,0.0,3
Halmstad,1,0,0,1,0,5,-5,0,sweden,0.0,0.0,-5,0.0,0.0,0.0,0.0,3
GIF Sundsvall,1,1,0,0,2,0,2,3,sweden2,1.0,1.0,2,2.0,3.0,1.0,1.0,1
Orgryte,1,1,0,0,2,1,1,3,sweden2,1.0,1.0,1,2.0,3.0,1.0,1.0,1
Ostersunds,1,1,0,0,1,0,1,3,sweden2,1.0,1.0,1,1.0,3.0,1.0,1.0,1
Brage,1,0,1,0,2,2,0,1,sweden2,0.0,1.0,0,2.0,1.0,0.0,1.0,2
Falkenberg,1,0,1,0,2,2,0,1,sweden2,0.0,1.0,0,2.0,1.0,0.0,1.0,2
Landskrona,1,0,1,0,2,2,0,1,sweden2,0.0,1.0,0,2.0,1.0,0.0,1.0,2
Varberg BoIS,1,0,1,0,2,2,0,1,sweden2,0.0,1.0,0,2.0,1.0,0.0,1.0,2
Kalmar,1,0,1,0,0,0,0,1,sweden2,0.0,1.0,0,0.0,1.0,0.0,1.0,2
Sandviken,1,0,1,0,0,0,0,1,sweden2,0.0,1.0,0,0.0,1.0,0.0,1.0,2
Oddevold,0,0,0,0,0,0,0,0,sweden2,0.0,0.0,0,0.0,0.0,0.0,0.0,3
Orebro,0,0,0,0,0,0,0,0,sweden2,0.0,0.0,0,0.0,0.0,0.0,0.0,3
Umea,0,0,0,0,0,0,0,0,sweden2,0.0,0.0,0,0.0,0.0,0.0,0.0,3
Vasteras,0,0,0,0,0,0,0,0,sweden2,0.0,0.0,0,0.0,0.0,0.0,0.0,3
Utsikten,1,0,0,1,1,2,-1,0,sweden2,0.0,0.0,-1,1.0,0.0,0.0,0.0,3
Trelleborg,1,0,0,1,0,1,-1,0,sweden2,0.0,0.0,-1,0.0,0.0,0.0,0.0,3
Helsingborg,1,0,0,1,0,2,-2,0,sweden2,0.0,0.0,-2,0.0,0.0,0.0,0.0,3
Servette,8,6,1,1,18,10,8,19,switzerland,0.75,0.88,8,2.25,2.38,1.33,1.14,1
BSC Young Boys,8,6,0,2,18,5,13,18,switzerland,0.75,0.75,13,2.25,2.25,1.33,1.33,2
FC Zurich,8,5,0,3,15,11,4,15,switzerland,0.62,0.62,4,1.88,1.88,1.61,1.61,3
FC Basel,8,3,3,2,12,9,3,12,switzerland,0.38,0.75,3,1.5,1.5,2.63,1.33,4
Luzern,8,3,2,3,15,14,1,11,switzerland,0.38,0.62,1,1.88,1.38,2.63,1.61,5
Yverdon,8,3,2,3,12,18,-6,11,switzerland,0.38,0.62,-6,1.5,1.38,2.63,1.61,5
St. Gallen,8,3,1,4,9,13,-4,10,switzerland,0.38,0.5,-4,1.12,1.25,2.63,2.0,6
Lausanne Sport,8,2,3,3,12,14,-2,9,switzerland,0.25,0.62,-2,1.5,1.12,4.0,1.61,7
Sion,8,2,3,3,11,16,-5,9,switzerland,0.25,0.62,-5,1.38,1.12,4.0,1.61,7
Grasshopper,8,1,4,3,10,13,-3,7,switzerland,0.12,0.62,-3,1.25,0.88,8.33,1.61,8
Lugano,8,2,1,5,7,12,-5,7,switzerland,0.25,0.38,-5,0.88,0.88,4.0,2.63,8
Winterthur,8,2,0,6,10,14,-4,6,switzerland,0.25,0.25,-4,1.25,0.75,4.0,4.0,9
Bangkok Utd,8,6,2,0,17,6,11,20,thailand,0.75,1.0,11,2.12,2.5,1.33,1.0,1
Pathum Utd,8,6,2,0,15,4,11,20,thailand,0.75,1.0,11,1.88,2.5,1.33,1.0,1
Buriram Utd,8,6,1,1,17,6,11,19,thailand,0.75,0.88,11,2.12,2.38,1.33,1.14,2
Ratchaburi,8,4,3,1,18,10,8,15,thailand,0.5,0.88,8,2.25,1.88,2.0,1.14,3
Lamphun Warrior,8,4,2,2,10,8,2,14,thailand,0.5,0.75,2,1.25,1.75,2.0,1.33,4
Prachuap,8,4,0,4,16,10,6,12,thailand,0.5,0.5,6,2.0,1.5,2.0,2.0,5
Chiangrai Utd,8,4,0,4,12,8,4,12,thailand,0.5,0.5,4,1.5,1.5,2.0,2.0,5
Uthai Thani,8,3,3,2,10,6,4,12,thailand,0.38,0.75,4,1.25,1.5,2.63,1.33,5
Muang Thong Utd,8,4,0,4,13,17,-4,12,thailand,0.5,0.5,-4,1.62,1.5,2.0,2.0,5
Port FC,8,3,2,3,14,13,1,11,thailand,0.38,0.62,1,1.75,1.38,2.63,1.61,6
N. Bua Pitchaya,8,1,4,3,5,12,-7,7,thailand,0.12,0.62,-7,0.62,0.88,8.33,1.61,7
Nakhon Pathom,8,2,1,5,7,16,-9,7,thailand,0.25,0.38,-9,0.88,0.88,4.0,2.63,7
Sukhothai,8,1,3,4,8,13,-5,6,thailand,0.12,0.5,-5,1.0,0.75,8.33,2.0,8
N. Ratchasima,8,1,3,4,11,20,-9,6,thailand,0.12,0.5,-9,1.38,0.75,8.33,2.0,8
Rayong,8,1,2,5,11,17,-6,5,thailand,0.12,0.38,-6,1.38,0.62,8.33,2.63,9
Khon Kaen Utd,8,0,2,6,4,19,-15,2,thailand,0.0,0.25,-15,0.5,0.25,0.0,4.0,10
Kanchanaburi,8,6,2,0,18,6,12,20,thailand2,0.75,1.0,12,2.25,2.5,1.33,1.0,1
Chonburi,8,6,1,1,16,6,10,19,thailand2,0.75,0.88,10,2.0,2.38,1.33,1.14,2
Ayutthaya Utd,8,4,2,2,18,10,8,14,thailand2,0.5,0.75,8,2.25,1.75,2.0,1.33,3
Kasetsart,8,4,2,2,9,6,3,14,thailand2,0.5,0.75,3,1.12,1.75,2.0,1.33,3
Police Tero,8,4,1,3,12,11,1,13,thailand2,0.5,0.62,1,1.5,1.62,2.0,1.61,4
Nakhon Si,8,4,1,3,15,15,0,13,thailand2,0.5,0.62,0,1.88,1.62,2.0,1.61,4
Mahasarakham,8,2,5,1,9,7,2,11,thailand2,0.25,0.88,2,1.12,1.38,4.0,1.14,5
Lampang,8,3,2,3,12,11,1,11,thailand2,0.38,0.62,1,1.5,1.38,2.63,1.61,5
Chainat,8,3,1,4,7,8,-1,10,thailand2,0.38,0.5,-1,0.88,1.25,2.63,2.0,6
Suphanburi,8,2,4,2,16,20,-4,10,thailand2,0.25,0.75,-4,2.0,1.25,4.0,1.33,6
Phrae Utd,8,2,3,3,14,13,1,9,thailand2,0.25,0.62,1,1.75,1.12,4.0,1.61,7
Sisaket Utd,8,2,3,3,6,11,-5,9,thailand2,0.25,0.62,-5,0.75,1.12,4.0,1.61,7
Bangkok FC,8,2,2,4,9,12,-3,8,thailand2,0.25,0.5,-3,1.12,1.0,4.0,2.0,8
Chanthaburi,8,2,2,4,9,12,-3,8,thailand2,0.25,0.5,-3,1.12,1.0,4.0,2.0,8
Chiangmai Utd,8,2,2,4,10,16,-6,8,thailand2,0.25,0.5,-6,1.25,1.0,4.0,2.0,8
Pattaya United,8,2,2,4,5,14,-9,8,thailand2,0.25,0.5,-9,0.62,1.0,4.0,2.0,8
Trat FC,8,1,1,6,7,15,-8,4,thailand2,0.12,0.25,-8,0.88,0.5,8.33,4.0,9
Samut Prakan,0,0,0,0,0,0,0,0,thailand2,0.0,0.0,0,0.0,0.0,0.0,0.0,10
Fenerbahce,8,6,2,0,18,7,11,20,turkey,0.75,1.0,11,2.25,2.5,1.33,1.0,1
Galatasaray,8,5,2,1,16,7,9,17,turkey,0.62,0.88,9,2.0,2.12,1.61,1.14,2
Besiktas,8,5,1,2,13,7,6,16,turkey,0.62,0.75,6,1.62,2.0,1.61,1.33,3
Kayserispor,8,4,2,2,13,7,6,14,turkey,0.5,0.75,6,1.62,1.75,2.0,1.33,4
Bodrumspor,8,4,2,2,8,7,1,14,turkey,0.5,0.75,1,1.0,1.75,2.0,1.33,4
Antalyaspor,8,4,2,2,10,13,-3,14,turkey,0.5,0.75,-3,1.25,1.75,2.0,1.33,4
Kasimpasa,8,4,1,3,17,15,2,13,turkey,0.5,0.62,2,2.12,1.62,2.0,1.61,5
Konyaspor,8,4,1,3,10,8,2,13,turkey,0.5,0.62,2,1.25,1.62,2.0,1.61,5
Gaziantep,8,4,0,4,11,10,1,12,turkey,0.5,0.5,1,1.38,1.5,2.0,2.0,6
Trabzonspor,8,3,2,3,10,8,2,11,turkey,0.38,0.62,2,1.25,1.38,2.63,1.61,7
Eyupspor,8,3,2,3,8,10,-2,11,turkey,0.38,0.62,-2,1.0,1.38,2.63,1.61,7
Samsunspor,8,3,2,3,10,13,-3,11,turkey,0.38,0.62,-3,1.25,1.38,2.63,1.61,7
Basaksehir,8,3,1,4,12,12,0,10,turkey,0.38,0.5,0,1.5,1.25,2.63,2.0,8
Rizespor,8,3,0,5,15,17,-2,9,turkey,0.38,0.38,-2,1.88,1.12,2.63,2.63,9
Hatayspor,8,3,0,5,12,19,-7,9,turkey,0.38,0.38,-7,1.5,1.12,2.63,2.63,9
Sivasspor,8,2,1,5,12,12,0,7,turkey,0.25,0.38,0,1.5,0.88,4.0,2.63,10
Alanyaspor,8,2,0,6,8,14,-6,6,turkey,0.25,0.25,-6,1.0,0.75,4.0,4.0,11
Goztepe,8,0,4,4,7,12,-5,4,turkey,0.0,0.5,-5,0.88,0.5,0.0,2.0,12
Adana Demirspor,8,0,2,6,11,23,-12,2,turkey,0.0,0.25,-12,1.38,0.25,0.0,4.0,13
Igdir,8,4,3,1,12,5,7,15,turkey2,0.5,0.88,7,1.5,1.88,2.0,1.14,1
Amed SK,8,4,3,1,12,6,6,15,turkey2,0.5,0.88,6,1.5,1.88,2.0,1.14,1
Kocaelispor,8,3,5,0,9,4,5,14,turkey2,0.38,1.0,5,1.12,1.75,2.63,1.0,2
F. Karagumruk,8,4,2,2,11,8,3,14,turkey2,0.5,0.75,3,1.38,1.75,2.0,1.33,2
Genclerbirligi,8,4,2,2,14,12,2,14,turkey2,0.5,0.75,2,1.75,1.75,2.0,1.33,2
Erzurum BB,8,4,2,2,11,9,2,14,turkey2,0.5,0.75,2,1.38,1.75,2.0,1.33,2
Bandirmaspor,8,4,2,2,9,9,0,14,turkey2,0.5,0.75,0,1.12,1.75,2.0,1.33,2
Istanbulspor,8,4,1,3,14,5,9,13,turkey2,0.5,0.62,9,1.75,1.62,2.0,1.61,3
Umraniyespor,8,3,4,1,10,5,5,13,turkey2,0.38,0.88,5,1.25,1.62,2.63,1.14,3
Boluspor,8,3,3,2,5,2,3,12,turkey2,0.38,0.75,3,0.62,1.5,2.63,1.33,4
Sakaryaspor,8,3,3,2,13,11,2,12,turkey2,0.38,0.75,2,1.62,1.5,2.63,1.33,4
Erokspor,8,2,5,1,13,10,3,11,turkey2,0.25,0.88,3,1.62,1.38,4.0,1.14,5
Corum,8,3,2,3,10,11,-1,11,turkey2,0.38,0.62,-1,1.25,1.38,2.63,1.61,5
Ankaragucu,8,2,2,4,10,11,-1,8,turkey2,0.25,0.5,-1,1.25,1.0,4.0,2.0,6
Keciorengucu,8,2,2,4,14,16,-2,8,turkey2,0.25,0.5,-2,1.75,1.0,4.0,2.0,6
Adanaspor,8,2,2,4,7,11,-4,8,turkey2,0.25,0.5,-4,0.88,1.0,4.0,2.0,6
Pendikspor,8,2,2,4,9,14,-5,8,turkey2,0.25,0.5,-5,1.12,1.0,4.0,2.0,6
Manisa BB,8,2,1,5,9,10,-1,7,turkey2,0.25,0.38,-1,1.12,0.88,4.0,2.63,7
Sanliurfaspor,8,1,3,4,8,10,-2,6,turkey2,0.12,0.5,-2,1.0,0.75,8.33,2.0,8
Y. Malatyaspor,8,0,0,8,1,31,-30,0,turkey2,0.0,0.0,-30,0.12,0.0,0.0,0.0,9
B. Petrolspor,8,7,1,0,15,2,13,22,turkey3,0.88,1.0,13,1.88,2.75,1.14,1.0,1
Altinordu,8,5,2,1,16,9,7,17,turkey3,0.62,0.88,7,2.0,2.12,1.61,1.14,2
Sariyer,8,5,1,2,21,8,13,16,turkey3,0.62,0.75,13,2.62,2.0,1.61,1.33,3
Kastamonuspor,8,4,4,0,12,5,7,16,turkey3,0.5,1.0,7,1.5,2.0,2.0,1.0,3
Trabzon FK,8,4,3,1,9,4,5,15,turkey3,0.5,0.88,5,1.12,1.88,2.0,1.14,4
Ankaraspor,8,4,2,2,16,5,11,14,turkey3,0.5,0.75,11,2.0,1.75,2.0,1.33,5
Adana,8,4,2,2,11,5,6,14,turkey3,0.5,0.75,6,1.38,1.75,2.0,1.33,5
Iskenderun,8,4,2,2,15,12,3,14,turkey3,0.5,0.75,3,1.88,1.75,2.0,1.33,5
B. Anadolu,8,4,2,2,10,12,-2,14,turkey3,0.5,0.75,-2,1.25,1.75,2.0,1.33,5
Kirklarelispor,8,4,1,3,14,11,3,13,turkey3,0.5,0.62,3,1.75,1.62,2.0,1.61,6
Fethiyespor,8,2,3,3,6,7,-1,9,turkey3,0.25,0.62,-1,0.75,1.12,4.0,1.61,7
Inegolspor,8,2,3,3,10,16,-6,9,turkey3,0.25,0.62,-6,1.25,1.12,4.0,1.61,7
Isparta Davrazs,8,2,2,4,8,11,-3,8,turkey3,0.25,0.5,-3,1.0,1.0,4.0,2.0,8
Altay,8,2,1,5,7,15,-8,7,turkey3,0.25,0.38,-8,0.88,0.88,4.0,2.63,9
Kepez Belediyes,8,1,2,5,6,12,-6,5,turkey3,0.12,0.38,-6,0.75,0.62,8.33,2.63,10
Karakopru,8,1,1,6,6,11,-5,4,turkey3,0.12,0.25,-5,0.75,0.5,8.33,4.0,11
24 Erzincanspor,8,0,2,6,9,22,-13,2,turkey3,0.0,0.25,-13,1.12,0.25,0.0,4.0,12
Afyonspor,8,0,0,8,0,24,-24,0,turkey3,0.0,0.0,-24,0.0,0.0,0.0,0.0,13
Serik Belediyes,8,5,2,1,22,6,16,17,turkey4,0.62,0.88,16,2.75,2.12,1.61,1.14,1
Bucaspor,8,5,1,2,12,8,4,16,turkey4,0.62,0.75,4,1.5,2.0,1.61,1.33,2
Elazigspor,8,5,0,3,17,7,10,15,turkey4,0.62,0.62,10,2.12,1.88,1.61,1.61,3
Menemen B.,8,4,3,1,17,11,6,15,turkey4,0.5,0.88,6,2.12,1.88,2.0,1.14,3
Aksaray B.,8,4,3,1,16,11,5,15,turkey4,0.5,0.88,5,2.0,1.88,2.0,1.14,3
Beyoglu Yeni C.,8,4,2,2,9,6,3,14,turkey4,0.5,0.75,3,1.12,1.75,2.0,1.33,4
Karacabey,8,4,2,2,10,8,2,14,turkey4,0.5,0.75,2,1.25,1.75,2.0,1.33,4
A. Demirspor,8,3,4,1,9,6,3,13,turkey4,0.38,0.88,3,1.12,1.62,2.63,1.14,5
Erbaaspor,8,4,1,3,14,12,2,13,turkey4,0.5,0.62,2,1.75,1.62,2.0,1.61,5
Diyarbekirspor,8,4,0,4,8,7,1,12,turkey4,0.5,0.5,1,1.0,1.5,2.0,2.0,6
Van Spor,8,3,3,2,14,14,0,12,turkey4,0.38,0.75,0,1.75,1.5,2.63,1.33,6
Yeni Mersin,8,3,2,3,8,6,2,11,turkey4,0.38,0.62,2,1.0,1.38,2.63,1.61,7
Karaman,8,1,6,1,11,10,1,9,turkey4,0.12,0.88,1,1.38,1.12,8.33,1.14,8
Arnavutkoy B.,8,2,2,4,12,17,-5,8,turkey4,0.25,0.5,-5,1.5,1.0,4.0,2.0,9
Somaspor,8,2,1,5,7,8,-1,7,turkey4,0.25,0.38,-1,0.88,0.88,4.0,2.63,10
Derince,8,2,1,5,7,16,-9,7,turkey4,0.25,0.38,-9,0.88,0.88,4.0,2.63,10
Nazillispor,8,0,1,7,6,22,-16,1,turkey4,0.0,0.12,-16,0.75,0.12,0.0,8.33,11
Giresunspor,8,0,0,8,5,29,-24,0,turkey4,0.0,0.0,-24,0.62,0.0,0.0,0.0,12
Karsiyaka,8,5,2,1,18,8,10,17,turkey5,0.62,0.88,10,2.25,2.12,1.61,1.14,1
Kutahyaspor,8,5,2,1,16,9,7,17,turkey5,0.62,0.88,7,2.0,2.12,1.61,1.14,1
K. Bulvarspor,8,5,1,2,14,13,1,16,turkey5,0.62,0.75,1,1.75,2.0,1.61,1.33,2
Bursaspor,8,4,3,1,18,7,11,15,turkey5,0.5,0.88,11,2.25,1.88,2.0,1.14,3
Musspor,8,4,2,2,12,6,6,14,turkey5,0.5,0.75,6,1.5,1.75,2.0,1.33,4
Duzcespor,8,4,2,2,7,7,0,14,turkey5,0.5,0.75,0,0.88,1.75,2.0,1.33,4
Silifke,8,4,1,3,10,7,3,13,turkey5,0.5,0.62,3,1.25,1.62,2.0,1.61,5
Artvin Hopaspor,8,3,3,2,5,5,0,12,turkey5,0.38,0.75,0,0.62,1.5,2.63,1.33,6
Anadolu U.,8,3,2,3,11,15,-4,11,turkey5,0.38,0.62,-4,1.38,1.38,2.63,1.61,7
Tokat,8,3,1,4,10,7,3,10,turkey5,0.38,0.5,3,1.25,1.25,2.63,2.0,8
Kusadasispor,8,3,1,4,8,11,-3,10,turkey5,0.38,0.5,-3,1.0,1.25,2.63,2.0,8
Kirsehir B.,8,2,2,4,5,13,-8,8,turkey5,0.25,0.5,-8,0.62,1.0,4.0,2.0,9
Kahramanmar.,8,2,1,5,10,12,-2,7,turkey5,0.25,0.38,-2,1.25,0.88,4.0,2.63,10
Elaziz K.,8,1,2,5,5,9,-4,5,turkey5,0.12,0.38,-4,0.62,0.62,8.33,2.63,11
Ergene Velimese,8,1,2,5,4,13,-9,5,turkey5,0.12,0.38,-9,0.5,0.62,8.33,2.63,11
Viven Bornova,8,0,3,5,5,16,-11,3,turkey5,0.0,0.38,-11,0.62,0.38,0.0,2.63,12
Muglaspor,8,8,0,0,15,0,15,24,turkey6,1.0,1.0,15,1.88,3.0,1.0,1.0,1
Usakspor,8,4,4,0,17,7,10,16,turkey6,0.5,1.0,10,2.12,2.0,2.0,1.0,2
Tire 2021 FK,8,4,2,2,13,6,7,14,turkey6,0.5,0.75,7,1.62,1.75,2.0,1.33,3
Amasyaspor,8,4,1,3,16,11,5,13,turkey6,0.5,0.62,5,2.0,1.62,2.0,1.61,4
Balikesirspor,8,4,1,3,12,8,4,13,turkey6,0.5,0.62,4,1.5,1.62,2.0,1.61,4
Mazidagi,8,3,4,1,10,6,4,13,turkey6,0.38,0.88,4,1.25,1.62,2.63,1.14,4
Inegol Kafkas,8,3,2,3,8,8,0,11,turkey6,0.38,0.62,0,1.0,1.38,2.63,1.61,5
Fatsa B.,8,3,2,3,5,6,-1,11,turkey6,0.38,0.62,-1,0.62,1.38,2.63,1.61,5
Turk Metal 1963,8,3,2,3,11,14,-3,11,turkey6,0.38,0.62,-3,1.38,1.38,2.63,1.61,5
Cayelispor,8,2,4,2,7,5,2,10,turkey6,0.25,0.75,2,0.88,1.25,4.0,1.33,6
Beykoz Ishaklis,8,2,3,3,10,12,-2,9,turkey6,0.25,0.62,-2,1.25,1.12,4.0,1.61,7
Silivrispor,8,2,3,3,8,11,-3,9,turkey6,0.25,0.62,-3,1.0,1.12,4.0,1.61,7
Etimesgut,8,2,3,3,6,10,-4,9,turkey6,0.25,0.62,-4,0.75,1.12,4.0,1.61,7
Kelkit,8,1,4,3,8,11,-3,7,turkey6,0.12,0.62,-3,1.0,0.88,8.33,1.61,8
Nevsehirspor,8,0,3,5,6,13,-7,3,turkey6,0.0,0.38,-7,0.75,0.38,0.0,2.63,9
Adiyaman,8,0,0,8,2,26,-24,0,turkey6,0.0,0.0,-24,0.25,0.0,0.0,0.0,10
Aliaga FAS,8,6,2,0,16,5,11,20,turkey7,0.75,1.0,11,2.0,2.5,1.33,1.0,1
Ayvalikgucu,8,6,2,0,13,5,8,20,turkey7,0.75,1.0,8,1.62,2.5,1.33,1.0,1
Orduspor,8,5,1,2,16,7,9,16,turkey7,0.62,0.75,9,2.0,2.0,1.61,1.33,2
Kucukcekmece,8,5,1,2,14,9,5,16,turkey7,0.62,0.75,5,1.75,2.0,1.61,1.33,2
Corluspor,8,5,0,3,17,9,8,15,turkey7,0.62,0.62,8,2.12,1.88,1.61,1.61,3
Osmaniyespor,8,4,3,1,14,12,2,15,turkey7,0.5,0.88,2,1.75,1.88,2.0,1.14,3
Yozgat Bld Bozo,8,3,1,4,13,14,-1,10,turkey7,0.38,0.5,-1,1.62,1.25,2.63,2.0,4
Viransehir,8,3,0,5,5,10,-5,9,turkey7,0.38,0.38,-5,0.62,1.12,2.63,2.63,5
Efeler 09,8,2,3,3,5,11,-6,9,turkey7,0.25,0.62,-6,0.62,1.12,4.0,1.61,5
Pazarspor,8,2,2,4,11,12,-1,8,turkey7,0.25,0.5,-1,1.38,1.0,4.0,2.0,6
Alanya 1221,8,2,2,4,6,8,-2,8,turkey7,0.25,0.5,-2,0.75,1.0,4.0,2.0,6
Bayburt,8,2,2,4,5,9,-4,8,turkey7,0.25,0.5,-4,0.62,1.0,4.0,2.0,6
K. Idmanyurdu,8,2,1,5,6,10,-4,7,turkey7,0.25,0.38,-4,0.75,0.88,4.0,2.63,7
1923 M.,8,1,3,4,10,15,-5,6,turkey7,0.12,0.5,-5,1.25,0.75,8.33,2.0,8
Cankaya FK,8,1,3,4,10,19,-9,6,turkey7,0.12,0.5,-9,1.25,0.75,8.33,2.0,8
1922 Konyaspor,8,0,4,4,7,13,-6,4,turkey7,0.0,0.5,-6,0.88,0.5,0.0,2.0,9
Mardin BB,8,6,1,1,15,5,10,19,turkey8,0.75,0.88,10,1.88,2.38,1.33,1.14,1
Sebat G.,8,6,0,2,21,7,14,18,turkey8,0.75,0.75,14,2.62,2.25,1.33,1.33,2
Agri 1970,8,5,2,1,10,7,3,17,turkey8,0.62,0.88,3,1.25,2.12,1.61,1.14,3
K. Istiklalspor,8,4,2,2,17,12,5,14,turkey8,0.5,0.75,5,2.12,1.75,2.0,1.33,4
Polatli B.,8,4,2,2,10,8,2,14,turkey8,0.5,0.75,2,1.25,1.75,2.0,1.33,4
Kirikkale B.,8,4,2,2,12,11,1,14,turkey8,0.5,0.75,1,1.5,1.75,2.0,1.33,4
Tepecik,8,3,3,2,11,9,2,12,turkey8,0.38,0.75,2,1.38,1.5,2.63,1.33,5
Nilufer B.,8,3,2,3,9,7,2,11,turkey8,0.38,0.62,2,1.12,1.38,2.63,1.61,6
Denizlispor,8,2,4,2,13,12,1,10,turkey8,0.25,0.75,1,1.62,1.25,4.0,1.33,7
Edirnespor,8,2,3,3,10,15,-5,9,turkey8,0.25,0.62,-5,1.25,1.12,4.0,1.61,8
Orduspor 1967,8,2,2,4,8,11,-3,8,turkey8,0.25,0.5,-3,1.0,1.0,4.0,2.0,9
Erciyes,8,2,2,4,10,14,-4,8,turkey8,0.25,0.5,-4,1.25,1.0,4.0,2.0,9
Z. Komurspor,8,2,2,4,10,18,-8,8,turkey8,0.25,0.5,-8,1.25,1.0,4.0,2.0,9
Nigde Belediyes,8,1,3,4,8,11,-3,6,turkey8,0.12,0.5,-3,1.0,0.75,8.33,2.0,10
Coruhlu,8,0,4,4,12,20,-8,4,turkey8,0.0,0.5,-8,1.5,0.5,0.0,2.0,11
Turgutluspor,8,0,2,6,8,17,-9,2,turkey8,0.0,0.25,-9,1.0,0.25,0.0,4.0,12
Shabab Al Ahli,8,7,1,0,16,3,13,22,uae,0.88,1.0,13,2.0,2.75,1.14,1.0,1
Al Wahda,8,5,1,2,16,9,7,16,uae,0.62,0.75,7,2.0,2.0,1.61,1.33,2
Ajman,8,5,0,3,16,14,2,15,uae,0.62,0.62,2,2.0,1.88,1.61,1.61,3
Al Wasl,8,4,2,2,9,6,3,14,uae,0.5,0.75,3,1.12,1.75,2.0,1.33,4
Al Bataeh,8,4,2,2,9,7,2,14,uae,0.5,0.75,2,1.12,1.75,2.0,1.33,4
Al Sharjah,8,4,2,2,5,3,2,14,uae,0.5,0.75,2,0.62,1.75,2.0,1.33,4
Bani Yas,8,4,2,2,7,8,-1,14,uae,0.5,0.75,-1,0.88,1.75,2.0,1.33,4
Al Jazira,8,4,1,3,13,10,3,13,uae,0.5,0.62,3,1.62,1.62,2.0,1.61,5
Khorfakkan,8,4,1,3,10,9,1,13,uae,0.5,0.62,1,1.25,1.62,2.0,1.61,5
Al Ain,8,3,1,4,16,15,1,10,uae,0.38,0.5,1,2.0,1.25,2.63,2.0,6
Al Nasr,8,2,1,5,9,14,-5,7,uae,0.25,0.38,-5,1.12,0.88,4.0,2.63,7
Dibba Al Hisn,8,2,1,5,9,14,-5,7,uae,0.25,0.38,-5,1.12,0.88,4.0,2.63,7
Ittihad Kalba,8,1,2,5,6,11,-5,5,uae,0.12,0.38,-5,0.75,0.62,8.33,2.63,8
Al Urooba,8,0,0,8,7,18,-11,0,uae,0.0,0.0,-11,0.88,0.0,0.0,0.0,9
Dynamo Kyiv,8,5,3,0,13,4,9,18,ukraine,0.62,1.0,9,1.62,2.25,1.61,1.0,1
Kryvbas KR,8,5,1,2,11,8,3,16,ukraine,0.62,0.75,3,1.38,2.0,1.61,1.33,2
Shakhtar,8,4,3,1,11,4,7,15,ukraine,0.5,0.88,7,1.38,1.88,2.0,1.14,3
Zorya Luhansk,8,4,2,2,12,11,1,14,ukraine,0.5,0.75,1,1.5,1.75,2.0,1.33,4
Oleksandria,8,4,2,2,9,8,1,14,ukraine,0.5,0.75,1,1.12,1.75,2.0,1.33,4
Polessya,8,4,2,2,8,8,0,14,ukraine,0.5,0.75,0,1.0,1.75,2.0,1.33,4
Livyi Bereh,8,4,1,3,8,5,3,13,ukraine,0.5,0.62,3,1.0,1.62,2.0,1.61,5
Veres,8,4,1,3,12,11,1,13,ukraine,0.5,0.62,1,1.5,1.62,2.0,1.61,5
Karpaty Lviv,8,3,2,3,11,6,5,11,ukraine,0.38,0.62,5,1.38,1.38,2.63,1.61,6
Inhulets,8,3,1,4,6,10,-4,10,ukraine,0.38,0.5,-4,0.75,1.25,2.63,2.0,7
Obolon,8,2,3,3,6,10,-4,9,ukraine,0.25,0.62,-4,0.75,1.12,4.0,1.61,8
Kolos Kovalivka,8,2,2,4,8,8,0,8,ukraine,0.25,0.5,0,1.0,1.0,4.0,2.0,9
LNZ Cherkasy,8,2,1,5,7,10,-3,7,ukraine,0.25,0.38,-3,0.88,0.88,4.0,2.63,10
Rukh Lviv,8,2,1,5,4,10,-6,7,ukraine,0.25,0.38,-6,0.5,0.88,4.0,2.63,10
Vorskla Poltava,8,1,2,5,3,10,-7,5,ukraine,0.12,0.38,-7,0.38,0.62,8.33,2.63,11
Chornomorets,8,1,0,7,5,18,-13,3,ukraine,0.12,0.12,-13,0.62,0.38,8.33,8.33,12
Dnipro-1,0,0,0,0,0,0,0,0,ukraine,0.0,0.0,0,0.0,0.0,0.0,0.0,13
Liverpool M.,8,6,2,0,16,6,10,20,uruguay,0.75,1.0,10,2.0,2.5,1.33,1.0,1
Juventud,8,5,1,2,14,11,3,16,uruguay,0.62,0.75,3,1.75,2.0,1.61,1.33,2
Racing CM,8,5,0,3,10,6,4,15,uruguay,0.62,0.62,4,1.25,1.88,1.61,1.61,3
Defensor S.,8,4,2,2,9,5,4,14,uruguay,0.5,0.75,4,1.12,1.75,2.0,1.33,4
Plaza Colonia,8,4,2,2,9,6,3,14,uruguay,0.5,0.75,3,1.12,1.75,2.0,1.33,4
Nacional,8,3,4,1,17,12,5,13,uruguay,0.38,0.88,5,2.12,1.62,2.63,1.14,5
Cerro Largo,8,3,4,1,10,7,3,13,uruguay,0.38,0.88,3,1.25,1.62,2.63,1.14,5
Cerro,8,2,4,2,7,7,0,10,uruguay,0.25,0.75,0,0.88,1.25,4.0,1.33,6
Boston River,8,2,3,3,9,10,-1,9,uruguay,0.25,0.62,-1,1.12,1.12,4.0,1.61,7
Miramar Misione,8,2,2,4,9,11,-2,8,uruguay,0.25,0.5,-2,1.12,1.0,4.0,2.0,8
Danubio,8,0,7,1,8,9,-1,7,uruguay,0.0,0.88,-1,1.0,0.88,0.0,1.14,9
Wanderers,8,1,4,3,8,9,-1,7,uruguay,0.12,0.62,-1,1.0,0.88,8.33,1.61,9
Montevideo City,8,1,4,3,9,15,-6,7,uruguay,0.12,0.62,-6,1.12,0.88,8.33,1.61,9
Progreso,8,1,4,3,9,16,-7,7,uruguay,0.12,0.62,-7,1.12,0.88,8.33,1.61,9
Penarol,8,1,3,4,5,11,-6,6,uruguay,0.12,0.5,-6,0.62,0.75,8.33,2.0,10
River Plate,8,0,2,6,7,14,-7,2,uruguay,0.0,0.25,-7,0.88,0.25,0.0,4.0,11
Nacional,7,5,1,1,18,5,13,16,uruguay2,0.71,0.86,13,2.57,2.29,1.41,1.16,1
Penarol,7,4,2,1,10,5,5,14,uruguay2,0.57,0.86,5,1.43,2.0,1.75,1.16,2
Danubio,7,4,2,1,11,11,0,14,uruguay2,0.57,0.86,0,1.57,2.0,1.75,1.16,2
Wanderers,7,4,1,2,11,9,2,13,uruguay2,0.57,0.71,2,1.57,1.86,1.75,1.41,3
Defensor S.,7,3,2,2,7,5,2,11,uruguay2,0.43,0.71,2,1.0,1.57,2.33,1.41,4
Cerro Largo,7,3,2,2,6,7,-1,11,uruguay2,0.43,0.71,-1,0.86,1.57,2.33,1.41,4
Cerro,7,3,1,3,8,5,3,10,uruguay2,0.43,0.57,3,1.14,1.43,2.33,1.75,5
Fenix,7,3,1,3,10,9,1,10,uruguay2,0.43,0.57,1,1.43,1.43,2.33,1.75,5
Miramar Misione,7,3,1,3,7,10,-3,10,uruguay2,0.43,0.57,-3,1.0,1.43,2.33,1.75,5
River Plate,7,2,2,3,8,9,-1,8,uruguay2,0.29,0.57,-1,1.14,1.14,3.45,1.75,6
Progreso,7,2,2,3,8,11,-3,8,uruguay2,0.29,0.57,-3,1.14,1.14,3.45,1.75,6
Rampla Juniors,7,2,2,3,8,12,-4,8,uruguay2,0.29,0.57,-4,1.14,1.14,3.45,1.75,6
Boston River,7,2,1,4,6,8,-2,7,uruguay2,0.29,0.43,-2,0.86,1.0,3.45,2.33,7
Racing CM,7,1,3,3,8,10,-2,6,uruguay2,0.14,0.57,-2,1.14,0.86,7.14,1.75,8
D. Maldonado,7,1,3,3,5,9,-4,6,uruguay2,0.14,0.57,-4,0.71,0.86,7.14,1.75,8
Liverpool M.,7,1,0,6,4,10,-6,3,uruguay2,0.14,0.14,-6,0.57,0.43,7.14,7.14,9
Inter Miami,5,4,1,0,11,5,6,13,usa,0.8,1.0,6,2.2,2.6,1.25,1.0,1
Vancouver,6,4,1,1,10,5,5,13,usa,0.67,0.83,5,1.67,2.17,1.49,1.2,1
Philadelphia,6,4,0,2,13,8,5,12,usa,0.67,0.67,5,2.17,2.0,1.49,1.49,2
Columbus Crew,6,3,3,0,8,4,4,12,usa,0.5,1.0,4,1.33,2.0,2.0,1.0,2
Austin,6,4,0,2,5,3,2,12,usa,0.67,0.67,2,0.83,2.0,1.49,1.49,2
San Diego,6,3,2,1,10,6,4,11,usa,0.5,0.83,4,1.67,1.83,2.0,1.2,3
Chicago Fire,6,3,2,1,13,10,3,11,usa,0.5,0.83,3,2.17,1.83,2.0,1.2,3
Minnesota Utd,6,3,2,1,9,6,3,11,usa,0.5,0.83,3,1.5,1.83,2.0,1.2,3
Colorado Rapids,6,3,2,1,8,7,1,11,usa,0.5,0.83,1,1.33,1.83,2.0,1.2,3
Charlotte,6,3,1,2,10,6,4,10,usa,0.5,0.67,4,1.67,1.67,2.0,1.49,4
Nashville SC,6,3,1,2,9,5,4,10,usa,0.5,0.67,4,1.5,1.67,2.0,1.49,4
Orlando City,6,3,1,2,15,12,3,10,usa,0.5,0.67,3,2.5,1.67,2.0,1.49,4
Portland,6,3,1,2,9,8,1,10,usa,0.5,0.67,1,1.5,1.67,2.0,1.49,4
Dallas,6,3,1,2,9,9,0,10,usa,0.5,0.67,0,1.5,1.67,2.0,1.49,4
Cincinnati,6,3,1,2,8,9,-1,10,usa,0.5,0.67,-1,1.33,1.67,2.0,1.49,4
Los Angeles FC,6,3,0,3,8,9,-1,9,usa,0.5,0.5,-1,1.33,1.5,2.0,2.0,5
St. Louis City,6,2,2,2,4,2,2,8,usa,0.33,0.67,2,0.67,1.33,3.03,1.49,6
New York RB,6,2,2,2,7,6,1,8,usa,0.33,0.67,1,1.17,1.33,3.03,1.49,6
New York City,6,2,2,2,9,9,0,8,usa,0.33,0.67,0,1.5,1.33,3.03,1.49,6
Atlanta Utd,6,2,2,2,10,11,-1,8,usa,0.33,0.67,-1,1.67,1.33,3.03,1.49,6
SJ Earthquakes,6,2,1,3,9,9,0,7,usa,0.33,0.5,0,1.5,1.17,3.03,2.0,7
Seattle,6,1,3,2,8,8,0,6,usa,0.17,0.67,0,1.33,1.0,5.88,1.49,8
DC United,6,1,3,2,8,11,-3,6,usa,0.17,0.67,-3,1.33,1.0,5.88,1.49,8
Real Salt Lake,6,2,0,4,5,11,-6,6,usa,0.33,0.33,-6,0.83,1.0,3.03,3.03,8
New England,5,1,1,3,3,6,-3,4,usa,0.2,0.4,-3,0.6,0.8,5.0,2.5,9
Toronto,6,0,2,4,6,12,-6,2,usa,0.0,0.33,-6,1.0,0.33,0.0,3.03,10
LA Galaxy,6,0,2,4,5,12,-7,2,usa,0.0,0.33,-7,0.83,0.33,0.0,3.03,10
Houston Dynamo,6,0,2,4,4,11,-7,2,usa,0.0,0.33,-7,0.67,0.33,0.0,3.03,10
CF Montreal,6,0,2,4,3,10,-7,2,usa,0.0,0.33,-7,0.5,0.33,0.0,3.03,10
San Antonio,4,4,0,0,8,3,5,12,usa2,1.0,1.0,5,2.0,3.0,1.0,1.0,1
Louisville City,4,3,1,0,7,2,5,10,usa2,0.75,1.0,5,1.75,2.5,1.33,1.0,2
Monterey Bay,4,3,0,1,9,4,5,9,usa2,0.75,0.75,5,2.25,2.25,1.33,1.33,3
Loudoun Utd,4,3,0,1,7,4,3,9,usa2,0.75,0.75,3,1.75,2.25,1.33,1.33,3
New Mexico,4,3,0,1,6,4,2,9,usa2,0.75,0.75,2,1.5,2.25,1.33,1.33,3
FC Tulsa,4,3,0,1,3,1,2,9,usa2,0.75,0.75,2,0.75,2.25,1.33,1.33,3
Detroit City,4,2,1,1,6,5,1,7,usa2,0.5,0.75,1,1.5,1.75,2.0,1.33,4
North Carolina,4,2,1,1,5,4,1,7,usa2,0.5,0.75,1,1.25,1.75,2.0,1.33,4
Pittsburgh,4,2,1,1,4,3,1,7,usa2,0.5,0.75,1,1.0,1.75,2.0,1.33,4
Lexington,4,1,2,1,7,6,1,5,usa2,0.25,0.75,1,1.75,1.25,4.0,1.33,5
Colorado S.,4,1,2,1,8,8,0,5,usa2,0.25,0.75,0,2.0,1.25,4.0,1.33,5
El Paso,4,1,2,1,8,8,0,5,usa2,0.25,0.75,0,2.0,1.25,4.0,1.33,5
Indy Eleven,3,1,1,1,6,5,1,4,usa2,0.33,0.67,1,2.0,1.33,3.03,1.49,6
Sacramento R.,3,1,1,1,4,4,0,4,usa2,0.33,0.67,0,1.33,1.33,3.03,1.49,6
Las Vegas L.,3,1,1,1,3,3,0,4,usa2,0.33,0.67,0,1.0,1.33,3.03,1.49,6
Orange County,3,1,1,1,6,7,-1,4,usa2,0.33,0.67,-1,2.0,1.33,3.03,1.49,6
Charleston,3,1,0,2,4,4,0,3,usa2,0.33,0.33,0,1.33,1.0,3.03,3.03,7
Tampa Bay,3,1,0,2,2,3,-1,3,usa2,0.33,0.33,-1,0.67,1.0,3.03,3.03,7
Phoenix Rising,4,0,2,2,7,10,-3,2,usa2,0.0,0.5,-3,1.75,0.5,0.0,2.0,8
Birmingham L.,4,0,2,2,4,8,-4,2,usa2,0.0,0.5,-4,1.0,0.5,0.0,2.0,8
Oakland Roots,4,0,1,3,5,9,-4,1,usa2,0.0,0.25,-4,1.25,0.25,0.0,4.0,9
Rhode Island,3,0,1,2,2,6,-4,1,usa2,0.0,0.33,-4,0.67,0.33,0.0,3.03,9
Hartford A.,3,0,0,3,1,5,-4,0,usa2,0.0,0.0,-4,0.33,0.0,0.0,0.0,10
Miami FC,4,0,0,4,2,8,-6,0,usa2,0.0,0.0,-6,0.5,0.0,0.0,0.0,10
Naples,4,2,2,0,4,1,3,8,usa3,0.5,1.0,3,1.0,2.0,2.0,1.0,1
Richmond K.,4,2,0,2,8,6,2,6,usa3,0.5,0.5,2,2.0,1.5,2.0,2.0,2
Spokane V.,3,1,1,1,6,3,3,4,usa3,0.33,0.67,3,2.0,1.33,3.03,1.49,3
One Knoxville,2,1,1,0,4,2,2,4,usa3,0.5,1.0,2,2.0,2.0,2.0,1.0,3
Westchester SC,2,1,1,0,4,2,2,4,usa3,0.5,1.0,2,2.0,2.0,2.0,1.0,3
Charlotte I.,2,1,1,0,1,0,1,4,usa3,0.5,1.0,1,0.5,2.0,2.0,1.0,3
Greenville,3,1,1,1,4,5,-1,4,usa3,0.33,0.67,-1,1.33,1.33,3.03,1.49,3
Union Omaha,2,1,0,1,3,4,-1,3,usa3,0.5,0.5,-1,1.5,1.5,2.0,2.0,4
Forward Madison,2,1,0,1,2,3,-1,3,usa3,0.5,0.5,-1,1.0,1.5,2.0,2.0,4
Tormenta,3,1,0,2,5,7,-2,3,usa3,0.33,0.33,-2,1.67,1.0,3.03,3.03,4
Chattanooga RW,2,0,2,0,1,1,0,2,usa3,0.0,1.0,0,0.5,1.0,0.0,1.0,5
Portland Hearts,1,0,1,0,0,0,0,1,usa3,0.0,1.0,0,0.0,1.0,0.0,1.0,6
Alta,2,0,0,2,1,5,-4,0,usa3,0.0,0.0,-4,0.5,0.0,0.0,0.0,7
Texoma,2,0,0,2,1,5,-4,0,usa3,0.0,0.0,-4,0.5,0.0,0.0,0.0,7
D. La Guaira,8,5,2,1,15,8,7,17,venezuela,0.62,0.88,7,1.88,2.12,1.61,1.14,1
D. Tachira,8,5,2,1,12,6,6,17,venezuela,0.62,0.88,6,1.5,2.12,1.61,1.14,1
UCV,8,5,2,1,10,5,5,17,venezuela,0.62,0.88,5,1.25,2.12,1.61,1.14,1
Carabobo,8,4,3,1,9,7,2,15,venezuela,0.5,0.88,2,1.12,1.88,2.0,1.14,2
Puerto Cabello,8,4,2,2,8,4,4,14,venezuela,0.5,0.75,4,1.0,1.75,2.0,1.33,3
A. Anzoategui,8,3,3,2,10,7,3,12,venezuela,0.38,0.75,3,1.25,1.5,2.63,1.33,4
Caracas,8,3,3,2,7,5,2,12,venezuela,0.38,0.75,2,0.88,1.5,2.63,1.33,4
Rayo Zuliano,8,3,1,4,6,7,-1,10,venezuela,0.38,0.5,-1,0.75,1.25,2.63,2.0,5
Portuguesa,8,2,2,4,5,8,-3,8,venezuela,0.25,0.5,-3,0.62,1.0,4.0,2.0,6
E. Merida,8,2,1,5,11,13,-2,7,venezuela,0.25,0.38,-2,1.38,0.88,4.0,2.63,7
Metropolitanos,8,1,4,3,8,11,-3,7,venezuela,0.12,0.62,-3,1.0,0.88,8.33,1.61,7
Monagas,8,2,1,5,7,14,-7,7,venezuela,0.25,0.38,-7,0.88,0.88,4.0,2.63,7
Zamora,8,1,2,5,6,11,-5,5,venezuela,0.12,0.38,-5,0.75,0.62,8.33,2.63,8
Yaracuyanos,8,0,4,4,8,16,-8,4,venezuela,0.0,0.5,-8,1.0,0.5,0.0,2.0,9
AGMK,3,3,0,0,7,2,5,9,uzbekistan,1.0,1.0,5,2.33,3.0,1.0,1.0,1
Bunyodkor,3,2,1,0,7,3,4,7,uzbekistan,0.67,1.0,4,2.33,2.33,1.49,1.0,2
D. Samarqand,3,2,1,0,2,0,2,7,uzbekistan,0.67,1.0,2,0.67,2.33,1.49,1.0,2
Buxoro,3,2,0,1,7,3,4,6,uzbekistan,0.67,0.67,4,2.33,2.0,1.49,1.49,3
Xorazm,3,2,0,1,5,4,1,6,uzbekistan,0.67,0.67,1,1.67,2.0,1.49,1.49,3
Navbahor,3,1,2,0,5,4,1,5,uzbekistan,0.33,1.0,1,1.67,1.67,3.03,1.0,4
Nasaf Qarshi,3,1,2,0,2,1,1,5,uzbekistan,0.33,1.0,1,0.67,1.67,3.03,1.0,4
Andijan,3,0,3,0,4,4,0,3,uzbekistan,0.0,1.0,0,1.33,1.0,0.0,1.0,5
Neftchi,3,0,3,0,2,2,0,3,uzbekistan,0.0,1.0,0,0.67,1.0,0.0,1.0,5
Kokand-1912,3,0,3,0,1,1,0,3,uzbekistan,0.0,1.0,0,0.33,1.0,0.0,1.0,5
Mashal,2,1,0,1,1,1,0,3,uzbekistan,0.5,0.5,0,0.5,1.5,2.0,2.0,5
Qizilqum,3,1,0,2,3,5,-2,3,uzbekistan,0.33,0.33,-2,1.0,1.0,3.03,3.03,5
Shurtan,3,0,1,2,0,4,-4,1,uzbekistan,0.0,0.33,-4,0.0,0.33,0.0,3.03,6
Sogdiana,3,0,0,3,2,5,-3,0,uzbekistan,0.0,0.0,-3,0.67,0.0,0.0,0.0,7
Pakhtakor,2,0,0,2,0,3,-3,0,uzbekistan,0.0,0.0,-3,0.0,0.0,0.0,0.0,7
Termez Surkhon,3,0,0,3,1,7,-6,0,uzbekistan,0.0,0.0,-6,0.33,0.0,0.0,0.0,7
Viettel,8,5,1,2,14,8,6,16,vietnam,0.62,0.75,6,1.75,2.0,1.61,1.33,1
Hai Phong,8,5,1,2,9,4,5,16,vietnam,0.62,0.75,5,1.12,2.0,1.61,1.33,1
Nam Dinh,8,4,3,1,13,6,7,15,vietnam,0.5,0.88,7,1.62,1.88,2.0,1.14,2
Ha Noi,8,4,2,2,14,7,7,14,vietnam,0.5,0.75,7,1.75,1.75,2.0,1.33,3
Binh Duong,8,4,1,3,11,12,-1,13,vietnam,0.5,0.62,-1,1.38,1.62,2.0,1.61,4
Quang Nam,8,3,3,2,13,11,2,12,vietnam,0.38,0.75,2,1.62,1.5,2.63,1.33,5
Cong An Nhan,8,2,5,1,13,10,3,11,vietnam,0.25,0.88,3,1.62,1.38,4.0,1.14,6
Song Lam Nghe,8,3,2,3,6,12,-6,11,vietnam,0.38,0.62,-6,0.75,1.38,2.63,1.61,6
Ho Chi Minh,8,2,4,2,9,11,-2,10,vietnam,0.25,0.75,-2,1.12,1.25,4.0,1.33,7
Thanh Hoa,8,1,6,1,8,8,0,9,vietnam,0.12,0.88,0,1.0,1.12,8.33,1.14,8
Hong Linh Ha T.,8,0,7,1,6,7,-1,7,vietnam,0.0,0.88,-1,0.75,0.88,0.0,1.14,9
Gia Lai,8,1,3,4,7,13,-6,6,vietnam,0.12,0.5,-6,0.88,0.75,8.33,2.0,10
Da Nang,8,1,2,5,6,11,-5,5,vietnam,0.12,0.38,-5,0.75,0.62,8.33,2.63,11
Binh Dinh,8,0,2,6,4,13,-9,2,vietnam,0.0,0.25,-9,0.5,0.25,0.0,4.0,12
Phu Dong,8,8,0,0,15,1,14,24,vietnam2,1.0,1.0,14,1.88,3.0,1.0,1.0,1
Binh Phuoc,8,5,2,1,13,7,6,17,vietnam2,0.62,0.88,6,1.62,2.12,1.61,1.14,2
PVF-CAND,8,4,2,2,8,8,0,14,vietnam2,0.5,0.75,0,1.0,1.75,2.0,1.33,3
Ba Ria Vung Tau,8,4,1,3,9,9,0,13,vietnam2,0.5,0.62,0,1.12,1.62,2.0,1.61,4
S. Khanh Hoa,8,2,4,2,8,8,0,10,vietnam2,0.25,0.75,0,1.0,1.25,4.0,1.33,5
Long An,8,2,4,2,5,5,0,10,vietnam2,0.25,0.75,0,0.62,1.25,4.0,1.33,5
Ho Chi Minh B,8,2,3,3,7,10,-3,9,vietnam2,0.25,0.62,-3,0.88,1.12,4.0,1.61,6
Hoa Binh,8,1,5,2,2,4,-2,8,vietnam2,0.12,0.75,-2,0.25,1.0,8.33,1.33,7
Dong Nai,8,0,6,2,1,3,-2,6,vietnam2,0.0,0.75,-2,0.12,0.75,0.0,1.33,8
Dong Thap,8,1,3,4,1,4,-3,6,vietnam2,0.12,0.5,-3,0.12,0.75,8.33,2.0,8
Hue,8,1,1,6,7,14,-7,4,vietnam2,0.12,0.25,-7,0.88,0.5,8.33,4.0,9
The New Saints,8,7,0,1,23,3,20,21,wales,0.88,0.88,20,2.88,2.62,1.14,1.14,1
Barry,8,5,1,2,16,13,3,16,wales,0.62,0.75,3,2.0,2.0,1.61,1.33,2
Flint,8,5,1,2,15,14,1,16,wales,0.62,0.75,1,1.88,2.0,1.61,1.33,2
Connahs Quay,8,5,0,3,14,6,8,15,wales,0.62,0.62,8,1.75,1.88,1.61,1.61,3
Caernarfon,8,3,2,3,15,12,3,11,wales,0.38,0.62,3,1.88,1.38,2.63,1.61,4
Briton Ferry,8,3,2,3,12,13,-1,11,wales,0.38,0.62,-1,1.5,1.38,2.63,1.61,4
Penybont,8,3,2,3,9,12,-3,11,wales,0.38,0.62,-3,1.12,1.38,2.63,1.61,4
Cardiff MU,8,3,2,3,9,14,-5,11,wales,0.38,0.62,-5,1.12,1.38,2.63,1.61,4
Haverfordwest,8,2,4,2,8,11,-3,10,wales,0.25,0.75,-3,1.0,1.25,4.0,1.33,5
Newtown,8,1,4,3,10,12,-2,7,wales,0.12,0.62,-2,1.25,0.88,8.33,1.61,6
Aberystwyth,8,1,0,7,6,15,-9,3,wales,0.12,0.12,-9,0.75,0.38,8.33,8.33,7
Bala Town,8,0,2,6,6,18,-12,2,wales,0.0,0.25,-12,0.75,0.25,0.0,4.0,8
