Team_Home_Overall,GP,W,D,L,GF,GA,GD,Pts_Overall,Liga,PIO,PIO_HA,GD_Overall,GF_AVG_Overall,PPG_Overall,Odd_Justa_MO,Odd_Justa_HA,Rank_Overall
AF Elbasani,8,4,3,1,8,6,2,15,Albania - Abissnet Superiore,0.5,0.88,2,1.0,1.88,2.0,1.14,1
Partizani T.,8,4,1,3,6,6,0,13,Albania - Abissnet Superiore,0.5,0.62,0,0.75,1.62,2.0,1.61,2
Skenderbeu K.,8,3,2,3,11,9,2,11,Albania - Abissnet Superiore,0.38,0.62,2,1.38,1.38,2.63,1.61,3
Bylis,8,3,2,3,7,9,-2,11,Albania - Abissnet Superiore,0.38,0.62,-2,0.88,1.38,2.63,1.61,3
KF Tirana,8,2,4,2,10,7,3,10,Albania - Abissnet Superiore,0.25,0.75,3,1.25,1.25,4.0,1.33,4
Vllaznia S.,8,1,5,2,8,7,1,8,Albania - Abissnet Superiore,0.12,0.75,1,1.0,1.0,8.33,1.33,5
Dinamo Tirana,8,2,2,4,7,13,-6,8,Albania - Abissnet Superiore,0.25,0.5,-6,0.88,1.0,4.0,2.0,5
Egnatia R.,8,1,4,3,8,9,-1,7,Albania - Abissnet Superiore,0.12,0.62,-1,1.0,0.88,8.33,1.61,6
Laci,8,1,3,4,4,7,-3,6,Albania - Abissnet Superiore,0.12,0.5,-3,0.5,0.75,8.33,2.0,7
Racing Club,8,6,1,1,13,5,8,19,Argentina - Liga Profesional,0.75,0.88,8,1.62,2.38,1.33,1.14,1
Rosario Central,8,5,3,0,11,4,7,18,Argentina - Liga Profesional,0.62,1.0,7,1.38,2.25,1.61,1.0,2
I. Rivadavia,8,5,2,1,12,8,4,17,Argentina - Liga Profesional,0.62,0.88,4,1.5,2.12,1.61,1.14,3
Boca Juniors,8,5,1,2,15,6,9,16,Argentina - Liga Profesional,0.62,0.75,9,1.88,2.0,1.61,1.33,4
River Plate,8,4,4,0,14,6,8,16,Argentina - Liga Profesional,0.5,1.0,8,1.75,2.0,2.0,1.0,4
Argentinos Jrs,8,4,3,1,15,6,9,15,Argentina - Liga Profesional,0.5,0.88,9,1.88,1.88,2.0,1.14,5
Platense,8,4,2,2,7,4,3,14,Argentina - Liga Profesional,0.5,0.75,3,0.88,1.75,2.0,1.33,6
Barracas C.,8,4,2,2,8,8,0,14,Argentina - Liga Profesional,0.5,0.75,0,1.0,1.75,2.0,1.33,6
Newells,8,3,4,1,8,3,5,13,Argentina - Liga Profesional,0.38,0.88,5,1.0,1.62,2.63,1.14,7
Aldosivi,8,4,1,3,12,10,2,13,Argentina - Liga Profesional,0.5,0.62,2,1.5,1.62,2.0,1.61,7
D. Riestra,8,3,4,1,6,4,2,13,Argentina - Liga Profesional,0.38,0.88,2,0.75,1.62,2.63,1.14,7
Independiente,8,3,3,2,10,6,4,12,Argentina - Liga Profesional,0.38,0.75,4,1.25,1.5,2.63,1.33,8
Huracan,8,3,3,2,9,8,1,12,Argentina - Liga Profesional,0.38,0.75,1,1.12,1.5,2.63,1.33,8
Velez Sarsfield,8,4,0,4,7,9,-2,12,Argentina - Liga Profesional,0.5,0.5,-2,0.88,1.5,2.0,2.0,8
Lanus,8,2,5,1,8,5,3,11,Argentina - Liga Profesional,0.25,0.88,3,1.0,1.38,4.0,1.14,9
Instituto,8,3,2,3,11,13,-2,11,Argentina - Liga Profesional,0.38,0.62,-2,1.38,1.38,2.63,1.61,9
San Lorenzo,8,2,4,2,5,5,0,10,Argentina - Liga Profesional,0.25,0.75,0,0.62,1.25,4.0,1.33,10
Union Santa Fe,8,2,3,3,8,8,0,9,Argentina - Liga Profesional,0.25,0.62,0,1.0,1.12,4.0,1.61,11
Sarmiento,8,1,6,1,5,5,0,9,Argentina - Liga Profesional,0.12,0.88,0,0.62,1.12,8.33,1.14,11
A. Tucuman,8,3,0,5,8,9,-1,9,Argentina - Liga Profesional,0.38,0.38,-1,1.0,1.12,2.63,2.63,11
Belgrano,8,1,6,1,6,7,-1,9,Argentina - Liga Profesional,0.12,0.88,-1,0.75,1.12,8.33,1.14,11
Tigre,8,2,3,3,6,7,-1,9,Argentina - Liga Profesional,0.25,0.62,-1,0.75,1.12,4.0,1.61,11
T. de Cordoba,8,1,4,3,6,7,-1,7,Argentina - Liga Profesional,0.12,0.62,-1,0.75,0.88,8.33,1.61,12
Godoy Cruz,8,1,4,3,2,9,-7,7,Argentina - Liga Profesional,0.12,0.62,-7,0.25,0.88,8.33,1.61,12
Banfield,8,1,3,4,9,14,-5,6,Argentina - Liga Profesional,0.12,0.5,-5,1.12,0.75,8.33,2.0,13
Gimnasia,8,1,3,4,4,10,-6,6,Argentina - Liga Profesional,0.12,0.5,-6,0.5,0.75,8.33,2.0,13
Defensa y J.,8,1,2,5,7,16,-9,5,Argentina - Liga Profesional,0.12,0.38,-9,0.88,0.62,8.33,2.63,14
Central Cordoba,8,1,1,6,6,14,-8,4,Argentina - Liga Profesional,0.12,0.25,-8,0.75,0.5,8.33,4.0,15
Estudiantes,8,0,3,5,3,12,-9,3,Argentina - Liga Profesional,0.0,0.38,-9,0.38,0.38,0.0,2.63,16
Gimnasia Jujuy,8,6,1,1,12,3,9,19,Argentina - Primera Nacional,0.75,0.88,9,1.5,2.38,1.33,1.14,1
SM Tucuman,8,5,3,0,8,1,7,18,Argentina - Primera Nacional,0.62,1.0,7,1.0,2.25,1.61,1.0,2
Deportivo Moron,8,5,2,1,13,4,9,17,Argentina - Primera Nacional,0.62,0.88,9,1.62,2.12,1.61,1.14,3
Chacarita J.,8,5,2,1,13,6,7,17,Argentina - Primera Nacional,0.62,0.88,7,1.62,2.12,1.61,1.14,3
Atlanta,8,4,3,1,8,5,3,15,Argentina - Primera Nacional,0.5,0.88,3,1.0,1.88,2.0,1.14,4
D. de Belgrano,8,4,3,1,7,4,3,15,Argentina - Primera Nacional,0.5,0.88,3,0.88,1.88,2.0,1.14,4
E. Rio Cuarto,8,4,2,2,8,5,3,14,Argentina - Primera Nacional,0.5,0.75,3,1.0,1.75,2.0,1.33,5
Atletico Mitre,8,3,4,1,7,2,5,13,Argentina - Primera Nacional,0.38,0.88,5,0.88,1.62,2.63,1.14,6
Agropecuario,8,4,1,3,10,7,3,13,Argentina - Primera Nacional,0.5,0.62,3,1.25,1.62,2.0,1.61,6
G. Mendoza,8,3,4,1,9,6,3,13,Argentina - Primera Nacional,0.38,0.88,3,1.12,1.62,2.63,1.14,6
Quilmes,8,4,1,3,9,6,3,13,Argentina - Primera Nacional,0.5,0.62,3,1.12,1.62,2.0,1.61,6
Tristan Suarez,8,3,4,1,9,6,3,13,Argentina - Primera Nacional,0.38,0.88,3,1.12,1.62,2.63,1.14,6
Almagro,8,3,4,1,7,5,2,13,Argentina - Primera Nacional,0.38,0.88,2,0.88,1.62,2.63,1.14,6
Chaco For Ever,8,4,1,3,9,8,1,13,Argentina - Primera Nacional,0.5,0.62,1,1.12,1.62,2.0,1.61,6
Patronato,8,3,3,2,10,9,1,12,Argentina - Primera Nacional,0.38,0.75,1,1.25,1.5,2.63,1.33,7
San Telmo,8,3,3,2,7,8,-1,12,Argentina - Primera Nacional,0.38,0.75,-1,0.88,1.5,2.63,1.33,7
Los Andes,8,3,2,3,9,7,2,11,Argentina - Primera Nacional,0.38,0.62,2,1.12,1.38,2.63,1.61,8
D. Madryn,8,2,5,1,5,4,1,11,Argentina - Primera Nacional,0.25,0.88,1,0.62,1.38,4.0,1.14,8
Colegiales,8,3,2,3,3,4,-1,11,Argentina - Primera Nacional,0.38,0.62,-1,0.38,1.38,2.63,1.61,8
Temperley,8,3,2,3,5,7,-2,11,Argentina - Primera Nacional,0.38,0.62,-2,0.62,1.38,2.63,1.61,8
Racing Cordoba,8,2,4,2,11,10,1,10,Argentina - Primera Nacional,0.25,0.75,1,1.38,1.25,4.0,1.33,9
Deportivo Maipu,8,2,4,2,8,8,0,10,Argentina - Primera Nacional,0.25,0.75,0,1.0,1.25,4.0,1.33,9
Ferro Carril,8,3,1,4,4,7,-3,10,Argentina - Primera Nacional,0.38,0.5,-3,0.5,1.25,2.63,2.0,9
Nueva Chicago,8,2,3,3,9,9,0,9,Argentina - Primera Nacional,0.25,0.62,0,1.12,1.12,4.0,1.61,10
Almirante Brown,8,2,3,3,5,5,0,9,Argentina - Primera Nacional,0.25,0.62,0,0.62,1.12,4.0,1.61,10
Alvarado,8,2,3,3,8,11,-3,9,Argentina - Primera Nacional,0.25,0.62,-3,1.0,1.12,4.0,1.61,10
CA Estudiantes,8,3,0,5,6,9,-3,9,Argentina - Primera Nacional,0.38,0.38,-3,0.75,1.12,2.63,2.63,10
San Miguel,8,1,5,2,6,7,-1,8,Argentina - Primera Nacional,0.12,0.75,-1,0.75,1.0,8.33,1.33,11
CA Guemes,8,2,2,4,6,8,-2,8,Argentina - Primera Nacional,0.25,0.5,-2,0.75,1.0,4.0,2.0,11
Argentino Merlo,8,6,1,1,15,6,9,19,Argentina - Primera B,0.75,0.88,9,1.88,2.38,1.33,1.14,1
A. Quilmes,8,5,2,1,12,4,8,17,Argentina - Primera B,0.62,0.88,8,1.5,2.12,1.61,1.14,2
Comunicaciones,8,5,2,1,12,6,6,17,Argentina - Primera B,0.62,0.88,6,1.5,2.12,1.61,1.14,2
Villa Dalmine,8,5,2,1,7,2,5,17,Argentina - Primera B,0.62,0.88,5,0.88,2.12,1.61,1.14,2
Deportivo Merlo,8,4,3,1,8,4,4,15,Argentina - Primera B,0.5,0.88,4,1.0,1.88,2.0,1.14,3
Excursionistas,8,4,2,2,16,9,7,14,Argentina - Primera B,0.5,0.75,7,2.0,1.75,2.0,1.33,4
D. Armenio,8,4,1,3,13,8,5,13,Argentina - Primera B,0.5,0.62,5,1.62,1.62,2.0,1.61,5
Colegiales,8,4,1,3,9,7,2,13,Argentina - Primera B,0.5,0.62,2,1.12,1.62,2.0,1.61,5
Midland,8,3,3,2,10,7,3,12,Argentina - Primera B,0.38,0.75,3,1.25,1.5,2.63,1.33,6
Sacachispas,8,3,2,3,4,6,-2,11,Argentina - Primera B,0.38,0.62,-2,0.5,1.38,2.63,1.61,7
Liniers,8,2,4,2,5,5,0,10,Argentina - Primera B,0.25,0.75,0,0.62,1.25,4.0,1.33,8
S. Italiano,8,2,3,3,9,9,0,9,Argentina - Primera B,0.25,0.62,0,1.12,1.12,4.0,1.61,9
Flandria,8,2,3,3,7,9,-2,9,Argentina - Primera B,0.25,0.62,-2,0.88,1.12,4.0,1.61,9
SM Burzaco,8,3,0,5,5,9,-4,9,Argentina - Primera B,0.38,0.38,-4,0.62,1.12,2.63,2.63,9
Dock Sud,8,2,2,4,5,8,-3,8,Argentina - Primera B,0.25,0.5,-3,0.62,1.0,4.0,2.0,10
Los Andes,8,2,2,4,5,9,-4,8,Argentina - Primera B,0.25,0.5,-4,0.62,1.0,4.0,2.0,10
Acassuso,8,2,2,4,5,12,-7,8,Argentina - Primera B,0.25,0.5,-7,0.62,1.0,4.0,2.0,10
UAI Urquiza,8,2,2,4,10,18,-8,8,Argentina - Primera B,0.25,0.5,-8,1.25,1.0,4.0,2.0,10
V. San Carlos,8,2,1,5,5,9,-4,7,Argentina - Primera B,0.25,0.38,-4,0.62,0.88,4.0,2.63,11
D. Laferrere,8,1,4,3,4,9,-5,7,Argentina - Primera B,0.12,0.62,-5,0.5,0.88,8.33,1.61,11
Canuelas,8,2,0,6,6,11,-5,6,Argentina - Primera B,0.25,0.25,-5,0.75,0.75,4.0,4.0,12
Fenix,8,1,1,6,5,12,-7,4,Argentina - Primera B,0.12,0.25,-7,0.62,0.5,8.33,4.0,13
G. Chivilcoy,8,5,3,0,9,4,5,18,Argentina - Torneo Federal,0.62,1.0,5,1.12,2.25,1.61,1.0,1
Ciudad Bolivar,7,5,2,0,14,3,11,17,Argentina - Torneo Federal,0.71,1.0,11,2.0,2.43,1.41,1.0,2
Circulo D.,8,5,1,2,11,7,4,16,Argentina - Torneo Federal,0.62,0.75,4,1.38,2.0,1.61,1.33,3
A. Rafaela,8,5,1,2,12,9,3,16,Argentina - Torneo Federal,0.62,0.75,3,1.5,2.0,1.61,1.33,3
Cipolletti,8,5,0,3,14,5,9,15,Argentina - Torneo Federal,0.62,0.62,9,1.75,1.88,1.61,1.61,4
I. Chivilcoy,8,4,3,1,11,5,6,15,Argentina - Torneo Federal,0.5,0.88,6,1.38,1.88,2.0,1.14,4
Olimpo Bahia B.,8,4,3,1,9,6,3,15,Argentina - Torneo Federal,0.5,0.88,3,1.12,1.88,2.0,1.14,4
S. Belgrano,8,4,2,2,14,6,8,14,Argentina - Torneo Federal,0.5,0.75,8,1.75,1.75,2.0,1.33,5
Villa Mitre,8,4,2,2,10,5,5,14,Argentina - Torneo Federal,0.5,0.75,5,1.25,1.75,2.0,1.33,5
Huracan Las H.,8,4,2,2,9,11,-2,14,Argentina - Torneo Federal,0.5,0.75,-2,1.12,1.75,2.0,1.33,5
Douglas Haig,8,3,4,1,9,6,3,13,Argentina - Torneo Federal,0.38,0.88,3,1.12,1.62,2.63,1.14,6
Sarmiento DLB,7,4,0,3,11,7,4,12,Argentina - Torneo Federal,0.57,0.57,4,1.57,1.71,1.75,1.75,7
SM Formosa,7,3,3,1,7,3,4,12,Argentina - Torneo Federal,0.43,0.86,4,1.0,1.71,2.33,1.16,7
D. Rincon,8,4,0,4,11,9,2,12,Argentina - Torneo Federal,0.5,0.5,2,1.38,1.5,2.0,2.0,7
SM Mendoza,7,3,2,2,12,8,4,11,Argentina - Torneo Federal,0.43,0.71,4,1.71,1.57,2.33,1.41,8
J. Antoniana,7,3,2,2,8,5,3,11,Argentina - Torneo Federal,0.43,0.71,3,1.14,1.57,2.33,1.41,8
Kimberley,8,3,2,3,6,6,0,11,Argentina - Torneo Federal,0.38,0.62,0,0.75,1.38,2.63,1.61,8
Costa Brava,7,2,4,1,7,5,2,10,Argentina - Torneo Federal,0.29,0.86,2,1.0,1.43,3.45,1.16,9
Bartolom√© Mitre,7,3,1,3,6,5,1,10,Argentina - Torneo Federal,0.43,0.57,1,0.86,1.43,2.33,1.75,9
Ben Hur,8,3,1,4,10,11,-1,10,Argentina - Torneo Federal,0.38,0.5,-1,1.25,1.25,2.63,2.0,9
D. Belgrano VR,8,2,4,2,5,6,-1,10,Argentina - Torneo Federal,0.25,0.75,-1,0.62,1.25,4.0,1.33,9
Guillermo Brown,8,3,1,4,11,14,-3,10,Argentina - Torneo Federal,0.38,0.5,-3,1.38,1.25,2.63,2.0,9
S. Estudiantes,7,2,3,2,6,4,2,9,Argentina - Torneo Federal,0.29,0.71,2,0.86,1.29,3.45,1.41,10
S. Las Parejas,8,2,3,3,6,7,-1,9,Argentina - Torneo Federal,0.25,0.62,-1,0.75,1.12,4.0,1.61,10
Sol de America,7,2,2,3,10,8,2,8,Argentina - Torneo Federal,0.29,0.57,2,1.43,1.14,3.45,1.75,11
Argentino MM,7,2,2,3,6,7,-1,8,Argentina - Torneo Federal,0.29,0.57,-1,0.86,1.14,3.45,1.75,11
Juventud U. U.,7,1,5,1,6,7,-1,8,Argentina - Torneo Federal,0.14,0.86,-1,0.86,1.14,7.14,1.16,11
Gimnasia E.,8,2,2,4,4,11,-7,8,Argentina - Torneo Federal,0.25,0.5,-7,0.5,1.0,4.0,2.0,11
Boca Unidos,7,2,1,4,7,11,-4,7,Argentina - Torneo Federal,0.29,0.43,-4,1.0,1.0,3.45,2.33,12
Noah,8,7,1,0,24,5,19,22,Armenia - Premier League,0.88,1.0,19,3.0,2.75,1.14,1.0,1
Ararat-Armenia,8,7,1,0,24,7,17,22,Armenia - Premier League,0.88,1.0,17,3.0,2.75,1.14,1.0,1
Urartu,8,5,2,1,21,8,13,17,Armenia - Premier League,0.62,0.88,13,2.62,2.12,1.61,1.14,2
Van,8,3,3,2,13,10,3,12,Armenia - Premier League,0.38,0.75,3,1.62,1.5,2.63,1.33,3
BKMA,8,3,3,2,11,13,-2,12,Armenia - Premier League,0.38,0.75,-2,1.38,1.5,2.63,1.33,3
Ararat Yerevan,8,3,2,3,12,13,-1,11,Armenia - Premier League,0.38,0.62,-1,1.5,1.38,2.63,1.61,4
Pyunik,8,3,1,4,15,15,0,10,Armenia - Premier League,0.38,0.5,0,1.88,1.25,2.63,2.0,5
Alashkert,8,1,4,3,8,12,-4,7,Armenia - Premier League,0.12,0.62,-4,1.0,0.88,8.33,1.61,6
West Armenia,8,2,0,6,4,24,-20,6,Armenia - Premier League,0.25,0.25,-20,0.5,0.75,4.0,4.0,7
Shirak,8,1,1,6,9,22,-13,4,Armenia - Premier League,0.12,0.25,-13,1.12,0.5,8.33,4.0,8
Gandzasar,8,0,1,7,3,17,-14,1,Armenia - Premier League,0.0,0.12,-14,0.38,0.12,0.0,8.33,9
Western United,8,6,0,2,22,11,11,18,Australia - A-League,0.75,0.75,11,2.75,2.25,1.33,1.33,1
WS Wanderers,8,5,3,0,19,9,10,18,Australia - A-League,0.62,1.0,10,2.38,2.25,1.61,1.0,1
Melbourne City,8,5,2,1,16,8,8,17,Australia - A-League,0.62,0.88,8,2.0,2.12,1.61,1.14,2
Melbourne V.,8,4,2,2,17,14,3,14,Australia - A-League,0.5,0.75,3,2.12,1.75,2.0,1.33,3
Auckland,8,3,4,1,13,10,3,13,Australia - A-League,0.38,0.88,3,1.62,1.62,2.63,1.14,4
Brisbane Roar,8,4,1,3,12,14,-2,13,Australia - A-League,0.5,0.62,-2,1.5,1.62,2.0,1.61,4
Sydney FC,8,3,2,3,14,16,-2,11,Australia - A-League,0.38,0.62,-2,1.75,1.38,2.63,1.61,5
Newcastle Jets,8,2,2,4,16,16,0,8,Australia - A-League,0.25,0.5,0,2.0,1.0,4.0,2.0,6
Macarthur FC,8,2,2,4,17,19,-2,8,Australia - A-League,0.25,0.5,-2,2.12,1.0,4.0,2.0,6
Perth Glory,8,2,1,5,10,15,-5,7,Australia - A-League,0.25,0.38,-5,1.25,0.88,4.0,2.63,7
Adelaide Utd,8,1,3,4,15,21,-6,6,Australia - A-League,0.12,0.5,-6,1.88,0.75,8.33,2.0,8
Wellington,8,1,2,5,10,17,-7,5,Australia - A-League,0.12,0.38,-7,1.25,0.62,8.33,2.63,9
Central Coast,8,1,2,5,9,20,-11,5,Australia - A-League,0.12,0.38,-11,1.12,0.62,8.33,2.63,9
Heidelberg Utd,8,7,0,1,24,8,16,21,Australia - NPL Victoria,0.88,0.88,16,3.0,2.62,1.14,1.14,1
Dandenong T.,8,6,1,1,21,12,9,19,Australia - NPL Victoria,0.75,0.88,9,2.62,2.38,1.33,1.14,2
Avondale,8,6,0,2,22,7,15,18,Australia - NPL Victoria,0.75,0.75,15,2.75,2.25,1.33,1.33,3
Oakleigh C.,8,6,0,2,19,8,11,18,Australia - NPL Victoria,0.75,0.75,11,2.38,2.25,1.33,1.33,3
Dandenong City,8,4,1,3,15,11,4,13,Australia - NPL Victoria,0.5,0.62,4,1.88,1.62,2.0,1.61,4
Preston Lions,8,4,1,3,13,12,1,13,Australia - NPL Victoria,0.5,0.62,1,1.62,1.62,2.0,1.61,4
Hume City,8,4,1,3,12,15,-3,13,Australia - NPL Victoria,0.5,0.62,-3,1.5,1.62,2.0,1.61,4
Green Gully,8,4,1,3,11,14,-3,13,Australia - NPL Victoria,0.5,0.62,-3,1.38,1.62,2.0,1.61,4
M. Victory B,8,3,1,4,14,15,-1,10,Australia - NPL Victoria,0.38,0.5,-1,1.75,1.25,2.63,2.0,5
St. Albans,8,2,1,5,13,17,-4,7,Australia - NPL Victoria,0.25,0.38,-4,1.62,0.88,4.0,2.63,6
Melbourne K.,8,2,0,6,8,14,-6,6,Australia - NPL Victoria,0.25,0.25,-6,1.0,0.75,4.0,4.0,7
Altona Magic,8,0,4,4,5,14,-9,4,Australia - NPL Victoria,0.0,0.5,-9,0.62,0.5,0.0,2.0,8
Port Melbourne,8,1,1,6,10,27,-17,4,Australia - NPL Victoria,0.12,0.25,-17,1.25,0.5,8.33,4.0,8
South Melbourne,8,0,2,6,2,15,-13,2,Australia - NPL Victoria,0.0,0.25,-13,0.25,0.25,0.0,4.0,9
Moreton City E.,5,4,0,1,10,5,5,12,Australia - NPL Queensland,0.8,0.8,5,2.0,2.4,1.25,1.25,1
Gold C. Knights,5,4,0,1,7,3,4,12,Australia - NPL Queensland,0.8,0.8,4,1.4,2.4,1.25,1.25,1
Q. Lions,6,3,1,2,11,8,3,10,Australia - NPL Queensland,0.5,0.67,3,1.83,1.67,2.0,1.49,2
Gold C. Utd,5,3,0,2,7,8,-1,9,Australia - NPL Queensland,0.6,0.6,-1,1.4,1.8,1.67,1.67,3
Eastern Suburbs,4,2,2,0,10,5,5,8,Australia - NPL Queensland,0.5,1.0,5,2.5,2.0,2.0,1.0,4
Peninsula,5,2,1,2,9,5,4,7,Australia - NPL Queensland,0.4,0.6,4,1.8,1.4,2.5,1.67,5
Wynnum Wolves,6,2,1,3,12,12,0,7,Australia - NPL Queensland,0.33,0.5,0,2.0,1.17,3.03,2.0,5
Olympic FC,5,2,0,3,8,6,2,6,Australia - NPL Queensland,0.4,0.4,2,1.6,1.2,2.5,2.5,6
Brisbane City,5,2,0,3,7,10,-3,6,Australia - NPL Queensland,0.4,0.4,-3,1.4,1.2,2.5,2.5,6
Brisbane Roar B,5,2,0,3,6,10,-4,6,Australia - NPL Queensland,0.4,0.4,-4,1.2,1.2,2.5,2.5,6
SC Wanderers,5,1,1,3,6,12,-6,4,Australia - NPL Queensland,0.2,0.4,-6,1.2,0.8,5.0,2.5,7
St George W.,6,0,2,4,4,13,-9,2,Australia - NPL Queensland,0.0,0.33,-9,0.67,0.33,0.0,3.03,8
Austria Wien,8,6,1,1,16,6,10,19,Austria - Bundesliga,0.75,0.88,10,2.0,2.38,1.33,1.14,1
Wolfsberger AC,8,5,1,2,19,11,8,16,Austria - Bundesliga,0.62,0.75,8,2.38,2.0,1.61,1.33,2
Salzburg,8,4,4,0,12,5,7,16,Austria - Bundesliga,0.5,1.0,7,1.5,2.0,2.0,1.0,2
BW Linz,8,5,1,2,13,9,4,16,Austria - Bundesliga,0.62,0.75,4,1.62,2.0,1.61,1.33,2
Sturm Graz,8,4,2,2,15,13,2,14,Austria - Bundesliga,0.5,0.75,2,1.88,1.75,2.0,1.33,3
LASK Linz,8,3,2,3,10,12,-2,11,Austria - Bundesliga,0.38,0.62,-2,1.25,1.38,2.63,1.61,4
Hartberg,8,2,3,3,7,13,-6,9,Austria - Bundesliga,0.25,0.62,-6,0.88,1.12,4.0,1.61,5
Rapid Wien,8,2,1,5,14,12,2,7,Austria - Bundesliga,0.25,0.38,2,1.75,0.88,4.0,2.63,6
Altach,8,1,4,3,8,15,-7,7,Austria - Bundesliga,0.12,0.62,-7,1.0,0.88,8.33,1.61,6
Tirol,8,1,3,4,9,13,-4,6,Austria - Bundesliga,0.12,0.5,-4,1.12,0.75,8.33,2.0,7
A. Klagenfurt,8,1,3,4,9,14,-5,6,Austria - Bundesliga,0.12,0.5,-5,1.12,0.75,8.33,2.0,7
Grazer AK,8,1,1,6,9,19,-10,4,Austria - Bundesliga,0.12,0.25,-10,1.12,0.5,8.33,4.0,8
Kapfenberger,8,7,0,1,20,10,10,21,Austria - 2. Liga,0.88,0.88,10,2.5,2.62,1.14,1.14,1
Ried,8,5,2,1,17,5,12,17,Austria - 2. Liga,0.62,0.88,12,2.12,2.12,1.61,1.14,2
Stripfing,8,4,3,1,14,10,4,15,Austria - 2. Liga,0.5,0.88,4,1.75,1.88,2.0,1.14,3
St. Polten,8,4,2,2,21,13,8,14,Austria - 2. Liga,0.5,0.75,8,2.62,1.75,2.0,1.33,4
Floridsdorfer,8,4,2,2,9,8,1,14,Austria - 2. Liga,0.5,0.75,1,1.12,1.75,2.0,1.33,4
First Vienna,8,4,1,3,11,12,-1,13,Austria - 2. Liga,0.5,0.62,-1,1.38,1.62,2.0,1.61,5
Liefering,8,4,0,4,12,10,2,12,Austria - 2. Liga,0.5,0.5,2,1.5,1.5,2.0,2.0,6
Admira Wacker,8,3,2,3,13,12,1,11,Austria - 2. Liga,0.38,0.62,1,1.62,1.38,2.63,1.61,7
SV Horn,8,3,2,3,12,11,1,11,Austria - 2. Liga,0.38,0.62,1,1.5,1.38,2.63,1.61,7
A. Lustenau,8,3,2,3,7,7,0,11,Austria - 2. Liga,0.38,0.62,0,0.88,1.38,2.63,1.61,7
Sturm Graz B,8,3,1,4,13,14,-1,10,Austria - 2. Liga,0.38,0.5,-1,1.62,1.25,2.63,2.0,8
Voitsberg,8,2,2,4,7,13,-6,8,Austria - 2. Liga,0.25,0.5,-6,0.88,1.0,4.0,2.0,9
Rapid Wien B,8,2,1,5,9,18,-9,7,Austria - 2. Liga,0.25,0.38,-9,1.12,0.88,4.0,2.63,10
Amstetten,8,1,3,4,9,12,-3,6,Austria - 2. Liga,0.12,0.5,-3,1.12,0.75,8.33,2.0,11
Bregenz,8,2,0,6,12,18,-6,6,Austria - 2. Liga,0.25,0.25,-6,1.5,0.75,4.0,4.0,11
Lafnitz,8,1,1,6,13,26,-13,4,Austria - 2. Liga,0.12,0.25,-13,1.62,0.5,8.33,4.0,12
Qarabag,8,6,2,0,18,4,14,20,Azerbaijan - Premier League,0.75,1.0,14,2.25,2.5,1.33,1.0,1
Zira,8,6,1,1,14,5,9,19,Azerbaijan - Premier League,0.75,0.88,9,1.75,2.38,1.33,1.14,2
Shamakhi,8,3,3,2,8,10,-2,12,Azerbaijan - Premier League,0.38,0.75,-2,1.0,1.5,2.63,1.33,3
Neftci,8,2,4,2,12,14,-2,10,Azerbaijan - Premier League,0.25,0.75,-2,1.5,1.25,4.0,1.33,4
Araz,8,1,6,1,8,8,0,9,Azerbaijan - Premier League,0.12,0.88,0,1.0,1.12,8.33,1.14,5
Sumqayit,8,2,2,4,12,15,-3,8,Azerbaijan - Premier League,0.25,0.5,-3,1.5,1.0,4.0,2.0,6
Sabah,8,1,4,3,10,12,-2,7,Azerbaijan - Premier League,0.12,0.62,-2,1.25,0.88,8.33,1.61,7
Turan,8,1,4,3,7,11,-4,7,Azerbaijan - Premier League,0.12,0.62,-4,0.88,0.88,8.33,1.61,7
Kapaz,8,1,4,3,5,9,-4,7,Azerbaijan - Premier League,0.12,0.62,-4,0.62,0.88,8.33,1.61,7
Sebail,8,0,4,4,7,13,-6,4,Azerbaijan - Premier League,0.0,0.5,-6,0.88,0.5,0.0,2.0,8
Al-Muharraq,8,8,0,0,24,4,20,24,Bahrain - Premier League,1.0,1.0,20,3.0,3.0,1.0,1.0,1
Al Riffa,8,4,2,2,18,12,6,14,Bahrain - Premier League,0.5,0.75,6,2.25,1.75,2.0,1.33,2
East Riffa,8,3,5,0,11,7,4,14,Bahrain - Premier League,0.38,1.0,4,1.38,1.75,2.63,1.0,2
Sitra,8,3,4,1,12,8,4,13,Bahrain - Premier League,0.38,0.88,4,1.5,1.62,2.63,1.14,3
AAli FC,8,2,4,2,11,12,-1,10,Bahrain - Premier League,0.25,0.75,-1,1.38,1.25,4.0,1.33,4
Khalidiya,8,2,3,3,13,14,-1,9,Bahrain - Premier League,0.25,0.62,-1,1.62,1.12,4.0,1.61,5
Malkiya,8,1,5,2,7,10,-3,8,Bahrain - Premier League,0.12,0.75,-3,0.88,1.0,8.33,1.33,6
Al-Najma,8,2,2,4,6,9,-3,8,Bahrain - Premier League,0.25,0.5,-3,0.75,1.0,4.0,2.0,6
Bahrain SC,8,2,2,4,8,14,-6,8,Bahrain - Premier League,0.25,0.5,-6,1.0,1.0,4.0,2.0,6
Al Ahli M.,8,2,1,5,8,12,-4,7,Bahrain - Premier League,0.25,0.38,-4,1.0,0.88,4.0,2.63,7
Al Shabbab,8,0,5,3,4,9,-5,5,Bahrain - Premier League,0.0,0.62,-5,0.5,0.62,0.0,1.61,8
Manama,8,1,2,5,8,21,-13,5,Bahrain - Premier League,0.12,0.38,-13,1.0,0.62,8.33,2.63,8
Mohammedan,8,6,1,1,17,5,12,19,Bangladesh - Premier League,0.75,0.88,12,2.12,2.38,1.33,1.14,1
Bashundhara K.,8,5,2,1,20,4,16,17,Bangladesh - Premier League,0.62,0.88,16,2.5,2.12,1.61,1.14,2
Abahani,8,4,3,1,15,4,11,15,Bangladesh - Premier League,0.5,0.88,11,1.88,1.88,2.0,1.14,3
Fortis,8,3,4,1,9,5,4,13,Bangladesh - Premier League,0.38,0.88,4,1.12,1.62,2.63,1.14,4
B. Police,8,4,1,3,9,11,-2,13,Bangladesh - Premier League,0.5,0.62,-2,1.12,1.62,2.0,1.61,4
Brothers Union,8,3,2,3,9,5,4,11,Bangladesh - Premier League,0.38,0.62,4,1.12,1.38,2.63,1.61,5
Fakirerpool,8,3,1,4,11,20,-9,10,Bangladesh - Premier League,0.38,0.5,-9,1.38,1.25,2.63,2.0,6
Rahmatgonj,8,2,2,4,11,10,1,8,Bangladesh - Premier League,0.25,0.5,1,1.38,1.0,4.0,2.0,7
Chittagong,8,1,0,7,4,19,-15,3,Bangladesh - Premier League,0.12,0.12,-15,0.5,0.38,8.33,8.33,8
Dhaka Wanderers,8,1,0,7,5,27,-22,3,Bangladesh - Premier League,0.12,0.12,-22,0.62,0.38,8.33,8.33,8
Maxline,7,5,2,0,13,4,9,17,Belarus - Vysshaya Liga,0.71,1.0,9,1.86,2.43,1.41,1.0,1
Slavia Mozyr,7,4,2,1,14,8,6,14,Belarus - Vysshaya Liga,0.57,0.86,6,2.0,2.0,1.75,1.16,2
Isloch,7,3,4,0,14,6,8,13,Belarus - Vysshaya Liga,0.43,1.0,8,2.0,1.86,2.33,1.0,3
Dinamo Minsk,6,4,1,1,9,6,3,13,Belarus - Vysshaya Liga,0.67,0.83,3,1.5,2.17,1.49,1.2,3
BATE Borisov,7,4,1,2,6,3,3,13,Belarus - Vysshaya Liga,0.57,0.71,3,0.86,1.86,1.75,1.41,3
FC Minsk,7,4,1,2,11,11,0,13,Belarus - Vysshaya Liga,0.57,0.71,0,1.57,1.86,1.75,1.41,3
Dinamo Brest,7,3,3,1,9,6,3,12,Belarus - Vysshaya Liga,0.43,0.86,3,1.29,1.71,2.33,1.16,4
T. Zhodino,7,2,5,0,5,3,2,11,Belarus - Vysshaya Liga,0.29,1.0,2,0.71,1.57,3.45,1.0,5
Vitebsk,7,3,1,3,13,8,5,10,Belarus - Vysshaya Liga,0.43,0.57,5,1.86,1.43,2.33,1.75,6
Naftan,7,3,1,3,9,12,-3,10,Belarus - Vysshaya Liga,0.43,0.57,-3,1.29,1.43,2.33,1.75,6
Neman Grodno,6,3,0,3,8,4,4,9,Belarus - Vysshaya Liga,0.5,0.5,4,1.33,1.5,2.0,2.0,7
Gomel,7,1,3,3,2,5,-3,6,Belarus - Vysshaya Liga,0.14,0.57,-3,0.29,0.86,7.14,1.75,8
Slutsk,7,1,1,5,5,9,-4,4,Belarus - Vysshaya Liga,0.14,0.29,-4,0.71,0.57,7.14,3.45,9
Arsenal D.,7,0,4,3,6,11,-5,4,Belarus - Vysshaya Liga,0.0,0.57,-5,0.86,0.57,0.0,1.75,9
Smorgon,7,0,1,6,3,13,-10,1,Belarus - Vysshaya Liga,0.0,0.14,-10,0.43,0.14,0.0,7.14,10
Molodechno,7,0,0,7,3,21,-18,0,Belarus - Vysshaya Liga,0.0,0.0,-18,0.43,0.0,0.0,0.0,11
Dinamo Minsk B,7,3,3,1,8,5,3,12,Belarus - First League,0.43,0.86,3,1.14,1.71,2.33,1.16,1
Ostrovets,6,4,0,2,11,9,2,12,Belarus - First League,0.67,0.67,2,1.83,2.0,1.49,1.49,1
BATE B,6,3,2,1,17,7,10,11,Belarus - First League,0.5,0.83,10,2.83,1.83,2.0,1.2,2
Dnepr Mogilev,6,3,2,1,11,9,2,11,Belarus - First League,0.5,0.83,2,1.83,1.83,2.0,1.2,2
ABFF U19,7,3,2,2,9,8,1,11,Belarus - First League,0.43,0.71,1,1.29,1.57,2.33,1.41,2
Niva,6,2,4,0,13,8,5,10,Belarus - First League,0.33,1.0,5,2.17,1.67,3.03,1.0,3
Lida,6,3,1,2,13,9,4,10,Belarus - First League,0.5,0.67,4,2.17,1.67,2.0,1.49,3
Volna Pinsk,6,2,4,0,13,10,3,10,Belarus - First League,0.33,1.0,3,2.17,1.67,3.03,1.0,3
Slonim,6,3,1,2,7,7,0,10,Belarus - First League,0.5,0.67,0,1.17,1.67,2.0,1.49,3
Lokomotiv Gomel,6,2,3,1,11,11,0,9,Belarus - First League,0.33,0.83,0,1.83,1.5,3.03,1.2,4
Belshina,5,2,2,1,11,8,3,8,Belarus - First League,0.4,0.8,3,2.2,1.6,2.5,1.25,5
Bumprom,6,1,4,1,7,6,1,7,Belarus - First League,0.17,0.83,1,1.17,1.17,5.88,1.2,6
Uni X L. Minsk,6,2,1,3,8,13,-5,7,Belarus - First League,0.33,0.5,-5,1.33,1.17,3.03,2.0,6
Baranovichi,5,1,3,1,7,7,0,6,Belarus - First League,0.2,0.8,0,1.4,1.2,5.0,1.25,7
Osipovichy,7,1,2,4,12,16,-4,5,Belarus - First League,0.14,0.43,-4,1.71,0.71,7.14,2.33,8
Orsha,6,1,1,4,10,19,-9,4,Belarus - First League,0.17,0.33,-9,1.67,0.67,5.88,3.03,9
Gomel B,6,0,3,3,5,10,-5,3,Belarus - First League,0.0,0.5,-5,0.83,0.5,0.0,2.0,10
Minsk B,7,0,0,7,5,16,-11,0,Belarus - First League,0.0,0.0,-11,0.71,0.0,0.0,0.0,11
KRC Genk,8,6,2,0,11,5,6,20,Belgium - Pro League,0.75,1.0,6,1.38,2.5,1.33,1.0,1
Royale Union SG,8,6,0,2,18,6,12,18,Belgium - Pro League,0.75,0.75,12,2.25,2.25,1.33,1.33,2
Anderlecht,8,5,0,3,12,6,6,15,Belgium - Pro League,0.62,0.62,6,1.5,1.88,1.61,1.61,3
Westerlo,8,4,2,2,13,10,3,14,Belgium - Pro League,0.5,0.75,3,1.62,1.75,2.0,1.33,4
Gent,8,3,4,1,10,8,2,13,Belgium - Pro League,0.38,0.88,2,1.25,1.62,2.63,1.14,5
Club Brugge,8,3,3,2,14,11,3,12,Belgium - Pro League,0.38,0.75,3,1.75,1.5,2.63,1.33,6
OH Leuven,8,3,3,2,9,9,0,12,Belgium - Pro League,0.38,0.75,0,1.12,1.5,2.63,1.33,6
KV Mechelen,8,3,2,3,9,11,-2,11,Belgium - Pro League,0.38,0.62,-2,1.12,1.38,2.63,1.61,7
Antwerp,8,2,4,2,7,8,-1,10,Belgium - Pro League,0.25,0.75,-1,0.88,1.25,4.0,1.33,8
Charleroi,8,2,3,3,13,10,3,9,Belgium - Pro League,0.25,0.62,3,1.62,1.12,4.0,1.61,9
Sint-Truiden,8,2,3,3,14,13,1,9,Belgium - Pro League,0.25,0.62,1,1.75,1.12,4.0,1.61,9
Kortrijk,8,2,2,4,11,13,-2,8,Belgium - Pro League,0.25,0.5,-2,1.38,1.0,4.0,2.0,10
Standard Liege,8,2,2,4,7,13,-6,8,Belgium - Pro League,0.25,0.5,-6,0.88,1.0,4.0,2.0,10
Cercle Brugge,8,0,5,3,6,12,-6,5,Belgium - Pro League,0.0,0.62,-6,0.75,0.62,0.0,1.61,11
Beerschot,8,1,2,5,5,13,-8,5,Belgium - Pro League,0.12,0.38,-8,0.62,0.62,8.33,2.63,11
Dender,8,1,1,6,6,17,-11,4,Belgium - Pro League,0.12,0.25,-11,0.75,0.5,8.33,4.0,12
Lokeren-Temse,8,7,0,1,15,4,11,21,Belgium - Challenger Pro League,0.88,0.88,11,1.88,2.62,1.14,1.14,1
La Louviere,8,6,2,0,15,6,9,20,Belgium - Challenger Pro League,0.75,1.0,9,1.88,2.5,1.33,1.0,2
Beveren,8,6,1,1,17,8,9,19,Belgium - Challenger Pro League,0.75,0.88,9,2.12,2.38,1.33,1.14,3
RWDM,8,5,1,2,10,4,6,16,Belgium - Challenger Pro League,0.62,0.75,6,1.25,2.0,1.61,1.33,4
Club Brugge B,8,4,1,3,13,9,4,13,Belgium - Challenger Pro League,0.5,0.62,4,1.62,1.62,2.0,1.61,5
Zulte-Waregem,8,4,1,3,13,10,3,13,Belgium - Challenger Pro League,0.5,0.62,3,1.62,1.62,2.0,1.61,5
Patro Eisden,8,3,3,2,8,7,1,12,Belgium - Challenger Pro League,0.38,0.75,1,1.0,1.5,2.63,1.33,6
RFC Liege,8,3,2,3,15,14,1,11,Belgium - Challenger Pro League,0.38,0.62,1,1.88,1.38,2.63,1.61,7
Eupen,8,3,2,3,8,10,-2,11,Belgium - Challenger Pro League,0.38,0.62,-2,1.0,1.38,2.63,1.61,7
Lierse K.,8,3,1,4,9,8,1,10,Belgium - Challenger Pro League,0.38,0.5,1,1.12,1.25,2.63,2.0,8
Lommel SK,8,3,1,4,8,8,0,10,Belgium - Challenger Pro League,0.38,0.5,0,1.0,1.25,2.63,2.0,8
Francs Borains,8,2,0,6,8,15,-7,6,Belgium - Challenger Pro League,0.25,0.25,-7,1.0,0.75,4.0,4.0,9
Seraing,8,0,3,5,7,19,-12,3,Belgium - Challenger Pro League,0.0,0.38,-12,0.88,0.38,0.0,2.63,10
Anderlecht B,8,0,2,6,9,22,-13,2,Belgium - Challenger Pro League,0.0,0.25,-13,1.12,0.25,0.0,4.0,11
KRC Genk B,8,0,1,7,4,17,-13,1,Belgium - Challenger Pro League,0.0,0.12,-13,0.5,0.12,0.0,8.33,12
Deinze,0,0,0,0,0,0,0,0,Belgium - Challenger Pro League,0.0,0.0,0,0.0,0.0,0.0,0.0,13
Always Ready,6,6,0,0,21,4,17,18,Bolivia - Primera Div. - Apertura,1.0,1.0,17,3.5,3.0,1.0,1.0,1
Bolivar,6,5,0,1,21,7,14,15,Bolivia - Primera Div. - Apertura,0.83,0.83,14,3.5,2.5,1.2,1.2,2
The Strongest,6,4,1,1,16,7,9,13,Bolivia - Primera Div. - Apertura,0.67,0.83,9,2.67,2.17,1.49,1.2,3
Blooming,6,4,0,2,15,11,4,12,Bolivia - Primera Div. - Apertura,0.67,0.67,4,2.5,2.0,1.49,1.49,4
ABB,6,3,2,1,5,4,1,11,Bolivia - Primera Div. - Apertura,0.5,0.83,1,0.83,1.83,2.0,1.2,5
Aurora,6,2,2,2,13,11,2,8,Bolivia - Primera Div. - Apertura,0.33,0.67,2,2.17,1.33,3.03,1.49,6
SA Bulo Bulo,6,2,2,2,9,9,0,8,Bolivia - Primera Div. - Apertura,0.33,0.67,0,1.5,1.33,3.03,1.49,6
GV San Jose,6,2,1,3,7,13,-6,7,Bolivia - Primera Div. - Apertura,0.33,0.5,-6,1.17,1.17,3.03,2.0,7
Real Oruro,6,1,3,2,6,7,-1,6,Bolivia - Primera Div. - Apertura,0.17,0.67,-1,1.0,1.0,5.88,1.49,8
Real Tomayapo,6,1,3,2,4,6,-2,6,Bolivia - Primera Div. - Apertura,0.17,0.67,-2,0.67,1.0,5.88,1.49,8
Guabira,6,2,0,4,11,18,-7,6,Bolivia - Primera Div. - Apertura,0.33,0.33,-7,1.83,1.0,3.03,3.03,8
I. Petrolero,6,1,2,3,5,10,-5,5,Bolivia - Primera Div. - Apertura,0.17,0.5,-5,0.83,0.83,5.88,2.0,9
U. de Vinto,6,1,2,3,6,14,-8,5,Bolivia - Primera Div. - Apertura,0.17,0.5,-8,1.0,0.83,5.88,2.0,9
Nacional Potosi,5,1,1,3,6,7,-1,4,Bolivia - Primera Div. - Apertura,0.2,0.4,-1,1.2,0.8,5.0,2.5,10
Oriente P.,5,0,3,2,4,9,-5,3,Bolivia - Primera Div. - Apertura,0.0,0.6,-5,0.8,0.6,0.0,1.67,11
Wilstermann,6,1,0,5,5,17,-12,3,Bolivia - Primera Div. - Apertura,0.17,0.17,-12,0.83,0.5,5.88,5.88,11
Bolivar,8,6,1,1,28,11,17,19,Bolivia - Primera Div. - Clausura,0.75,0.88,17,3.5,2.38,1.33,1.14,1
The Strongest,8,6,0,2,26,11,15,18,Bolivia - Primera Div. - Clausura,0.75,0.75,15,3.25,2.25,1.33,1.33,2
Always Ready,8,4,1,3,20,13,7,13,Bolivia - Primera Div. - Clausura,0.5,0.62,7,2.5,1.62,2.0,1.61,3
Gualberto V. SJ,8,4,1,3,18,12,6,13,Bolivia - Primera Div. - Clausura,0.5,0.62,6,2.25,1.62,2.0,1.61,3
Nacional Potosi,8,4,1,3,16,12,4,13,Bolivia - Primera Div. - Clausura,0.5,0.62,4,2.0,1.62,2.0,1.61,3
Royal Pari,8,4,1,3,11,10,1,13,Bolivia - Primera Div. - Clausura,0.5,0.62,1,1.38,1.62,2.0,1.61,3
Aurora,8,3,3,2,19,14,5,12,Bolivia - Primera Div. - Clausura,0.38,0.75,5,2.38,1.5,2.63,1.33,4
Real Tomayapo,8,4,0,4,14,12,2,12,Bolivia - Primera Div. - Clausura,0.5,0.5,2,1.75,1.5,2.0,2.0,4
Blooming,8,3,3,2,10,13,-3,12,Bolivia - Primera Div. - Clausura,0.38,0.75,-3,1.25,1.5,2.63,1.33,4
Guabira,8,3,2,3,10,10,0,11,Bolivia - Primera Div. - Clausura,0.38,0.62,0,1.25,1.38,2.63,1.61,5
Wilstermann,8,2,4,2,11,13,-2,10,Bolivia - Primera Div. - Clausura,0.25,0.75,-2,1.38,1.25,4.0,1.33,6
I. Petrolero,8,3,0,5,13,20,-7,9,Bolivia - Primera Div. - Clausura,0.38,0.38,-7,1.62,1.12,2.63,2.63,7
SA Bulo Bulo,8,2,2,4,14,22,-8,8,Bolivia - Primera Div. - Clausura,0.25,0.5,-8,1.75,1.0,4.0,2.0,8
Oriente P.,8,2,1,5,14,23,-9,7,Bolivia - Primera Div. - Clausura,0.25,0.38,-9,1.75,0.88,4.0,2.63,9
U. de Vinto,8,2,1,5,8,17,-9,7,Bolivia - Primera Div. - Clausura,0.25,0.38,-9,1.0,0.88,4.0,2.63,9
Santa Cruz,8,1,0,7,7,27,-20,3,Bolivia - Primera Div. - Clausura,0.12,0.12,-20,0.88,0.38,8.33,8.33,10
Palmeiras,7,5,1,1,8,3,5,16,Brazil - Serie A,0.71,0.86,5,1.14,2.29,1.41,1.16,1
Bragantino,7,5,1,1,9,5,4,16,Brazil - Serie A,0.71,0.86,4,1.29,2.29,1.41,1.16,1
Flamengo,7,4,2,1,16,4,12,14,Brazil - Serie A,0.57,0.86,12,2.29,2.0,1.75,1.16,2
Cruzeiro,7,4,1,2,9,7,2,13,Brazil - Serie A,0.57,0.71,2,1.29,1.86,1.75,1.41,3
Fluminense,7,4,1,2,8,7,1,13,Brazil - Serie A,0.57,0.71,1,1.14,1.86,1.75,1.41,3
Bahia,7,3,3,1,7,7,0,12,Brazil - Serie A,0.43,0.86,0,1.0,1.71,2.33,1.16,4
Ceara,7,3,2,2,9,7,2,11,Brazil - Serie A,0.43,0.71,2,1.29,1.57,2.33,1.41,5
Corinthians,7,3,1,3,10,12,-2,10,Brazil - Serie A,0.43,0.57,-2,1.43,1.43,2.33,1.75,6
Internacional,7,2,3,2,10,8,2,9,Brazil - Serie A,0.29,0.71,2,1.43,1.29,3.45,1.41,7
Sao Paulo,7,1,6,0,6,5,1,9,Brazil - Serie A,0.14,1.0,1,0.86,1.29,7.14,1.0,7
Atletico MG,7,2,3,2,7,8,-1,9,Brazil - Serie A,0.29,0.71,-1,1.0,1.29,3.45,1.41,7
Botafogo,7,2,2,3,6,5,1,8,Brazil - Serie A,0.29,0.57,1,0.86,1.14,3.45,1.75,8
Gremio,7,2,2,3,6,11,-5,8,Brazil - Serie A,0.29,0.57,-5,0.86,1.14,3.45,1.75,8
Mirassol,7,1,4,2,11,10,1,7,Brazil - Serie A,0.14,0.71,1,1.57,1.0,7.14,1.41,9
Fortaleza,7,1,4,2,5,5,0,7,Brazil - Serie A,0.14,0.71,0,0.71,1.0,7.14,1.41,9
Vasco da Gama,7,2,1,4,6,9,-3,7,Brazil - Serie A,0.29,0.43,-3,0.86,1.0,3.45,2.33,9
Juventude,7,2,1,4,7,15,-8,7,Brazil - Serie A,0.29,0.43,-8,1.0,1.0,3.45,2.33,9
Vitoria,7,1,3,3,7,10,-3,6,Brazil - Serie A,0.14,0.57,-3,1.0,0.86,7.14,1.75,10
Santos,7,1,1,5,7,10,-3,4,Brazil - Serie A,0.14,0.29,-3,1.0,0.57,7.14,3.45,11
Sport Recife,7,0,2,5,4,10,-6,2,Brazil - Serie A,0.0,0.29,-6,0.57,0.29,0.0,3.45,12
Vila Nova,6,4,1,1,7,3,4,13,Brazil - Serie B,0.67,0.83,4,1.17,2.17,1.49,1.2,1
Goias,6,4,1,1,8,5,3,13,Brazil - Serie B,0.67,0.83,3,1.33,2.17,1.49,1.2,1
Remo,6,3,3,0,8,4,4,12,Brazil - Serie B,0.5,1.0,4,1.33,2.0,2.0,1.0,2
Cuiaba,6,3,3,0,8,5,3,12,Brazil - Serie B,0.5,1.0,3,1.33,2.0,2.0,1.0,2
Avai,6,3,2,1,10,5,5,11,Brazil - Serie B,0.5,0.83,5,1.67,1.83,2.0,1.2,3
CRB,6,3,2,1,6,5,1,11,Brazil - Serie B,0.5,0.83,1,1.0,1.83,2.0,1.2,3
Coritiba,6,3,1,2,6,4,2,10,Brazil - Serie B,0.5,0.67,2,1.0,1.67,2.0,1.49,4
Chapecoense,7,3,1,3,7,6,1,10,Brazil - Serie B,0.43,0.57,1,1.0,1.43,2.33,1.75,4
Athletico PR,7,3,1,3,10,11,-1,10,Brazil - Serie B,0.43,0.57,-1,1.43,1.43,2.33,1.75,4
Ferroviaria,6,2,3,1,5,3,2,9,Brazil - Serie B,0.33,0.83,2,0.83,1.5,3.03,1.2,5
Atletico GO,6,2,3,1,8,7,1,9,Brazil - Serie B,0.33,0.83,1,1.33,1.5,3.03,1.2,5
Novorizontino,6,2,3,1,5,4,1,9,Brazil - Serie B,0.33,0.83,1,0.83,1.5,3.03,1.2,5
America MG,6,3,0,3,5,7,-2,9,Brazil - Serie B,0.5,0.5,-2,0.83,1.5,2.0,2.0,5
Operario PR,6,2,1,3,4,6,-2,7,Brazil - Serie B,0.33,0.5,-2,0.67,1.17,3.03,2.0,6
Criciuma,6,1,2,3,9,8,1,5,Brazil - Serie B,0.17,0.5,1,1.5,0.83,5.88,2.0,7
Botafogo SP,6,1,2,3,7,8,-1,5,Brazil - Serie B,0.17,0.5,-1,1.17,0.83,5.88,2.0,7
Volta Redonda,6,1,1,4,2,5,-3,4,Brazil - Serie B,0.17,0.33,-3,0.33,0.67,5.88,3.03,8
Athletic Club,6,1,0,5,5,13,-8,3,Brazil - Serie B,0.17,0.17,-8,0.83,0.5,5.88,5.88,9
Paysandu,6,0,2,4,2,7,-5,2,Brazil - Serie B,0.0,0.33,-5,0.33,0.33,0.0,3.03,10
Amazonas,6,0,2,4,2,8,-6,2,Brazil - Serie B,0.0,0.33,-6,0.33,0.33,0.0,3.03,10
Ituano,4,3,1,0,7,3,4,10,Brazil - Serie C,0.75,1.0,4,1.75,2.5,1.33,1.0,1
Ponte Preta,4,3,1,0,6,2,4,10,Brazil - Serie C,0.75,1.0,4,1.5,2.5,1.33,1.0,1
Maringa,4,3,1,0,8,5,3,10,Brazil - Serie C,0.75,1.0,3,2.0,2.5,1.33,1.0,1
Caxias,4,3,0,1,7,4,3,9,Brazil - Serie C,0.75,0.75,3,1.75,2.25,1.33,1.33,2
Londrina,4,2,2,0,6,2,4,8,Brazil - Serie C,0.5,1.0,4,1.5,2.0,2.0,1.0,3
Brusque,4,2,2,0,2,0,2,8,Brazil - Serie C,0.5,1.0,2,0.5,2.0,2.0,1.0,3
Tombense,4,2,1,1,6,5,1,7,Brazil - Serie C,0.5,0.75,1,1.5,1.75,2.0,1.33,4
Ypiranga,4,2,0,2,5,6,-1,6,Brazil - Serie C,0.5,0.5,-1,1.25,1.5,2.0,2.0,5
Botafogo PB,4,1,2,1,4,2,2,5,Brazil - Serie C,0.25,0.75,2,1.0,1.25,4.0,1.33,6
CSA,4,1,2,1,4,4,0,5,Brazil - Serie C,0.25,0.75,0,1.0,1.25,4.0,1.33,6
Sao Bernardo,4,1,2,1,2,2,0,5,Brazil - Serie C,0.25,0.75,0,0.5,1.25,4.0,1.33,6
Retro,4,1,1,2,2,3,-1,4,Brazil - Serie C,0.25,0.5,-1,0.5,1.0,4.0,2.0,7
Floresta,4,1,1,2,1,3,-2,4,Brazil - Serie C,0.25,0.5,-2,0.25,1.0,4.0,2.0,7
ABC,4,0,3,1,4,5,-1,3,Brazil - Serie C,0.0,0.75,-1,1.0,0.75,0.0,1.33,8
Guarani,4,1,0,3,4,7,-3,3,Brazil - Serie C,0.25,0.25,-3,1.0,0.75,4.0,4.0,8
Itabaiana,4,1,0,3,4,7,-3,3,Brazil - Serie C,0.25,0.25,-3,1.0,0.75,4.0,4.0,8
Confianca,4,1,0,3,5,9,-4,3,Brazil - Serie C,0.25,0.25,-4,1.25,0.75,4.0,4.0,8
Nautico,4,0,2,2,2,4,-2,2,Brazil - Serie C,0.0,0.5,-2,0.5,0.5,0.0,2.0,9
Anapolis,4,0,2,2,1,4,-3,2,Brazil - Serie C,0.0,0.5,-3,0.25,0.5,0.0,2.0,9
Figueirense,4,0,1,3,6,9,-3,1,Brazil - Serie C,0.0,0.25,-3,1.5,0.25,0.0,4.0,10
ASA,3,3,0,0,8,2,6,9,Brazil - Serie D,1.0,1.0,6,2.67,3.0,1.0,1.0,1
Ceilandia,3,3,0,0,4,1,3,9,Brazil - Serie D,1.0,1.0,3,1.33,3.0,1.0,1.0,1
Luverdense,3,3,0,0,3,0,3,9,Brazil - Serie D,1.0,1.0,3,1.0,3.0,1.0,1.0,1
America RN,3,2,1,0,6,1,5,7,Brazil - Serie D,0.67,1.0,5,2.0,2.33,1.49,1.0,2
Santa Cruz,3,2,1,0,5,0,5,7,Brazil - Serie D,0.67,1.0,5,1.67,2.33,1.49,1.0,2
Cianorte,3,2,1,0,6,2,4,7,Brazil - Serie D,0.67,1.0,4,2.0,2.33,1.49,1.0,2
Manauara,3,2,1,0,6,2,4,7,Brazil - Serie D,0.67,1.0,4,2.0,2.33,1.49,1.0,2
Aparecidense,3,2,1,0,4,0,4,7,Brazil - Serie D,0.67,1.0,4,1.33,2.33,1.49,1.0,2
Inter Limeira,3,2,1,0,5,2,3,7,Brazil - Serie D,0.67,1.0,3,1.67,2.33,1.49,1.0,2
Aguia de Maraba,3,2,1,0,4,1,3,7,Brazil - Serie D,0.67,1.0,3,1.33,2.33,1.49,1.0,2
Joinville,3,2,1,0,3,1,2,7,Brazil - Serie D,0.67,1.0,2,1.0,2.33,1.49,1.0,2
Barra FC,3,2,0,1,5,2,3,6,Brazil - Serie D,0.67,0.67,3,1.67,2.0,1.49,1.49,3
Tuna Luso,3,2,0,1,7,5,2,6,Brazil - Serie D,0.67,0.67,2,2.33,2.0,1.49,1.49,3
Ferroviario,3,2,0,1,5,3,2,6,Brazil - Serie D,0.67,0.67,2,1.67,2.0,1.49,1.49,3
Rio Branco ES,3,2,0,1,4,2,2,6,Brazil - Serie D,0.67,0.67,2,1.33,2.0,1.49,1.49,3
Agua Santa,3,2,0,1,6,5,1,6,Brazil - Serie D,0.67,0.67,1,2.0,2.0,1.49,1.49,3
Azuriz,3,2,0,1,3,2,1,6,Brazil - Serie D,0.67,0.67,1,1.0,2.0,1.49,1.49,3
Jequie,3,2,0,1,4,4,0,6,Brazil - Serie D,0.67,0.67,0,1.33,2.0,1.49,1.49,3
Manaus,3,1,2,0,6,2,4,5,Brazil - Serie D,0.33,1.0,4,2.0,1.67,3.03,1.0,4
Maranhao,3,1,2,0,4,1,3,5,Brazil - Serie D,0.33,1.0,3,1.33,1.67,3.03,1.0,4
Altos,3,1,2,0,4,2,2,5,Brazil - Serie D,0.33,1.0,2,1.33,1.67,3.03,1.0,4
EC Sao Jose,3,1,2,0,4,2,2,5,Brazil - Serie D,0.33,1.0,2,1.33,1.67,3.03,1.0,4
Itabirito,3,1,2,0,3,2,1,5,Brazil - Serie D,0.33,1.0,1,1.0,1.67,3.03,1.0,4
Maracana,3,1,2,0,3,2,1,5,Brazil - Serie D,0.33,1.0,1,1.0,1.67,3.03,1.0,4
Sergipe,3,1,1,1,3,1,2,4,Brazil - Serie D,0.33,0.67,2,1.0,1.33,3.03,1.49,5
Goiatuba EC,3,1,1,1,5,4,1,4,Brazil - Serie D,0.33,0.67,1,1.67,1.33,3.03,1.49,5
CFRJ . Marica,3,1,1,1,4,3,1,4,Brazil - Serie D,0.33,0.67,1,1.33,1.33,3.03,1.49,5
Portuguesa,3,1,1,1,5,5,0,4,Brazil - Serie D,0.33,0.67,0,1.67,1.33,3.03,1.49,5
Independencia,3,1,1,1,4,4,0,4,Brazil - Serie D,0.33,0.67,0,1.33,1.33,3.03,1.49,5
Flamengo,8,7,1,0,22,0,22,22,Brazil - Carioca,0.88,1.0,22,2.75,2.75,1.14,1.0,1
Fluminense,8,4,3,1,12,7,5,15,Brazil - Carioca,0.5,0.88,5,1.5,1.88,2.0,1.14,2
Vasco da Gama,8,4,2,2,11,7,4,14,Brazil - Carioca,0.5,0.75,4,1.38,1.75,2.0,1.33,3
Volta Redonda,8,4,2,2,11,10,1,14,Brazil - Carioca,0.5,0.75,1,1.38,1.75,2.0,1.33,3
Sampaio Correa,8,3,3,2,11,9,2,12,Brazil - Carioca,0.38,0.75,2,1.38,1.5,2.63,1.33,4
Madureira,8,3,2,3,7,5,2,11,Brazil - Carioca,0.38,0.62,2,0.88,1.38,2.63,1.61,5
Boavista,8,1,7,0,7,5,2,10,Brazil - Carioca,0.12,1.0,2,0.88,1.25,8.33,1.0,6
Botafogo,8,3,1,4,7,8,-1,10,Brazil - Carioca,0.38,0.5,-1,0.88,1.25,2.63,2.0,6
Nova Iguacu,8,2,3,3,4,7,-3,9,Brazil - Carioca,0.25,0.62,-3,0.5,1.12,4.0,1.61,7
CFRJ . Marica,8,1,2,5,7,15,-8,5,Brazil - Carioca,0.12,0.38,-8,0.88,0.62,8.33,2.63,8
Portuguesa RJ,8,1,1,6,9,21,-12,4,Brazil - Carioca,0.12,0.25,-12,1.12,0.5,8.33,4.0,9
Bangu,8,0,3,5,4,18,-14,3,Brazil - Carioca,0.0,0.38,-14,0.5,0.38,0.0,2.63,10
Atletico MG,8,4,4,0,9,2,7,16,Brazil - Mineiro,0.5,1.0,7,1.12,2.0,2.0,1.0,1
Tombense,8,5,1,2,8,5,3,16,Brazil - Mineiro,0.62,0.75,3,1.0,2.0,1.61,1.33,1
Betim,8,4,3,1,12,5,7,15,Brazil - Mineiro,0.5,0.88,7,1.5,1.88,2.0,1.14,2
America MG,8,3,4,1,14,5,9,13,Brazil - Mineiro,0.38,0.88,9,1.75,1.62,2.63,1.14,3
Athletic Club,8,4,0,4,12,12,0,12,Brazil - Mineiro,0.5,0.5,0,1.5,1.5,2.0,2.0,4
Cruzeiro,8,3,2,3,11,9,2,11,Brazil - Mineiro,0.38,0.62,2,1.38,1.38,2.63,1.61,5
Democrata GV,8,3,2,3,8,9,-1,11,Brazil - Mineiro,0.38,0.62,-1,1.0,1.38,2.63,1.61,5
Uberlandia,8,2,3,3,10,10,0,9,Brazil - Mineiro,0.25,0.62,0,1.25,1.12,4.0,1.61,6
Itabirito,8,2,2,4,7,11,-4,8,Brazil - Mineiro,0.25,0.5,-4,0.88,1.0,4.0,2.0,7
Pouso Alegre,8,2,2,4,7,15,-8,8,Brazil - Mineiro,0.25,0.5,-8,0.88,1.0,4.0,2.0,7
Aymores,8,1,4,3,3,5,-2,7,Brazil - Mineiro,0.12,0.62,-2,0.38,0.88,8.33,1.61,8
Villa Nova,8,1,1,6,4,17,-13,4,Brazil - Mineiro,0.12,0.25,-13,0.5,0.5,8.33,4.0,9
Anapolis,8,6,0,2,13,6,7,18,Brazil - Goiano,0.75,0.75,7,1.62,2.25,1.33,1.33,1
Vila Nova,8,4,3,1,8,5,3,15,Brazil - Goiano,0.5,0.88,3,1.0,1.88,2.0,1.14,2
Atletico GO,8,4,2,2,10,6,4,14,Brazil - Goiano,0.5,0.75,4,1.25,1.75,2.0,1.33,3
CRAC,8,4,2,2,7,4,3,14,Brazil - Goiano,0.5,0.75,3,0.88,1.75,2.0,1.33,3
Goias,8,4,2,2,7,5,2,14,Brazil - Goiano,0.5,0.75,2,0.88,1.75,2.0,1.33,3
Goianesia,8,2,4,2,11,9,2,10,Brazil - Goiano,0.25,0.75,2,1.38,1.25,4.0,1.33,4
ABECAT Ouvidore,8,3,1,4,8,10,-2,10,Brazil - Goiano,0.38,0.5,-2,1.0,1.25,2.63,2.0,4
Goiatuba EC,8,2,4,2,4,6,-2,10,Brazil - Goiano,0.25,0.75,-2,0.5,1.25,4.0,1.33,4
Jataiense,8,3,0,5,10,10,0,9,Brazil - Goiano,0.38,0.38,0,1.25,1.12,2.63,2.63,5
Goiania,8,2,1,5,8,14,-6,7,Brazil - Goiano,0.25,0.38,-6,1.0,0.88,4.0,2.63,6
Aparecidense,8,1,3,4,4,7,-3,6,Brazil - Goiano,0.12,0.5,-3,0.5,0.75,8.33,2.0,7
Inhumas,8,1,2,5,5,13,-8,5,Brazil - Goiano,0.12,0.38,-8,0.62,0.62,8.33,2.63,8
Santa Cruz,8,6,1,1,13,3,10,19,Brazil - Pernambucano,0.75,0.88,10,1.62,2.38,1.33,1.14,1
Nautico,8,5,0,3,14,8,6,15,Brazil - Pernambucano,0.62,0.62,6,1.75,1.88,1.61,1.61,2
Sport Recife,8,4,2,2,16,7,9,14,Brazil - Pernambucano,0.5,0.75,9,2.0,1.75,2.0,1.33,3
Maguary PE,8,4,2,2,10,9,1,14,Brazil - Pernambucano,0.5,0.75,1,1.25,1.75,2.0,1.33,3
Retro,8,3,3,2,7,7,0,12,Brazil - Pernambucano,0.38,0.75,0,0.88,1.5,2.63,1.33,4
Decisao,8,3,3,2,10,11,-1,12,Brazil - Pernambucano,0.38,0.75,-1,1.25,1.5,2.63,1.33,4
Jaguar,8,3,1,4,10,16,-6,10,Brazil - Pernambucano,0.38,0.5,-6,1.25,1.25,2.63,2.0,5
Central,8,2,2,4,8,9,-1,8,Brazil - Pernambucano,0.25,0.5,-1,1.0,1.0,4.0,2.0,6
Afogados,8,0,4,4,4,12,-8,4,Brazil - Pernambucano,0.0,0.5,-8,0.5,0.5,0.0,2.0,7
Petrolina,8,0,2,6,3,13,-10,2,Brazil - Pernambucano,0.0,0.25,-10,0.38,0.25,0.0,4.0,8
Corinthians,8,5,3,0,13,7,6,18,Brazil - Paulista,0.62,1.0,6,1.62,2.25,1.61,1.0,1
Palmeiras,8,4,4,0,15,6,9,16,Brazil - Paulista,0.5,1.0,9,1.88,2.0,2.0,1.0,2
Ponte Preta,8,5,1,2,9,6,3,16,Brazil - Paulista,0.62,0.75,3,1.12,2.0,1.61,1.33,2
Santos,8,4,2,2,15,8,7,14,Brazil - Paulista,0.5,0.75,7,1.88,1.75,2.0,1.33,3
Bragantino,8,4,2,2,10,5,5,14,Brazil - Paulista,0.5,0.75,5,1.25,1.75,2.0,1.33,3
Sao Bernardo,8,4,2,2,12,11,1,14,Brazil - Paulista,0.5,0.75,1,1.5,1.75,2.0,1.33,3
Novorizontino,8,3,4,1,8,6,2,13,Brazil - Paulista,0.38,0.88,2,1.0,1.62,2.63,1.14,4
Portuguesa,8,2,5,1,12,10,2,11,Brazil - Paulista,0.25,0.88,2,1.5,1.38,4.0,1.14,5
Velo Clube,8,2,4,2,10,10,0,10,Brazil - Paulista,0.25,0.75,0,1.25,1.25,4.0,1.33,6
Sao Paulo,8,2,3,3,12,11,1,9,Brazil - Paulista,0.25,0.62,1,1.5,1.12,4.0,1.61,7
Botafogo SP,8,2,3,3,8,10,-2,9,Brazil - Paulista,0.25,0.62,-2,1.0,1.12,4.0,1.61,7
Mirassol,8,2,1,5,10,17,-7,7,Brazil - Paulista,0.25,0.38,-7,1.25,0.88,4.0,2.63,8
Guarani,8,1,3,4,10,13,-3,6,Brazil - Paulista,0.12,0.5,-3,1.25,0.75,8.33,2.0,9
Agua Santa,8,0,4,4,5,13,-8,4,Brazil - Paulista,0.0,0.5,-8,0.62,0.5,0.0,2.0,10
Noroeste,8,0,3,5,9,16,-7,3,Brazil - Paulista,0.0,0.38,-7,1.12,0.38,0.0,2.63,11
Inter Limeira,8,0,3,5,5,15,-10,3,Brazil - Paulista,0.0,0.38,-10,0.62,0.38,0.0,2.63,11
Treze,8,5,2,1,17,7,10,17,Brazil - Paraibano,0.62,0.88,10,2.12,2.12,1.61,1.14,1
Sousa,8,5,2,1,12,3,9,17,Brazil - Paraibano,0.62,0.88,9,1.5,2.12,1.61,1.14,1
Botafogo PB,8,5,1,2,15,6,9,16,Brazil - Paraibano,0.62,0.75,9,1.88,2.0,1.61,1.33,2
Serra Branca,8,4,2,2,20,8,12,14,Brazil - Paraibano,0.5,0.75,12,2.5,1.75,2.0,1.33,3
Campinense,8,4,2,2,14,9,5,14,Brazil - Paraibano,0.5,0.75,5,1.75,1.75,2.0,1.33,3
Pombal,8,2,3,3,7,8,-1,9,Brazil - Paraibano,0.25,0.62,-1,0.88,1.12,4.0,1.61,4
Nacional Patos,8,2,3,3,13,17,-4,9,Brazil - Paraibano,0.25,0.62,-4,1.62,1.12,4.0,1.61,4
EC de Patos,8,2,1,5,11,16,-5,7,Brazil - Paraibano,0.25,0.38,-5,1.38,0.88,4.0,2.63,5
Auto Esporte,8,1,3,4,8,15,-7,6,Brazil - Paraibano,0.12,0.5,-7,1.0,0.75,8.33,2.0,6
Picuiense,8,0,1,7,5,33,-28,1,Brazil - Paraibano,0.0,0.12,-28,0.62,0.12,0.0,8.33,7
Santa Catarina,8,4,3,1,14,9,5,15,Brazil - Catarinense,0.5,0.88,5,1.75,1.88,2.0,1.14,1
Brusque,8,4,2,2,12,6,6,14,Brazil - Catarinense,0.5,0.75,6,1.5,1.75,2.0,1.33,2
Avai,8,4,1,3,12,6,6,13,Brazil - Catarinense,0.5,0.62,6,1.5,1.62,2.0,1.61,3
Criciuma,8,3,4,1,10,4,6,13,Brazil - Catarinense,0.38,0.88,6,1.25,1.62,2.63,1.14,3
Figueirense,8,4,1,3,16,11,5,13,Brazil - Catarinense,0.5,0.62,5,2.0,1.62,2.0,1.61,3
Barra FC,8,3,3,2,6,7,-1,12,Brazil - Catarinense,0.38,0.75,-1,0.75,1.5,2.63,1.33,4
Marcilio Dias,8,2,4,2,7,8,-1,10,Brazil - Catarinense,0.25,0.75,-1,0.88,1.25,4.0,1.33,5
Concordia,8,3,1,4,8,15,-7,10,Brazil - Catarinense,0.38,0.5,-7,1.0,1.25,2.63,2.0,5
Chapecoense,8,1,6,1,10,9,1,9,Brazil - Catarinense,0.12,0.88,1,1.25,1.12,8.33,1.14,6
Joinville,8,2,3,3,9,14,-5,9,Brazil - Catarinense,0.25,0.62,-5,1.12,1.12,4.0,1.61,6
Caravaggio,8,2,1,5,5,12,-7,7,Brazil - Catarinense,0.25,0.38,-7,0.62,0.88,4.0,2.63,7
Hercilio Luz,8,1,2,5,6,13,-7,5,Brazil - Catarinense,0.12,0.38,-7,0.75,0.62,8.33,2.63,8
Internacional,8,6,2,0,16,4,12,20,Brazil - Gaucho,0.75,1.0,12,2.0,2.5,1.33,1.0,1
Juventude,8,6,1,1,14,6,8,19,Brazil - Gaucho,0.75,0.88,8,1.75,2.38,1.33,1.14,2
Gremio,8,5,2,1,19,3,16,17,Brazil - Gaucho,0.62,0.88,16,2.38,2.12,1.61,1.14,3
Caxias,8,4,2,2,8,9,-1,14,Brazil - Gaucho,0.5,0.75,-1,1.0,1.75,2.0,1.33,4
Ypiranga,8,3,3,2,6,6,0,12,Brazil - Gaucho,0.38,0.75,0,0.75,1.5,2.63,1.33,5
Guarany de Bage,8,2,3,3,6,6,0,9,Brazil - Gaucho,0.25,0.62,0,0.75,1.12,4.0,1.61,6
Sao Luiz,8,2,3,3,7,13,-6,9,Brazil - Gaucho,0.25,0.62,-6,0.88,1.12,4.0,1.61,6
Brasil de P.,8,1,4,3,5,10,-5,7,Brazil - Gaucho,0.12,0.62,-5,0.62,0.88,8.33,1.61,7
Monsoon,8,2,1,5,7,14,-7,7,Brazil - Gaucho,0.25,0.38,-7,0.88,0.88,4.0,2.63,7
Pelotas,8,1,3,4,6,13,-7,6,Brazil - Gaucho,0.12,0.5,-7,0.75,0.75,8.33,2.0,8
EC Sao Jose,8,0,5,3,5,10,-5,5,Brazil - Gaucho,0.0,0.62,-5,0.62,0.62,0.0,1.61,9
Avenida,8,0,3,5,4,9,-5,3,Brazil - Gaucho,0.0,0.38,-5,0.5,0.38,0.0,2.63,10
Ludogorets,8,6,1,1,16,4,12,19,Bulgaria - Parva Liga,0.75,0.88,12,2.0,2.38,1.33,1.14,1
CSKA Sofia,8,5,2,1,10,3,7,17,Bulgaria - Parva Liga,0.62,0.88,7,1.25,2.12,1.61,1.14,2
Arda,8,4,3,1,21,7,14,15,Bulgaria - Parva Liga,0.5,0.88,14,2.62,1.88,2.0,1.14,3
Lokomotiv Sofia,8,4,2,2,13,11,2,14,Bulgaria - Parva Liga,0.5,0.75,2,1.62,1.75,2.0,1.33,4
Levski Sofia,8,3,4,1,9,6,3,13,Bulgaria - Parva Liga,0.38,0.88,3,1.12,1.62,2.63,1.14,5
Botev Vratsa,8,4,1,3,11,12,-1,13,Bulgaria - Parva Liga,0.5,0.62,-1,1.38,1.62,2.0,1.61,5
Spartak Varna,8,4,0,4,12,11,1,12,Bulgaria - Parva Liga,0.5,0.5,1,1.5,1.5,2.0,2.0,6
Botev Plovdiv,8,2,5,1,10,11,-1,11,Bulgaria - Parva Liga,0.25,0.88,-1,1.25,1.38,4.0,1.14,7
Slavia Sofia,8,3,1,4,14,15,-1,10,Bulgaria - Parva Liga,0.38,0.5,-1,1.75,1.25,2.63,2.0,8
Septemvri Sofia,8,3,0,5,10,15,-5,9,Bulgaria - Parva Liga,0.38,0.38,-5,1.25,1.12,2.63,2.63,9
L. Krumovgrad,8,3,0,5,6,16,-10,9,Bulgaria - Parva Liga,0.38,0.38,-10,0.75,1.12,2.63,2.63,9
Lok. Plovdiv,8,2,2,4,7,8,-1,8,Bulgaria - Parva Liga,0.25,0.5,-1,0.88,1.0,4.0,2.0,10
Cherno More,8,1,5,2,7,12,-5,8,Bulgaria - Parva Liga,0.12,0.75,-5,0.88,1.0,8.33,1.33,10
CSKA 1948 Sofia,8,2,1,5,7,12,-5,7,Bulgaria - Parva Liga,0.25,0.38,-5,0.88,0.88,4.0,2.63,11
Beroe,8,1,3,4,6,12,-6,6,Bulgaria - Parva Liga,0.12,0.5,-6,0.75,0.75,8.33,2.0,12
Hebar,8,1,2,5,6,11,-5,5,Bulgaria - Parva Liga,0.12,0.38,-5,0.75,0.62,8.33,2.63,13
A. Ottawa,5,4,1,0,15,7,8,13,Canada - Premier League,0.8,1.0,8,3.0,2.6,1.25,1.0,1
HFX Wanderers,5,3,2,0,8,4,4,11,Canada - Premier League,0.6,1.0,4,1.6,2.2,1.67,1.0,2
Forge,5,2,3,0,6,3,3,9,Canada - Premier League,0.4,1.0,3,1.2,1.8,2.5,1.0,3
Vancouver FC,5,1,2,2,6,9,-3,5,Canada - Premier League,0.2,0.6,-3,1.2,1.0,5.0,1.67,4
York Utd,5,1,1,3,8,9,-1,4,Canada - Premier League,0.2,0.4,-1,1.6,0.8,5.0,2.5,5
Cavalry,4,1,1,2,4,6,-2,4,Canada - Premier League,0.25,0.5,-2,1.0,1.0,4.0,2.0,5
Pacific,5,1,1,3,5,9,-4,4,Canada - Premier League,0.2,0.4,-4,1.0,0.8,5.0,2.5,5
Valour,4,0,1,3,2,7,-5,1,Canada - Premier League,0.0,0.25,-5,0.5,0.25,0.0,4.0,6
U. de Chile,8,5,1,2,15,8,7,16,Chile - Primera Division,0.62,0.75,7,1.88,2.0,1.61,1.33,1
Audax Italiano,8,5,1,2,12,6,6,16,Chile - Primera Division,0.62,0.75,6,1.5,2.0,1.61,1.33,1
Cobresal,8,4,3,1,10,6,4,15,Chile - Primera Division,0.5,0.88,4,1.25,1.88,2.0,1.14,2
U. Catolica,8,4,2,2,13,6,7,14,Chile - Primera Division,0.5,0.75,7,1.62,1.75,2.0,1.33,3
Palestino,8,4,1,3,11,9,2,13,Chile - Primera Division,0.5,0.62,2,1.38,1.62,2.0,1.61,4
Coquimbo Unido,8,3,4,1,7,5,2,13,Chile - Primera Division,0.38,0.88,2,0.88,1.62,2.63,1.14,4
Huachipato,8,4,1,3,10,10,0,13,Chile - Primera Division,0.5,0.62,0,1.25,1.62,2.0,1.61,4
Union La Calera,8,3,3,2,8,7,1,12,Chile - Primera Division,0.38,0.75,1,1.0,1.5,2.63,1.33,5
Colo-Colo,7,3,1,3,9,6,3,10,Chile - Primera Division,0.43,0.57,3,1.29,1.43,2.33,1.75,6
OHiggins,8,2,4,2,9,9,0,10,Chile - Primera Division,0.25,0.75,0,1.12,1.25,4.0,1.33,6
Nublense,8,2,4,2,7,9,-2,10,Chile - Primera Division,0.25,0.75,-2,0.88,1.25,4.0,1.33,6
La Serena,8,3,1,4,8,12,-4,10,Chile - Primera Division,0.38,0.5,-4,1.0,1.25,2.63,2.0,6
Union Espanola,8,2,0,6,9,11,-2,6,Chile - Primera Division,0.25,0.25,-2,1.12,0.75,4.0,4.0,7
D. Limache,8,2,0,6,10,16,-6,6,Chile - Primera Division,0.25,0.25,-6,1.25,0.75,4.0,4.0,7
D. Iquique,8,1,2,5,9,17,-8,5,Chile - Primera Division,0.12,0.38,-8,1.12,0.62,8.33,2.63,8
Everton,8,1,2,5,6,15,-9,5,Chile - Primera Division,0.12,0.38,-9,0.75,0.62,8.33,2.63,8
San Marcos,8,6,1,1,13,7,6,19,Chile - Primera B,0.75,0.88,6,1.62,2.38,1.33,1.14,1
Copiapo,8,5,2,1,13,4,9,17,Chile - Primera B,0.62,0.88,9,1.62,2.12,1.61,1.14,2
San Luis,8,4,3,1,10,7,3,15,Chile - Primera B,0.5,0.88,3,1.25,1.88,2.0,1.14,3
S. Wanderers,8,4,2,2,13,10,3,14,Chile - Primera B,0.5,0.75,3,1.62,1.75,2.0,1.33,4
Recoleta,8,4,2,2,9,7,2,14,Chile - Primera B,0.5,0.75,2,1.12,1.75,2.0,1.33,4
Cobreloa,8,3,4,1,12,9,3,13,Chile - Primera B,0.38,0.88,3,1.5,1.62,2.63,1.14,5
Concepcion,8,4,0,4,12,11,1,12,Chile - Primera B,0.5,0.5,1,1.5,1.5,2.0,2.0,6
Curico Unido,8,2,4,2,10,8,2,10,Chile - Primera B,0.25,0.75,2,1.25,1.25,4.0,1.33,7
U. Concepcion,8,3,1,4,7,7,0,10,Chile - Primera B,0.38,0.5,0,0.88,1.25,2.63,2.0,7
Antofagasta,8,2,3,3,12,16,-4,9,Chile - Primera B,0.25,0.62,-4,1.5,1.12,4.0,1.61,8
Magallanes,8,2,2,4,7,8,-1,8,Chile - Primera B,0.25,0.5,-1,0.88,1.0,4.0,2.0,9
Rangers,8,1,5,2,8,11,-3,8,Chile - Primera B,0.12,0.75,-3,1.0,1.0,8.33,1.33,9
S. Morning,8,2,2,4,5,8,-3,8,Chile - Primera B,0.25,0.5,-3,0.62,1.0,4.0,2.0,9
CD Santa Cruz,8,2,1,5,8,13,-5,7,Chile - Primera B,0.25,0.38,-5,1.0,0.88,4.0,2.63,10
U. San Felipe,8,1,2,5,5,11,-6,5,Chile - Primera B,0.12,0.38,-6,0.62,0.62,8.33,2.63,11
Deportes Temuco,8,1,2,5,5,12,-7,5,Chile - Primera B,0.12,0.38,-7,0.62,0.62,8.33,2.63,11
Chengdu,8,7,1,0,15,4,11,22,China - Super League,0.88,1.0,11,1.88,2.75,1.14,1.0,1
S. Shenhua,8,6,1,1,16,8,8,19,China - Super League,0.75,0.88,8,2.0,2.38,1.33,1.14,2
Beijing Guoan,8,5,3,0,20,9,11,18,China - Super League,0.62,1.0,11,2.5,2.25,1.61,1.0,3
Shanghai Port,8,4,2,2,17,13,4,14,China - Super League,0.5,0.75,4,2.12,1.75,2.0,1.33,4
Qingdao West C.,8,3,3,2,15,15,0,12,China - Super League,0.38,0.75,0,1.88,1.5,2.63,1.33,5
Wuhan Three T.,8,3,2,3,13,15,-2,11,China - Super League,0.38,0.62,-2,1.62,1.38,2.63,1.61,6
Zhejiang,8,3,1,4,14,14,0,10,China - Super League,0.38,0.5,0,1.75,1.25,2.63,2.0,7
Shandong T.,8,3,1,4,15,16,-1,10,China - Super League,0.38,0.5,-1,1.88,1.25,2.63,2.0,7
Tianjin T.,8,2,3,3,13,15,-2,9,China - Super League,0.25,0.62,-2,1.62,1.12,4.0,1.61,8
Dalian Yingbo,8,2,3,3,7,11,-4,9,China - Super League,0.25,0.62,-4,0.88,1.12,4.0,1.61,8
Meizhou Hakka,8,2,2,4,13,15,-2,8,China - Super League,0.25,0.5,-2,1.62,1.0,4.0,2.0,9
Yunnan Yukun,8,2,2,4,11,15,-4,8,China - Super League,0.25,0.5,-4,1.38,1.0,4.0,2.0,9
Sichuan Jiuniu,8,2,2,4,6,15,-9,8,China - Super League,0.25,0.5,-9,0.75,1.0,4.0,2.0,9
Qingdao Hainiu,8,1,3,4,9,11,-2,6,China - Super League,0.12,0.5,-2,1.12,0.75,8.33,2.0,10
Henan SL,8,2,0,6,13,16,-3,6,China - Super League,0.25,0.25,-3,1.62,0.75,4.0,4.0,10
Changchun Yatai,8,1,2,5,9,16,-7,5,China - Super League,0.12,0.38,-7,1.12,0.62,8.33,2.63,11
Chongqing T.,7,6,1,0,15,6,9,19,China - League One,0.86,1.0,9,2.14,2.71,1.16,1.0,1
Liaoning Tieren,7,6,0,1,20,6,14,18,China - League One,0.86,0.86,14,2.86,2.57,1.16,1.16,2
Guangdong GZP,7,5,1,1,14,5,9,16,China - League One,0.71,0.86,9,2.0,2.29,1.41,1.16,3
S. Gongfu,7,4,2,1,11,5,6,14,China - League One,0.57,0.86,6,1.57,2.0,1.75,1.16,4
Suzhou Dongwu,7,3,4,0,7,1,6,13,China - League One,0.43,1.0,6,1.0,1.86,2.33,1.0,5
Dalian Kuncheng,7,2,3,2,7,8,-1,9,China - League One,0.29,0.71,-1,1.0,1.29,3.45,1.41,6
Shenzhen J.,7,3,0,4,10,17,-7,9,China - League One,0.43,0.43,-7,1.43,1.29,2.33,2.33,6
Shanghai Jiadin,7,2,2,3,5,7,-2,8,China - League One,0.29,0.57,-2,0.71,1.14,3.45,1.75,7
Nantong Zhiyun,7,2,2,3,6,9,-3,8,China - League One,0.29,0.57,-3,0.86,1.14,3.45,1.75,7
Yanbian Longdin,7,2,2,3,6,11,-5,8,China - League One,0.29,0.57,-5,0.86,1.14,3.45,1.75,7
Heilongjiang IC,7,1,4,2,8,10,-2,7,China - League One,0.14,0.71,-2,1.14,1.0,7.14,1.41,8
Nanjing City,7,1,3,3,7,9,-2,6,China - League One,0.14,0.57,-2,1.0,0.86,7.14,1.75,9
Shaanxi Union,7,1,2,4,7,9,-2,5,China - League One,0.14,0.43,-2,1.0,0.71,7.14,2.33,10
Foshan Nanshi,7,1,2,4,4,10,-6,5,China - League One,0.14,0.43,-6,0.57,0.71,7.14,2.33,10
Qingdao RL,7,0,4,3,4,9,-5,4,China - League One,0.0,0.57,-5,0.57,0.57,0.0,1.75,11
Guangxi Baoyun,7,0,2,5,4,13,-9,2,China - League One,0.0,0.29,-9,0.57,0.29,0.0,3.45,12
Wuxi Wugou,8,5,3,0,13,2,11,18,China - League Two,0.62,1.0,11,1.62,2.25,1.61,1.0,1
Chengdu Rongche,8,5,2,1,16,5,11,17,China - League Two,0.62,0.88,11,2.0,2.12,1.61,1.14,2
Guangxi H.,8,5,2,1,10,4,6,17,China - League Two,0.62,0.88,6,1.25,2.12,1.61,1.14,2
Changchun Xidu,8,5,2,1,9,3,6,17,China - League Two,0.62,0.88,6,1.12,2.12,1.61,1.14,2
Wenzhou Pro.,8,4,4,0,10,4,6,16,China - League Two,0.5,1.0,6,1.25,2.0,2.0,1.0,3
Guizhou Zhuchen,8,5,1,2,9,7,2,16,China - League Two,0.62,0.75,2,1.12,2.0,1.61,1.33,3
Jiangxi Lushan,8,4,3,1,9,4,5,15,China - League Two,0.5,0.88,5,1.12,1.88,2.0,1.14,4
Shandong T. B,8,4,3,1,8,5,3,15,China - League Two,0.5,0.88,3,1.0,1.88,2.0,1.14,4
Shenzhen 2028,8,4,2,2,6,5,1,14,China - League Two,0.5,0.75,1,0.75,1.75,2.0,1.33,5
Guangzhou Dande,8,4,1,3,12,7,5,13,China - League Two,0.5,0.62,5,1.5,1.62,2.0,1.61,6
Shanghai Port B,8,4,1,3,11,6,5,13,China - League Two,0.5,0.62,5,1.38,1.62,2.0,1.61,6
Haikou M.,8,3,3,2,8,7,1,12,China - League Two,0.38,0.75,1,1.0,1.5,2.63,1.33,7
Nantong Haimen,8,3,3,2,10,11,-1,12,China - League Two,0.38,0.75,-1,1.25,1.5,2.63,1.33,7
Ganzhou Ruishi,8,2,4,2,7,7,0,10,China - League Two,0.25,0.75,0,0.88,1.25,4.0,1.33,8
Langfang Glory,8,2,3,3,7,11,-4,9,China - League Two,0.25,0.62,-4,0.88,1.12,4.0,1.61,9
Wuhan Three Tow,8,1,4,3,6,5,1,7,China - League Two,0.12,0.62,1,0.75,0.88,8.33,1.61,10
Taian Tiankuang,8,2,1,5,6,8,-2,7,China - League Two,0.25,0.38,-2,0.75,0.88,4.0,2.63,10
Xian Ronghai,8,1,4,3,3,10,-7,7,China - League Two,0.12,0.62,-7,0.38,0.88,8.33,1.61,10
Hubei Istar,8,1,3,4,4,9,-5,6,China - League Two,0.12,0.5,-5,0.5,0.75,8.33,2.0,11
Rizhao Yuqi,8,1,3,4,3,9,-6,6,China - League Two,0.12,0.5,-6,0.38,0.75,8.33,2.0,11
Beijing IT,8,1,1,6,6,11,-5,4,China - League Two,0.12,0.25,-5,0.75,0.5,8.33,4.0,12
Quanzhou Yassin,8,0,3,5,3,11,-8,3,China - League Two,0.0,0.38,-8,0.38,0.38,0.0,2.63,13
Guangdong Mingt,8,0,3,5,3,12,-9,3,China - League Two,0.0,0.38,-9,0.38,0.38,0.0,2.63,13
Guangxi Lanhang,8,0,1,7,2,18,-16,1,China - League Two,0.0,0.12,-16,0.25,0.12,0.0,8.33,14
Millonarios,8,4,3,1,10,3,7,15,Colombia - Primera A - Apertura,0.5,0.88,7,1.25,1.88,2.0,1.14,1
Junior,8,4,3,1,9,5,4,15,Colombia - Primera A - Apertura,0.5,0.88,4,1.12,1.88,2.0,1.14,1
Once Caldas,8,4,2,2,10,5,5,14,Colombia - Primera A - Apertura,0.5,0.75,5,1.25,1.75,2.0,1.33,2
Deportes Tolima,8,4,2,2,14,11,3,14,Colombia - Primera A - Apertura,0.5,0.75,3,1.75,1.75,2.0,1.33,2
A. Bucaramanga,8,4,1,3,12,8,4,13,Colombia - Primera A - Apertura,0.5,0.62,4,1.5,1.62,2.0,1.61,3
A. Nacional,8,3,3,2,10,6,4,12,Colombia - Primera A - Apertura,0.38,0.75,4,1.25,1.5,2.63,1.33,4
America de Cali,8,3,3,2,5,6,-1,12,Colombia - Primera A - Apertura,0.38,0.75,-1,0.62,1.5,2.63,1.33,4
D. Pereira,8,2,5,1,11,9,2,11,Colombia - Primera A - Apertura,0.25,0.88,2,1.38,1.38,4.0,1.14,5
I. Medelin,8,2,5,1,6,4,2,11,Colombia - Primera A - Apertura,0.25,0.88,2,0.75,1.38,4.0,1.14,5
Santa Fe,8,3,2,3,8,9,-1,11,Colombia - Primera A - Apertura,0.38,0.62,-1,1.0,1.38,2.63,1.61,5
A. Petrolera,8,3,2,3,5,6,-1,11,Colombia - Primera A - Apertura,0.38,0.62,-1,0.62,1.38,2.63,1.61,5
Envigado,8,3,1,4,9,9,0,10,Colombia - Primera A - Apertura,0.38,0.5,0,1.12,1.25,2.63,2.0,6
Deportivo Cali,8,2,4,2,7,8,-1,10,Colombia - Primera A - Apertura,0.25,0.75,-1,0.88,1.25,4.0,1.33,6
Deportivo Pasto,8,2,4,2,7,9,-2,10,Colombia - Primera A - Apertura,0.25,0.75,-2,0.88,1.25,4.0,1.33,6
Llaneros,8,3,0,5,6,8,-2,9,Colombia - Primera A - Apertura,0.38,0.38,-2,0.75,1.12,2.63,2.63,7
Fortaleza CEIF,8,2,2,4,3,8,-5,8,Colombia - Primera A - Apertura,0.25,0.5,-5,0.38,1.0,4.0,2.0,8
La Equidad,8,2,1,5,7,13,-6,7,Colombia - Primera A - Apertura,0.25,0.38,-6,0.88,0.88,4.0,2.63,9
Boyaca Chico,8,1,3,4,4,14,-10,6,Colombia - Primera A - Apertura,0.12,0.5,-10,0.5,0.75,8.33,2.0,10
R. Aguilas,8,0,5,3,5,8,-3,5,Colombia - Primera A - Apertura,0.0,0.62,-3,0.62,0.62,0.0,1.61,11
Union Magdalena,8,0,4,4,7,11,-4,4,Colombia - Primera A - Apertura,0.0,0.5,-4,0.88,0.5,0.0,2.0,12
I. Medelin,8,5,2,1,15,6,9,17,Colombia - Primera A - Clausura,0.62,0.88,9,1.88,2.12,1.61,1.14,1
Millonarios,8,5,2,1,11,4,7,17,Colombia - Primera A - Clausura,0.62,0.88,7,1.38,2.12,1.61,1.14,1
Junior,8,4,3,1,11,4,7,15,Colombia - Primera A - Clausura,0.5,0.88,7,1.38,1.88,2.0,1.14,2
Santa Fe,8,4,3,1,12,6,6,15,Colombia - Primera A - Clausura,0.5,0.88,6,1.5,1.88,2.0,1.14,2
D. Pereira,8,4,3,1,12,9,3,15,Colombia - Primera A - Clausura,0.5,0.88,3,1.5,1.88,2.0,1.14,2
Deportes Tolima,8,4,2,2,9,4,5,14,Colombia - Primera A - Clausura,0.5,0.75,5,1.12,1.75,2.0,1.33,3
Deportivo Pasto,8,4,1,3,14,11,3,13,Colombia - Primera A - Clausura,0.5,0.62,3,1.75,1.62,2.0,1.61,4
A. Nacional,8,3,4,1,9,7,2,13,Colombia - Primera A - Clausura,0.38,0.88,2,1.12,1.62,2.63,1.14,4
A. Bucaramanga,8,3,3,2,12,7,5,12,Colombia - Primera A - Clausura,0.38,0.75,5,1.5,1.5,2.63,1.33,5
America de Cali,8,3,2,3,10,10,0,11,Colombia - Primera A - Clausura,0.38,0.62,0,1.25,1.38,2.63,1.61,6
Fortaleza CEIF,8,3,1,4,9,8,1,10,Colombia - Primera A - Clausura,0.38,0.5,1,1.12,1.25,2.63,2.0,7
La Equidad,8,2,3,3,12,13,-1,9,Colombia - Primera A - Clausura,0.25,0.62,-1,1.5,1.12,4.0,1.61,8
Patriotas,8,2,2,4,12,14,-2,8,Colombia - Primera A - Clausura,0.25,0.5,-2,1.5,1.0,4.0,2.0,9
Deportivo Cali,8,2,2,4,5,9,-4,8,Colombia - Primera A - Clausura,0.25,0.5,-4,0.62,1.0,4.0,2.0,9
A. Petrolera,8,2,2,4,7,12,-5,8,Colombia - Primera A - Clausura,0.25,0.5,-5,0.88,1.0,4.0,2.0,9
Jaguares de C.,8,2,2,4,7,14,-7,8,Colombia - Primera A - Clausura,0.25,0.5,-7,0.88,1.0,4.0,2.0,9
Envigado,8,2,1,5,5,9,-4,7,Colombia - Primera A - Clausura,0.25,0.38,-4,0.62,0.88,4.0,2.63,10
Boyaca Chico,8,2,1,5,5,15,-10,7,Colombia - Primera A - Clausura,0.25,0.38,-10,0.62,0.88,4.0,2.63,10
Once Caldas,8,1,2,5,4,12,-8,5,Colombia - Primera A - Clausura,0.12,0.38,-8,0.5,0.62,8.33,2.63,11
R. Aguilas,8,1,1,6,4,15,-11,4,Colombia - Primera A - Clausura,0.12,0.25,-11,0.5,0.5,8.33,4.0,12
Saprissa,8,5,2,1,13,7,6,17,Costa Rica - Primera Div. - Apertura,0.62,0.88,6,1.62,2.12,1.61,1.14,1
Alajuelense,8,5,1,2,13,6,7,16,Costa Rica - Primera Div. - Apertura,0.62,0.75,7,1.62,2.0,1.61,1.33,2
Santos Guapiles,8,5,1,2,14,8,6,16,Costa Rica - Primera Div. - Apertura,0.62,0.75,6,1.75,2.0,1.61,1.33,2
Guanacasteca,8,4,1,3,11,11,0,13,Costa Rica - Primera Div. - Apertura,0.5,0.62,0,1.38,1.62,2.0,1.61,3
Herediano,8,3,3,2,11,9,2,12,Costa Rica - Primera Div. - Apertura,0.38,0.75,2,1.38,1.5,2.63,1.33,4
San Carlos,8,2,5,1,11,11,0,11,Costa Rica - Primera Div. - Apertura,0.25,0.88,0,1.38,1.38,4.0,1.14,5
Cartagines,8,3,1,4,15,18,-3,10,Costa Rica - Primera Div. - Apertura,0.38,0.5,-3,1.88,1.25,2.63,2.0,6
Zeledon,8,3,1,4,9,12,-3,10,Costa Rica - Primera Div. - Apertura,0.38,0.5,-3,1.12,1.25,2.63,2.0,6
M. Liberia,8,2,2,4,9,11,-2,8,Costa Rica - Primera Div. - Apertura,0.25,0.5,-2,1.12,1.0,4.0,2.0,7
Sporting SJ,8,2,1,5,10,11,-1,7,Costa Rica - Primera Div. - Apertura,0.25,0.38,-1,1.25,0.88,4.0,2.63,8
Santa Ana,8,2,1,5,7,11,-4,7,Costa Rica - Primera Div. - Apertura,0.25,0.38,-4,0.88,0.88,4.0,2.63,8
Puntarenas,8,2,1,5,8,16,-8,7,Costa Rica - Primera Div. - Apertura,0.25,0.38,-8,1.0,0.88,4.0,2.63,8
Slavia Prague,8,6,1,1,20,6,14,19,CzechRepublic - 1. Liga,0.75,0.88,14,2.5,2.38,1.33,1.14,1
Banik Ostrava,8,5,2,1,13,7,6,17,CzechRepublic - 1. Liga,0.62,0.88,6,1.62,2.12,1.61,1.14,2
Jablonec,8,5,2,1,8,5,3,17,CzechRepublic - 1. Liga,0.62,0.88,3,1.0,2.12,1.61,1.14,2
Viktoria Plzen,8,5,1,2,17,10,7,16,CzechRepublic - 1. Liga,0.62,0.75,7,2.12,2.0,1.61,1.33,3
Slovan Liberec,8,4,2,2,13,8,5,14,CzechRepublic - 1. Liga,0.5,0.75,5,1.62,1.75,2.0,1.33,4
Karvina,8,4,2,2,12,12,0,14,CzechRepublic - 1. Liga,0.5,0.75,0,1.5,1.75,2.0,1.33,4
Hradec Kralove,8,4,1,3,11,8,3,13,CzechRepublic - 1. Liga,0.5,0.62,3,1.38,1.62,2.0,1.61,5
Dukla Praha,8,3,3,2,9,8,1,12,CzechRepublic - 1. Liga,0.38,0.75,1,1.12,1.5,2.63,1.33,6
Teplice,8,2,4,2,7,7,0,10,CzechRepublic - 1. Liga,0.25,0.75,0,0.88,1.25,4.0,1.33,7
Sparta Prague,8,3,1,4,10,12,-2,10,CzechRepublic - 1. Liga,0.38,0.5,-2,1.25,1.25,2.63,2.0,7
Sigma Olomouc,8,2,3,3,8,11,-3,9,CzechRepublic - 1. Liga,0.25,0.62,-3,1.0,1.12,4.0,1.61,8
Bohemians,8,2,1,5,8,11,-3,7,CzechRepublic - 1. Liga,0.25,0.38,-3,1.0,0.88,4.0,2.63,9
Mlada Boleslav,8,2,0,6,6,12,-6,6,CzechRepublic - 1. Liga,0.25,0.25,-6,0.75,0.75,4.0,4.0,10
Slovacko,8,1,2,5,4,16,-12,5,CzechRepublic - 1. Liga,0.12,0.38,-12,0.5,0.62,8.33,2.63,11
Pardubice,8,1,1,6,5,12,-7,4,CzechRepublic - 1. Liga,0.12,0.25,-7,0.62,0.5,8.33,4.0,12
C. Budejovice,8,0,2,6,5,14,-9,2,CzechRepublic - 1. Liga,0.0,0.25,-9,0.62,0.25,0.0,4.0,13
Viborg,8,4,4,0,17,10,7,16,Denmark - Superligaen,0.5,1.0,7,2.12,2.0,2.0,1.0,1
FC Kobenhavn,8,5,0,3,16,11,5,15,Denmark - Superligaen,0.62,0.62,5,2.0,1.88,1.61,1.61,2
Brondby IF,8,4,3,1,12,10,2,15,Denmark - Superligaen,0.5,0.88,2,1.5,1.88,2.0,1.14,2
SonderjyskE,8,4,2,2,13,12,1,14,Denmark - Superligaen,0.5,0.75,1,1.62,1.75,2.0,1.33,3
FC Midtjylland,8,4,1,3,20,13,7,13,Denmark - Superligaen,0.5,0.62,7,2.5,1.62,2.0,1.61,4
Vejle BK,8,3,3,2,11,13,-2,12,Denmark - Superligaen,0.38,0.75,-2,1.38,1.5,2.63,1.33,5
Silkeborg,8,3,2,3,15,10,5,11,Denmark - Superligaen,0.38,0.62,5,1.88,1.38,2.63,1.61,6
Randers FC,8,3,1,4,15,18,-3,10,Denmark - Superligaen,0.38,0.5,-3,1.88,1.25,2.63,2.0,7
Lyngby,8,2,3,3,8,9,-1,9,Denmark - Superligaen,0.25,0.62,-1,1.0,1.12,4.0,1.61,8
Nordsjaelland,8,2,1,5,10,16,-6,7,Denmark - Superligaen,0.25,0.38,-6,1.25,0.88,4.0,2.63,9
Aalborg BK,8,1,3,4,10,17,-7,6,Denmark - Superligaen,0.12,0.5,-7,1.25,0.75,8.33,2.0,10
AGF Aarhus,8,1,1,6,10,18,-8,4,Denmark - Superligaen,0.12,0.25,-8,1.25,0.5,8.33,4.0,11
Fredericia,8,5,3,0,12,3,9,18,Denmark - 1st Division,0.62,1.0,9,1.5,2.25,1.61,1.0,1
Hillerod,8,5,2,1,17,5,12,17,Denmark - 1st Division,0.62,0.88,12,2.12,2.12,1.61,1.14,2
Kolding IF,8,5,0,3,13,11,2,15,Denmark - 1st Division,0.62,0.62,2,1.62,1.88,1.61,1.61,3
Odense BK,8,3,3,2,14,8,6,12,Denmark - 1st Division,0.38,0.75,6,1.75,1.5,2.63,1.33,4
B 93,8,3,3,2,16,14,2,12,Denmark - 1st Division,0.38,0.75,2,2.0,1.5,2.63,1.33,4
AC Horsens,8,4,0,4,10,14,-4,12,Denmark - 1st Division,0.5,0.5,-4,1.25,1.5,2.0,2.0,4
Hvidovre,8,2,3,3,6,8,-2,9,Denmark - 1st Division,0.25,0.62,-2,0.75,1.12,4.0,1.61,5
Hobro,8,2,3,3,6,10,-4,9,Denmark - 1st Division,0.25,0.62,-4,0.75,1.12,4.0,1.61,5
HB Koge,8,2,3,3,9,14,-5,9,Denmark - 1st Division,0.25,0.62,-5,1.12,1.12,4.0,1.61,5
Vendsyssel,8,1,4,3,7,9,-2,7,Denmark - 1st Division,0.12,0.62,-2,0.88,0.88,8.33,1.61,6
Roskilde,8,1,3,4,12,17,-5,6,Denmark - 1st Division,0.12,0.5,-5,1.5,0.75,8.33,2.0,7
Esbjerg,8,1,1,6,8,17,-9,4,Denmark - 1st Division,0.12,0.25,-9,1.0,0.5,8.33,4.0,8
AB Copenhagen,8,5,1,2,20,11,9,16,Denmark - 2nd Division,0.62,0.75,9,2.5,2.0,1.61,1.33,1
Aarhus Fremad,8,5,1,2,12,3,9,16,Denmark - 2nd Division,0.62,0.75,9,1.5,2.0,1.61,1.33,1
Middelfart,8,5,1,2,12,9,3,16,Denmark - 2nd Division,0.62,0.75,3,1.5,2.0,1.61,1.33,1
Skive,8,4,2,2,9,6,3,14,Denmark - 2nd Division,0.5,0.75,3,1.12,1.75,2.0,1.33,2
Naestved,8,4,1,3,10,9,1,13,Denmark - 2nd Division,0.5,0.62,1,1.25,1.62,2.0,1.61,3
BK Frem,8,3,2,3,9,7,2,11,Denmark - 2nd Division,0.38,0.62,2,1.12,1.38,2.63,1.61,4
Ishoj,8,3,2,3,8,9,-1,11,Denmark - 2nd Division,0.38,0.62,-1,1.0,1.38,2.63,1.61,4
Fremad Amager,8,3,1,4,10,11,-1,10,Denmark - 2nd Division,0.38,0.5,-1,1.25,1.25,2.63,2.0,5
Hellerup IK,8,3,0,5,6,16,-10,9,Denmark - 2nd Division,0.38,0.38,-10,0.75,1.12,2.63,2.63,6
Helsingor,8,1,5,2,9,11,-2,8,Denmark - 2nd Division,0.12,0.75,-2,1.12,1.0,8.33,1.33,7
Nykobing,8,1,2,5,8,13,-5,5,Denmark - 2nd Division,0.12,0.38,-5,1.0,0.62,8.33,2.63,8
Thisted,8,1,2,5,8,16,-8,5,Denmark - 2nd Division,0.12,0.38,-8,1.0,0.62,8.33,2.63,8
I. del Valle,8,6,1,1,19,6,13,19,Ecuador - Liga Pro 1st Stage,0.75,0.88,13,2.38,2.38,1.33,1.14,1
Barcelona SC,8,6,0,2,12,9,3,18,Ecuador - Liga Pro 1st Stage,0.75,0.75,3,1.5,2.25,1.33,1.33,2
Cuniburo,8,5,1,2,16,8,8,16,Ecuador - Liga Pro 1st Stage,0.62,0.75,8,2.0,2.0,1.61,1.33,3
LDU Quito,8,4,2,2,15,7,8,14,Ecuador - Liga Pro 1st Stage,0.5,0.75,8,1.88,1.75,2.0,1.33,4
Libertad,8,4,2,2,13,10,3,14,Ecuador - Liga Pro 1st Stage,0.5,0.75,3,1.62,1.75,2.0,1.33,4
Aucas,8,4,2,2,11,8,3,14,Ecuador - Liga Pro 1st Stage,0.5,0.75,3,1.38,1.75,2.0,1.33,4
Emelec,8,3,3,2,8,7,1,12,Ecuador - Liga Pro 1st Stage,0.38,0.75,1,1.0,1.5,2.63,1.33,5
U. Catolica,8,3,2,3,12,10,2,11,Ecuador - Liga Pro 1st Stage,0.38,0.62,2,1.5,1.38,2.63,1.61,6
Orense,8,3,2,3,8,10,-2,11,Ecuador - Liga Pro 1st Stage,0.38,0.62,-2,1.0,1.38,2.63,1.61,6
D. Cuenca,8,3,1,4,5,8,-3,10,Ecuador - Liga Pro 1st Stage,0.38,0.5,-3,0.62,1.25,2.63,2.0,7
Mushuc Runa,8,2,3,3,10,12,-2,9,Ecuador - Liga Pro 1st Stage,0.25,0.62,-2,1.25,1.12,4.0,1.61,8
Manta,8,2,3,3,9,14,-5,9,Ecuador - Liga Pro 1st Stage,0.25,0.62,-5,1.12,1.12,4.0,1.61,8
Tecnico U.,8,2,2,4,7,10,-3,8,Ecuador - Liga Pro 1st Stage,0.25,0.5,-3,0.88,1.0,4.0,2.0,9
El Nacional,8,2,1,5,12,15,-3,7,Ecuador - Liga Pro 1st Stage,0.25,0.38,-3,1.5,0.88,4.0,2.63,10
Delfin,8,0,4,4,3,14,-11,4,Ecuador - Liga Pro 1st Stage,0.0,0.5,-11,0.38,0.5,0.0,2.0,11
Macara,8,0,3,5,5,10,-5,3,Ecuador - Liga Pro 1st Stage,0.0,0.38,-5,0.62,0.38,0.0,2.63,12
Gualaceo,8,5,3,0,13,7,6,18,Ecuador - Serie B,0.62,1.0,6,1.62,2.25,1.61,1.0,1
Cumbaya,8,4,2,2,12,7,5,14,Ecuador - Serie B,0.5,0.75,5,1.5,1.75,2.0,1.33,2
Leones Norte,8,3,4,1,10,6,4,13,Ecuador - Serie B,0.38,0.88,4,1.25,1.62,2.63,1.14,3
San Antonio,8,4,1,3,7,7,0,13,Ecuador - Serie B,0.5,0.62,0,0.88,1.62,2.0,1.61,3
22 de Julio,8,2,5,1,7,8,-1,11,Ecuador - Serie B,0.25,0.88,-1,0.88,1.38,4.0,1.14,4
Guayaquil City,8,2,4,2,11,9,2,10,Ecuador - Serie B,0.25,0.75,2,1.38,1.25,4.0,1.33,5
Vinotinto,8,3,1,4,11,10,1,10,Ecuador - Serie B,0.38,0.5,1,1.38,1.25,2.63,2.0,5
Nueve Octubre,8,2,4,2,6,6,0,10,Ecuador - Serie B,0.25,0.75,0,0.75,1.25,4.0,1.33,5
Vargas Torres,8,1,5,2,6,7,-1,8,Ecuador - Serie B,0.12,0.75,-1,0.75,1.0,8.33,1.33,6
I. Juniors,8,2,2,4,7,11,-4,8,Ecuador - Serie B,0.25,0.5,-4,0.88,1.0,4.0,2.0,6
Imbabura,8,0,5,3,6,10,-4,5,Ecuador - Serie B,0.0,0.62,-4,0.75,0.62,0.0,1.61,7
Chacaritas,8,0,4,4,5,13,-8,4,Ecuador - Serie B,0.0,0.5,-8,0.62,0.5,0.0,2.0,8
Al Ahly,8,5,2,1,17,9,8,17,Egypt - Premier League,0.62,0.88,8,2.12,2.12,1.61,1.14,1
El Gouna,8,5,2,1,11,5,6,17,Egypt - Premier League,0.62,0.88,6,1.38,2.12,1.61,1.14,1
Pyramids FC,8,5,2,1,13,8,5,17,Egypt - Premier League,0.62,0.88,5,1.62,2.12,1.61,1.14,1
National Bank,8,4,3,1,18,12,6,15,Egypt - Premier League,0.5,0.88,6,2.25,1.88,2.0,1.14,2
Zamalek,8,3,5,0,13,5,8,14,Egypt - Premier League,0.38,1.0,8,1.62,1.75,2.63,1.0,3
ZED FC,8,3,4,1,11,5,6,13,Egypt - Premier League,0.38,0.88,6,1.38,1.62,2.63,1.14,4
ENPPI,8,4,1,3,7,10,-3,13,Egypt - Premier League,0.5,0.62,-3,0.88,1.62,2.0,1.61,4
Al Masry,8,3,3,2,13,7,6,12,Egypt - Premier League,0.38,0.75,6,1.62,1.5,2.63,1.33,5
Ceramica C.,8,3,2,3,14,12,2,11,Egypt - Premier League,0.38,0.62,2,1.75,1.38,2.63,1.61,6
Pharco,8,3,2,3,7,8,-1,11,Egypt - Premier League,0.38,0.62,-1,0.88,1.38,2.63,1.61,6
Modern Sport,8,3,1,4,10,11,-1,10,Egypt - Premier League,0.38,0.5,-1,1.25,1.25,2.63,2.0,7
Ghazl El M.,8,3,0,5,7,10,-3,9,Egypt - Premier League,0.38,0.38,-3,0.88,1.12,2.63,2.63,8
Al Ittihad,8,2,2,4,6,10,-4,8,Egypt - Premier League,0.25,0.5,-4,0.75,1.0,4.0,2.0,9
Petrojet,8,2,2,4,10,18,-8,8,Egypt - Premier League,0.25,0.5,-8,1.25,1.0,4.0,2.0,9
Ismaily,8,1,4,3,4,8,-4,7,Egypt - Premier League,0.12,0.62,-4,0.5,0.88,8.33,1.61,10
El Geish,8,1,3,4,5,9,-4,6,Egypt - Premier League,0.12,0.5,-4,0.62,0.75,8.33,2.0,11
Smouha,8,1,3,4,3,9,-6,6,Egypt - Premier League,0.12,0.5,-6,0.38,0.75,8.33,2.0,11
Haras El Hodood,8,1,1,6,7,16,-9,4,Egypt - Premier League,0.12,0.25,-9,0.88,0.5,8.33,4.0,12
Newcastle Utd,8,6,1,1,20,7,13,19,Premier League,0.75,0.88,13,2.5,2.38,1.33,1.14,3
Wolverhampton,8,6,1,1,14,6,8,19,Premier League,0.75,0.88,8,1.75,2.38,1.33,1.14,3
Liverpool,8,6,0,2,17,9,8,18,Premier League,0.75,0.75,8,2.12,2.25,1.33,1.33,4
Aston Villa,8,6,0,2,16,8,8,18,Premier League,0.75,0.75,8,2.0,2.25,1.33,1.33,4
Manchester City,8,5,2,1,14,6,8,17,Premier League,0.62,0.88,8,1.75,2.12,1.61,1.14,5
Chelsea,8,5,2,1,10,5,5,17,Premier League,0.62,0.88,5,1.25,2.12,1.61,1.14,5
Brentford,8,4,2,2,14,10,4,14,Premier League,0.5,0.75,4,1.75,1.75,2.0,1.33,7
Arsenal,8,3,4,1,13,8,5,13,Premier League,0.38,0.88,5,1.62,1.62,2.63,1.14,8
Nottm Forest,8,4,1,3,10,9,1,13,Premier League,0.5,0.62,1,1.25,1.62,2.0,1.61,8
Bournemouth,8,2,4,2,10,10,0,10,Premier League,0.25,0.75,0,1.25,1.25,4.0,1.33,11
Crystal Palace,8,2,4,2,9,15,-6,10,Premier League,0.25,0.75,-6,1.12,1.25,4.0,1.33,11
Fulham,8,3,0,5,10,11,-1,9,Premier League,0.38,0.38,-1,1.25,1.12,2.63,2.63,12
Brighton,8,2,3,3,13,17,-4,9,Premier League,0.25,0.62,-4,1.62,1.12,4.0,1.61,12
Everton,8,1,4,3,6,9,-3,7,Premier League,0.12,0.62,-3,0.75,0.88,8.33,1.61,14
Manchester Utd,8,1,3,4,9,12,-3,6,Premier League,0.12,0.5,-3,1.12,0.75,8.33,2.0,15
Tottenham,8,1,2,5,10,18,-8,5,Premier League,0.12,0.38,-8,1.25,0.62,8.33,2.63,16
Ipswich Town,8,1,2,5,9,19,-10,5,Premier League,0.12,0.38,-10,1.12,0.62,8.33,2.63,16
West Ham Utd,8,0,4,4,8,12,-4,4,Premier League,0.0,0.5,-4,1.0,0.5,0.0,2.0,17
Leicester City,8,1,1,6,4,15,-11,4,Premier League,0.12,0.25,-11,0.5,0.5,8.33,4.0,17
Southampton,8,0,2,6,6,17,-11,2,Premier League,0.0,0.25,-11,0.75,0.25,0.0,4.0,19
Burnley,8,7,1,0,17,5,12,22,Premier League,0.88,1.0,12,2.12,2.75,1.14,1.0,1
Leeds Utd,8,6,2,0,19,5,14,20,Premier League,0.75,1.0,14,2.38,2.5,1.33,1.0,2
Swansea City,8,5,2,1,13,7,6,17,Premier League,0.62,0.88,6,1.62,2.12,1.61,1.14,5
Millwall,8,5,0,3,10,10,0,15,Premier League,0.62,0.62,0,1.25,1.88,1.61,1.61,6
Blackburn,8,4,2,2,11,8,3,14,Premier League,0.5,0.75,3,1.38,1.75,2.0,1.33,7
Luton Town,8,4,2,2,11,9,2,14,Premier League,0.5,0.75,2,1.38,1.75,2.0,1.33,7
Plymouth,8,4,1,3,11,11,0,13,Premier League,0.5,0.62,0,1.38,1.62,2.0,1.61,8
Derby County,8,3,3,2,8,5,3,12,Premier League,0.38,0.75,3,1.0,1.5,2.63,1.33,9
Portsmouth,8,3,3,2,12,10,2,12,Premier League,0.38,0.75,2,1.5,1.5,2.63,1.33,9
Stoke City,8,3,3,2,8,11,-3,12,Premier League,0.38,0.75,-3,1.0,1.5,2.63,1.33,9
Oxford Utd,8,3,2,3,10,10,0,11,Premier League,0.38,0.62,0,1.25,1.38,2.63,1.61,10
Bristol City,8,3,2,3,10,14,-4,11,Premier League,0.38,0.62,-4,1.25,1.38,2.63,1.61,10
QP Rangers,8,3,2,3,9,13,-4,11,Premier League,0.38,0.62,-4,1.12,1.38,2.63,1.61,10
Sheffield Utd,8,3,1,4,10,8,2,10,Premier League,0.38,0.5,2,1.25,1.25,2.63,2.0,11
Coventry City,8,3,1,4,9,10,-1,10,Premier League,0.38,0.5,-1,1.12,1.25,2.63,2.0,11
Middlesbrough,8,3,1,4,7,8,-1,10,Premier League,0.38,0.5,-1,0.88,1.25,2.63,2.0,11
Hull City,8,2,2,4,5,7,-2,8,Premier League,0.25,0.5,-2,0.62,1.0,4.0,2.0,13
Norwich City,8,2,2,4,11,14,-3,8,Premier League,0.25,0.5,-3,1.38,1.0,4.0,2.0,13
Sheffield Wed,8,1,4,3,7,10,-3,7,Premier League,0.12,0.62,-3,0.88,0.88,8.33,1.61,14
West Brom,8,2,1,5,9,13,-4,7,Premier League,0.25,0.38,-4,1.12,0.88,4.0,2.63,14
Sunderland,8,2,1,5,3,7,-4,7,Premier League,0.25,0.38,-4,0.38,0.88,4.0,2.63,14
Watford,8,1,2,5,6,10,-4,5,Premier League,0.12,0.38,-4,0.75,0.62,8.33,2.63,16
Cardiff City,8,0,5,3,6,11,-5,5,Premier League,0.0,0.62,-5,0.75,0.62,0.0,1.61,16
Preston,8,0,3,5,9,15,-6,3,Premier League,0.0,0.38,-6,1.12,0.38,0.0,2.63,18
Birmingham City,8,7,1,0,19,5,14,22,League One,0.88,1.0,14,2.38,2.75,1.14,1.0,1
Stockport,8,7,1,0,19,7,12,22,League One,0.88,1.0,12,2.38,2.75,1.14,1.0,1
Charlton,8,6,1,1,18,8,10,19,League One,0.75,0.88,10,2.25,2.38,1.33,1.14,2
Leyton Orient,8,6,1,1,18,10,8,19,League One,0.75,0.88,8,2.25,2.38,1.33,1.14,2
Wrexham,8,5,3,0,15,4,11,18,League One,0.62,1.0,11,1.88,2.25,1.61,1.0,3
Rotherham,8,4,2,2,12,10,2,14,League One,0.5,0.75,2,1.5,1.75,2.0,1.33,4
Crawley Town,8,4,1,3,17,12,5,13,League One,0.5,0.62,5,2.12,1.62,2.0,1.61,5
Blackpool,8,4,1,3,15,10,5,13,League One,0.5,0.62,5,1.88,1.62,2.0,1.61,5
Reading,8,4,1,3,13,10,3,13,League One,0.5,0.62,3,1.62,1.62,2.0,1.61,5
Wigan Athletic,8,2,6,0,6,4,2,12,League One,0.25,1.0,2,0.75,1.5,4.0,1.0,6
Lincoln City,8,3,2,3,11,11,0,11,League One,0.38,0.62,0,1.38,1.38,2.63,1.61,7
Burton Albion,8,3,2,3,10,11,-1,11,League One,0.38,0.62,-1,1.25,1.38,2.63,1.61,7
Exeter City,8,3,2,3,9,12,-3,11,League One,0.38,0.62,-3,1.12,1.38,2.63,1.61,7
Wycombe,8,3,1,4,5,9,-4,10,League One,0.38,0.5,-4,0.62,1.25,2.63,2.0,8
Northampton,8,2,3,3,11,10,1,9,League One,0.25,0.62,1,1.38,1.12,4.0,1.61,9
Barnsley,8,2,2,4,17,19,-2,8,League One,0.25,0.5,-2,2.12,1.0,4.0,2.0,10
Cambridge Utd,8,2,2,4,9,11,-2,8,League One,0.25,0.5,-2,1.12,1.0,4.0,2.0,10
Stevenage,8,2,2,4,7,11,-4,8,League One,0.25,0.5,-4,0.88,1.0,4.0,2.0,10
Bolton,8,2,2,4,7,13,-6,8,League One,0.25,0.5,-6,0.88,1.0,4.0,2.0,10
Mansfield,8,2,1,5,15,21,-6,7,League One,0.25,0.38,-6,1.88,0.88,4.0,2.63,11
Peterborough,8,1,3,4,11,18,-7,6,League One,0.12,0.5,-7,1.38,0.75,8.33,2.0,12
Shrewsbury,8,1,2,5,6,13,-7,5,League One,0.12,0.38,-7,0.75,0.62,8.33,2.63,13
Huddersfield,8,1,0,7,6,17,-11,3,League One,0.12,0.12,-11,0.75,0.38,8.33,8.33,14
Bristol Rovers,8,0,1,7,5,15,-10,1,League One,0.0,0.12,-10,0.62,0.12,0.0,8.33,15
Doncaster,8,5,3,0,16,6,10,18,League Two,0.62,1.0,10,2.0,2.25,1.61,1.0,1
Port Vale,8,5,1,2,17,8,9,16,League Two,0.62,0.75,9,2.12,2.0,1.61,1.33,2
Chesterfield,8,4,3,1,14,10,4,15,League Two,0.5,0.88,4,1.75,1.88,2.0,1.14,3
Swindon Town,8,4,2,2,16,8,8,14,League Two,0.5,0.75,8,2.0,1.75,2.0,1.33,4
Tranmere,8,4,2,2,17,10,7,14,League Two,0.5,0.75,7,2.12,1.75,2.0,1.33,4
Bromley,8,4,2,2,15,12,3,14,League Two,0.5,0.75,3,1.88,1.75,2.0,1.33,4
Gillingham,8,3,5,0,9,6,3,14,League Two,0.38,1.0,3,1.12,1.75,2.63,1.0,4
Salford City,8,3,4,1,17,11,6,13,League Two,0.38,0.88,6,2.12,1.62,2.63,1.14,5
Harrogate,8,3,3,2,14,13,1,12,League Two,0.38,0.75,1,1.75,1.5,2.63,1.33,6
Barrow,8,2,5,1,9,5,4,11,League Two,0.25,0.88,4,1.12,1.38,4.0,1.14,7
Carlisle Utd,8,3,2,3,14,15,-1,11,League Two,0.38,0.62,-1,1.75,1.38,2.63,1.61,7
Notts County,8,3,1,4,12,10,2,10,League Two,0.38,0.5,2,1.5,1.25,2.63,2.0,8
Fleetwood,8,3,1,4,11,14,-3,10,League Two,0.38,0.5,-3,1.38,1.25,2.63,2.0,8
Cheltenham,8,3,1,4,9,15,-6,10,League Two,0.38,0.5,-6,1.12,1.25,2.63,2.0,8
Bradford,8,2,3,3,12,13,-1,9,League Two,0.25,0.62,-1,1.5,1.12,4.0,1.61,9
AFC Wimbledon,8,2,3,3,5,7,-2,9,League Two,0.25,0.62,-2,0.62,1.12,4.0,1.61,9
Grimsby,8,2,3,3,9,13,-4,9,League Two,0.25,0.62,-4,1.12,1.12,4.0,1.61,9
Colchester Utd,8,2,3,3,6,10,-4,9,League Two,0.25,0.62,-4,0.75,1.12,4.0,1.61,9
Accrington,8,2,3,3,8,14,-6,9,League Two,0.25,0.62,-6,1.0,1.12,4.0,1.61,9
Walsall,8,1,4,3,8,11,-3,7,League Two,0.12,0.62,-3,1.0,0.88,8.33,1.61,10
Morecambe,8,2,0,6,7,15,-8,6,League Two,0.25,0.25,-8,0.88,0.75,4.0,4.0,11
Milton Keynes,8,1,3,4,3,11,-8,6,League Two,0.12,0.5,-8,0.38,0.75,8.33,2.0,11
Crewe Alexandra,8,1,1,6,4,10,-6,4,League Two,0.12,0.25,-6,0.5,0.5,8.33,4.0,12
Newport,8,0,3,5,4,14,-10,3,League Two,0.0,0.38,-10,0.5,0.38,0.0,2.63,13
York City,8,7,1,0,25,5,20,22,England - National League,0.88,1.0,20,3.12,2.75,1.14,1.0,1
Barnet,8,5,2,1,17,6,11,17,England - National League,0.62,0.88,11,2.12,2.12,1.61,1.14,2
Woking,8,4,4,0,14,8,6,16,England - National League,0.5,1.0,6,1.75,2.0,2.0,1.0,3
Maidenhead Utd,8,4,3,1,14,6,8,15,England - National League,0.5,0.88,8,1.75,1.88,2.0,1.14,4
Boston Utd,8,5,0,3,11,10,1,15,England - National League,0.62,0.62,1,1.38,1.88,1.61,1.61,4
Rochdale,8,4,2,2,13,6,7,14,England - National League,0.5,0.75,7,1.62,1.75,2.0,1.33,5
Hartlepool,8,4,2,2,15,14,1,14,England - National League,0.5,0.75,1,1.88,1.75,2.0,1.33,5
Dagenham & R.,8,3,4,1,12,6,6,13,England - National League,0.38,0.88,6,1.5,1.62,2.63,1.14,6
Tamworth,8,4,1,3,15,14,1,13,England - National League,0.5,0.62,1,1.88,1.62,2.0,1.61,6
Southend Utd,8,3,3,2,9,5,4,12,England - National League,0.38,0.75,4,1.12,1.5,2.63,1.33,7
Forest Green,8,3,2,3,10,10,0,11,England - National League,0.38,0.62,0,1.25,1.38,2.63,1.61,8
Braintree Town,8,3,2,3,9,9,0,11,England - National League,0.38,0.62,0,1.12,1.38,2.63,1.61,8
Solihull Moors,8,3,2,3,8,9,-1,11,England - National League,0.38,0.62,-1,1.0,1.38,2.63,1.61,8
Wealdstone,8,3,2,3,8,12,-4,11,England - National League,0.38,0.62,-4,1.0,1.38,2.63,1.61,8
Yeovil Town,8,3,1,4,10,9,1,10,England - National League,0.38,0.5,1,1.25,1.25,2.63,2.0,9
Oldham,8,3,1,4,9,8,1,10,England - National League,0.38,0.5,1,1.12,1.25,2.63,2.0,9
Altrincham,8,2,3,3,11,14,-3,9,England - National League,0.25,0.62,-3,1.38,1.12,4.0,1.61,10
Sutton Utd,8,2,3,3,9,13,-4,9,England - National League,0.25,0.62,-4,1.12,1.12,4.0,1.61,10
Halifax Town,8,2,2,4,4,10,-6,8,England - National League,0.25,0.5,-6,0.5,1.0,4.0,2.0,11
Gateshead FC,8,2,1,5,10,16,-6,7,England - National League,0.25,0.38,-6,1.25,0.88,4.0,2.63,12
Aldershot Town,8,2,1,5,8,22,-14,7,England - National League,0.25,0.38,-14,1.0,0.88,4.0,2.63,12
Eastleigh,8,1,3,4,6,14,-8,6,England - National League,0.12,0.5,-8,0.75,0.75,8.33,2.0,13
Ebbsfleet Utd,8,1,2,5,11,18,-7,5,England - National League,0.12,0.38,-7,1.38,0.62,8.33,2.63,14
AFC Fylde,8,0,1,7,4,15,-11,1,England - National League,0.0,0.12,-11,0.5,0.12,0.0,8.33,15
Brackley Town,8,7,0,1,15,3,12,21,England - National L. North,0.88,0.88,12,1.88,2.62,1.14,1.14,1
Kidderminster,8,6,1,1,20,6,14,19,England - National L. North,0.75,0.88,14,2.5,2.38,1.33,1.14,2
Chester,8,5,2,1,13,8,5,17,England - National L. North,0.62,0.88,5,1.62,2.12,1.61,1.14,3
Buxton,8,5,1,2,12,6,6,16,England - National L. North,0.62,0.75,6,1.5,2.0,1.61,1.33,4
Spennymoor,8,5,1,2,12,9,3,16,England - National L. North,0.62,0.75,3,1.5,2.0,1.61,1.33,4
Kings Lynn,8,5,1,2,7,7,0,16,England - National L. North,0.62,0.75,0,0.88,2.0,1.61,1.33,4
Chorley,8,4,3,1,17,3,14,15,England - National L. North,0.5,0.88,14,2.12,1.88,2.0,1.14,5
Scunthorpe,8,5,0,3,13,4,9,15,England - National L. North,0.62,0.62,9,1.62,1.88,1.61,1.61,5
Marine,8,4,2,2,10,8,2,14,England - National L. North,0.5,0.75,2,1.25,1.75,2.0,1.33,6
Hereford Utd,8,4,1,3,15,11,4,13,England - National L. North,0.5,0.62,4,1.88,1.62,2.0,1.61,7
Alfreton Town,8,3,4,1,8,6,2,13,England - National L. North,0.38,0.88,2,1.0,1.62,2.63,1.14,7
Darlington,8,3,3,2,15,12,3,12,England - National L. North,0.38,0.75,3,1.88,1.5,2.63,1.33,8
Scarborough,8,3,3,2,8,8,0,12,England - National L. North,0.38,0.75,0,1.0,1.5,2.63,1.33,8
Curzon,8,3,3,2,9,10,-1,12,England - National L. North,0.38,0.75,-1,1.12,1.5,2.63,1.33,8
Oxford City,8,3,2,3,10,8,2,11,England - National L. North,0.38,0.62,2,1.25,1.38,2.63,1.61,9
Peterborough S.,8,3,1,4,10,14,-4,10,England - National L. North,0.38,0.5,-4,1.25,1.25,2.63,2.0,10
Southport,8,2,3,3,6,7,-1,9,England - National L. North,0.25,0.62,-1,0.75,1.12,4.0,1.61,11
Radcliffe,8,2,2,4,7,13,-6,8,England - National L. North,0.25,0.5,-6,0.88,1.0,4.0,2.0,12
Leamington,8,1,2,5,3,10,-7,5,England - National L. North,0.12,0.38,-7,0.38,0.62,8.33,2.63,13
Rushall,8,1,2,5,8,17,-9,5,England - National L. North,0.12,0.38,-9,1.0,0.62,8.33,2.63,13
Needham Market,8,1,0,7,6,16,-10,3,England - National L. North,0.12,0.12,-10,0.75,0.38,8.33,8.33,14
South Shields,8,0,2,6,4,14,-10,2,England - National L. North,0.0,0.25,-10,0.5,0.25,0.0,4.0,15
Warrington,8,0,1,7,3,15,-12,1,England - National L. North,0.0,0.12,-12,0.38,0.12,0.0,8.33,16
Farsley Celtic,8,0,0,8,5,28,-23,0,England - National L. North,0.0,0.0,-23,0.62,0.0,0.0,0.0,17
Torquay Utd,8,7,0,1,14,3,11,21,England - National L. South,0.88,0.88,11,1.75,2.62,1.14,1.14,1
Eastbourne,8,6,1,1,17,5,12,19,England - National L. South,0.75,0.88,12,2.12,2.38,1.33,1.14,2
Truro City,8,5,1,2,15,8,7,16,England - National L. South,0.62,0.75,7,1.88,2.0,1.61,1.33,3
Maidstone Utd,8,4,3,1,17,6,11,15,England - National L. South,0.5,0.88,11,2.12,1.88,2.0,1.14,4
Boreham Wood,8,5,0,3,18,11,7,15,England - National L. South,0.62,0.62,7,2.25,1.88,1.61,1.61,4
Dorking,8,4,3,1,14,8,6,15,England - National L. South,0.5,0.88,6,1.75,1.88,2.0,1.14,4
Hornchurch,8,4,2,2,12,8,4,14,England - National L. South,0.5,0.75,4,1.5,1.75,2.0,1.33,5
Weston-s.-Mare,8,4,1,3,12,10,2,13,England - National L. South,0.5,0.62,2,1.5,1.62,2.0,1.61,6
Chesham Utd,8,4,1,3,12,11,1,13,England - National L. South,0.5,0.62,1,1.5,1.62,2.0,1.61,6
Slough Town,8,4,1,3,13,15,-2,13,England - National L. South,0.5,0.62,-2,1.62,1.62,2.0,1.61,6
Bath City,8,3,3,2,13,6,7,12,England - National L. South,0.38,0.75,7,1.62,1.5,2.63,1.33,7
St Albans,8,3,3,2,9,10,-1,12,England - National L. South,0.38,0.75,-1,1.12,1.5,2.63,1.33,7
Worthing,8,3,2,3,14,9,5,11,England - National L. South,0.38,0.62,5,1.75,1.38,2.63,1.61,8
Chelmsford City,8,3,1,4,14,8,6,10,England - National L. South,0.38,0.5,6,1.75,1.25,2.63,2.0,9
Farnborough,8,3,1,4,17,15,2,10,England - National L. South,0.38,0.5,2,2.12,1.25,2.63,2.0,9
Enfield Town,8,2,4,2,10,15,-5,10,England - National L. South,0.25,0.75,-5,1.25,1.25,4.0,1.33,9
Chippenham,8,3,1,4,5,12,-7,10,England - National L. South,0.38,0.5,-7,0.62,1.25,2.63,2.0,9
Hemel Hempstead,8,2,3,3,7,11,-4,9,England - National L. South,0.25,0.62,-4,0.88,1.12,4.0,1.61,10
Salisbury,8,2,2,4,7,11,-4,8,England - National L. South,0.25,0.5,-4,0.88,1.0,4.0,2.0,11
Aveley,8,2,2,4,6,11,-5,8,England - National L. South,0.25,0.5,-5,0.75,1.0,4.0,2.0,11
Weymouth,8,2,2,4,10,17,-7,8,England - National L. South,0.25,0.5,-7,1.25,1.0,4.0,2.0,11
Welling Utd,8,1,2,5,6,21,-15,5,England - National L. South,0.12,0.38,-15,0.75,0.62,8.33,2.63,12
Tonbridge,8,1,1,6,5,17,-12,4,England - National L. South,0.12,0.25,-12,0.62,0.5,8.33,4.0,13
Hampton & R.,8,1,0,7,10,25,-15,3,England - National L. South,0.12,0.12,-15,1.25,0.38,8.33,8.33,14
Horsham,8,8,0,0,19,3,16,24,England - Isthmian league,1.0,1.0,16,2.38,3.0,1.0,1.0,1
Billericay Town,8,6,0,2,21,9,12,18,England - Isthmian league,0.75,0.75,12,2.62,2.25,1.33,1.33,2
Cray Valley PM,8,6,0,2,16,9,7,18,England - Isthmian league,0.75,0.75,7,2.0,2.25,1.33,1.33,2
Dartford,8,5,2,1,16,9,7,17,England - Isthmian league,0.62,0.88,7,2.0,2.12,1.61,1.14,3
Dover Athletic,8,5,1,2,14,10,4,16,England - Isthmian league,0.62,0.75,4,1.75,2.0,1.61,1.33,4
Carshalton,8,5,0,3,20,13,7,15,England - Isthmian league,0.62,0.62,7,2.5,1.88,1.61,1.61,5
Chichester City,8,5,0,3,14,7,7,15,England - Isthmian league,0.62,0.62,7,1.75,1.88,1.61,1.61,5
Chatham Town,8,4,2,2,13,8,5,14,England - Isthmian league,0.5,0.75,5,1.62,1.75,2.0,1.33,6
Potters Bar,8,4,0,4,12,14,-2,12,England - Isthmian league,0.5,0.5,-2,1.5,1.5,2.0,2.0,7
Cray Wanderers,8,3,1,4,17,14,3,10,England - Isthmian league,0.38,0.5,3,2.12,1.25,2.63,2.0,8
Folkestone,8,3,1,4,8,12,-4,10,England - Isthmian league,0.38,0.5,-4,1.0,1.25,2.63,2.0,8
Lewes,8,3,1,4,12,17,-5,10,England - Isthmian league,0.38,0.5,-5,1.5,1.25,2.63,2.0,8
Whitehawk,8,3,0,5,7,8,-1,9,England - Isthmian league,0.38,0.38,-1,0.88,1.12,2.63,2.63,9
Hashtag United,8,2,3,3,11,13,-2,9,England - Isthmian league,0.25,0.62,-2,1.38,1.12,4.0,1.61,9
Wingate & F.,8,2,3,3,10,12,-2,9,England - Isthmian league,0.25,0.62,-2,1.25,1.12,4.0,1.61,9
Cheshunt,8,3,0,5,10,15,-5,9,England - Isthmian league,0.38,0.38,-5,1.25,1.12,2.63,2.63,9
Hendon,8,2,2,4,15,20,-5,8,England - Isthmian league,0.25,0.5,-5,1.88,1.0,4.0,2.0,10
Bowers & Pitsea,8,2,1,5,6,15,-9,7,England - Isthmian league,0.25,0.38,-9,0.75,0.88,4.0,2.63,11
Bognor Regis,8,2,1,5,6,18,-12,7,England - Isthmian league,0.25,0.38,-12,0.75,0.88,4.0,2.63,11
Canvey Island,8,1,3,4,4,9,-5,6,England - Isthmian league,0.12,0.5,-5,0.5,0.75,8.33,2.0,12
Hastings Utd,8,1,3,4,7,13,-6,6,England - Isthmian league,0.12,0.5,-6,0.88,0.75,8.33,2.0,12
Dulwich Hamlet,8,1,1,6,6,17,-11,4,England - Isthmian league,0.12,0.25,-11,0.75,0.5,8.33,4.0,13
Macclesfield,8,8,0,0,27,4,23,24,England - Northern league,1.0,1.0,23,3.38,3.0,1.0,1.0,1
Stockton Town,8,6,1,1,9,3,6,19,England - Northern league,0.75,0.88,6,1.12,2.38,1.33,1.14,2
Worksop Town,8,6,0,2,19,9,10,18,England - Northern league,0.75,0.75,10,2.38,2.25,1.33,1.33,3
Bamber Bridge,8,5,0,3,13,7,6,15,England - Northern league,0.62,0.62,6,1.62,1.88,1.61,1.61,4
Gainsborough,8,5,0,3,13,8,5,15,England - Northern league,0.62,0.62,5,1.62,1.88,1.61,1.61,4
Prescot Cables,8,5,0,3,10,8,2,15,England - Northern league,0.62,0.62,2,1.25,1.88,1.61,1.61,4
Ilkeston Town,8,4,2,2,12,10,2,14,England - Northern league,0.5,0.75,2,1.5,1.75,2.0,1.33,5
Leek Town,8,4,1,3,13,9,4,13,England - Northern league,0.5,0.62,4,1.62,1.62,2.0,1.61,6
Guiseley,8,3,3,2,9,8,1,12,England - Northern league,0.38,0.75,1,1.12,1.5,2.63,1.33,7
Whitby Town,8,4,0,4,11,14,-3,12,England - Northern league,0.5,0.5,-3,1.38,1.5,2.0,2.0,7
Morpeth Town,8,2,5,1,8,10,-2,11,England - Northern league,0.25,0.88,-2,1.0,1.38,4.0,1.14,8
Mickleover,8,3,2,3,9,13,-4,11,England - Northern league,0.38,0.62,-4,1.12,1.38,2.63,1.61,8
Workington,8,3,1,4,14,9,5,10,England - Northern league,0.38,0.5,5,1.75,1.25,2.63,2.0,9
Matlock,8,2,3,3,11,10,1,9,England - Northern league,0.25,0.62,1,1.38,1.12,4.0,1.61,10
Ashton Utd,8,3,0,5,12,15,-3,9,England - Northern league,0.38,0.38,-3,1.5,1.12,2.63,2.63,10
Hyde Utd,8,3,0,5,9,16,-7,9,England - Northern league,0.38,0.38,-7,1.12,1.12,2.63,2.63,10
Rylands,8,2,2,4,8,11,-3,8,England - Northern league,0.25,0.5,-3,1.0,1.0,4.0,2.0,11
Lancaster City,8,2,2,4,8,16,-8,8,England - Northern league,0.25,0.5,-8,1.0,1.0,4.0,2.0,11
FC United,8,1,3,4,8,15,-7,6,England - Northern league,0.12,0.5,-7,1.0,0.75,8.33,2.0,12
Basford Utd,8,1,2,5,8,15,-7,5,England - Northern league,0.12,0.38,-7,1.0,0.62,8.33,2.63,13
Hebburn Town,8,1,2,5,8,15,-7,5,England - Northern league,0.12,0.38,-7,1.0,0.62,8.33,2.63,13
Blyth Spartans,8,0,0,8,7,22,-15,0,England - Northern league,0.0,0.0,-15,0.88,0.0,0.0,0.0,14
Bedford Town,8,6,2,0,17,6,11,20,England - Southern Central,0.75,1.0,11,2.12,2.5,1.33,1.0,1
Spalding United,8,5,3,0,25,7,18,18,England - Southern Central,0.62,1.0,18,3.12,2.25,1.61,1.0,2
AFC Sudbury,8,5,2,1,11,7,4,17,England - Southern Central,0.62,0.88,4,1.38,2.12,1.61,1.14,3
Kettering Town,8,4,4,0,11,6,5,16,England - Southern Central,0.5,1.0,5,1.38,2.0,2.0,1.0,4
Harborough Town,8,4,3,1,15,6,9,15,England - Southern Central,0.5,0.88,9,1.88,1.88,2.0,1.14,5
Telford Utd,8,3,5,0,16,5,11,14,England - Southern Central,0.38,1.0,11,2.0,1.75,2.63,1.0,6
Halesowen Town,8,3,5,0,12,6,6,14,England - Southern Central,0.38,1.0,6,1.5,1.75,2.63,1.0,6
Stourbridge,8,4,2,2,12,10,2,14,England - Southern Central,0.5,0.75,2,1.5,1.75,2.0,1.33,6
Banbury Utd,8,3,3,2,13,10,3,12,England - Southern Central,0.38,0.75,3,1.62,1.5,2.63,1.33,7
Stamford,8,3,3,2,8,13,-5,12,England - Southern Central,0.38,0.75,-5,1.0,1.5,2.63,1.33,7
Stratford Town,8,2,4,2,10,9,1,10,England - Southern Central,0.25,0.75,1,1.25,1.25,4.0,1.33,8
Royston,8,2,4,2,9,8,1,10,England - Southern Central,0.25,0.75,1,1.12,1.25,4.0,1.33,8
Barwell,8,3,1,4,11,19,-8,10,England - Southern Central,0.38,0.5,-8,1.38,1.25,2.63,2.0,8
Redditch Utd,8,2,3,3,8,9,-1,9,England - Southern Central,0.25,0.62,-1,1.0,1.12,4.0,1.61,9
Alvechurch,8,2,3,3,9,11,-2,9,England - Southern Central,0.25,0.62,-2,1.12,1.12,4.0,1.61,9
B. Stortford,8,2,2,4,8,14,-6,8,England - Southern Central,0.25,0.5,-6,1.0,1.0,4.0,2.0,10
Bromsgrove,8,2,1,5,13,14,-1,7,England - Southern Central,0.25,0.38,-1,1.62,0.88,4.0,2.63,11
St. Ives Town,8,1,4,3,10,13,-3,7,England - Southern Central,0.12,0.62,-3,1.25,0.88,8.33,1.61,11
Biggleswade,8,2,1,5,8,14,-6,7,England - Southern Central,0.25,0.38,-6,1.0,0.88,4.0,2.63,11
Leiston,8,1,3,4,6,11,-5,6,England - Southern Central,0.12,0.5,-5,0.75,0.75,8.33,2.0,12
Hitchin Town,8,0,2,6,9,20,-11,2,England - Southern Central,0.0,0.25,-11,1.12,0.25,0.0,4.0,13
Lowestoft,8,0,1,7,8,27,-19,1,England - Southern Central,0.0,0.12,-19,1.0,0.12,0.0,8.33,14
Flora,8,6,1,1,19,6,13,19,Estonia - Meistriliiga,0.75,0.88,13,2.38,2.38,1.33,1.14,1
Nomme Kalju,8,6,0,2,20,8,12,18,Estonia - Meistriliiga,0.75,0.75,12,2.5,2.25,1.33,1.33,2
Levadia,8,5,1,2,19,6,13,16,Estonia - Meistriliiga,0.62,0.75,13,2.38,2.0,1.61,1.33,3
Paide,8,5,1,2,12,5,7,16,Estonia - Meistriliiga,0.62,0.75,7,1.5,2.0,1.61,1.33,3
Narva Trans,8,5,0,3,14,7,7,15,Estonia - Meistriliiga,0.62,0.62,7,1.75,1.88,1.61,1.61,4
Vaprus,8,2,2,4,10,10,0,8,Estonia - Meistriliiga,0.25,0.5,0,1.25,1.0,4.0,2.0,5
Harju JK,8,2,1,5,10,16,-6,7,Estonia - Meistriliiga,0.25,0.38,-6,1.25,0.88,4.0,2.63,6
Kuressaare,8,2,1,5,6,16,-10,7,Estonia - Meistriliiga,0.25,0.38,-10,0.75,0.88,4.0,2.63,6
Tallinna Kalev,8,2,1,5,9,27,-18,7,Estonia - Meistriliiga,0.25,0.38,-18,1.12,0.88,4.0,2.63,6
Tammeka,8,1,0,7,4,22,-18,3,Estonia - Meistriliiga,0.12,0.12,-18,0.5,0.38,8.33,8.33,7
Nomme Utd,8,7,0,1,20,7,13,21,Estonia - Esiliiga,0.88,0.88,13,2.5,2.62,1.14,1.14,1
Tartu Welco,8,5,2,1,17,9,8,17,Estonia - Esiliiga,0.62,0.88,8,2.12,2.12,1.61,1.14,2
Viimsi,8,5,1,2,17,7,10,16,Estonia - Esiliiga,0.62,0.75,10,2.12,2.0,1.61,1.33,3
Elva,8,4,2,2,15,12,3,14,Estonia - Esiliiga,0.5,0.75,3,1.88,1.75,2.0,1.33,4
Levadia B,8,4,1,3,10,9,1,13,Estonia - Esiliiga,0.5,0.62,1,1.25,1.62,2.0,1.61,5
Flora B,8,2,4,2,20,12,8,10,Estonia - Esiliiga,0.25,0.75,8,2.5,1.25,4.0,1.33,6
FC Tallinn,8,2,3,3,12,14,-2,9,Estonia - Esiliiga,0.25,0.62,-2,1.5,1.12,4.0,1.61,7
Nomme Kalju B,8,2,0,6,8,20,-12,6,Estonia - Esiliiga,0.25,0.25,-12,1.0,0.75,4.0,4.0,8
Tallinna K. B,8,0,3,5,7,21,-14,3,Estonia - Esiliiga,0.0,0.38,-14,0.88,0.38,0.0,2.63,9
Tammeka B,8,1,0,7,11,27,-16,3,Estonia - Esiliiga,0.12,0.12,-16,1.38,0.38,8.33,8.33,9
NSI Runavik,8,8,0,0,40,6,34,24,FaroeIslands - Premier League,1.0,1.0,34,5.0,3.0,1.0,1.0,1
Klaksvik,8,8,0,0,30,3,27,24,FaroeIslands - Premier League,1.0,1.0,27,3.75,3.0,1.0,1.0,1
HB Torshavn,8,5,0,3,18,19,-1,15,FaroeIslands - Premier League,0.62,0.62,-1,2.25,1.88,1.61,1.61,2
B36 Torshavn,8,4,1,3,14,13,1,13,FaroeIslands - Premier League,0.5,0.62,1,1.75,1.62,2.0,1.61,3
Vikingur,8,3,2,3,8,8,0,11,FaroeIslands - Premier League,0.38,0.62,0,1.0,1.38,2.63,1.61,4
Streymur,8,3,1,4,9,17,-8,10,FaroeIslands - Premier League,0.38,0.5,-8,1.12,1.25,2.63,2.0,5
B68 Toftir,8,2,1,5,7,20,-13,7,FaroeIslands - Premier League,0.25,0.38,-13,0.88,0.88,4.0,2.63,6
Suduroy,8,2,0,6,3,16,-13,6,FaroeIslands - Premier League,0.25,0.25,-13,0.38,0.75,4.0,4.0,7
TB Tvoroyri,8,1,2,5,8,24,-16,5,FaroeIslands - Premier League,0.12,0.38,-16,1.0,0.62,8.33,2.63,8
07 Vestur,8,0,1,7,7,18,-11,1,FaroeIslands - Premier League,0.0,0.12,-11,0.88,0.12,0.0,8.33,9
Skala,8,7,1,0,27,2,25,22,FaroeIslands - 1. Deild,0.88,1.0,25,3.38,2.75,1.14,1.0,1
B71 Sandur,8,6,0,2,14,11,3,18,FaroeIslands - 1. Deild,0.75,0.75,3,1.75,2.25,1.33,1.33,2
AB Argir,7,5,2,0,16,4,12,17,FaroeIslands - 1. Deild,0.71,1.0,12,2.29,2.43,1.41,1.0,3
Vikingur B,8,5,0,3,18,12,6,15,FaroeIslands - 1. Deild,0.62,0.62,6,2.25,1.88,1.61,1.61,4
IF Fuglafjordur,8,4,2,2,18,14,4,14,FaroeIslands - 1. Deild,0.5,0.75,4,2.25,1.75,2.0,1.33,5
Streymur B,8,4,0,4,11,19,-8,12,FaroeIslands - 1. Deild,0.5,0.5,-8,1.38,1.5,2.0,2.0,6
Klaksvik B,8,3,1,4,12,17,-5,10,FaroeIslands - 1. Deild,0.38,0.5,-5,1.5,1.25,2.63,2.0,7
NSI Runavik B,8,2,1,5,14,17,-3,7,FaroeIslands - 1. Deild,0.25,0.38,-3,1.75,0.88,4.0,2.63,8
B36 Torshavn B,8,0,1,7,5,26,-21,1,FaroeIslands - 1. Deild,0.0,0.12,-21,0.62,0.12,0.0,8.33,9
07 Vestur B,8,0,0,8,7,21,-14,0,FaroeIslands - 1. Deild,0.0,0.0,-14,0.88,0.0,0.0,0.0,10
KuPS,6,5,1,0,10,3,7,16,Finland - Veikkausliiga,0.83,1.0,7,1.67,2.67,1.2,1.0,1
SJK,6,4,1,1,9,5,4,13,Finland - Veikkausliiga,0.67,0.83,4,1.5,2.17,1.49,1.2,2
Inter Turku,5,3,2,0,11,3,8,11,Finland - Veikkausliiga,0.6,1.0,8,2.2,2.2,1.67,1.0,3
Ilves,5,3,0,2,12,7,5,9,Finland - Veikkausliiga,0.6,0.6,5,2.4,1.8,1.67,1.67,4
Haka,5,2,1,2,7,7,0,7,Finland - Veikkausliiga,0.4,0.6,0,1.4,1.4,2.5,1.67,5
VPS,5,2,1,2,8,10,-2,7,Finland - Veikkausliiga,0.4,0.6,-2,1.6,1.4,2.5,1.67,5
Jaro,5,2,0,3,6,6,0,6,Finland - Veikkausliiga,0.4,0.4,0,1.2,1.2,2.5,2.5,6
Gnistan,5,2,0,3,6,8,-2,6,Finland - Veikkausliiga,0.4,0.4,-2,1.2,1.2,2.5,2.5,6
Mariehamn,6,2,0,4,6,12,-6,6,Finland - Veikkausliiga,0.33,0.33,-6,1.0,1.0,3.03,3.03,6
HJK Helsinki,5,1,1,3,6,7,-1,4,Finland - Veikkausliiga,0.2,0.4,-1,1.2,0.8,5.0,2.5,7
KTP,5,1,1,3,6,13,-7,4,Finland - Veikkausliiga,0.2,0.4,-7,1.2,0.8,5.0,2.5,7
Oulu,6,1,0,5,9,15,-6,3,Finland - Veikkausliiga,0.17,0.17,-6,1.5,0.5,5.88,5.88,8
TPS,3,3,0,0,12,4,8,9,Finland - Ykkosliga,1.0,1.0,8,4.0,3.0,1.0,1.0,1
Ekenas IF,3,3,0,0,10,5,5,9,Finland - Ykkosliga,1.0,1.0,5,3.33,3.0,1.0,1.0,1
Lahti,3,2,1,0,3,0,3,7,Finland - Ykkosliga,0.67,1.0,3,1.0,2.33,1.49,1.0,2
JIPPO,3,1,1,1,4,3,1,4,Finland - Ykkosliga,0.33,0.67,1,1.33,1.33,3.03,1.49,3
PK-35,3,1,1,1,3,3,0,4,Finland - Ykkosliga,0.33,0.67,0,1.0,1.33,3.03,1.49,3
SJK Akatemia,3,1,0,2,7,6,1,3,Finland - Ykkosliga,0.33,0.33,1,2.33,1.0,3.03,3.03,4
Klubi-04,3,1,0,2,6,9,-3,3,Finland - Ykkosliga,0.33,0.33,-3,2.0,1.0,3.03,3.03,4
JaPS,3,1,0,2,8,14,-6,3,Finland - Ykkosliga,0.33,0.33,-6,2.67,1.0,3.03,3.03,4
KaPa,3,0,1,2,3,8,-5,1,Finland - Ykkosliga,0.0,0.33,-5,1.0,0.33,0.0,3.03,5
SalPa,3,0,0,3,1,5,-4,0,Finland - Ykkosliga,0.0,0.0,-4,0.33,0.0,0.0,0.0,6
Tampere Utd,4,3,0,1,6,4,2,9,Finland - Ykkonen,0.75,0.75,2,1.5,2.25,1.33,1.33,1
PKKU,4,2,1,1,10,5,5,7,Finland - Ykkonen,0.5,0.75,5,2.5,1.75,2.0,1.33,2
KuPS Ak.,4,2,1,1,6,5,1,7,Finland - Ykkonen,0.5,0.75,1,1.5,1.75,2.0,1.33,2
KPV Kokkola,4,2,1,1,4,4,0,7,Finland - Ykkonen,0.5,0.75,0,1.0,1.75,2.0,1.33,2
Inter Turku B,4,2,0,2,9,7,2,6,Finland - Ykkonen,0.5,0.5,2,2.25,1.5,2.0,2.0,3
Atlantis,4,2,0,2,7,5,2,6,Finland - Ykkonen,0.5,0.5,2,1.75,1.5,2.0,2.0,3
EPS,4,2,0,2,5,6,-1,6,Finland - Ykkonen,0.5,0.5,-1,1.25,1.5,2.0,2.0,3
Rovaniemi,4,2,0,2,5,8,-3,6,Finland - Ykkonen,0.5,0.5,-3,1.25,1.5,2.0,2.0,3
OLS Oulu,4,1,2,1,9,8,1,5,Finland - Ykkonen,0.25,0.75,1,2.25,1.25,4.0,1.33,4
JJK,4,1,1,2,7,6,1,4,Finland - Ykkonen,0.25,0.5,1,1.75,1.0,4.0,2.0,5
Jazz Pori,4,1,1,2,2,5,-3,4,Finland - Ykkonen,0.25,0.5,-3,0.5,1.0,4.0,2.0,5
Mikkelin,4,0,1,3,1,8,-7,1,Finland - Ykkonen,0.0,0.25,-7,0.25,0.25,0.0,4.0,6
VJS,3,3,0,0,16,2,14,9,Finland - Kakkonen Group A,1.0,1.0,14,5.33,3.0,1.0,1.0,1
Honka,3,3,0,0,11,1,10,9,Finland - Kakkonen Group A,1.0,1.0,10,3.67,3.0,1.0,1.0,1
GrIFK,3,2,0,1,8,3,5,6,Finland - Kakkonen Group A,0.67,0.67,5,2.67,2.0,1.49,1.49,2
PuiU Helsinki,3,2,0,1,5,3,2,6,Finland - Kakkonen Group A,0.67,0.67,2,1.67,2.0,1.49,1.49,2
MYPA,3,1,1,1,5,6,-1,4,Finland - Kakkonen Group A,0.33,0.67,-1,1.67,1.33,3.03,1.49,3
PEPO,3,1,1,1,4,5,-1,4,Finland - Kakkonen Group A,0.33,0.67,-1,1.33,1.33,3.03,1.49,3
HaPK,3,1,1,1,3,4,-1,4,Finland - Kakkonen Group A,0.33,0.67,-1,1.0,1.33,3.03,1.49,3
Vaajakoski,3,0,1,2,4,13,-9,1,Finland - Kakkonen Group A,0.0,0.33,-9,1.33,0.33,0.0,3.03,4
Reipas,3,0,0,3,2,10,-8,0,Finland - Kakkonen Group A,0.0,0.0,-8,0.67,0.0,0.0,0.0,5
JPS,3,0,0,3,0,11,-11,0,Finland - Kakkonen Group A,0.0,0.0,-11,0.0,0.0,0.0,0.0,5
Ilves B,3,3,0,0,12,2,10,9,Finland - Kakkonen Group B,1.0,1.0,10,4.0,3.0,1.0,1.0,1
TPV,3,3,0,0,9,3,6,9,Finland - Kakkonen Group B,1.0,1.0,6,3.0,3.0,1.0,1.0,1
P-Iirot,3,2,0,1,7,4,3,6,Finland - Kakkonen Group B,0.67,0.67,3,2.33,2.0,1.49,1.49,2
HJS,3,1,1,1,6,7,-1,4,Finland - Kakkonen Group B,0.33,0.67,-1,2.0,1.33,3.03,1.49,3
PPJ,3,1,1,1,6,9,-3,4,Finland - Kakkonen Group B,0.33,0.67,-3,2.0,1.33,3.03,1.49,3
Kiffen,3,1,0,2,7,7,0,3,Finland - Kakkonen Group B,0.33,0.33,0,2.33,1.0,3.03,3.03,4
MuSa,3,1,0,2,5,5,0,3,Finland - Kakkonen Group B,0.33,0.33,0,1.67,1.0,3.03,3.03,4
Atlantis B,3,1,0,2,5,8,-3,3,Finland - Kakkonen Group B,0.33,0.33,-3,1.67,1.0,3.03,3.03,4
NJS,3,1,0,2,4,12,-8,3,Finland - Kakkonen Group B,0.33,0.33,-8,1.33,1.0,3.03,3.03,4
HPS,3,0,0,3,3,7,-4,0,Finland - Kakkonen Group B,0.0,0.0,-4,1.0,0.0,0.0,0.0,5
SJK Akatemia B,3,3,0,0,15,5,10,9,Finland - Kakkonen Group C,1.0,1.0,10,5.0,3.0,1.0,1.0,1
JS Hercules,3,3,0,0,9,5,4,9,Finland - Kakkonen Group C,1.0,1.0,4,3.0,3.0,1.0,1.0,1
VPS B,3,2,1,0,15,3,12,7,Finland - Kakkonen Group C,0.67,1.0,12,5.0,2.33,1.49,1.0,2
OsPa,3,1,1,1,9,5,4,4,Finland - Kakkonen Group C,0.33,0.67,4,3.0,1.33,3.03,1.49,3
JBK,3,1,1,1,6,6,0,4,Finland - Kakkonen Group C,0.33,0.67,0,2.0,1.33,3.03,1.49,3
TP-47,3,1,1,1,5,10,-5,4,Finland - Kakkonen Group C,0.33,0.67,-5,1.67,1.33,3.03,1.49,3
VIFK,3,0,2,1,6,7,-1,2,Finland - Kakkonen Group C,0.0,0.67,-1,2.0,0.67,0.0,1.49,4
Narpes Kraft,3,0,1,2,4,6,-2,1,Finland - Kakkonen Group C,0.0,0.33,-2,1.33,0.33,0.0,3.03,5
GBK Kokkola,3,0,1,2,2,10,-8,1,Finland - Kakkonen Group C,0.0,0.33,-8,0.67,0.33,0.0,3.03,5
Kuopion Elo,3,0,0,3,4,18,-14,0,Finland - Kakkonen Group C,0.0,0.0,-14,1.33,0.0,0.0,0.0,6
Strasbourg,8,6,2,0,15,7,8,20,France - Ligue 1,0.75,1.0,8,1.88,2.5,1.33,1.0,1
Paris SG,8,5,1,2,19,10,9,16,France - Ligue 1,0.62,0.75,9,2.38,2.0,1.61,1.33,2
Lille,8,5,1,2,11,6,5,16,France - Ligue 1,0.62,0.75,5,1.38,2.0,1.61,1.33,2
Monaco,8,4,3,1,13,6,7,15,France - Ligue 1,0.5,0.88,7,1.62,1.88,2.0,1.14,3
Lyon,8,5,0,3,19,13,6,15,France - Ligue 1,0.62,0.62,6,2.38,1.88,1.61,1.61,3
Lens,8,5,0,3,8,9,-1,15,France - Ligue 1,0.62,0.62,-1,1.0,1.88,1.61,1.61,3
Brest,8,4,2,2,14,13,1,14,France - Ligue 1,0.5,0.75,1,1.75,1.75,2.0,1.33,4
Auxerre,8,4,1,3,12,9,3,13,France - Ligue 1,0.5,0.62,3,1.5,1.62,2.0,1.61,5
Reims,8,3,2,3,6,5,1,11,France - Ligue 1,0.38,0.62,1,0.75,1.38,2.63,1.61,6
Nice,8,3,2,3,11,11,0,11,France - Ligue 1,0.38,0.62,0,1.38,1.38,2.63,1.61,6
Le Havre,8,3,2,3,13,16,-3,11,France - Ligue 1,0.38,0.62,-3,1.62,1.38,2.63,1.61,6
Marseille,8,3,1,4,15,15,0,10,France - Ligue 1,0.38,0.5,0,1.88,1.25,2.63,2.0,7
Rennes,8,3,0,5,13,14,-1,9,France - Ligue 1,0.38,0.38,-1,1.62,1.12,2.63,2.63,8
Nantes,8,2,2,4,7,9,-2,8,France - Ligue 1,0.25,0.5,-2,0.88,1.0,4.0,2.0,9
Saint-Etienne,8,2,2,4,11,18,-7,8,France - Ligue 1,0.25,0.5,-7,1.38,1.0,4.0,2.0,9
Angers,8,2,0,6,4,12,-8,6,France - Ligue 1,0.25,0.25,-8,0.5,0.75,4.0,4.0,10
Toulouse,8,1,2,5,9,14,-5,5,France - Ligue 1,0.12,0.38,-5,1.12,0.62,8.33,2.63,11
Montpellier,8,0,1,7,1,14,-13,1,France - Ligue 1,0.0,0.12,-13,0.12,0.12,0.0,8.33,12
Paris FC,8,5,2,1,14,10,4,17,France - Ligue 2,0.62,0.88,4,1.75,2.12,1.61,1.14,1
Lorient,8,5,1,2,20,7,13,16,France - Ligue 2,0.62,0.75,13,2.5,2.0,1.61,1.33,2
Metz,8,4,3,1,22,14,8,15,France - Ligue 2,0.5,0.88,8,2.75,1.88,2.0,1.14,3
Guingamp,8,4,1,3,14,12,2,13,France - Ligue 2,0.5,0.62,2,1.75,1.62,2.0,1.61,4
Amiens,8,4,1,3,12,11,1,13,France - Ligue 2,0.5,0.62,1,1.5,1.62,2.0,1.61,4
Laval,8,4,1,3,10,10,0,13,France - Ligue 2,0.5,0.62,0,1.25,1.62,2.0,1.61,4
AC Ajaccio,8,3,3,2,9,10,-1,12,France - Ligue 2,0.38,0.75,-1,1.12,1.5,2.63,1.33,5
Rodez Aveyron,8,2,5,1,15,11,4,11,France - Ligue 2,0.25,0.88,4,1.88,1.38,4.0,1.14,6
Troyes,8,3,2,3,9,8,1,11,France - Ligue 2,0.38,0.62,1,1.12,1.38,2.63,1.61,6
SC Bastia,8,3,2,3,13,13,0,11,France - Ligue 2,0.38,0.62,0,1.62,1.38,2.63,1.61,6
Grenoble,8,3,2,3,12,12,0,11,France - Ligue 2,0.38,0.62,0,1.5,1.38,2.63,1.61,6
Annecy,8,2,3,3,8,11,-3,9,France - Ligue 2,0.25,0.62,-3,1.0,1.12,4.0,1.61,7
Pau FC,8,2,3,3,10,17,-7,9,France - Ligue 2,0.25,0.62,-7,1.25,1.12,4.0,1.61,7
Red Star,8,1,5,2,10,10,0,8,France - Ligue 2,0.12,0.75,0,1.25,1.0,8.33,1.33,8
Martigues,8,2,2,4,10,11,-1,8,France - Ligue 2,0.25,0.5,-1,1.25,1.0,4.0,2.0,8
Clermont,8,1,4,3,8,13,-5,7,France - Ligue 2,0.12,0.62,-5,1.0,0.88,8.33,1.61,9
USL Dunkerque,8,2,1,5,8,13,-5,7,France - Ligue 2,0.25,0.38,-5,1.0,0.88,4.0,2.63,9
Caen,8,0,3,5,8,19,-11,3,France - Ligue 2,0.0,0.38,-11,1.0,0.38,0.0,2.63,10
Nancy,8,6,1,1,17,5,12,19,France - National,0.75,0.88,12,2.12,2.38,1.33,1.14,1
Le Mans,8,5,2,1,13,6,7,17,France - National,0.62,0.88,7,1.62,2.12,1.61,1.14,2
Dijon,8,4,3,1,12,8,4,15,France - National,0.5,0.88,4,1.5,1.88,2.0,1.14,3
Concarneau,8,3,4,1,13,7,6,13,France - National,0.38,0.88,6,1.62,1.62,2.63,1.14,4
Aubagne,8,3,3,2,11,8,3,12,France - National,0.38,0.75,3,1.38,1.5,2.63,1.33,5
Boulogne,8,3,3,2,12,11,1,12,France - National,0.38,0.75,1,1.5,1.5,2.63,1.33,5
Sochaux,8,3,2,3,8,8,0,11,France - National,0.38,0.62,0,1.0,1.38,2.63,1.61,6
Versailles,8,2,3,3,13,12,1,9,France - National,0.25,0.62,1,1.62,1.12,4.0,1.61,7
Rouen,8,2,3,3,11,13,-2,9,France - National,0.25,0.62,-2,1.38,1.12,4.0,1.61,7
Bourg-en-Bresse,8,2,3,3,5,7,-2,9,France - National,0.25,0.62,-2,0.62,1.12,4.0,1.61,7
Villefranche,8,1,5,2,9,10,-1,8,France - National,0.12,0.75,-1,1.12,1.0,8.33,1.33,8
Valenciennes,8,2,2,4,7,8,-1,8,France - National,0.25,0.5,-1,0.88,1.0,4.0,2.0,8
Quevilly Rouen,8,2,2,4,6,14,-8,8,France - National,0.25,0.5,-8,0.75,1.0,4.0,2.0,8
Paris 13 A.,8,1,4,3,7,9,-2,7,France - National,0.12,0.62,-2,0.88,0.88,8.33,1.61,9
Orleans,8,1,4,3,6,11,-5,7,France - National,0.12,0.62,-5,0.75,0.88,8.33,1.61,9
Chateauroux,8,1,3,4,12,19,-7,6,France - National,0.12,0.5,-7,1.5,0.75,8.33,2.0,10
Nimes,8,1,3,4,4,11,-7,6,France - National,0.12,0.5,-7,0.5,0.75,8.33,2.0,10
Iberia,8,7,1,0,14,4,10,22,Georgia - Erovnuli Liga,0.88,1.0,10,1.75,2.75,1.14,1.0,1
Torpedo Kutaisi,8,4,3,1,12,7,5,15,Georgia - Erovnuli Liga,0.5,0.88,5,1.5,1.88,2.0,1.14,2
Dinamo Tbilisi,8,4,2,2,13,7,6,14,Georgia - Erovnuli Liga,0.5,0.75,6,1.62,1.75,2.0,1.33,3
Dinamo Batumi,8,3,4,1,12,7,5,13,Georgia - Erovnuli Liga,0.38,0.88,5,1.5,1.62,2.63,1.14,4
Dila Gori,8,4,1,3,8,5,3,13,Georgia - Erovnuli Liga,0.5,0.62,3,1.0,1.62,2.0,1.61,4
Gagra,8,3,1,4,6,10,-4,10,Georgia - Erovnuli Liga,0.38,0.5,-4,0.75,1.25,2.63,2.0,5
Gareji Sagarejo,8,2,2,4,9,9,0,8,Georgia - Erovnuli Liga,0.25,0.5,0,1.12,1.0,4.0,2.0,6
Kolkheti Poti,8,2,1,5,6,18,-12,7,Georgia - Erovnuli Liga,0.25,0.38,-12,0.75,0.88,4.0,2.63,7
Samgurali,8,1,2,5,10,10,0,5,Georgia - Erovnuli Liga,0.12,0.38,0,1.25,0.62,8.33,2.63,8
Telavi,8,1,1,6,3,16,-13,4,Georgia - Erovnuli Liga,0.12,0.25,-13,0.38,0.5,8.33,4.0,9
Spaeri,8,6,2,0,18,6,12,20,Georgia - Erovnuli Liga 2,0.75,1.0,12,2.25,2.5,1.33,1.0,1
Merani Martvili,8,6,0,2,13,11,2,18,Georgia - Erovnuli Liga 2,0.75,0.75,2,1.62,2.25,1.33,1.33,2
Gonio,8,3,3,2,11,10,1,12,Georgia - Erovnuli Liga 2,0.38,0.75,1,1.38,1.5,2.63,1.33,3
Bolnisi,8,3,2,3,7,8,-1,11,Georgia - Erovnuli Liga 2,0.38,0.62,-1,0.88,1.38,2.63,1.61,4
Rustavi,8,2,4,2,9,9,0,10,Georgia - Erovnuli Liga 2,0.25,0.75,0,1.12,1.25,4.0,1.33,5
L. Tbilisi,8,2,3,3,11,11,0,9,Georgia - Erovnuli Liga 2,0.25,0.62,0,1.38,1.12,4.0,1.61,6
Meshakhte,8,1,6,1,5,5,0,9,Georgia - Erovnuli Liga 2,0.12,0.88,0,0.62,1.12,8.33,1.14,6
Samtredia,8,1,3,4,6,9,-3,6,Georgia - Erovnuli Liga 2,0.12,0.5,-3,0.75,0.75,8.33,2.0,7
D. Tbilisi B,8,1,3,4,5,8,-3,6,Georgia - Erovnuli Liga 2,0.12,0.5,-3,0.62,0.75,8.33,2.0,7
Iberia B,8,1,2,5,5,13,-8,5,Georgia - Erovnuli Liga 2,0.12,0.38,-8,0.62,0.62,8.33,2.63,8
Werder Bremen,8,5,2,1,14,7,7,17,Germany - Bundesliga,0.62,0.88,7,1.75,2.12,1.61,1.14,1
Dortmund,8,5,1,2,19,11,8,16,Germany - Bundesliga,0.62,0.75,8,2.38,2.0,1.61,1.33,2
Bayern Munich,8,4,3,1,21,12,9,15,Germany - Bundesliga,0.5,0.88,9,2.62,1.88,2.0,1.14,3
Leverkusen,8,4,3,1,13,9,4,15,Germany - Bundesliga,0.5,0.88,4,1.62,1.88,2.0,1.14,3
E. Frankfurt,8,4,2,2,13,6,7,14,Germany - Bundesliga,0.5,0.75,7,1.62,1.75,2.0,1.33,4
Union Berlin,8,3,5,0,13,10,3,14,Germany - Bundesliga,0.38,1.0,3,1.62,1.75,2.63,1.0,4
RB Leipzig,8,3,3,2,12,12,0,12,Germany - Bundesliga,0.38,0.75,0,1.5,1.5,2.63,1.33,5
Freiburg,8,3,3,2,12,13,-1,12,Germany - Bundesliga,0.38,0.75,-1,1.5,1.5,2.63,1.33,5
FC Augsburg,8,3,2,3,7,10,-3,11,Germany - Bundesliga,0.38,0.62,-3,0.88,1.38,2.63,1.61,6
Heidenheim,8,3,2,3,6,10,-4,11,Germany - Bundesliga,0.38,0.62,-4,0.75,1.38,2.63,1.61,6
Sankt Pauli,8,2,4,2,8,8,0,10,Germany - Bundesliga,0.25,0.75,0,1.0,1.25,4.0,1.33,7
Holstein Kiel,8,2,3,3,13,16,-3,9,Germany - Bundesliga,0.25,0.62,-3,1.62,1.12,4.0,1.61,8
Stuttgart,8,2,2,4,15,14,1,8,Germany - Bundesliga,0.25,0.5,1,1.88,1.0,4.0,2.0,9
Monchengladbach,8,2,2,4,17,19,-2,8,Germany - Bundesliga,0.25,0.5,-2,2.12,1.0,4.0,2.0,9
FSV Mainz,8,1,4,3,10,15,-5,7,Germany - Bundesliga,0.12,0.62,-5,1.25,0.88,8.33,1.61,10
Hoffenheim,8,1,3,4,13,16,-3,6,Germany - Bundesliga,0.12,0.5,-3,1.62,0.75,8.33,2.0,11
Bochum,8,1,2,5,7,16,-9,5,Germany - Bundesliga,0.12,0.38,-9,0.88,0.62,8.33,2.63,12
Wolfsburg,8,0,2,6,5,14,-9,2,Germany - Bundesliga,0.0,0.25,-9,0.62,0.25,0.0,4.0,13
Hertha Berlin,8,5,2,1,16,8,8,17,Germany - 2. Bundesliga,0.62,0.88,8,2.0,2.12,1.61,1.14,1
Hamburger SV,8,4,2,2,19,9,10,14,Germany - 2. Bundesliga,0.5,0.75,10,2.38,1.75,2.0,1.33,2
FC Koln,8,4,2,2,10,7,3,14,Germany - 2. Bundesliga,0.5,0.75,3,1.25,1.75,2.0,1.33,2
Elversberg,8,3,4,1,15,6,9,13,Germany - 2. Bundesliga,0.38,0.88,9,1.88,1.62,2.63,1.14,3
Braunschweig,8,3,4,1,15,14,1,13,Germany - 2. Bundesliga,0.38,0.88,1,1.88,1.62,2.63,1.14,3
Dusseldorf,8,3,3,2,12,14,-2,12,Germany - 2. Bundesliga,0.38,0.75,-2,1.5,1.5,2.63,1.33,4
Karlsruher SC,8,3,3,2,8,10,-2,12,Germany - 2. Bundesliga,0.38,0.75,-2,1.0,1.5,2.63,1.33,4
Paderborn,8,3,2,3,15,13,2,11,Germany - 2. Bundesliga,0.38,0.62,2,1.88,1.38,2.63,1.61,5
Darmstadt,8,3,2,3,11,11,0,11,Germany - 2. Bundesliga,0.38,0.62,0,1.38,1.38,2.63,1.61,5
Hannover 96,8,3,2,3,8,10,-2,11,Germany - 2. Bundesliga,0.38,0.62,-2,1.0,1.38,2.63,1.61,5
Ulm,8,3,1,4,8,9,-1,10,Germany - 2. Bundesliga,0.38,0.5,-1,1.0,1.25,2.63,2.0,6
FC Nurnberg,8,3,1,4,13,15,-2,10,Germany - 2. Bundesliga,0.38,0.5,-2,1.62,1.25,2.63,2.0,6
Preuss. Munster,8,2,3,3,10,8,2,9,Germany - 2. Bundesliga,0.25,0.62,2,1.25,1.12,4.0,1.61,7
Magdeburg,8,2,3,3,7,11,-4,9,Germany - 2. Bundesliga,0.25,0.62,-4,0.88,1.12,4.0,1.61,7
Regensburg,8,2,3,3,6,13,-7,9,Germany - 2. Bundesliga,0.25,0.62,-7,0.75,1.12,4.0,1.61,7
Kaiserslautern,8,2,2,4,12,16,-4,8,Germany - 2. Bundesliga,0.25,0.5,-4,1.5,1.0,4.0,2.0,8
Schalke 04,8,2,2,4,11,15,-4,8,Germany - 2. Bundesliga,0.25,0.5,-4,1.38,1.0,4.0,2.0,8
Greuther Furth,8,0,3,5,5,12,-7,3,Germany - 2. Bundesliga,0.0,0.38,-7,0.62,0.38,0.0,2.63,9
Bielefeld,8,6,2,0,18,5,13,20,Germany - 3. Liga,0.75,1.0,13,2.25,2.5,1.33,1.0,1
Hansa Rostock,8,5,1,2,12,6,6,16,Germany - 3. Liga,0.62,0.75,6,1.5,2.0,1.61,1.33,2
RW Essen,8,5,1,2,13,11,2,16,Germany - 3. Liga,0.62,0.75,2,1.62,2.0,1.61,1.33,2
1860 Munchen,8,5,0,3,15,8,7,15,Germany - 3. Liga,0.62,0.62,7,1.88,1.88,1.61,1.61,3
Dynamo Dresden,8,4,3,1,15,9,6,15,Germany - 3. Liga,0.5,0.88,6,1.88,1.88,2.0,1.14,3
Alemannia A.,8,4,1,3,10,8,2,13,Germany - 3. Liga,0.5,0.62,2,1.25,1.62,2.0,1.61,4
Osnabruck,8,4,1,3,6,4,2,13,Germany - 3. Liga,0.5,0.62,2,0.75,1.62,2.0,1.61,4
VfB Stuttgart B,8,3,3,2,11,9,2,12,Germany - 3. Liga,0.38,0.75,2,1.38,1.5,2.63,1.33,5
Saarbrucken,8,3,3,2,12,11,1,12,Germany - 3. Liga,0.38,0.75,1,1.5,1.5,2.63,1.33,5
Hannover 96 B,8,2,5,1,16,12,4,11,Germany - 3. Liga,0.25,0.88,4,2.0,1.38,4.0,1.14,6
Verl,8,3,1,4,16,16,0,10,Germany - 3. Liga,0.38,0.5,0,2.0,1.25,2.63,2.0,7
Viktoria Koln,8,3,1,4,9,11,-2,10,Germany - 3. Liga,0.38,0.5,-2,1.12,1.25,2.63,2.0,7
Mannheim,8,2,4,2,8,10,-2,10,Germany - 3. Liga,0.25,0.75,-2,1.0,1.25,4.0,1.33,7
Energie Cottbus,8,3,1,4,8,15,-7,10,Germany - 3. Liga,0.38,0.5,-7,1.0,1.25,2.63,2.0,7
FC Ingolstadt,8,2,3,3,15,15,0,9,Germany - 3. Liga,0.25,0.62,0,1.88,1.12,4.0,1.61,8
Dortmund B,8,2,3,3,12,15,-3,9,Germany - 3. Liga,0.25,0.62,-3,1.5,1.12,4.0,1.61,8
Erzgebirge Aue,8,3,0,5,8,15,-7,9,Germany - 3. Liga,0.38,0.38,-7,1.0,1.12,2.63,2.63,8
Wehen Wiesbaden,8,2,2,4,14,16,-2,8,Germany - 3. Liga,0.25,0.5,-2,1.75,1.0,4.0,2.0,9
Unterhaching,8,1,3,4,6,13,-7,6,Germany - 3. Liga,0.12,0.5,-7,0.75,0.75,8.33,2.0,10
Sandhausen,8,0,0,8,4,17,-13,0,Germany - 3. Liga,0.0,0.0,-13,0.5,0.0,0.0,0.0,11
Nations,8,6,1,1,9,1,8,19,Ghana - Premier League,0.75,0.88,8,1.12,2.38,1.33,1.14,1
Heart of Lions,8,5,1,2,12,6,6,16,Ghana - Premier League,0.62,0.75,6,1.5,2.0,1.61,1.33,2
Dreams,8,5,1,2,10,7,3,16,Ghana - Premier League,0.62,0.75,3,1.25,2.0,1.61,1.33,2
Medeama,8,5,0,3,14,5,9,15,Ghana - Premier League,0.62,0.62,9,1.75,1.88,1.61,1.61,3
Accra Lions,8,5,0,3,13,8,5,15,Ghana - Premier League,0.62,0.62,5,1.62,1.88,1.61,1.61,3
Samartex,8,4,2,2,13,6,7,14,Ghana - Premier League,0.5,0.75,7,1.62,1.75,2.0,1.33,4
Aduana Stars,8,4,1,3,11,9,2,13,Ghana - Premier League,0.5,0.62,2,1.38,1.62,2.0,1.61,5
Karela,8,4,1,3,8,6,2,13,Ghana - Premier League,0.5,0.62,2,1.0,1.62,2.0,1.61,5
Bibiani GS,8,4,1,3,7,7,0,13,Ghana - Premier League,0.5,0.62,0,0.88,1.62,2.0,1.61,5
Asante Kotoko,8,3,3,2,5,7,-2,12,Ghana - Premier League,0.38,0.75,-2,0.62,1.5,2.63,1.33,6
Hearts of Oak,8,2,4,2,6,5,1,10,Ghana - Premier League,0.25,0.75,1,0.75,1.25,4.0,1.33,7
Berekum Chelsea,8,3,1,4,8,9,-1,10,Ghana - Premier League,0.38,0.5,-1,1.0,1.25,2.63,2.0,7
Vision,8,2,3,3,8,9,-1,9,Ghana - Premier League,0.25,0.62,-1,1.0,1.12,4.0,1.61,8
Young Apostles,8,2,3,3,7,9,-2,9,Ghana - Premier League,0.25,0.62,-2,0.88,1.12,4.0,1.61,8
Holy Stars,8,3,0,5,6,11,-5,9,Ghana - Premier League,0.38,0.38,-5,0.75,1.12,2.63,2.63,8
Bechem Utd,8,2,1,5,7,10,-3,7,Ghana - Premier League,0.25,0.38,-3,0.88,0.88,4.0,2.63,9
Legon Cities,8,1,1,6,4,9,-5,4,Ghana - Premier League,0.12,0.25,-5,0.5,0.5,8.33,4.0,10
Nsoatreman,8,0,0,8,0,24,-24,0,Ghana - Premier League,0.0,0.0,-24,0.0,0.0,0.0,0.0,11
St Josephs,8,7,0,1,24,4,20,21,Gibraltar - Premier Division,0.88,0.88,20,3.0,2.62,1.14,1.14,1
Lincoln RI,8,7,0,1,18,3,15,21,Gibraltar - Premier Division,0.88,0.88,15,2.25,2.62,1.14,1.14,1
Europa FC,8,5,0,3,18,12,6,15,Gibraltar - Premier Division,0.62,0.62,6,2.25,1.88,1.61,1.61,2
Manchester 62,8,4,1,3,16,7,9,13,Gibraltar - Premier Division,0.5,0.62,9,2.0,1.62,2.0,1.61,3
Magpies,8,4,0,4,16,13,3,12,Gibraltar - Premier Division,0.5,0.5,3,2.0,1.5,2.0,2.0,4
College 1975,8,3,1,4,13,13,0,10,Gibraltar - Premier Division,0.38,0.5,0,1.62,1.25,2.63,2.0,5
Lynx,8,3,1,4,10,22,-12,10,Gibraltar - Premier Division,0.38,0.5,-12,1.25,1.25,2.63,2.0,5
Glacis Utd,8,2,0,6,13,24,-11,6,Gibraltar - Premier Division,0.25,0.25,-11,1.62,0.75,4.0,4.0,6
Europa Point,8,0,2,6,7,28,-21,2,Gibraltar - Premier Division,0.0,0.25,-21,0.88,0.25,0.0,4.0,7
Mons Calpe,8,0,1,7,7,25,-18,1,Gibraltar - Premier Division,0.0,0.12,-18,0.88,0.12,0.0,8.33,8
Lions FC,8,0,1,7,3,22,-19,1,Gibraltar - Premier Division,0.0,0.12,-19,0.38,0.12,0.0,8.33,8
Olympiakos,8,7,0,1,16,7,9,21,Greece - Super League,0.88,0.88,9,2.0,2.62,1.14,1.14,1
Aris,8,4,3,1,9,6,3,15,Greece - Super League,0.5,0.88,3,1.12,1.88,2.0,1.14,2
Levadiakos,8,4,2,2,12,6,6,14,Greece - Super League,0.5,0.75,6,1.5,1.75,2.0,1.33,3
Panserraikos,8,4,2,2,12,11,1,14,Greece - Super League,0.5,0.75,1,1.5,1.75,2.0,1.33,3
Panathinaikos,8,4,1,3,15,13,2,13,Greece - Super League,0.5,0.62,2,1.88,1.62,2.0,1.61,4
Atromitos,8,4,1,3,9,8,1,13,Greece - Super League,0.5,0.62,1,1.12,1.62,2.0,1.61,4
Volos,8,3,3,2,9,7,2,12,Greece - Super League,0.38,0.75,2,1.12,1.5,2.63,1.33,5
PAOK,8,4,0,4,14,15,-1,12,Greece - Super League,0.5,0.5,-1,1.75,1.5,2.0,2.0,5
OFI Crete,8,4,0,4,13,14,-1,12,Greece - Super League,0.5,0.5,-1,1.62,1.5,2.0,2.0,5
A. Kallithea,8,3,2,3,8,10,-2,11,Greece - Super League,0.38,0.62,-2,1.0,1.38,2.63,1.61,6
Asteras T.,8,3,1,4,7,11,-4,10,Greece - Super League,0.38,0.5,-4,0.88,1.25,2.63,2.0,7
Panaitolikos,8,1,4,3,3,6,-3,7,Greece - Super League,0.12,0.62,-3,0.38,0.88,8.33,1.61,8
Lamia,8,1,2,5,5,13,-8,5,Greece - Super League,0.12,0.38,-8,0.62,0.62,8.33,2.63,9
AEK Athens,8,1,1,6,7,12,-5,4,Greece - Super League,0.12,0.25,-5,0.88,0.5,8.33,4.0,10
Malacateco,8,6,0,2,15,5,10,18,Guatemala - Liga Nacional - Apertura,0.75,0.75,10,1.88,2.25,1.33,1.33,1
Xelaju,8,5,2,1,16,5,11,17,Guatemala - Liga Nacional - Apertura,0.62,0.88,11,2.0,2.12,1.61,1.14,2
Municipal,8,4,2,2,13,13,0,14,Guatemala - Liga Nacional - Apertura,0.5,0.75,0,1.62,1.75,2.0,1.33,3
Coban Imperial,8,4,1,3,13,9,4,13,Guatemala - Liga Nacional - Apertura,0.5,0.62,4,1.62,1.62,2.0,1.61,4
Antigua GFC,8,3,3,2,14,11,3,12,Guatemala - Liga Nacional - Apertura,0.38,0.75,3,1.75,1.5,2.63,1.33,5
Xinabajul,8,3,2,3,15,14,1,11,Guatemala - Liga Nacional - Apertura,0.38,0.62,1,1.88,1.38,2.63,1.61,6
Comunicaciones,8,3,2,3,12,13,-1,11,Guatemala - Liga Nacional - Apertura,0.38,0.62,-1,1.5,1.38,2.63,1.61,6
Guastatoya,8,2,4,2,12,10,2,10,Guatemala - Liga Nacional - Apertura,0.25,0.75,2,1.5,1.25,4.0,1.33,7
Mixco,8,3,1,4,7,11,-4,10,Guatemala - Liga Nacional - Apertura,0.38,0.5,-4,0.88,1.25,2.63,2.0,7
Achuapa,8,2,3,3,6,10,-4,9,Guatemala - Liga Nacional - Apertura,0.25,0.62,-4,0.75,1.12,4.0,1.61,8
Marquense,8,0,3,5,4,16,-12,3,Guatemala - Liga Nacional - Apertura,0.0,0.38,-12,0.5,0.38,0.0,2.63,9
Zacapa Tellioz,8,0,2,6,3,14,-11,2,Guatemala - Liga Nacional - Apertura,0.0,0.25,-11,0.38,0.25,0.0,4.0,10
Municipal,8,3,2,3,8,6,2,11,guatemala2,0.38,0.62,2,1.0,1.38,2.63,1.61,1
Guastatoya,8,3,2,3,9,10,-1,11,guatemala2,0.38,0.62,-1,1.12,1.38,2.63,1.61,1
Comunicaciones,8,2,3,3,10,11,-1,9,guatemala2,0.25,0.62,-1,1.25,1.12,4.0,1.61,2
Antigua GFC,8,2,3,3,5,7,-2,9,guatemala2,0.25,0.62,-2,0.62,1.12,4.0,1.61,2
Mixco,8,1,5,2,7,8,-1,8,guatemala2,0.12,0.75,-1,0.88,1.0,8.33,1.33,3
Coban Imperial,8,2,0,6,10,16,-6,6,guatemala2,0.25,0.25,-6,1.25,0.75,4.0,4.0,4
Malacateco,8,1,2,5,10,16,-6,5,guatemala2,0.12,0.38,-6,1.25,0.62,8.33,2.63,5
Marquense,8,1,2,5,3,9,-6,5,guatemala2,0.12,0.38,-6,0.38,0.62,8.33,2.63,5
Xinabajul,8,1,1,6,6,18,-12,4,guatemala2,0.12,0.25,-12,0.75,0.5,8.33,4.0,6
Xelaju,8,0,3,5,5,10,-5,3,guatemala2,0.0,0.38,-5,0.62,0.38,0.0,2.63,7
Achuapa,8,1,0,7,6,12,-6,3,guatemala2,0.12,0.12,-6,0.75,0.38,8.33,8.33,7
Olimpia,8,6,2,0,16,4,12,20,Honduras - Liga Nacional - Apertura,0.75,1.0,12,2.0,2.5,1.33,1.0,1
Genesis,8,4,3,1,16,8,8,15,Honduras - Liga Nacional - Apertura,0.5,0.88,8,2.0,1.88,2.0,1.14,2
Motagua,8,4,2,2,18,14,4,14,Honduras - Liga Nacional - Apertura,0.5,0.75,4,2.25,1.75,2.0,1.33,3
Olancho,8,3,4,1,15,10,5,13,Honduras - Liga Nacional - Apertura,0.38,0.88,5,1.88,1.62,2.63,1.14,4
Marathon,8,2,4,2,9,8,1,10,Honduras - Liga Nacional - Apertura,0.25,0.75,1,1.12,1.25,4.0,1.33,5
Juticalpa,8,2,2,4,7,14,-7,8,Honduras - Liga Nacional - Apertura,0.25,0.5,-7,0.88,1.0,4.0,2.0,6
UPNFM,8,2,2,4,6,16,-10,8,Honduras - Liga Nacional - Apertura,0.25,0.5,-10,0.75,1.0,4.0,2.0,6
Real Espana,8,1,4,3,6,7,-1,7,Honduras - Liga Nacional - Apertura,0.12,0.62,-1,0.75,0.88,8.33,1.61,7
Real Sociedad,8,1,3,4,10,17,-7,6,Honduras - Liga Nacional - Apertura,0.12,0.5,-7,1.25,0.75,8.33,2.0,8
Victoria,8,1,2,5,13,18,-5,5,Honduras - Liga Nacional - Apertura,0.12,0.38,-5,1.62,0.62,8.33,2.63,9
Marathon,8,4,3,1,12,6,6,15,honduras2,0.5,0.88,6,1.5,1.88,2.0,1.14,1
Olimpia,8,4,2,2,12,7,5,14,honduras2,0.5,0.75,5,1.5,1.75,2.0,1.33,2
Real Espana,8,3,3,2,11,9,2,12,honduras2,0.38,0.75,2,1.38,1.5,2.63,1.33,3
Victoria,8,2,4,2,12,11,1,10,honduras2,0.25,0.75,1,1.5,1.25,4.0,1.33,4
Motagua,8,2,4,2,9,8,1,10,honduras2,0.25,0.75,1,1.12,1.25,4.0,1.33,4
Olancho,8,1,3,4,8,12,-4,6,honduras2,0.12,0.5,-4,1.0,0.75,8.33,2.0,5
Genesis,8,1,3,4,4,12,-8,6,honduras2,0.12,0.5,-8,0.5,0.75,8.33,2.0,5
Juticalpa,8,1,2,5,3,15,-12,5,honduras2,0.12,0.38,-12,0.38,0.62,8.33,2.63,6
Real Sociedad,8,0,4,4,5,11,-6,4,honduras2,0.0,0.5,-6,0.62,0.5,0.0,2.0,7
UPNFM,8,0,3,5,7,17,-10,3,honduras2,0.0,0.38,-10,0.88,0.38,0.0,2.63,8
LM Warriors,8,6,1,1,19,9,10,19,Hong Kong - Premier League,0.75,0.88,10,2.38,2.38,1.33,1.14,1
Tai Po,8,5,2,1,28,16,12,17,Hong Kong - Premier League,0.62,0.88,12,3.5,2.12,1.61,1.14,2
Eastern,8,5,2,1,21,11,10,17,Hong Kong - Premier League,0.62,0.88,10,2.62,2.12,1.61,1.14,2
Kitchee,8,4,0,4,15,12,3,12,Hong Kong - Premier League,0.5,0.5,3,1.88,1.5,2.0,2.0,3
North District,8,4,0,4,15,21,-6,12,Hong Kong - Premier League,0.5,0.5,-6,1.88,1.5,2.0,2.0,3
HK Rangers,8,3,2,3,16,11,5,11,Hong Kong - Premier League,0.38,0.62,5,2.0,1.38,2.63,1.61,4
Southern D.,8,2,3,3,11,13,-2,9,Hong Kong - Premier League,0.25,0.62,-2,1.38,1.12,4.0,1.61,5
Kowloon City,8,1,1,6,13,29,-16,4,Hong Kong - Premier League,0.12,0.25,-16,1.62,0.5,8.33,4.0,6
Hong Kong FC,8,0,1,7,6,22,-16,1,Hong Kong - Premier League,0.0,0.12,-16,0.75,0.12,0.0,8.33,7
Ferencvaros,8,6,2,0,21,4,17,20,Hungary - NB I,0.75,1.0,17,2.62,2.5,1.33,1.0,1
Gyor,8,6,2,0,15,6,9,20,Hungary - NB I,0.75,1.0,9,1.88,2.5,1.33,1.0,1
Paks,8,5,2,1,17,7,10,17,Hungary - NB I,0.62,0.88,10,2.12,2.12,1.61,1.14,2
Puskas A.,8,3,4,1,12,9,3,13,Hungary - NB I,0.38,0.88,3,1.5,1.62,2.63,1.14,3
Debrecen,8,3,2,3,12,9,3,11,Hungary - NB I,0.38,0.62,3,1.5,1.38,2.63,1.61,4
MTK Budapest,8,1,4,3,10,10,0,7,Hungary - NB I,0.12,0.62,0,1.25,0.88,8.33,1.61,5
Zalaegerszegi,8,1,4,3,9,11,-2,7,Hungary - NB I,0.12,0.62,-2,1.12,0.88,8.33,1.61,5
DVTK,8,1,4,3,8,14,-6,7,Hungary - NB I,0.12,0.62,-6,1.0,0.88,8.33,1.61,5
Ujpest,8,1,4,3,9,16,-7,7,Hungary - NB I,0.12,0.62,-7,1.12,0.88,8.33,1.61,5
Nyiregyhaza,8,2,1,5,4,17,-13,7,Hungary - NB I,0.25,0.38,-13,0.5,0.88,4.0,2.63,5
Kecskemeti TE,8,0,5,3,7,14,-7,5,Hungary - NB I,0.0,0.62,-7,0.88,0.62,0.0,1.61,6
Fehervar,8,0,4,4,6,13,-7,4,Hungary - NB I,0.0,0.5,-7,0.75,0.5,0.0,2.0,7
Kisvarda,8,6,2,0,19,10,9,20,Hungary - NB II,0.75,1.0,9,2.38,2.5,1.33,1.0,1
Honved,8,5,2,1,12,7,5,17,Hungary - NB II,0.62,0.88,5,1.5,2.12,1.61,1.14,2
Vasas,8,5,0,3,14,10,4,15,Hungary - NB II,0.62,0.62,4,1.75,1.88,1.61,1.61,3
Mezokovesd,8,4,1,3,13,9,4,13,Hungary - NB II,0.5,0.62,4,1.62,1.62,2.0,1.61,4
Szentlorinc,8,3,4,1,13,10,3,13,Hungary - NB II,0.38,0.88,3,1.62,1.62,2.63,1.14,4
Szeged,8,3,3,2,11,10,1,12,Hungary - NB II,0.38,0.75,1,1.38,1.5,2.63,1.33,5
Kazincbarcika,8,3,3,2,12,12,0,12,Hungary - NB II,0.38,0.75,0,1.5,1.5,2.63,1.33,5
Kozarmisleny,8,4,0,4,11,11,0,12,Hungary - NB II,0.5,0.5,0,1.38,1.5,2.0,2.0,5
BVSC,8,3,2,3,12,11,1,11,Hungary - NB II,0.38,0.62,1,1.5,1.38,2.63,1.61,6
Budafoki,8,2,2,4,13,15,-2,8,Hungary - NB II,0.25,0.5,-2,1.62,1.0,4.0,2.0,7
Csakvari,8,2,2,4,11,13,-2,8,Hungary - NB II,0.25,0.5,-2,1.38,1.0,4.0,2.0,7
Soroksar,8,2,2,4,11,13,-2,8,Hungary - NB II,0.25,0.5,-2,1.38,1.0,4.0,2.0,7
Ajka,8,1,4,3,6,11,-5,7,Hungary - NB II,0.12,0.62,-5,0.75,0.88,8.33,1.61,8
Bekescsaba,8,1,3,4,7,13,-6,6,Hungary - NB II,0.12,0.5,-6,0.88,0.75,8.33,2.0,9
Tatabanya,8,1,3,4,8,15,-7,6,Hungary - NB II,0.12,0.5,-7,1.0,0.75,8.33,2.0,9
Gyirmot,8,0,5,3,5,8,-3,5,Hungary - NB II,0.0,0.62,-3,0.62,0.62,0.0,1.61,10
Vikingur R.,5,3,1,1,10,4,6,10,Iceland - Besta deild,0.6,0.8,6,2.0,2.0,1.67,1.25,1
Vestri,5,3,1,1,6,2,4,10,Iceland - Besta deild,0.6,0.8,4,1.2,2.0,1.67,1.25,1
Breidablik,5,3,1,1,10,8,2,10,Iceland - Besta deild,0.6,0.8,2,2.0,2.0,1.67,1.25,1
KR Reykjavik,5,1,4,0,15,10,5,7,Iceland - Besta deild,0.2,1.0,5,3.0,1.4,5.0,1.0,2
IBV,5,2,1,2,6,7,-1,7,Iceland - Besta deild,0.4,0.6,-1,1.2,1.4,2.5,1.67,2
Afturelding,5,2,1,2,4,5,-1,7,Iceland - Besta deild,0.4,0.6,-1,0.8,1.4,2.5,1.67,2
Fram,5,2,0,3,10,9,1,6,Iceland - Besta deild,0.4,0.4,1,2.0,1.2,2.5,2.5,3
Valur,5,1,3,1,8,9,-1,6,Iceland - Besta deild,0.2,0.8,-1,1.6,1.2,5.0,1.25,3
Stjarnan,5,2,0,3,7,10,-3,6,Iceland - Besta deild,0.4,0.4,-3,1.4,1.2,2.5,2.5,3
IA Akranes,5,2,0,3,5,9,-4,6,Iceland - Besta deild,0.4,0.4,-4,1.0,1.2,2.5,2.5,3
Hafnarfjordur,5,1,1,3,8,8,0,4,Iceland - Besta deild,0.2,0.4,0,1.6,0.8,5.0,2.5,4
KA Akureyri,5,1,1,3,6,14,-8,4,Iceland - Besta deild,0.2,0.4,-8,1.2,0.8,5.0,2.5,4
Keflavik,1,1,0,0,3,1,2,3,Iceland - 1. Deild,1.0,1.0,2,3.0,3.0,1.0,1.0,1
Selfoss,1,1,0,0,2,1,1,3,Iceland - 1. Deild,1.0,1.0,1,2.0,3.0,1.0,1.0,1
IR Reykjavik,1,1,0,0,1,0,1,3,Iceland - 1. Deild,1.0,1.0,1,1.0,3.0,1.0,1.0,1
Fylkir,1,0,1,0,1,1,0,1,Iceland - 1. Deild,0.0,1.0,0,1.0,1.0,0.0,1.0,2
HK Kopavogur,1,0,1,0,1,1,0,1,Iceland - 1. Deild,0.0,1.0,0,1.0,1.0,0.0,1.0,2
Leiknir R.,1,0,1,0,1,1,0,1,Iceland - 1. Deild,0.0,1.0,0,1.0,1.0,0.0,1.0,2
Njardvik,1,0,1,0,1,1,0,1,Iceland - 1. Deild,0.0,1.0,0,1.0,1.0,0.0,1.0,2
Thor Akureyri,1,0,1,0,1,1,0,1,Iceland - 1. Deild,0.0,1.0,0,1.0,1.0,0.0,1.0,2
Throttur R.,1,0,1,0,1,1,0,1,Iceland - 1. Deild,0.0,1.0,0,1.0,1.0,0.0,1.0,2
Grindavik,1,0,0,1,1,2,-1,0,Iceland - 1. Deild,0.0,0.0,-1,1.0,0.0,0.0,0.0,3
Volsungur,1,0,0,1,0,1,-1,0,Iceland - 1. Deild,0.0,0.0,-1,0.0,0.0,0.0,0.0,3
Fjolnir,1,0,0,1,1,3,-2,0,Iceland - 1. Deild,0.0,0.0,-2,1.0,0.0,0.0,0.0,3
KFA,1,1,0,0,8,1,7,3,Iceland - 2. Deild,1.0,1.0,7,8.0,3.0,1.0,1.0,1
Throttur Vogar,1,1,0,0,2,1,1,3,Iceland - 2. Deild,1.0,1.0,1,2.0,3.0,1.0,1.0,1
Dalvik/Reynir,1,0,1,0,1,1,0,1,Iceland - 2. Deild,0.0,1.0,0,1.0,1.0,0.0,1.0,2
Grotta,1,0,1,0,1,1,0,1,Iceland - 2. Deild,0.0,1.0,0,1.0,1.0,0.0,1.0,2
Haukar,1,0,1,0,1,1,0,1,Iceland - 2. Deild,0.0,1.0,0,1.0,1.0,0.0,1.0,2
Hottur/Huginn,1,0,1,0,1,1,0,1,Iceland - 2. Deild,0.0,1.0,0,1.0,1.0,0.0,1.0,2
V. Olafsvik,1,0,1,0,1,1,0,1,Iceland - 2. Deild,0.0,1.0,0,1.0,1.0,0.0,1.0,2
Vidir,1,0,1,0,1,1,0,1,Iceland - 2. Deild,0.0,1.0,0,1.0,1.0,0.0,1.0,2
Aeggir,1,0,1,0,0,0,0,1,Iceland - 2. Deild,0.0,1.0,0,0.0,1.0,0.0,1.0,2
KFG,1,0,1,0,0,0,0,1,Iceland - 2. Deild,0.0,1.0,0,0.0,1.0,0.0,1.0,2
Kari,1,0,0,1,1,2,-1,0,Iceland - 2. Deild,0.0,0.0,-1,1.0,0.0,0.0,0.0,3
Kormakur/Hvot,1,0,0,1,1,8,-7,0,Iceland - 2. Deild,0.0,0.0,-7,1.0,0.0,0.0,0.0,3
Mohun Bagan,8,6,2,0,16,2,14,20,India - Super League,0.75,1.0,14,2.0,2.5,1.33,1.0,1
Goa,8,6,0,2,13,7,6,18,India - Super League,0.75,0.75,6,1.62,2.25,1.33,1.33,2
NorthEast Utd,8,4,2,2,15,7,8,14,India - Super League,0.5,0.75,8,1.88,1.75,2.0,1.33,3
East Bengal,8,4,2,2,11,11,0,14,India - Super League,0.5,0.75,0,1.38,1.75,2.0,1.33,3
Mumbai City,8,3,3,2,10,6,4,12,India - Super League,0.38,0.75,4,1.25,1.5,2.63,1.33,4
Odisha FC,8,3,3,2,13,11,2,12,India - Super League,0.38,0.75,2,1.62,1.5,2.63,1.33,4
Bengaluru,8,3,1,4,11,10,1,10,India - Super League,0.38,0.5,1,1.38,1.25,2.63,2.0,5
Chennaiyin,8,3,1,4,11,12,-1,10,India - Super League,0.38,0.5,-1,1.38,1.25,2.63,2.0,5
Jamshedpur,8,3,1,4,12,16,-4,10,India - Super League,0.38,0.5,-4,1.5,1.25,2.63,2.0,5
Kerala Blasters,8,2,3,3,7,10,-3,9,India - Super League,0.25,0.62,-3,0.88,1.12,4.0,1.61,6
Punjab,8,2,2,4,11,15,-4,8,India - Super League,0.25,0.5,-4,1.38,1.0,4.0,2.0,7
Hyderabad,8,2,2,4,10,16,-6,8,India - Super League,0.25,0.5,-6,1.25,1.0,4.0,2.0,7
Mohammedan,8,0,2,6,4,19,-15,2,India - Super League,0.0,0.25,-15,0.5,0.25,0.0,4.0,8
Gokulam,8,6,0,2,23,14,9,18,India - I-League,0.75,0.75,9,2.88,2.25,1.33,1.33,1
Inter Kashi,8,4,3,1,14,11,3,15,India - I-League,0.5,0.88,3,1.75,1.88,2.0,1.14,2
Churchill B.,8,3,5,0,18,9,9,14,India - I-League,0.38,1.0,9,2.25,1.75,2.63,1.0,3
Real Kashmir,8,4,2,2,12,12,0,14,India - I-League,0.5,0.75,0,1.5,1.75,2.0,1.33,3
Rajasthan,8,4,0,4,16,13,3,12,India - I-League,0.5,0.5,3,2.0,1.5,2.0,2.0,4
Sreenidi Deccan,8,3,3,2,11,10,1,12,India - I-League,0.38,0.75,1,1.38,1.5,2.63,1.33,4
Dempo,8,3,2,3,24,17,7,11,India - I-League,0.38,0.62,7,3.0,1.38,2.63,1.61,5
Aizawl,8,3,2,3,16,15,1,11,India - I-League,0.38,0.62,1,2.0,1.38,2.63,1.61,5
SC Bengaluru,8,2,2,4,11,18,-7,8,India - I-League,0.25,0.5,-7,1.38,1.0,4.0,2.0,6
Namdhari,8,2,1,5,8,14,-6,7,India - I-League,0.25,0.38,-6,1.0,0.88,4.0,2.63,7
Shillong Lajong,8,1,3,4,12,23,-11,6,India - I-League,0.12,0.5,-11,1.5,0.75,8.33,2.0,8
Delhi FC,8,1,1,6,7,16,-9,4,India - I-League,0.12,0.25,-9,0.88,0.5,8.33,4.0,9
Malut United,8,6,2,0,13,6,7,20,Indonesia - Liga 1,0.75,1.0,7,1.62,2.5,1.33,1.0,1
PSBS Biak N.,8,5,3,0,12,5,7,18,Indonesia - Liga 1,0.62,1.0,7,1.5,2.25,1.61,1.0,2
Dewa Utd,8,4,2,2,14,5,9,14,Indonesia - Liga 1,0.5,0.75,9,1.75,1.75,2.0,1.33,3
Persib,8,4,2,2,16,10,6,14,Indonesia - Liga 1,0.5,0.75,6,2.0,1.75,2.0,1.33,3
Borneo,8,4,2,2,12,8,4,14,Indonesia - Liga 1,0.5,0.75,4,1.5,1.75,2.0,1.33,3
Persis Solo,8,4,2,2,11,8,3,14,Indonesia - Liga 1,0.5,0.75,3,1.38,1.75,2.0,1.33,3
Persebaya S.,8,3,4,1,12,9,3,13,Indonesia - Liga 1,0.38,0.88,3,1.5,1.62,2.63,1.14,4
Madura Utd,8,4,1,3,8,8,0,13,Indonesia - Liga 1,0.5,0.62,0,1.0,1.62,2.0,1.61,4
Arema,8,3,2,3,14,12,2,11,Indonesia - Liga 1,0.38,0.62,2,1.75,1.38,2.63,1.61,5
PSM,8,3,2,3,10,9,1,11,Indonesia - Liga 1,0.38,0.62,1,1.25,1.38,2.63,1.61,5
Semen Padang,8,3,2,3,10,17,-7,11,Indonesia - Liga 1,0.38,0.62,-7,1.25,1.38,2.63,1.61,5
Bali Utd,8,2,3,3,10,10,0,9,Indonesia - Liga 1,0.25,0.62,0,1.25,1.12,4.0,1.61,6
PSS Sleman,8,3,0,5,10,15,-5,9,Indonesia - Liga 1,0.38,0.38,-5,1.25,1.12,2.63,2.63,6
Barito Putera,8,2,2,4,11,13,-2,8,Indonesia - Liga 1,0.25,0.5,-2,1.38,1.0,4.0,2.0,7
Persija,8,2,1,5,5,9,-4,7,Indonesia - Liga 1,0.25,0.38,-4,0.62,0.88,4.0,2.63,8
Persita,8,2,1,5,8,14,-6,7,Indonesia - Liga 1,0.25,0.38,-6,1.0,0.88,4.0,2.63,8
Persik Kediri,8,0,4,4,9,15,-6,4,Indonesia - Liga 1,0.0,0.5,-6,1.12,0.5,0.0,2.0,9
PSIS Semarang,8,0,2,6,7,19,-12,2,Indonesia - Liga 1,0.0,0.25,-12,0.88,0.25,0.0,4.0,10
Tractor Sazi,8,6,2,0,19,8,11,20,Iran - Pro League,0.75,1.0,11,2.38,2.5,1.33,1.0,1
Persepolis,8,5,1,2,11,6,5,16,Iran - Pro League,0.62,0.75,5,1.38,2.0,1.61,1.33,2
Foolad,8,4,2,2,9,7,2,14,Iran - Pro League,0.5,0.75,2,1.12,1.75,2.0,1.33,3
Sepahan,8,3,4,1,10,6,4,13,Iran - Pro League,0.38,0.88,4,1.25,1.62,2.63,1.14,4
Zob Ahan,8,3,3,2,10,9,1,12,Iran - Pro League,0.38,0.75,1,1.25,1.5,2.63,1.33,5
Gol Gohar,8,3,3,2,8,7,1,12,Iran - Pro League,0.38,0.75,1,1.0,1.5,2.63,1.33,5
Malavan,8,3,2,3,11,11,0,11,Iran - Pro League,0.38,0.62,0,1.38,1.38,2.63,1.61,6
Shams A. Qazvin,8,3,2,3,10,12,-2,11,Iran - Pro League,0.38,0.62,-2,1.25,1.38,2.63,1.61,6
Havadar,8,2,4,2,10,12,-2,10,Iran - Pro League,0.25,0.75,-2,1.25,1.25,4.0,1.33,7
K. Khorramabad,8,2,3,3,5,8,-3,9,Iran - Pro League,0.25,0.62,-3,0.62,1.12,4.0,1.61,8
Esteghlal,8,1,5,2,11,9,2,8,Iran - Pro League,0.12,0.75,2,1.38,1.0,8.33,1.33,9
E. Khuzestan,8,1,5,2,5,5,0,8,Iran - Pro League,0.12,0.75,0,0.62,1.0,8.33,1.33,9
Chadormalu,8,1,4,3,5,8,-3,7,Iran - Pro League,0.12,0.62,-3,0.62,0.88,8.33,1.61,10
Aluminium Arak,8,1,4,3,5,10,-5,7,Iran - Pro League,0.12,0.62,-5,0.62,0.88,8.33,1.61,10
Mes Rafsanjan,8,1,2,5,6,12,-6,5,Iran - Pro League,0.12,0.38,-6,0.75,0.62,8.33,2.63,11
N. Mazandaran,8,0,4,4,4,9,-5,4,Iran - Pro League,0.0,0.5,-5,0.5,0.5,0.0,2.0,12
Derry City,8,5,1,2,13,8,5,16,Ireland - Premier Division,0.62,0.75,5,1.62,2.0,1.61,1.33,1
Shamrock Rovers,8,4,3,1,16,9,7,15,Ireland - Premier Division,0.5,0.88,7,2.0,1.88,2.0,1.14,2
Bohemians,8,5,0,3,13,11,2,15,Ireland - Premier Division,0.62,0.62,2,1.62,1.88,1.61,1.61,2
Drogheda Utd,8,3,4,1,14,10,4,13,Ireland - Premier Division,0.38,0.88,4,1.75,1.62,2.63,1.14,3
St. Patricks,8,3,3,2,9,6,3,12,Ireland - Premier Division,0.38,0.75,3,1.12,1.5,2.63,1.33,4
Galway Utd,8,3,1,4,11,12,-1,10,Ireland - Premier Division,0.38,0.5,-1,1.38,1.25,2.63,2.0,5
Shelbourne,8,2,4,2,9,10,-1,10,Ireland - Premier Division,0.25,0.75,-1,1.12,1.25,4.0,1.33,5
Waterford,8,3,0,5,7,14,-7,9,Ireland - Premier Division,0.38,0.38,-7,0.88,1.12,2.63,2.63,6
Sligo Rovers,8,1,2,5,11,16,-5,5,Ireland - Premier Division,0.12,0.38,-5,1.38,0.62,8.33,2.63,7
Cork City,8,1,2,5,8,15,-7,5,Ireland - Premier Division,0.12,0.38,-7,1.0,0.62,8.33,2.63,7
Bray Wanderers,8,7,0,1,17,6,11,21,Ireland - First Division,0.88,0.88,11,2.12,2.62,1.14,1.14,1
Dundalk,8,5,3,0,12,3,9,18,Ireland - First Division,0.62,1.0,9,1.5,2.25,1.61,1.0,2
Cobh Ramblers,8,5,0,3,12,8,4,15,Ireland - First Division,0.62,0.62,4,1.5,1.88,1.61,1.61,3
Finn Harps,8,3,3,2,15,11,4,12,Ireland - First Division,0.38,0.75,4,1.88,1.5,2.63,1.33,4
Wexford,8,3,2,3,12,11,1,11,Ireland - First Division,0.38,0.62,1,1.5,1.38,2.63,1.61,5
Treaty Utd,8,3,2,3,8,7,1,11,Ireland - First Division,0.38,0.62,1,1.0,1.38,2.63,1.61,5
UC Dublin,8,3,0,5,3,6,-3,9,Ireland - First Division,0.38,0.38,-3,0.38,1.12,2.63,2.63,6
Kerry,8,3,0,5,10,15,-5,9,Ireland - First Division,0.38,0.38,-5,1.25,1.12,2.63,2.63,6
Longford Town,8,2,2,4,7,14,-7,8,Ireland - First Division,0.25,0.5,-7,0.88,1.0,4.0,2.0,7
Athlone Town,8,0,3,5,2,10,-8,3,Ireland - First Division,0.0,0.38,-8,0.25,0.38,0.0,2.63,8
M. Tel Aviv,8,5,2,1,18,8,10,17,Israel - Ligat HaAl,0.62,0.88,10,2.25,2.12,1.61,1.14,1
H. Jerusalem,8,4,3,1,13,5,8,15,Israel - Ligat HaAl,0.5,0.88,8,1.62,1.88,2.0,1.14,2
H. Beer Sheva,8,4,2,2,14,9,5,14,Israel - Ligat HaAl,0.5,0.75,5,1.75,1.75,2.0,1.33,3
Ashdod,8,3,5,0,11,6,5,14,Israel - Ligat HaAl,0.38,1.0,5,1.38,1.75,2.63,1.0,3
Sakhnin,8,4,1,3,8,10,-2,13,Israel - Ligat HaAl,0.5,0.62,-2,1.0,1.62,2.0,1.61,4
Ironi Tiberias,8,3,2,3,10,10,0,11,Israel - Ligat HaAl,0.38,0.62,0,1.25,1.38,2.63,1.61,5
Maccabi Haifa,8,3,2,3,11,15,-4,11,Israel - Ligat HaAl,0.38,0.62,-4,1.38,1.38,2.63,1.61,5
Hapoel Hadera,8,3,1,4,10,15,-5,10,Israel - Ligat HaAl,0.38,0.5,-5,1.25,1.25,2.63,2.0,6
M. Petah Tikva,8,2,2,4,10,10,0,8,Israel - Ligat HaAl,0.25,0.5,0,1.25,1.0,4.0,2.0,7
Maccabi Netanya,8,2,2,4,9,12,-3,8,Israel - Ligat HaAl,0.25,0.5,-3,1.12,1.0,4.0,2.0,7
B. Jerusalem,8,2,2,4,10,14,-4,8,Israel - Ligat HaAl,0.25,0.5,-4,1.25,1.0,4.0,2.0,7
M. Bnei Raina,8,2,1,5,9,11,-2,7,Israel - Ligat HaAl,0.25,0.38,-2,1.12,0.88,4.0,2.63,8
Hapoel Haifa,8,2,1,5,10,15,-5,7,Israel - Ligat HaAl,0.25,0.38,-5,1.25,0.88,4.0,2.63,8
Kiryat Shmona,8,2,1,5,4,10,-6,7,Israel - Ligat HaAl,0.25,0.38,-6,0.5,0.88,4.0,2.63,8
H. Petah Tikva,8,7,1,0,11,0,11,22,Israel - Leumit League,0.88,1.0,11,1.38,2.75,1.14,1.0,1
Hapoel Tel Aviv,8,6,1,1,14,4,10,19,Israel - Leumit League,0.75,0.88,10,1.75,2.38,1.33,1.14,2
Hapoel Akko,8,4,2,2,12,8,4,14,Israel - Leumit League,0.5,0.75,4,1.5,1.75,2.0,1.33,3
H. Ramat Gan,8,4,1,3,18,8,10,13,Israel - Leumit League,0.5,0.62,10,2.25,1.62,2.0,1.61,4
M. Herziliya,8,4,1,3,11,9,2,13,Israel - Leumit League,0.5,0.62,2,1.38,1.62,2.0,1.61,4
Maccabi Jaffa,8,3,4,1,10,9,1,13,Israel - Leumit League,0.38,0.88,1,1.25,1.62,2.63,1.14,4
H. Nof Hagalil,8,2,4,2,6,5,1,10,Israel - Leumit League,0.25,0.75,1,0.75,1.25,4.0,1.33,5
H. Ironi Rishon,8,3,1,4,12,13,-1,10,Israel - Leumit League,0.38,0.5,-1,1.5,1.25,2.63,2.0,5
Hapoel Afula,8,2,3,3,9,9,0,9,Israel - Leumit League,0.25,0.62,0,1.12,1.12,4.0,1.61,6
H. Umm al-Fahm,8,2,3,3,10,13,-3,9,Israel - Leumit League,0.25,0.62,-3,1.25,1.12,4.0,1.61,6
Bnei Yehuda,8,3,0,5,11,15,-4,9,Israel - Leumit League,0.38,0.38,-4,1.38,1.12,2.63,2.63,6
H. Kfar Saba,8,2,2,4,6,10,-4,8,Israel - Leumit League,0.25,0.5,-4,0.75,1.0,4.0,2.0,7
Hapoel Raanana,8,1,4,3,4,7,-3,7,Israel - Leumit League,0.12,0.62,-3,0.5,0.88,8.33,1.61,8
Ramat Hasharon,8,1,4,3,9,16,-7,7,Israel - Leumit League,0.12,0.62,-7,1.12,0.88,8.33,1.61,8
Kafr Qasim,8,1,3,4,5,11,-6,6,Israel - Leumit League,0.12,0.5,-6,0.62,0.75,8.33,2.0,9
H. Kfar Shalem,8,2,0,6,4,15,-11,6,Israel - Leumit League,0.25,0.25,-11,0.5,0.75,4.0,4.0,9
Napoli,8,6,2,0,12,3,9,20,Italy - Serie A,0.75,1.0,9,1.5,2.5,1.33,1.0,1
AS Roma,8,6,2,0,8,2,6,20,Italy - Serie A,0.75,1.0,6,1.0,2.5,1.33,1.0,1
Como,8,5,2,1,12,5,7,17,Italy - Serie A,0.62,0.88,7,1.5,2.12,1.61,1.14,2
AC Milan,8,5,1,2,16,9,7,16,Italy - Serie A,0.62,0.75,7,2.0,2.0,1.61,1.33,3
Inter Milan,8,5,1,2,13,8,5,16,Italy - Serie A,0.62,0.75,5,1.62,2.0,1.61,1.33,3
Bologna,8,4,3,1,11,5,6,15,Italy - Serie A,0.5,0.88,6,1.38,1.88,2.0,1.14,4
Fiorentina,8,4,2,2,11,7,4,14,Italy - Serie A,0.5,0.75,4,1.38,1.75,2.0,1.33,5
Atalanta,8,4,1,3,12,5,7,13,Italy - Serie A,0.5,0.62,7,1.5,1.62,2.0,1.61,6
Lazio,8,3,4,1,9,10,-1,13,Italy - Serie A,0.38,0.88,-1,1.12,1.62,2.63,1.14,6
Juventus,8,3,2,3,7,11,-4,11,Italy - Serie A,0.38,0.62,-4,0.88,1.38,2.63,1.61,7
Torino,8,2,4,2,8,8,0,10,Italy - Serie A,0.25,0.75,0,1.0,1.25,4.0,1.33,8
Parma,8,1,6,1,8,8,0,9,Italy - Serie A,0.12,0.88,0,1.0,1.12,8.33,1.14,9
Cagliari,8,2,2,4,9,9,0,8,Italy - Serie A,0.25,0.5,0,1.12,1.0,4.0,2.0,10
Venezia,8,1,5,2,6,8,-2,8,Italy - Serie A,0.12,0.75,-2,0.75,1.0,8.33,1.33,10
Genoa,8,2,2,4,5,8,-3,8,Italy - Serie A,0.25,0.5,-3,0.62,1.0,4.0,2.0,10
Hellas Verona,8,1,3,4,3,7,-4,6,Italy - Serie A,0.12,0.5,-4,0.38,0.75,8.33,2.0,11
Udinese,8,1,2,5,4,12,-8,5,Italy - Serie A,0.12,0.38,-8,0.5,0.62,8.33,2.63,12
Empoli,8,0,3,5,4,11,-7,3,Italy - Serie A,0.0,0.38,-7,0.5,0.38,0.0,2.63,13
Lecce,8,0,2,6,6,14,-8,2,Italy - Serie A,0.0,0.25,-8,0.75,0.25,0.0,4.0,14
Monza,8,0,1,7,4,18,-14,1,Italy - Serie A,0.0,0.12,-14,0.5,0.12,0.0,8.33,15
Sassuolo,8,5,2,1,19,10,9,17,Italy - Serie B,0.62,0.88,9,2.38,2.12,1.61,1.14,1
Cremonese,8,4,4,0,17,9,8,16,Italy - Serie B,0.5,1.0,8,2.12,2.0,2.0,1.0,2
Pisa,8,5,0,3,14,8,6,15,Italy - Serie B,0.62,0.62,6,1.75,1.88,1.61,1.61,3
Juve Stabia,8,4,3,1,9,6,3,15,Italy - Serie B,0.5,0.88,3,1.12,1.88,2.0,1.14,3
Sudtirol,8,4,2,2,15,10,5,14,Italy - Serie B,0.5,0.75,5,1.88,1.75,2.0,1.33,4
Frosinone,8,3,4,1,12,8,4,13,Italy - Serie B,0.38,0.88,4,1.5,1.62,2.63,1.14,5
Salernitana,8,4,1,3,9,7,2,13,Italy - Serie B,0.5,0.62,2,1.12,1.62,2.0,1.61,5
Spezia,8,3,3,2,12,9,3,12,Italy - Serie B,0.38,0.75,3,1.5,1.5,2.63,1.33,6
Carrarese,8,3,3,2,9,9,0,12,Italy - Serie B,0.38,0.75,0,1.12,1.5,2.63,1.33,6
Mantova,8,3,2,3,13,13,0,11,Italy - Serie B,0.38,0.62,0,1.62,1.38,2.63,1.61,7
Palermo,8,3,1,4,16,15,1,10,Italy - Serie B,0.38,0.5,1,2.0,1.25,2.63,2.0,8
Reggiana,8,3,1,4,11,16,-5,10,Italy - Serie B,0.38,0.5,-5,1.38,1.25,2.63,2.0,8
Bari,8,2,3,3,9,10,-1,9,Italy - Serie B,0.25,0.62,-1,1.12,1.12,4.0,1.61,9
Brescia,8,2,3,3,7,8,-1,9,Italy - Serie B,0.25,0.62,-1,0.88,1.12,4.0,1.61,9
Modena,8,3,0,5,11,14,-3,9,Italy - Serie B,0.38,0.38,-3,1.38,1.12,2.63,2.63,9
Cosenza,8,2,2,4,7,15,-8,8,Italy - Serie B,0.25,0.5,-8,0.88,1.0,4.0,2.0,10
Cesena,8,1,4,3,6,11,-5,7,Italy - Serie B,0.12,0.62,-5,0.75,0.88,8.33,1.61,11
Sampdoria,8,1,4,3,6,11,-5,7,Italy - Serie B,0.12,0.62,-5,0.75,0.88,8.33,1.61,11
Catanzaro,8,1,3,4,13,18,-5,6,Italy - Serie B,0.12,0.5,-5,1.62,0.75,8.33,2.0,12
Cittadella,8,0,3,5,6,14,-8,3,Italy - Serie B,0.0,0.38,-8,0.75,0.38,0.0,2.63,13
Renate,8,6,1,1,13,7,6,19,Italy - Serie C - Group A,0.75,0.88,6,1.62,2.38,1.33,1.14,1
FeralpiSalo,8,5,1,2,14,8,6,16,Italy - Serie C - Group A,0.62,0.75,6,1.75,2.0,1.61,1.33,2
AlbinoLeffe,8,5,1,2,14,10,4,16,Italy - Serie C - Group A,0.62,0.75,4,1.75,2.0,1.61,1.33,2
Vicenza,8,5,1,2,10,8,2,16,Italy - Serie C - Group A,0.62,0.75,2,1.25,2.0,1.61,1.33,2
Atalanta B,8,4,3,1,13,8,5,15,Italy - Serie C - Group A,0.5,0.88,5,1.62,1.88,2.0,1.14,3
Arzignano,8,5,0,3,10,6,4,15,Italy - Serie C - Group A,0.62,0.62,4,1.25,1.88,1.61,1.61,3
Giana Erminio,8,4,2,2,12,6,6,14,Italy - Serie C - Group A,0.5,0.75,6,1.5,1.75,2.0,1.33,4
Padova,8,4,2,2,11,9,2,14,Italy - Serie C - Group A,0.5,0.75,2,1.38,1.75,2.0,1.33,4
Trento,8,4,1,3,11,10,1,13,Italy - Serie C - Group A,0.5,0.62,1,1.38,1.62,2.0,1.61,5
Pro Patria,8,3,2,3,10,8,2,11,Italy - Serie C - Group A,0.38,0.62,2,1.25,1.38,2.63,1.61,6
Caldiero Terme,8,3,2,3,10,10,0,11,Italy - Serie C - Group A,0.38,0.62,0,1.25,1.38,2.63,1.61,6
Virtus Verona,8,2,4,2,8,8,0,10,Italy - Serie C - Group A,0.25,0.75,0,1.0,1.25,4.0,1.33,7
Novara,8,3,1,4,9,14,-5,10,Italy - Serie C - Group A,0.38,0.5,-5,1.12,1.25,2.63,2.0,7
Triestina,8,3,0,5,9,9,0,9,Italy - Serie C - Group A,0.38,0.38,0,1.12,1.12,2.63,2.63,8
Lecco,8,2,3,3,6,7,-1,9,Italy - Serie C - Group A,0.25,0.62,-1,0.75,1.12,4.0,1.61,8
Pergolettese,8,2,0,6,7,12,-5,6,Italy - Serie C - Group A,0.25,0.25,-5,0.88,0.75,4.0,4.0,9
Pro Vercelli,8,1,3,4,6,11,-5,6,Italy - Serie C - Group A,0.12,0.5,-5,0.75,0.75,8.33,2.0,9
Alcione,8,1,3,4,5,10,-5,6,Italy - Serie C - Group A,0.12,0.5,-5,0.62,0.75,8.33,2.0,9
Lumezzane,8,0,4,4,6,14,-8,4,Italy - Serie C - Group A,0.0,0.5,-8,0.75,0.5,0.0,2.0,10
Clodiense,8,1,0,7,8,17,-9,3,Italy - Serie C - Group A,0.12,0.12,-9,1.0,0.38,8.33,8.33,11
Entella,8,4,4,0,15,6,9,16,Italy - Serie C - Group B,0.5,1.0,9,1.88,2.0,2.0,1.0,1
Arezzo,8,5,0,3,12,7,5,15,Italy - Serie C - Group B,0.62,0.62,5,1.5,1.88,1.61,1.61,2
Perugia,8,4,2,2,12,7,5,14,Italy - Serie C - Group B,0.5,0.75,5,1.5,1.75,2.0,1.33,3
Lucchese,8,4,2,2,15,14,1,14,Italy - Serie C - Group B,0.5,0.75,1,1.88,1.75,2.0,1.33,3
Pescara,8,4,1,3,14,8,6,13,Italy - Serie C - Group B,0.5,0.62,6,1.75,1.62,2.0,1.61,4
Pontedera,8,3,3,2,13,10,3,12,Italy - Serie C - Group B,0.38,0.75,3,1.62,1.5,2.63,1.33,5
Pineto,8,3,3,2,10,14,-4,12,Italy - Serie C - Group B,0.38,0.75,-4,1.25,1.5,2.63,1.33,5
Torres,8,3,2,3,12,10,2,11,Italy - Serie C - Group B,0.38,0.62,2,1.5,1.38,2.63,1.61,6
Ternana,8,3,2,3,7,6,1,11,Italy - Serie C - Group B,0.38,0.62,1,0.88,1.38,2.63,1.61,6
AC Milan B,8,3,2,3,11,11,0,11,Italy - Serie C - Group B,0.38,0.62,0,1.38,1.38,2.63,1.61,6
Rimini,8,3,2,3,11,12,-1,11,Italy - Serie C - Group B,0.38,0.62,-1,1.38,1.38,2.63,1.61,6
Gubbio,8,3,2,3,7,10,-3,11,Italy - Serie C - Group B,0.38,0.62,-3,0.88,1.38,2.63,1.61,6
SPAL,8,2,4,2,9,9,0,10,Italy - Serie C - Group B,0.25,0.75,0,1.12,1.25,4.0,1.33,7
Campobasso,8,3,1,4,9,13,-4,10,Italy - Serie C - Group B,0.38,0.5,-4,1.12,1.25,2.63,2.0,7
Pianese,8,3,0,5,10,12,-2,9,Italy - Serie C - Group B,0.38,0.38,-2,1.25,1.12,2.63,2.63,8
Vis Pesaro,8,1,5,2,8,8,0,8,Italy - Serie C - Group B,0.12,0.75,0,1.0,1.0,8.33,1.33,9
Sestri Levante,8,2,2,4,10,14,-4,8,Italy - Serie C - Group B,0.25,0.5,-4,1.25,1.0,4.0,2.0,9
Athletic Carpi,8,2,2,4,6,11,-5,8,Italy - Serie C - Group B,0.25,0.5,-5,0.75,1.0,4.0,2.0,9
Ascoli,8,1,4,3,4,7,-3,7,Italy - Serie C - Group B,0.12,0.62,-3,0.5,0.88,8.33,1.61,10
Legnago Salus,8,1,3,4,7,13,-6,6,Italy - Serie C - Group B,0.12,0.5,-6,0.88,0.75,8.33,2.0,11
Avellino,8,8,0,0,13,4,9,24,Italy - Serie C - Group C,1.0,1.0,9,1.62,3.0,1.0,1.0,1
Catania,8,5,2,1,13,5,8,17,Italy - Serie C - Group C,0.62,0.88,8,1.62,2.12,1.61,1.14,2
Monopoli,8,4,2,2,9,6,3,14,Italy - Serie C - Group C,0.5,0.75,3,1.12,1.75,2.0,1.33,3
Crotone,8,4,2,2,14,12,2,14,Italy - Serie C - Group C,0.5,0.75,2,1.75,1.75,2.0,1.33,3
Casertana,8,4,1,3,13,6,7,13,Italy - Serie C - Group C,0.5,0.62,7,1.62,1.62,2.0,1.61,4
Picerno,8,3,4,1,9,5,4,13,Italy - Serie C - Group C,0.38,0.88,4,1.12,1.62,2.63,1.14,4
ACR Messina,8,4,1,3,14,12,2,13,Italy - Serie C - Group C,0.5,0.62,2,1.75,1.62,2.0,1.61,4
A. Cerignola,8,4,1,3,10,9,1,13,Italy - Serie C - Group C,0.5,0.62,1,1.25,1.62,2.0,1.61,4
Juventus U23,8,4,0,4,15,11,4,12,Italy - Serie C - Group C,0.5,0.5,4,1.88,1.5,2.0,2.0,5
Cavese,8,3,2,3,10,12,-2,11,Italy - Serie C - Group C,0.38,0.62,-2,1.25,1.38,2.63,1.61,6
Benevento,8,2,4,2,10,9,1,10,Italy - Serie C - Group C,0.25,0.75,1,1.25,1.25,4.0,1.33,7
Latina,8,3,1,4,7,13,-6,10,Italy - Serie C - Group C,0.38,0.5,-6,0.88,1.25,2.63,2.0,7
Potenza,8,2,3,3,12,12,0,9,Italy - Serie C - Group C,0.25,0.62,0,1.5,1.12,4.0,1.61,8
Trapani,8,3,0,5,7,10,-3,9,Italy - Serie C - Group C,0.38,0.38,-3,0.88,1.12,2.63,2.63,8
Altamura,8,3,0,5,9,13,-4,9,Italy - Serie C - Group C,0.38,0.38,-4,1.12,1.12,2.63,2.63,8
Giugliano,8,2,2,4,17,16,1,8,Italy - Serie C - Group C,0.25,0.5,1,2.12,1.0,4.0,2.0,9
Foggia,8,1,1,6,7,16,-9,4,Italy - Serie C - Group C,0.12,0.25,-9,0.88,0.5,8.33,4.0,10
Sorrento,8,1,1,6,4,17,-13,4,Italy - Serie C - Group C,0.12,0.25,-13,0.5,0.5,8.33,4.0,10
Taranto,0,0,0,0,0,0,0,0,Italy - Serie C - Group C,0.0,0.0,0,0.0,0.0,0.0,0.0,11
Turris,0,0,0,0,0,0,0,0,Italy - Serie C - Group C,0.0,0.0,0,0.0,0.0,0.0,0.0,11
Lavagnese,8,7,1,0,11,3,8,22,Italy - Serie D - Group A,0.88,1.0,8,1.38,2.75,1.14,1.0,1
Gozzano,8,5,3,0,14,7,7,18,Italy - Serie D - Group A,0.62,1.0,7,1.75,2.25,1.61,1.0,2
NovaRomentin,8,4,2,2,19,6,13,14,Italy - Serie D - Group A,0.5,0.75,13,2.38,1.75,2.0,1.33,3
Oltrepo,8,4,2,2,10,8,2,14,Italy - Serie D - Group A,0.5,0.75,2,1.25,1.75,2.0,1.33,3
Chieri,8,3,4,1,11,6,5,13,Italy - Serie D - Group A,0.38,0.88,5,1.38,1.62,2.63,1.14,4
Vado,8,4,1,3,9,6,3,13,Italy - Serie D - Group A,0.5,0.62,3,1.12,1.62,2.0,1.61,4
Bra,8,4,1,3,11,9,2,13,Italy - Serie D - Group A,0.5,0.62,2,1.38,1.62,2.0,1.61,4
Sanremese,8,3,2,3,7,6,1,11,Italy - Serie D - Group A,0.38,0.62,1,0.88,1.38,2.63,1.61,5
Ligorna,8,3,2,3,10,14,-4,11,Italy - Serie D - Group A,0.38,0.62,-4,1.25,1.38,2.63,1.61,5
Vogherese,8,2,4,2,7,7,0,10,Italy - Serie D - Group A,0.25,0.75,0,0.88,1.25,4.0,1.33,6
Saluzzo,8,2,4,2,6,6,0,10,Italy - Serie D - Group A,0.25,0.75,0,0.75,1.25,4.0,1.33,6
Borgaro Nobis,8,3,1,4,9,16,-7,10,Italy - Serie D - Group A,0.38,0.5,-7,1.12,1.25,2.63,2.0,6
Citta di Varese,8,2,3,3,8,9,-1,9,Italy - Serie D - Group A,0.25,0.62,-1,1.0,1.12,4.0,1.61,7
Asti,8,2,3,3,4,9,-5,9,Italy - Serie D - Group A,0.25,0.62,-5,0.5,1.12,4.0,1.61,7
Chisola,8,2,2,4,11,10,1,8,Italy - Serie D - Group A,0.25,0.5,1,1.38,1.0,4.0,2.0,8
Cairese,8,2,2,4,8,9,-1,8,Italy - Serie D - Group A,0.25,0.5,-1,1.0,1.0,4.0,2.0,8
Derthona,8,2,2,4,6,9,-3,8,Italy - Serie D - Group A,0.25,0.5,-3,0.75,1.0,4.0,2.0,8
Pro Imperia,8,1,1,6,5,15,-10,4,Italy - Serie D - Group A,0.12,0.25,-10,0.62,0.5,8.33,4.0,9
Fossano,8,1,0,7,5,18,-13,3,Italy - Serie D - Group A,0.12,0.12,-13,0.62,0.38,8.33,8.33,10
Albenga,0,0,0,0,0,0,0,0,Italy - Serie D - Group A,0.0,0.0,0,0.0,0.0,0.0,0.0,11
Desenxano,8,6,0,2,10,5,5,18,Italy - Serie D - Group B,0.75,0.75,5,1.25,2.25,1.33,1.33,1
Pro Palazzolo,8,5,2,1,15,6,9,17,Italy - Serie D - Group B,0.62,0.88,9,1.88,2.12,1.61,1.14,2
USD Casatese,8,5,0,3,16,7,9,15,Italy - Serie D - Group B,0.62,0.62,9,2.0,1.88,1.61,1.61,3
Ospitaletto,8,4,3,1,15,11,4,15,Italy - Serie D - Group B,0.5,0.88,4,1.88,1.88,2.0,1.14,3
Sondrio,8,5,0,3,11,9,2,15,Italy - Serie D - Group B,0.62,0.62,2,1.38,1.88,1.61,1.61,3
Castellanzese,8,3,5,0,14,9,5,14,Italy - Serie D - Group B,0.38,1.0,5,1.75,1.75,2.63,1.0,4
Club Milano,8,4,1,3,14,16,-2,13,Italy - Serie D - Group B,0.5,0.62,-2,1.75,1.62,2.0,1.61,5
Varesina,8,3,3,2,16,13,3,12,Italy - Serie D - Group B,0.38,0.75,3,2.0,1.5,2.63,1.33,6
F. Caratese,8,3,2,3,16,10,6,11,Italy - Serie D - Group B,0.38,0.62,6,2.0,1.38,2.63,1.61,7
Pro Sesto,8,3,2,3,11,12,-1,11,Italy - Serie D - Group B,0.38,0.62,-1,1.38,1.38,2.63,1.61,7
Chievo,8,3,1,4,15,7,8,10,Italy - Serie D - Group B,0.38,0.5,8,1.88,1.25,2.63,2.0,8
Sangiuliano C.,8,2,4,2,10,9,1,10,Italy - Serie D - Group B,0.25,0.75,1,1.25,1.25,4.0,1.33,8
Magenta,8,2,4,2,7,9,-2,10,Italy - Serie D - Group B,0.25,0.75,-2,0.88,1.25,4.0,1.33,8
Vigasio,8,3,1,4,8,11,-3,10,Italy - Serie D - Group B,0.38,0.5,-3,1.0,1.25,2.63,2.0,8
SantAngelo,8,2,2,4,9,12,-3,8,Italy - Serie D - Group B,0.25,0.5,-3,1.12,1.0,4.0,2.0,9
Arconatese,8,2,2,4,10,17,-7,8,Italy - Serie D - Group B,0.25,0.5,-7,1.25,1.0,4.0,2.0,9
Breno,8,2,1,5,9,22,-13,7,Italy - Serie D - Group B,0.25,0.38,-13,1.12,0.88,4.0,2.63,10
Crema,8,1,3,4,14,17,-3,6,Italy - Serie D - Group B,0.12,0.5,-3,1.75,0.75,8.33,2.0,11
Ciliverghe,8,1,2,5,7,18,-11,5,Italy - Serie D - Group B,0.12,0.38,-11,0.88,0.62,8.33,2.63,12
Fanfulla,8,0,4,4,6,13,-7,4,Italy - Serie D - Group B,0.0,0.5,-7,0.75,0.5,0.0,2.0,13
D. Bellunesi,8,4,4,0,16,8,8,16,Italy - Serie D - Group C,0.5,1.0,8,2.0,2.0,2.0,1.0,1
Villa Alme,8,5,1,2,12,9,3,16,Italy - Serie D - Group C,0.62,0.75,3,1.5,2.0,1.61,1.33,1
Mestre,8,5,1,2,6,3,3,16,Italy - Serie D - Group C,0.62,0.75,3,0.75,2.0,1.61,1.33,1
Adriese,8,5,0,3,14,8,6,15,Italy - Serie D - Group C,0.62,0.62,6,1.75,1.88,1.61,1.61,2
Treviso,8,4,3,1,11,6,5,15,Italy - Serie D - Group C,0.5,0.88,5,1.38,1.88,2.0,1.14,2
Brusaporto,8,4,2,2,10,6,4,14,Italy - Serie D - Group C,0.5,0.75,4,1.25,1.75,2.0,1.33,3
Real Calepina,8,4,2,2,12,9,3,14,Italy - Serie D - Group C,0.5,0.75,3,1.5,1.75,2.0,1.33,3
Luparense,8,3,3,2,10,8,2,12,Italy - Serie D - Group C,0.38,0.75,2,1.25,1.5,2.63,1.33,4
Brian Lignano,8,3,3,2,10,11,-1,12,Italy - Serie D - Group C,0.38,0.75,-1,1.25,1.5,2.63,1.33,4
Bassano Virtus,8,3,1,4,15,7,8,10,Italy - Serie D - Group C,0.38,0.5,8,1.88,1.25,2.63,2.0,5
Campodarsego,8,2,4,2,11,11,0,10,Italy - Serie D - Group C,0.25,0.75,0,1.38,1.25,4.0,1.33,5
Portogruaro,8,2,4,2,6,6,0,10,Italy - Serie D - Group C,0.25,0.75,0,0.75,1.25,4.0,1.33,5
Ciserano,8,2,4,2,7,8,-1,10,Italy - Serie D - Group C,0.25,0.75,-1,0.88,1.25,4.0,1.33,5
Este,8,2,4,2,10,13,-3,10,Italy - Serie D - Group C,0.25,0.75,-3,1.25,1.25,4.0,1.33,5
Cjarlins Muzane,8,2,3,3,11,16,-5,9,Italy - Serie D - Group C,0.25,0.62,-5,1.38,1.12,4.0,1.61,6
Calvi Noale,8,2,2,4,10,11,-1,8,Italy - Serie D - Group C,0.25,0.5,-1,1.25,1.0,4.0,2.0,7
Chions,8,2,2,4,10,13,-3,8,Italy - Serie D - Group C,0.25,0.5,-3,1.25,1.0,4.0,2.0,7
Caravaggio,8,1,3,4,5,11,-6,6,Italy - Serie D - Group C,0.12,0.5,-6,0.62,0.75,8.33,2.0,8
Lavis,8,1,0,7,6,18,-12,3,Italy - Serie D - Group C,0.12,0.12,-12,0.75,0.38,8.33,8.33,9
Montecchio M.,8,0,2,6,4,14,-10,2,Italy - Serie D - Group C,0.0,0.25,-10,0.5,0.25,0.0,4.0,10
Lentigione,8,7,1,0,18,4,14,22,Italy - Serie D - Group D,0.88,1.0,14,2.25,2.75,1.14,1.0,1
Forli,8,7,0,1,21,9,12,21,Italy - Serie D - Group D,0.88,0.88,12,2.62,2.62,1.14,1.14,2
Imolese,8,4,3,1,18,10,8,15,Italy - Serie D - Group D,0.5,0.88,8,2.25,1.88,2.0,1.14,3
Pistoiese,8,5,0,3,12,5,7,15,Italy - Serie D - Group D,0.62,0.62,7,1.5,1.88,1.61,1.61,3
Ravenna,8,4,1,3,19,14,5,13,Italy - Serie D - Group D,0.5,0.62,5,2.38,1.62,2.0,1.61,4
Cittadella Vis,8,3,3,2,13,9,4,12,Italy - Serie D - Group D,0.38,0.75,4,1.62,1.5,2.63,1.33,5
Piacenza,8,3,3,2,11,7,4,12,Italy - Serie D - Group D,0.38,0.75,4,1.38,1.5,2.63,1.33,5
Progresso,8,3,2,3,11,9,2,11,Italy - Serie D - Group D,0.38,0.62,2,1.38,1.38,2.63,1.61,6
Zenith Prato,8,3,2,3,10,11,-1,11,Italy - Serie D - Group D,0.38,0.62,-1,1.25,1.38,2.63,1.61,6
Sammaurese,8,3,1,4,5,5,0,10,Italy - Serie D - Group D,0.38,0.5,0,0.62,1.25,2.63,2.0,7
Prato,8,3,1,4,9,11,-2,10,Italy - Serie D - Group D,0.38,0.5,-2,1.12,1.25,2.63,2.0,7
Sasso Marconi,8,2,3,3,11,13,-2,9,Italy - Serie D - Group D,0.25,0.62,-2,1.38,1.12,4.0,1.61,8
San Marino C.,8,2,3,3,12,15,-3,9,Italy - Serie D - Group D,0.25,0.62,-3,1.5,1.12,4.0,1.61,8
Tuttocuoio,8,1,5,2,9,10,-1,8,Italy - Serie D - Group D,0.12,0.75,-1,1.12,1.0,8.33,1.33,9
Tau Altopascio,8,1,5,2,8,9,-1,8,Italy - Serie D - Group D,0.12,0.75,-1,1.0,1.0,8.33,1.33,9
Fiorenzuola,8,2,1,5,4,12,-8,7,Italy - Serie D - Group D,0.25,0.38,-8,0.5,0.88,4.0,2.63,10
Corticella,8,2,1,5,6,23,-17,7,Italy - Serie D - Group D,0.25,0.38,-17,0.75,0.88,4.0,2.63,10
United Riccione,8,0,0,8,1,21,-20,0,Italy - Serie D - Group D,0.0,0.0,-20,0.12,0.0,0.0,0.0,11
Ghiviborgo,8,5,2,1,23,10,13,17,Italy - Serie D - Group E,0.62,0.88,13,2.88,2.12,1.61,1.14,1
Orvietana,8,5,2,1,13,5,8,17,Italy - Serie D - Group E,0.62,0.88,8,1.62,2.12,1.61,1.14,1
Flaminia,8,5,2,1,16,10,6,17,Italy - Serie D - Group E,0.62,0.88,6,2.0,2.12,1.61,1.14,1
San Donato,8,3,3,2,9,5,4,12,Italy - Serie D - Group E,0.38,0.75,4,1.12,1.5,2.63,1.33,2
Fulgens Foligno,8,3,3,2,12,10,2,12,Italy - Serie D - Group E,0.38,0.75,2,1.5,1.5,2.63,1.33,2
S. Trestina,8,3,3,2,7,6,1,12,Italy - Serie D - Group E,0.38,0.75,1,0.88,1.5,2.63,1.33,2
Ostia Mare,8,3,3,2,11,12,-1,12,Italy - Serie D - Group E,0.38,0.75,-1,1.38,1.5,2.63,1.33,2
T. Traiana,8,2,5,1,7,7,0,11,Italy - Serie D - Group E,0.25,0.88,0,0.88,1.38,4.0,1.14,3
Seravezza,8,3,2,3,12,13,-1,11,Italy - Serie D - Group E,0.38,0.62,-1,1.5,1.38,2.63,1.61,3
Montevarchi,8,1,7,0,8,6,2,10,Italy - Serie D - Group E,0.12,1.0,2,1.0,1.25,8.33,1.0,4
Poggibonsi,8,3,1,4,3,5,-2,10,Italy - Serie D - Group E,0.38,0.5,-2,0.38,1.25,2.63,2.0,4
FC Siena,8,2,3,3,12,12,0,9,Italy - Serie D - Group E,0.25,0.62,0,1.5,1.12,4.0,1.61,5
Livorno,8,2,3,3,13,20,-7,9,Italy - Serie D - Group E,0.25,0.62,-7,1.62,1.12,4.0,1.61,5
Grosseto,8,1,5,2,8,8,0,8,Italy - Serie D - Group E,0.12,0.75,0,1.0,1.0,8.33,1.33,6
Figline,8,1,3,4,6,9,-3,6,Italy - Serie D - Group E,0.12,0.5,-3,0.75,0.75,8.33,2.0,7
Gavorrano,8,1,3,4,6,14,-8,6,Italy - Serie D - Group E,0.12,0.5,-8,0.75,0.75,8.33,2.0,7
Sangiovannese,8,1,2,5,7,12,-5,5,Italy - Serie D - Group E,0.12,0.38,-5,0.88,0.62,8.33,2.63,8
Fezzanese,8,1,2,5,10,19,-9,5,Italy - Serie D - Group E,0.12,0.38,-9,1.25,0.62,8.33,2.63,8
Avezzano,8,4,2,2,15,7,8,14,Italy - Serie D - Group F,0.5,0.75,8,1.88,1.75,2.0,1.33,1
Sambenedettese,8,4,2,2,12,7,5,14,Italy - Serie D - Group F,0.5,0.75,5,1.5,1.75,2.0,1.33,1
LAquila,8,4,2,2,11,8,3,14,Italy - Serie D - Group F,0.5,0.75,3,1.38,1.75,2.0,1.33,1
Teramo,8,4,1,3,12,9,3,13,Italy - Serie D - Group F,0.5,0.62,3,1.5,1.62,2.0,1.61,2
Fossombrone,8,3,4,1,9,7,2,13,Italy - Serie D - Group F,0.38,0.88,2,1.12,1.62,2.63,1.14,2
Termoli Calcio,8,3,4,1,10,10,0,13,Italy - Serie D - Group F,0.38,0.88,0,1.25,1.62,2.63,1.14,2
San Nicolo,8,4,1,3,11,12,-1,13,Italy - Serie D - Group F,0.5,0.62,-1,1.38,1.62,2.0,1.61,2
Castelfidardo,8,3,3,2,9,7,2,12,Italy - Serie D - Group F,0.38,0.75,2,1.12,1.5,2.63,1.33,3
Isernia,8,4,0,4,11,11,0,12,Italy - Serie D - Group F,0.5,0.5,0,1.38,1.5,2.0,2.0,3
Civitanovese,8,3,2,3,11,9,2,11,Italy - Serie D - Group F,0.38,0.62,2,1.38,1.38,2.63,1.61,4
Sora,8,3,2,3,10,8,2,11,Italy - Serie D - Group F,0.38,0.62,2,1.25,1.38,2.63,1.61,4
Chieti,8,3,1,4,8,11,-3,10,Italy - Serie D - Group F,0.38,0.5,-3,1.0,1.25,2.63,2.0,5
Ancona 1905,8,2,3,3,8,15,-7,9,Italy - Serie D - Group F,0.25,0.62,-7,1.0,1.12,4.0,1.61,6
V. Senigallia,8,1,5,2,9,11,-2,8,Italy - Serie D - Group F,0.12,0.75,-2,1.12,1.0,8.33,1.33,7
Atletico Ascoli,8,1,5,2,5,7,-2,8,Italy - Serie D - Group F,0.12,0.75,-2,0.62,1.0,8.33,1.33,7
Recanatese,8,2,2,4,7,11,-4,8,Italy - Serie D - Group F,0.25,0.5,-4,0.88,1.0,4.0,2.0,7
Roma City,8,1,3,4,7,10,-3,6,Italy - Serie D - Group F,0.12,0.5,-3,0.88,0.75,8.33,2.0,8
Fermana,8,1,2,5,5,10,-5,5,Italy - Serie D - Group F,0.12,0.38,-5,0.62,0.62,8.33,2.63,9
Guidonia,8,6,2,0,18,5,13,20,Italy - Serie D - Group G,0.75,1.0,13,2.25,2.5,1.33,1.0,1
Savoia,8,5,3,0,14,4,10,18,Italy - Serie D - Group G,0.62,1.0,10,1.75,2.25,1.61,1.0,2
Sarnese,8,5,2,1,12,8,4,17,Italy - Serie D - Group G,0.62,0.88,4,1.5,2.12,1.61,1.14,3
Gelbison,8,4,3,1,15,10,5,15,Italy - Serie D - Group G,0.5,0.88,5,1.88,1.88,2.0,1.14,4
Paganese,8,4,2,2,11,5,6,14,Italy - Serie D - Group G,0.5,0.75,6,1.38,1.75,2.0,1.33,5
Ilvamaddalena,8,4,1,3,13,10,3,13,Italy - Serie D - Group G,0.5,0.62,3,1.62,1.62,2.0,1.61,6
Olbia,8,3,3,2,12,10,2,12,Italy - Serie D - Group G,0.38,0.75,2,1.5,1.5,2.63,1.33,7
Latte Dolce,8,3,3,2,12,11,1,12,Italy - Serie D - Group G,0.38,0.75,1,1.5,1.5,2.63,1.33,7
CynthiAlbalonga,8,3,2,3,11,12,-1,11,Italy - Serie D - Group G,0.38,0.62,-1,1.38,1.38,2.63,1.61,8
R. Monterotondo,8,3,1,4,7,11,-4,10,Italy - Serie D - Group G,0.38,0.5,-4,0.88,1.25,2.63,2.0,9
Trastevere,8,2,3,3,13,14,-1,9,Italy - Serie D - Group G,0.25,0.62,-1,1.62,1.12,4.0,1.61,10
A. Lodigiani,8,2,3,3,11,12,-1,9,Italy - Serie D - Group G,0.25,0.62,-1,1.38,1.12,4.0,1.61,10
S. Ogliastra,8,2,3,3,11,13,-2,9,Italy - Serie D - Group G,0.25,0.62,-2,1.38,1.12,4.0,1.61,10
Anzio,8,2,3,3,9,15,-6,9,Italy - Serie D - Group G,0.25,0.62,-6,1.12,1.12,4.0,1.61,10
Cassino,8,2,2,4,7,10,-3,8,Italy - Serie D - Group G,0.25,0.5,-3,0.88,1.0,4.0,2.0,11
Puteolana,8,1,4,3,9,14,-5,7,Italy - Serie D - Group G,0.12,0.62,-5,1.12,0.88,8.33,1.61,12
Terracina,8,0,2,6,7,18,-11,2,Italy - Serie D - Group G,0.0,0.25,-11,0.88,0.25,0.0,4.0,13
Atletico Uri,8,0,0,8,5,15,-10,0,Italy - Serie D - Group G,0.0,0.0,-10,0.62,0.0,0.0,0.0,14
Casarano,8,6,1,1,20,9,11,19,Italy - Serie D - Group H,0.75,0.88,11,2.5,2.38,1.33,1.14,1
Nocerina,8,5,2,1,20,7,13,17,Italy - Serie D - Group H,0.62,0.88,13,2.5,2.12,1.61,1.14,2
Citta di Fasano,8,5,1,2,19,11,8,16,Italy - Serie D - Group H,0.62,0.75,8,2.38,2.0,1.61,1.33,3
Francavilla,8,4,1,3,8,9,-1,13,Italy - Serie D - Group H,0.5,0.62,-1,1.0,1.62,2.0,1.61,4
Manfredonia,8,3,3,2,14,11,3,12,Italy - Serie D - Group H,0.38,0.75,3,1.75,1.5,2.63,1.33,5
Brindisi,8,3,3,2,13,11,2,12,Italy - Serie D - Group H,0.38,0.75,2,1.62,1.5,2.63,1.33,5
Ischia,8,2,5,1,6,6,0,11,Italy - Serie D - Group H,0.25,0.88,0,0.75,1.38,4.0,1.14,6
Nardo,8,3,2,3,12,13,-1,11,Italy - Serie D - Group H,0.38,0.62,-1,1.5,1.38,2.63,1.61,6
V. Francavilla,8,2,4,2,12,9,3,10,Italy - Serie D - Group H,0.25,0.75,3,1.5,1.25,4.0,1.33,7
Martina Franca,8,2,4,2,7,6,1,10,Italy - Serie D - Group H,0.25,0.75,1,0.88,1.25,4.0,1.33,7
Matera,8,2,4,2,16,18,-2,10,Italy - Serie D - Group H,0.25,0.75,-2,2.0,1.25,4.0,1.33,7
Real Acerrana,8,3,1,4,10,12,-2,10,Italy - Serie D - Group H,0.38,0.5,-2,1.25,1.25,2.63,2.0,7
Ugento,8,3,1,4,9,13,-4,10,Italy - Serie D - Group H,0.38,0.5,-4,1.12,1.25,2.63,2.0,7
Gravina,8,2,3,3,11,10,1,9,Italy - Serie D - Group H,0.25,0.62,1,1.38,1.12,4.0,1.61,8
USD Palmese,8,2,3,3,9,10,-1,9,Italy - Serie D - Group H,0.25,0.62,-1,1.12,1.12,4.0,1.61,8
Fidelis Andria,8,1,4,3,6,10,-4,7,Italy - Serie D - Group H,0.12,0.62,-4,0.75,0.88,8.33,1.61,9
Costa DAmalfi,8,1,1,6,7,17,-10,4,Italy - Serie D - Group H,0.12,0.25,-10,0.88,0.5,8.33,4.0,10
Angri Calcio,8,1,1,6,7,24,-17,4,Italy - Serie D - Group H,0.12,0.25,-17,0.88,0.5,8.33,4.0,10
Siracusa,8,8,0,0,21,4,17,24,Italy - Serie D - Group I,1.0,1.0,17,2.62,3.0,1.0,1.0,1
Reggina,8,8,0,0,16,6,10,24,Italy - Serie D - Group I,1.0,1.0,10,2.0,3.0,1.0,1.0,1
Scafatese,8,5,0,3,17,11,6,15,Italy - Serie D - Group I,0.62,0.62,6,2.12,1.88,1.61,1.61,2
Sancataldese,8,4,2,2,8,6,2,14,Italy - Serie D - Group I,0.5,0.75,2,1.0,1.75,2.0,1.33,3
Nissa,8,4,1,3,15,15,0,13,Italy - Serie D - Group I,0.5,0.62,0,1.88,1.62,2.0,1.61,4
Pompei,8,4,1,3,9,11,-2,13,Italy - Serie D - Group I,0.5,0.62,-2,1.12,1.62,2.0,1.61,4
Acireale,8,2,5,1,10,8,2,11,Italy - Serie D - Group I,0.25,0.88,2,1.25,1.38,4.0,1.14,5
Enna,8,3,2,3,8,8,0,11,Italy - Serie D - Group I,0.38,0.62,0,1.0,1.38,2.63,1.61,5
Ragusa,8,3,1,4,11,11,0,10,Italy - Serie D - Group I,0.38,0.5,0,1.38,1.25,2.63,2.0,6
Paterno,8,2,4,2,8,10,-2,10,Italy - Serie D - Group I,0.25,0.75,-2,1.0,1.25,4.0,1.33,6
Licata,8,3,0,5,10,11,-1,9,Italy - Serie D - Group I,0.38,0.38,-1,1.25,1.12,2.63,2.63,7
CD S. Agata,8,2,2,4,12,14,-2,8,Italy - Serie D - Group I,0.25,0.5,-2,1.5,1.0,4.0,2.0,8
Sambiase,8,2,2,4,6,8,-2,8,Italy - Serie D - Group I,0.25,0.5,-2,0.75,1.0,4.0,2.0,8
Vibonese,8,2,2,4,8,12,-4,8,Italy - Serie D - Group I,0.25,0.5,-4,1.0,1.0,4.0,2.0,8
Igea Virtus,8,2,1,5,8,14,-6,7,Italy - Serie D - Group I,0.25,0.38,-6,1.0,0.88,4.0,2.63,9
Locri 1909,8,1,2,5,10,15,-5,5,Italy - Serie D - Group I,0.12,0.38,-5,1.25,0.62,8.33,2.63,10
CastrumFavara,8,0,3,5,6,15,-9,3,Italy - Serie D - Group I,0.0,0.38,-9,0.75,0.38,0.0,2.63,11
Akragas,0,0,0,0,0,0,0,0,Italy - Serie D - Group I,0.0,0.0,0,0.0,0.0,0.0,0.0,12
Cagliari U20,8,5,3,0,12,5,7,18,Italy - Primavera 1,0.62,1.0,7,1.5,2.25,1.61,1.0,1
Roma U20,8,5,1,2,24,12,12,16,Italy - Primavera 1,0.62,0.75,12,3.0,2.0,1.61,1.33,2
Atalanta U20,8,5,1,2,15,6,9,16,Italy - Primavera 1,0.62,0.75,9,1.88,2.0,1.61,1.33,2
H. Verona U20,8,5,1,2,13,5,8,16,Italy - Primavera 1,0.62,0.75,8,1.62,2.0,1.61,1.33,2
Juventus U20,8,5,1,2,14,11,3,16,Italy - Primavera 1,0.62,0.75,3,1.75,2.0,1.61,1.33,2
Cesena U20,8,5,1,2,13,12,1,16,Italy - Primavera 1,0.62,0.75,1,1.62,2.0,1.61,1.33,2
Torino U20,8,4,1,3,16,12,4,13,Italy - Primavera 1,0.5,0.62,4,2.0,1.62,2.0,1.61,3
Lecce U20,8,3,3,2,14,11,3,12,Italy - Primavera 1,0.38,0.75,3,1.75,1.5,2.63,1.33,4
Sassuolo U20,8,4,0,4,8,9,-1,12,Italy - Primavera 1,0.5,0.5,-1,1.0,1.5,2.0,2.0,4
Milan U20,8,3,2,3,12,8,4,11,Italy - Primavera 1,0.38,0.62,4,1.5,1.38,2.63,1.61,5
Lazio U20,8,3,2,3,8,8,0,11,Italy - Primavera 1,0.38,0.62,0,1.0,1.38,2.63,1.61,5
Bologna U20,8,3,1,4,10,8,2,10,Italy - Primavera 1,0.38,0.5,2,1.25,1.25,2.63,2.0,6
Inter Milan U20,8,2,4,2,6,6,0,10,Italy - Primavera 1,0.25,0.75,0,0.75,1.25,4.0,1.33,6
Cremonese U20,8,2,3,3,9,10,-1,9,Italy - Primavera 1,0.25,0.62,-1,1.12,1.12,4.0,1.61,7
Empoli U20,8,2,3,3,7,12,-5,9,Italy - Primavera 1,0.25,0.62,-5,0.88,1.12,4.0,1.61,7
Monza U20,8,2,2,4,9,14,-5,8,Italy - Primavera 1,0.25,0.5,-5,1.12,1.0,4.0,2.0,8
Fiorentina U20,8,2,1,5,15,14,1,7,Italy - Primavera 1,0.25,0.38,1,1.88,0.88,4.0,2.63,9
Genoa U20,8,2,1,5,7,12,-5,7,Italy - Primavera 1,0.25,0.38,-5,0.88,0.88,4.0,2.63,9
Sampdoria U20,8,1,2,5,7,17,-10,5,Italy - Primavera 1,0.12,0.38,-10,0.88,0.62,8.33,2.63,10
Udinese U20,8,0,1,7,3,30,-27,1,Italy - Primavera 1,0.0,0.12,-27,0.38,0.12,0.0,8.33,11
Mount Pleasant,8,7,0,1,19,3,16,21,Jamaica - Premier League,0.88,0.88,16,2.38,2.62,1.14,1.14,1
Cavalier,8,6,1,1,17,8,9,19,Jamaica - Premier League,0.75,0.88,9,2.12,2.38,1.33,1.14,2
Waterhouse,8,5,2,1,11,4,7,17,Jamaica - Premier League,0.62,0.88,7,1.38,2.12,1.61,1.14,3
Tivoli Gardens,8,4,4,0,10,6,4,16,Jamaica - Premier League,0.5,1.0,4,1.25,2.0,2.0,1.0,4
Portmore Utd,8,4,1,3,6,5,1,13,Jamaica - Premier League,0.5,0.62,1,0.75,1.62,2.0,1.61,5
Montego Bay,8,3,3,2,10,5,5,12,Jamaica - Premier League,0.38,0.75,5,1.25,1.5,2.63,1.33,6
Arnett Gardens,8,3,2,3,14,11,3,11,Jamaica - Premier League,0.38,0.62,3,1.75,1.38,2.63,1.61,7
Chapelton,8,3,2,3,8,11,-3,11,Jamaica - Premier League,0.38,0.62,-3,1.0,1.38,2.63,1.61,7
Humble Lions,8,2,2,4,9,12,-3,8,Jamaica - Premier League,0.25,0.5,-3,1.12,1.0,4.0,2.0,8
Harbour View,8,2,2,4,11,15,-4,8,Jamaica - Premier League,0.25,0.5,-4,1.38,1.0,4.0,2.0,8
Molynes Utd,8,2,1,5,9,15,-6,7,Jamaica - Premier League,0.25,0.38,-6,1.12,0.88,4.0,2.63,9
Racing United,8,2,1,5,7,14,-7,7,Jamaica - Premier League,0.25,0.38,-7,0.88,0.88,4.0,2.63,9
Dunbeholden,8,1,2,5,2,11,-9,5,Jamaica - Premier League,0.12,0.38,-9,0.25,0.62,8.33,2.63,10
Vere Utd,8,0,1,7,4,22,-18,1,Jamaica - Premier League,0.0,0.12,-18,0.5,0.12,0.0,8.33,11
Urawa RD,8,6,0,2,12,5,7,18,Japan - J1 League,0.75,0.75,7,1.5,2.25,1.33,1.33,1
Kashiwa Reysol,8,4,4,0,8,4,4,16,Japan - J1 League,0.5,1.0,4,1.0,2.0,2.0,1.0,2
Kashima Antlers,8,5,0,3,11,7,4,15,Japan - J1 League,0.62,0.62,4,1.38,1.88,1.61,1.61,3
Kyoto Sanga,8,5,0,3,16,13,3,15,Japan - J1 League,0.62,0.62,3,2.0,1.88,1.61,1.61,3
Vissel Kobe,8,5,0,3,8,6,2,15,Japan - J1 League,0.62,0.62,2,1.0,1.88,1.61,1.61,3
Gamba Osaka,8,4,1,3,10,7,3,13,Japan - J1 League,0.5,0.62,3,1.25,1.62,2.0,1.61,4
Cerezo Osaka,8,4,1,3,12,10,2,13,Japan - J1 League,0.5,0.62,2,1.5,1.62,2.0,1.61,4
Tokyo Verdy,8,3,3,2,6,5,1,12,Japan - J1 League,0.38,0.75,1,0.75,1.5,2.63,1.33,5
S. Hiroshima,8,4,0,4,7,7,0,12,Japan - J1 League,0.5,0.5,0,0.88,1.5,2.0,2.0,5
K. Frontale,8,2,5,1,12,8,4,11,Japan - J1 League,0.25,0.88,4,1.5,1.38,4.0,1.14,6
Avispa Fukuoka,8,3,2,3,7,8,-1,11,Japan - J1 League,0.38,0.62,-1,0.88,1.38,2.63,1.61,6
Nagoya G.,8,3,1,4,9,8,1,10,Japan - J1 League,0.38,0.5,1,1.12,1.25,2.63,2.0,7
Shimizu S-Pulse,8,3,1,4,10,12,-2,10,Japan - J1 League,0.38,0.5,-2,1.25,1.25,2.63,2.0,7
Albirex Niigata,8,2,3,3,9,10,-1,9,Japan - J1 League,0.25,0.62,-1,1.12,1.12,4.0,1.61,8
FC Tokyo,8,2,3,3,10,12,-2,9,Japan - J1 League,0.25,0.62,-2,1.25,1.12,4.0,1.61,8
Fagiano Okayama,8,2,2,4,5,8,-3,8,Japan - J1 League,0.25,0.5,-3,0.62,1.0,4.0,2.0,9
Machida Zelvia,8,2,1,5,6,10,-4,7,Japan - J1 League,0.25,0.38,-4,0.75,0.88,4.0,2.63,10
Shonan Bellmare,8,2,1,5,3,11,-8,7,Japan - J1 League,0.25,0.38,-8,0.38,0.88,4.0,2.63,10
Yokohama M.,8,1,2,5,9,14,-5,5,Japan - J1 League,0.12,0.38,-5,1.12,0.62,8.33,2.63,11
Yokohama FC,8,1,2,5,5,11,-6,5,Japan - J1 League,0.12,0.38,-6,0.62,0.62,8.33,2.63,11
Vegalta Sendai,8,6,2,0,11,4,7,20,Japan - J2 League,0.75,1.0,7,1.38,2.5,1.33,1.0,1
Mito Hollyhock,8,5,2,1,13,5,8,17,Japan - J2 League,0.62,0.88,8,1.62,2.12,1.61,1.14,2
FC Imabari,8,3,5,0,12,7,5,14,Japan - J2 League,0.38,1.0,5,1.5,1.75,2.63,1.0,3
JEF Utd Chiba,8,4,2,2,11,8,3,14,Japan - J2 League,0.5,0.75,3,1.38,1.75,2.0,1.33,3
Sagan Tosu,8,4,2,2,10,8,2,14,Japan - J2 League,0.5,0.75,2,1.25,1.75,2.0,1.33,3
Oita Trinita,8,4,2,2,9,7,2,14,Japan - J2 League,0.5,0.75,2,1.12,1.75,2.0,1.33,3
Tokushima V.,8,4,1,3,7,4,3,13,Japan - J2 League,0.5,0.62,3,0.88,1.62,2.0,1.61,4
Omiya Ardija,8,3,3,2,10,9,1,12,Japan - J2 League,0.38,0.75,1,1.25,1.5,2.63,1.33,5
Ventforet Kofu,8,3,3,2,5,5,0,12,Japan - J2 League,0.38,0.75,0,0.62,1.5,2.63,1.33,5
Iwaki,8,3,2,3,11,13,-2,11,Japan - J2 League,0.38,0.62,-2,1.38,1.38,2.63,1.61,6
C. Sapporo,8,3,1,4,9,12,-3,10,Japan - J2 League,0.38,0.5,-3,1.12,1.25,2.63,2.0,7
M. Yamagata,8,2,3,3,9,8,1,9,Japan - J2 League,0.25,0.62,1,1.12,1.12,4.0,1.61,8
R. Kumamoto,8,2,3,3,6,5,1,9,Japan - J2 League,0.25,0.62,1,0.75,1.12,4.0,1.61,8
Jubilo Iwata,8,2,3,3,10,12,-2,9,Japan - J2 League,0.25,0.62,-2,1.25,1.12,4.0,1.61,8
Ehime FC,8,1,5,2,9,11,-2,8,Japan - J2 League,0.12,0.75,-2,1.12,1.0,8.33,1.33,9
Blaublitz Akita,8,2,1,5,6,11,-5,7,Japan - J2 League,0.25,0.38,-5,0.75,0.88,4.0,2.63,10
R. Yamaguchi,8,1,3,4,9,13,-4,6,Japan - J2 League,0.12,0.5,-4,1.12,0.75,8.33,2.0,11
Fujieda MYFC,8,2,0,6,11,16,-5,6,Japan - J2 League,0.25,0.25,-5,1.38,0.75,4.0,4.0,11
V-V. Nagasaki,8,1,3,4,12,18,-6,6,Japan - J2 League,0.12,0.5,-6,1.5,0.75,8.33,2.0,11
Kataller Toyama,8,0,4,4,6,10,-4,4,Japan - J2 League,0.0,0.5,-4,0.75,0.5,0.0,2.0,12
Tochigi City,8,5,3,0,15,6,9,18,Japan - J3 League,0.62,1.0,9,1.88,2.25,1.61,1.0,1
V. Hachinohe,8,5,2,1,9,4,5,17,Japan - J3 League,0.62,0.88,5,1.12,2.12,1.61,1.14,2
Osaka,8,5,0,3,11,8,3,15,Japan - J3 League,0.62,0.62,3,1.38,1.88,1.61,1.61,3
T. Miyazaki,8,4,3,1,11,8,3,15,Japan - J3 League,0.5,0.88,3,1.38,1.88,2.0,1.14,3
Kagoshima Utd,8,3,4,1,11,8,3,13,Japan - J3 League,0.38,0.88,3,1.38,1.62,2.63,1.14,4
Matsumoto Y.,8,4,1,3,9,10,-1,13,Japan - J3 League,0.5,0.62,-1,1.12,1.62,2.0,1.61,4
Nara Club,8,3,3,2,10,8,2,12,Japan - J3 League,0.38,0.75,2,1.25,1.5,2.63,1.33,5
G. Kitakyushu,8,3,2,3,6,5,1,11,Japan - J3 League,0.38,0.62,1,0.75,1.38,2.63,1.61,6
Fukushima Utd,8,3,2,3,14,14,0,11,Japan - J3 League,0.38,0.62,0,1.75,1.38,2.63,1.61,6
Tochigi SC,8,3,2,3,5,5,0,11,Japan - J3 League,0.38,0.62,0,0.62,1.38,2.63,1.61,6
Z. Kanazawa,8,3,1,4,8,9,-1,10,Japan - J3 League,0.38,0.5,-1,1.0,1.25,2.63,2.0,7
Kusatsu,8,2,3,3,12,13,-1,9,Japan - J3 League,0.25,0.62,-1,1.5,1.12,4.0,1.61,8
FC Ryukyu,8,2,3,3,8,9,-1,9,Japan - J3 League,0.25,0.62,-1,1.0,1.12,4.0,1.61,8
Gifu,8,2,3,3,8,11,-3,9,Japan - J3 League,0.25,0.62,-3,1.0,1.12,4.0,1.61,8
Gainare Tottori,8,2,2,4,7,9,-2,8,Japan - J3 League,0.25,0.5,-2,0.88,1.0,4.0,2.0,9
Kamatamare S.,8,2,2,4,6,8,-2,8,Japan - J3 League,0.25,0.5,-2,0.75,1.0,4.0,2.0,9
Kochi United,8,2,2,4,16,19,-3,8,Japan - J3 League,0.25,0.5,-3,2.0,1.0,4.0,2.0,9
SC Sagamihara,8,1,5,2,6,9,-3,8,Japan - J3 League,0.12,0.75,-3,0.75,1.0,8.33,1.33,9
Nagano Parceiro,8,1,2,5,7,12,-5,5,Japan - J3 League,0.12,0.38,-5,0.88,0.62,8.33,2.63,10
AC Numazu,8,0,3,5,6,12,-6,3,Japan - J3 League,0.0,0.38,-6,0.75,0.38,0.0,2.63,11
Al Wihdat,8,6,1,1,17,6,11,19,Jordan - Premier League,0.75,0.88,11,2.12,2.38,1.33,1.14,1
Al Faysali,8,4,4,0,7,3,4,16,Jordan - Premier League,0.5,1.0,4,0.88,2.0,2.0,1.0,2
Al Salt,8,4,2,2,8,5,3,14,Jordan - Premier League,0.5,0.75,3,1.0,1.75,2.0,1.33,3
Al Hussein,8,3,4,1,20,7,13,13,Jordan - Premier League,0.38,0.88,13,2.5,1.62,2.63,1.14,4
Shabab Al Ordon,8,3,2,3,11,8,3,11,Jordan - Premier League,0.38,0.62,3,1.38,1.38,2.63,1.61,5
Al Ramtha,8,3,2,3,9,7,2,11,Jordan - Premier League,0.38,0.62,2,1.12,1.38,2.63,1.61,5
Al Sareeh,8,3,2,3,6,6,0,11,Jordan - Premier League,0.38,0.62,0,0.75,1.38,2.63,1.61,5
Aqaba,8,3,2,3,7,15,-8,11,Jordan - Premier League,0.38,0.62,-8,0.88,1.38,2.63,1.61,5
Al Jazeera,8,3,1,4,8,8,0,10,Jordan - Premier League,0.38,0.5,0,1.0,1.25,2.63,2.0,6
Al Ahli,8,2,1,5,4,14,-10,7,Jordan - Premier League,0.25,0.38,-10,0.5,0.88,4.0,2.63,7
Maan,8,1,1,6,7,16,-9,4,Jordan - Premier League,0.12,0.25,-9,0.88,0.5,8.33,4.0,8
Moghayer Al S.,8,1,0,7,4,18,-14,3,Jordan - Premier League,0.12,0.12,-14,0.5,0.38,8.33,8.33,9
Kairat Almaty,8,6,2,0,21,5,16,20,Kazakhstan - Premier League,0.75,1.0,16,2.62,2.5,1.33,1.0,1
FC Astana,8,5,3,0,14,5,9,18,Kazakhstan - Premier League,0.62,1.0,9,1.75,2.25,1.61,1.0,2
Aktobe,7,5,1,1,12,4,8,16,Kazakhstan - Premier League,0.71,0.86,8,1.71,2.29,1.41,1.16,3
Tobol,7,4,2,1,9,4,5,14,Kazakhstan - Premier League,0.57,0.86,5,1.29,2.0,1.75,1.16,4
Yelimay Semey,7,4,1,2,11,5,6,13,Kazakhstan - Premier League,0.57,0.71,6,1.57,1.86,1.75,1.41,5
Okzhetpes,7,3,2,2,8,7,1,11,Kazakhstan - Premier League,0.43,0.71,1,1.14,1.57,2.33,1.41,6
Ordabasy,7,3,2,2,5,7,-2,11,Kazakhstan - Premier League,0.43,0.71,-2,0.71,1.57,2.33,1.41,6
Turan,7,2,2,3,8,8,0,8,Kazakhstan - Premier League,0.29,0.57,0,1.14,1.14,3.45,1.75,7
Kyzylzhar,7,2,2,3,8,10,-2,8,Kazakhstan - Premier League,0.29,0.57,-2,1.14,1.14,3.45,1.75,7
Zhenys,7,0,5,2,2,4,-2,5,Kazakhstan - Premier League,0.0,0.71,-2,0.29,0.71,0.0,1.41,8
Kaisar K.,7,0,4,3,5,11,-6,4,Kazakhstan - Premier League,0.0,0.57,-6,0.71,0.57,0.0,1.75,9
Zhetysu,7,0,4,3,1,8,-7,4,Kazakhstan - Premier League,0.0,0.57,-7,0.14,0.57,0.0,1.75,9
Ulytau,7,0,2,5,2,12,-10,2,Kazakhstan - Premier League,0.0,0.29,-10,0.29,0.29,0.0,3.45,10
Atyrau,8,0,0,8,5,22,-17,0,Kazakhstan - Premier League,0.0,0.0,-17,0.62,0.0,0.0,0.0,11
Drita,8,5,2,1,14,6,8,17,Kosovo - Superliga,0.62,0.88,8,1.75,2.12,1.61,1.14,1
Ferizaj,8,5,0,3,14,11,3,15,Kosovo - Superliga,0.62,0.62,3,1.75,1.88,1.61,1.61,2
Gjilani,8,4,2,2,9,10,-1,14,Kosovo - Superliga,0.5,0.75,-1,1.12,1.75,2.0,1.33,3
Ballkani,8,4,1,3,11,9,2,13,Kosovo - Superliga,0.5,0.62,2,1.38,1.62,2.0,1.61,4
Llapi,8,3,3,2,7,3,4,12,Kosovo - Superliga,0.38,0.75,4,0.88,1.5,2.63,1.33,5
Malisheva,8,3,3,2,10,7,3,12,Kosovo - Superliga,0.38,0.75,3,1.25,1.5,2.63,1.33,5
Dukagjini,8,3,3,2,5,4,1,12,Kosovo - Superliga,0.38,0.75,1,0.62,1.5,2.63,1.33,5
Prishtina,8,0,6,2,7,9,-2,6,Kosovo - Superliga,0.0,0.75,-2,0.88,0.75,0.0,1.33,6
Suhareka,8,1,1,6,7,16,-9,4,Kosovo - Superliga,0.12,0.25,-9,0.88,0.5,8.33,4.0,7
Feronikeli,8,1,1,6,4,13,-9,4,Kosovo - Superliga,0.12,0.25,-9,0.5,0.5,8.33,4.0,7
Al Kuwait,8,5,3,0,20,6,14,18,Kuwait - Premier League,0.62,1.0,14,2.5,2.25,1.61,1.0,1
Al Arabi SC,8,5,3,0,13,5,8,18,Kuwait - Premier League,0.62,1.0,8,1.62,2.25,1.61,1.0,1
Al Qadsia,8,4,0,4,15,13,2,12,Kuwait - Premier League,0.5,0.5,2,1.88,1.5,2.0,2.0,2
Al Nasar,8,4,0,4,16,16,0,12,Kuwait - Premier League,0.5,0.5,0,2.0,1.5,2.0,2.0,2
Al Fahaheel,8,2,5,1,10,8,2,11,Kuwait - Premier League,0.25,0.88,2,1.25,1.38,4.0,1.14,3
Kazma,8,2,3,3,13,10,3,9,Kuwait - Premier League,0.25,0.62,3,1.62,1.12,4.0,1.61,4
Al Salmiyah,8,2,3,3,11,16,-5,9,Kuwait - Premier League,0.25,0.62,-5,1.38,1.12,4.0,1.61,4
Khaitan,8,1,3,4,5,8,-3,6,Kuwait - Premier League,0.12,0.5,-3,0.62,0.75,8.33,2.0,5
Yarmouk,8,1,2,5,6,21,-15,5,Kuwait - Premier League,0.12,0.38,-15,0.75,0.62,8.33,2.63,6
Al Tadhamon,8,1,1,6,4,21,-17,4,Kuwait - Premier League,0.12,0.25,-17,0.5,0.5,8.33,4.0,7
Riga FC,8,6,1,1,22,7,15,19,Latvia - Virsliga,0.75,0.88,15,2.75,2.38,1.33,1.14,1
RFS,8,5,1,2,15,7,8,16,Latvia - Virsliga,0.62,0.75,8,1.88,2.0,1.61,1.33,2
Auda,8,5,0,3,12,6,6,15,Latvia - Virsliga,0.62,0.62,6,1.5,1.88,1.61,1.61,3
FS Jelgava,8,4,2,2,11,8,3,14,Latvia - Virsliga,0.5,0.75,3,1.38,1.75,2.0,1.33,4
Daugavpils,8,4,2,2,12,10,2,14,Latvia - Virsliga,0.5,0.75,2,1.5,1.75,2.0,1.33,4
Metta,8,2,2,4,8,12,-4,8,Latvia - Virsliga,0.25,0.5,-4,1.0,1.0,4.0,2.0,5
Liepaja,8,2,2,4,14,22,-8,8,Latvia - Virsliga,0.25,0.5,-8,1.75,1.0,4.0,2.0,5
Super Nova,8,1,4,3,11,15,-4,7,Latvia - Virsliga,0.12,0.62,-4,1.38,0.88,8.33,1.61,6
Tukums,8,1,3,4,7,13,-6,6,Latvia - Virsliga,0.12,0.5,-6,0.88,0.75,8.33,2.0,7
Grobina,8,1,1,6,5,17,-12,4,Latvia - Virsliga,0.12,0.25,-12,0.62,0.5,8.33,4.0,8
Hegelmann L.,8,6,0,2,14,11,3,18,Lithuania - A Lyga,0.75,0.75,3,1.75,2.25,1.33,1.33,1
Kauno Zalgiris,8,4,3,1,11,5,6,15,Lithuania - A Lyga,0.5,0.88,6,1.38,1.88,2.0,1.14,2
Dziugas Telsiai,8,5,0,3,7,4,3,15,Lithuania - A Lyga,0.62,0.62,3,0.88,1.88,1.61,1.61,2
Suduva,8,3,3,2,7,6,1,12,Lithuania - A Lyga,0.38,0.75,1,0.88,1.5,2.63,1.33,3
Panevezys,8,3,2,3,10,10,0,11,Lithuania - A Lyga,0.38,0.62,0,1.25,1.38,2.63,1.61,4
Banga,8,3,2,3,9,9,0,11,Lithuania - A Lyga,0.38,0.62,0,1.12,1.38,2.63,1.61,4
Siauliai,8,3,2,3,10,11,-1,11,Lithuania - A Lyga,0.38,0.62,-1,1.25,1.38,2.63,1.61,4
Riteriai,8,2,3,3,11,11,0,9,Lithuania - A Lyga,0.25,0.62,0,1.38,1.12,4.0,1.61,5
Zalgiris,8,2,2,4,8,10,-2,8,Lithuania - A Lyga,0.25,0.5,-2,1.0,1.0,4.0,2.0,6
Dainava,8,0,1,7,5,15,-10,1,Lithuania - A Lyga,0.0,0.12,-10,0.62,0.12,0.0,8.33,7
BFA Vilnius,7,6,1,0,14,3,11,19,Lithuania - 1st League,0.86,1.0,11,2.0,2.71,1.16,1.0,1
TransINVEST,7,6,0,1,20,7,13,18,Lithuania - 1st League,0.86,0.86,13,2.86,2.57,1.16,1.16,2
Tauras,7,5,2,0,15,1,14,17,Lithuania - 1st League,0.71,1.0,14,2.14,2.43,1.41,1.0,3
Neptuna K.,7,4,1,2,15,7,8,13,Lithuania - 1st League,0.57,0.71,8,2.14,1.86,1.75,1.41,4
Kauno Z. B,7,4,0,3,11,9,2,12,Lithuania - 1st League,0.57,0.57,2,1.57,1.71,1.75,1.75,5
Babrungas,7,3,3,1,10,11,-1,12,Lithuania - 1st League,0.43,0.86,-1,1.43,1.71,2.33,1.16,5
Panevezys B,7,3,1,3,13,16,-3,10,Lithuania - 1st League,0.43,0.57,-3,1.86,1.43,2.33,1.75,6
Zalgiris B,7,2,3,2,10,10,0,9,Lithuania - 1st League,0.29,0.71,0,1.43,1.29,3.45,1.41,7
Hegelmann B,7,2,3,2,8,9,-1,9,Lithuania - 1st League,0.29,0.71,-1,1.14,1.29,3.45,1.41,7
Ekranas,7,2,1,4,9,10,-1,7,Lithuania - 1st League,0.29,0.43,-1,1.29,1.0,3.45,2.33,8
Nevezis,7,2,1,4,12,15,-3,7,Lithuania - 1st League,0.29,0.43,-3,1.71,1.0,3.45,2.33,8
Atmosfera,7,2,1,4,7,11,-4,7,Lithuania - 1st League,0.29,0.43,-4,1.0,1.0,3.45,2.33,8
Minija,7,2,0,5,4,13,-9,6,Lithuania - 1st League,0.29,0.29,-9,0.57,0.86,3.45,3.45,9
Jonava,7,1,2,4,4,6,-2,5,Lithuania - 1st League,0.14,0.43,-2,0.57,0.71,7.14,2.33,10
Siauliai B,7,1,1,5,9,22,-13,4,Lithuania - 1st League,0.14,0.29,-13,1.29,0.57,7.14,3.45,11
Be1 NFA,7,0,2,5,3,14,-11,2,Lithuania - 1st League,0.0,0.29,-11,0.43,0.29,0.0,3.45,12
Differdange,8,7,1,0,17,0,17,22,Luxembourg - National Division,0.88,1.0,17,2.12,2.75,1.14,1.0,1
Niedercorn,8,6,1,1,16,7,9,19,Luxembourg - National Division,0.75,0.88,9,2.0,2.38,1.33,1.14,2
UNA Strassen,8,5,0,3,20,9,11,15,Luxembourg - National Division,0.62,0.62,11,2.5,1.88,1.61,1.61,3
Mondorf,8,5,0,3,12,9,3,15,Luxembourg - National Division,0.62,0.62,3,1.5,1.88,1.61,1.61,3
Racing,8,4,2,2,12,6,6,14,Luxembourg - National Division,0.5,0.75,6,1.5,1.75,2.0,1.33,4
Hostert,8,4,1,3,12,14,-2,13,Luxembourg - National Division,0.5,0.62,-2,1.5,1.62,2.0,1.61,5
Dudelange,8,3,3,2,14,8,6,12,Luxembourg - National Division,0.38,0.75,6,1.75,1.5,2.63,1.33,6
Rodange,8,3,3,2,7,7,0,12,Luxembourg - National Division,0.38,0.75,0,0.88,1.5,2.63,1.33,6
Hesperange,8,3,1,4,11,13,-2,10,Luxembourg - National Division,0.38,0.5,-2,1.38,1.25,2.63,2.0,7
Petange,8,3,1,4,11,13,-2,10,Luxembourg - National Division,0.38,0.5,-2,1.38,1.25,2.63,2.0,7
V. Rosport,8,1,5,2,7,9,-2,8,Luxembourg - National Division,0.12,0.75,-2,0.88,1.0,8.33,1.33,8
Jeunesse Esch,8,2,2,4,10,14,-4,8,Luxembourg - National Division,0.25,0.5,-4,1.25,1.0,4.0,2.0,8
Wiltz,8,2,2,4,9,15,-6,8,Luxembourg - National Division,0.25,0.5,-6,1.12,1.0,4.0,2.0,8
Bettembourg,8,2,1,5,10,15,-5,7,Luxembourg - National Division,0.25,0.38,-5,1.25,0.88,4.0,2.63,9
Fola Esch,8,2,0,6,6,16,-10,6,Luxembourg - National Division,0.25,0.25,-10,0.75,0.75,4.0,4.0,10
Mondercange,8,0,1,7,2,21,-19,1,Luxembourg - National Division,0.0,0.12,-19,0.25,0.12,0.0,8.33,11
Johor Darul,8,8,0,0,31,1,30,24,Malaysia - Super League,1.0,1.0,30,3.88,3.0,1.0,1.0,1
Selangor,8,5,2,1,15,3,12,17,Malaysia - Super League,0.62,0.88,12,1.88,2.12,1.61,1.14,2
Kuching,8,5,2,1,16,7,9,17,Malaysia - Super League,0.62,0.88,9,2.0,2.12,1.61,1.14,2
Kuala Lumpur,8,4,2,2,15,11,4,14,Malaysia - Super League,0.5,0.75,4,1.88,1.75,2.0,1.33,3
Pahang,8,4,1,3,16,14,2,13,Malaysia - Super League,0.5,0.62,2,2.0,1.62,2.0,1.61,4
Perak,8,3,3,2,14,8,6,12,Malaysia - Super League,0.38,0.75,6,1.75,1.5,2.63,1.33,5
Pulau Pinang,8,3,3,2,16,12,4,12,Malaysia - Super League,0.38,0.75,4,2.0,1.5,2.63,1.33,5
Terengganu,8,3,2,3,15,9,6,11,Malaysia - Super League,0.38,0.62,6,1.88,1.38,2.63,1.61,6
Sabah,8,2,5,1,9,8,1,11,Malaysia - Super League,0.25,0.88,1,1.12,1.38,4.0,1.14,6
Negeri Sembilan,8,2,1,5,7,12,-5,7,Malaysia - Super League,0.25,0.38,-5,0.88,0.88,4.0,2.63,7
PDRM,8,2,0,6,5,15,-10,6,Malaysia - Super League,0.25,0.25,-10,0.62,0.75,4.0,4.0,8
Kedah,8,1,1,6,5,24,-19,4,Malaysia - Super League,0.12,0.25,-19,0.62,0.5,8.33,4.0,9
Kelantan United,8,0,0,8,4,40,-36,0,Malaysia - Super League,0.0,0.0,-36,0.5,0.0,0.0,0.0,10
Mosta,8,5,1,2,11,9,2,16,Malta - Premier League,0.62,0.75,2,1.38,2.0,1.61,1.33,1
Floriana,8,4,3,1,11,7,4,15,Malta - Premier League,0.5,0.88,4,1.38,1.88,2.0,1.14,2
Birkirkara,8,4,2,2,12,5,7,14,Malta - Premier League,0.5,0.75,7,1.5,1.75,2.0,1.33,3
Hibernians,8,4,2,2,13,12,1,14,Malta - Premier League,0.5,0.75,1,1.62,1.75,2.0,1.33,3
Marsaxlokk,8,4,1,3,13,6,7,13,Malta - Premier League,0.5,0.62,7,1.62,1.62,2.0,1.61,4
Sliema,8,4,0,4,13,12,1,12,Malta - Premier League,0.5,0.5,1,1.62,1.5,2.0,2.0,5
Hamrun Spartans,8,3,1,4,7,6,1,10,Malta - Premier League,0.38,0.5,1,0.88,1.25,2.63,2.0,6
Naxxar Lions,8,3,1,4,11,15,-4,10,Malta - Premier League,0.38,0.5,-4,1.38,1.25,2.63,2.0,6
Zabbar,8,2,2,4,10,9,1,8,Malta - Premier League,0.25,0.5,1,1.25,1.0,4.0,2.0,7
Gzira Utd,8,2,2,4,5,13,-8,8,Malta - Premier League,0.25,0.5,-8,0.62,1.0,4.0,2.0,7
Balzan,8,1,4,3,6,8,-2,7,Malta - Premier League,0.12,0.62,-2,0.75,0.88,8.33,1.61,8
Melita,8,1,3,4,10,20,-10,6,Malta - Premier League,0.12,0.5,-10,1.25,0.75,8.33,2.0,9
Cruz Azul,8,6,2,0,20,6,14,20,Mexico - Liga MX - Apertura,0.75,1.0,14,2.5,2.5,1.33,1.0,1
Toluca,8,5,2,1,21,7,14,17,Mexico - Liga MX - Apertura,0.62,0.88,14,2.62,2.12,1.61,1.14,2
A. San Luis,8,5,1,2,12,8,4,16,Mexico - Liga MX - Apertura,0.62,0.75,4,1.5,2.0,1.61,1.33,3
Pumas UNAM,8,4,3,1,8,3,5,15,Mexico - Liga MX - Apertura,0.5,0.88,5,1.0,1.88,2.0,1.14,4
Tijuana,8,4,3,1,10,9,1,15,Mexico - Liga MX - Apertura,0.5,0.88,1,1.25,1.88,2.0,1.14,4
CF America,8,4,2,2,15,10,5,14,Mexico - Liga MX - Apertura,0.5,0.75,5,1.88,1.75,2.0,1.33,5
Tigres,8,4,2,2,13,11,2,14,Mexico - Liga MX - Apertura,0.5,0.75,2,1.62,1.75,2.0,1.33,5
Juarez,8,4,1,3,13,15,-2,13,Mexico - Liga MX - Apertura,0.5,0.62,-2,1.62,1.62,2.0,1.61,6
Monterrey,8,3,3,2,12,7,5,12,Mexico - Liga MX - Apertura,0.38,0.75,5,1.5,1.5,2.63,1.33,7
Club Leon,8,2,5,1,13,9,4,11,Mexico - Liga MX - Apertura,0.25,0.88,4,1.62,1.38,4.0,1.14,8
Guadalajara,8,3,2,3,10,8,2,11,Mexico - Liga MX - Apertura,0.38,0.62,2,1.25,1.38,2.63,1.61,8
Queretaro,8,2,2,4,7,13,-6,8,Mexico - Liga MX - Apertura,0.25,0.5,-6,0.88,1.0,4.0,2.0,9
Atlas,8,1,5,2,6,12,-6,8,Mexico - Liga MX - Apertura,0.12,0.75,-6,0.75,1.0,8.33,1.33,9
Mazatlan,8,1,4,3,4,9,-5,7,Mexico - Liga MX - Apertura,0.12,0.62,-5,0.5,0.88,8.33,1.61,10
Pachuca,8,1,1,6,12,16,-4,4,Mexico - Liga MX - Apertura,0.12,0.25,-4,1.5,0.5,8.33,4.0,11
Necaxa,8,0,3,5,7,18,-11,3,Mexico - Liga MX - Apertura,0.0,0.38,-11,0.88,0.38,0.0,2.63,12
Puebla,8,1,0,7,7,18,-11,3,Mexico - Liga MX - Apertura,0.12,0.12,-11,0.88,0.38,8.33,8.33,12
Santos Laguna,8,0,2,6,4,16,-12,2,Mexico - Liga MX - Apertura,0.0,0.25,-12,0.5,0.25,0.0,4.0,13
Toluca,8,6,1,1,19,12,7,19,Mexico - Liga MX - Clausura,0.75,0.88,7,2.38,2.38,1.33,1.14,1
Tigres,8,5,2,1,10,6,4,17,Mexico - Liga MX - Clausura,0.62,0.88,4,1.25,2.12,1.61,1.14,2
Monterrey,8,5,1,2,16,9,7,16,Mexico - Liga MX - Clausura,0.62,0.75,7,2.0,2.0,1.61,1.33,3
Cruz Azul,8,4,4,0,13,7,6,16,Mexico - Liga MX - Clausura,0.5,1.0,6,1.62,2.0,2.0,1.0,3
CF America,8,4,2,2,14,3,11,14,Mexico - Liga MX - Clausura,0.5,0.75,11,1.75,1.75,2.0,1.33,4
Queretaro,8,4,1,3,9,7,2,13,Mexico - Liga MX - Clausura,0.5,0.62,2,1.12,1.62,2.0,1.61,5
Necaxa,8,4,1,3,15,16,-1,13,Mexico - Liga MX - Clausura,0.5,0.62,-1,1.88,1.62,2.0,1.61,5
Pachuca,8,3,3,2,16,12,4,12,Mexico - Liga MX - Clausura,0.38,0.75,4,2.0,1.5,2.63,1.33,6
Tijuana,8,4,0,4,16,14,2,12,Mexico - Liga MX - Clausura,0.5,0.5,2,2.0,1.5,2.0,2.0,6
A. San Luis,8,4,0,4,10,13,-3,12,Mexico - Liga MX - Clausura,0.5,0.5,-3,1.25,1.5,2.0,2.0,6
Atlas,8,3,2,3,16,16,0,11,Mexico - Liga MX - Clausura,0.38,0.62,0,2.0,1.38,2.63,1.61,7
Pumas UNAM,8,3,1,4,11,11,0,10,Mexico - Liga MX - Clausura,0.38,0.5,0,1.38,1.25,2.63,2.0,8
Guadalajara,8,2,4,2,6,7,-1,10,Mexico - Liga MX - Clausura,0.25,0.75,-1,0.75,1.25,4.0,1.33,8
Juarez,8,1,5,2,8,9,-1,8,Mexico - Liga MX - Clausura,0.12,0.75,-1,1.0,1.0,8.33,1.33,9
Club Leon,8,2,1,5,8,12,-4,7,Mexico - Liga MX - Clausura,0.25,0.38,-4,1.0,0.88,4.0,2.63,10
Mazatlan,8,1,3,4,7,15,-8,6,Mexico - Liga MX - Clausura,0.12,0.5,-8,0.88,0.75,8.33,2.0,11
Santos Laguna,8,1,0,7,8,21,-13,3,Mexico - Liga MX - Clausura,0.12,0.12,-13,1.0,0.38,8.33,8.33,12
Puebla,8,0,1,7,1,13,-12,1,Mexico - Liga MX - Clausura,0.0,0.12,-12,0.12,0.12,0.0,8.33,13
Buducnost,8,5,3,0,27,10,17,18,Montenegro - First League,0.62,1.0,17,3.38,2.25,1.61,1.0,1
Petrovac,8,3,4,1,13,7,6,13,Montenegro - First League,0.38,0.88,6,1.62,1.62,2.63,1.14,2
Sutjeska,8,4,1,3,9,8,1,13,Montenegro - First League,0.5,0.62,1,1.12,1.62,2.0,1.61,2
Decic,8,3,3,2,7,5,2,12,Montenegro - First League,0.38,0.75,2,0.88,1.5,2.63,1.33,3
Jedinstvo,8,3,3,2,12,11,1,12,Montenegro - First League,0.38,0.75,1,1.5,1.5,2.63,1.33,3
Arsenal Tivat,8,3,1,4,5,12,-7,10,Montenegro - First League,0.38,0.5,-7,0.62,1.25,2.63,2.0,4
Otrant,8,2,3,3,15,14,1,9,Montenegro - First League,0.25,0.62,1,1.88,1.12,4.0,1.61,5
Jezero,8,2,3,3,10,11,-1,9,Montenegro - First League,0.25,0.62,-1,1.25,1.12,4.0,1.61,5
Bokelj,8,2,1,5,4,10,-6,7,Montenegro - First League,0.25,0.38,-6,0.5,0.88,4.0,2.63,6
Mornar Bar,8,2,1,5,6,16,-10,7,Montenegro - First League,0.25,0.38,-10,0.75,0.88,4.0,2.63,6
Berkane,8,5,2,1,11,3,8,17,morocco,0.62,0.88,8,1.38,2.12,1.61,1.14,1
Difaa El Jadida,8,4,3,1,9,5,4,15,morocco,0.5,0.88,4,1.12,1.88,2.0,1.14,2
Wydad,8,3,5,0,13,5,8,14,morocco,0.38,1.0,8,1.62,1.75,2.63,1.0,3
FUS Rabat,8,4,2,2,13,8,5,14,morocco,0.5,0.75,5,1.62,1.75,2.0,1.33,3
Raja Casablanca,8,3,5,0,9,5,4,14,morocco,0.38,1.0,4,1.12,1.75,2.63,1.0,3
FAR Rabat,8,4,2,2,11,9,2,14,morocco,0.5,0.75,2,1.38,1.75,2.0,1.33,3
Meknes,8,3,3,2,9,7,2,12,morocco,0.38,0.75,2,1.12,1.5,2.63,1.33,4
Union Touarga,8,3,3,2,9,7,2,12,morocco,0.38,0.75,2,1.12,1.5,2.63,1.33,4
Olympic Safi,8,2,4,2,7,7,0,10,morocco,0.25,0.75,0,0.88,1.25,4.0,1.33,5
Maghreb de Fes,8,2,4,2,8,10,-2,10,morocco,0.25,0.75,-2,1.0,1.25,4.0,1.33,5
Hassania Agadir,8,2,3,3,11,9,2,9,morocco,0.25,0.62,2,1.38,1.12,4.0,1.61,6
Moghreb Tetouan,8,2,3,3,8,10,-2,9,morocco,0.25,0.62,-2,1.0,1.12,4.0,1.61,6
R. Zemamra,8,3,0,5,6,10,-4,9,morocco,0.38,0.38,-4,0.75,1.12,2.63,2.63,6
Ittihad Tanger,8,2,2,4,11,14,-3,8,morocco,0.25,0.5,-3,1.38,1.0,4.0,2.0,7
JS Sousalem,8,0,1,7,4,17,-13,1,morocco,0.0,0.12,-13,0.5,0.12,0.0,8.33,8
C. Mohammedia,8,0,1,7,3,17,-14,1,morocco,0.0,0.12,-14,0.38,0.12,0.0,8.33,8
Shan Utd,8,7,1,0,24,2,22,22,myanmar,0.88,1.0,22,3.0,2.75,1.14,1.0,1
Yangon Utd,8,5,2,1,21,6,15,17,myanmar,0.62,0.88,15,2.62,2.12,1.61,1.14,2
Sagaing Utd,8,4,2,2,16,13,3,14,myanmar,0.5,0.75,3,2.0,1.75,2.0,1.33,3
Thitsar Arman,8,4,1,3,15,12,3,13,myanmar,0.5,0.62,3,1.88,1.62,2.0,1.61,4
Yadanarbon,8,3,3,2,18,15,3,12,myanmar,0.38,0.75,3,2.25,1.5,2.63,1.33,5
Dagon,8,3,2,3,10,11,-1,11,myanmar,0.38,0.62,-1,1.25,1.38,2.63,1.61,6
Hantharwady,8,3,2,3,7,11,-4,11,myanmar,0.38,0.62,-4,0.88,1.38,2.63,1.61,6
Rakhine Utd,8,3,2,3,10,16,-6,11,myanmar,0.38,0.62,-6,1.25,1.38,2.63,1.61,6
Ayeyawady,8,2,0,6,9,16,-7,6,myanmar,0.25,0.25,-7,1.12,0.75,4.0,4.0,7
Ispe FC,8,1,3,4,4,14,-10,6,myanmar,0.12,0.5,-10,0.5,0.75,8.33,2.0,7
Dagon Port,8,1,2,5,12,21,-9,5,myanmar,0.12,0.38,-9,1.5,0.62,8.33,2.63,8
Myawady,8,1,2,5,11,20,-9,5,myanmar,0.12,0.38,-9,1.38,0.62,8.33,2.63,8
Feyenoord,8,7,1,0,24,6,18,22,netherlands,0.88,1.0,18,3.0,2.75,1.14,1.0,1
FC Utrecht,8,6,1,1,19,6,13,19,netherlands,0.75,0.88,13,2.38,2.38,1.33,1.14,2
PSV Eindhoven,8,6,0,2,22,9,13,18,netherlands,0.75,0.75,13,2.75,2.25,1.33,1.33,3
Ajax Amsterdam,8,5,2,1,12,9,3,17,netherlands,0.62,0.88,3,1.5,2.12,1.61,1.14,4
Sparta,8,4,3,1,15,6,9,15,netherlands,0.5,0.88,9,1.88,1.88,2.0,1.14,5
Heerenveen,8,4,1,3,12,11,1,13,netherlands,0.5,0.62,1,1.5,1.62,2.0,1.61,6
Go Ahead Eagles,8,3,3,2,12,13,-1,12,netherlands,0.38,0.75,-1,1.5,1.5,2.63,1.33,7
FC Groningen,8,3,2,3,16,14,2,11,netherlands,0.38,0.62,2,2.0,1.38,2.63,1.61,8
Heracles Almelo,8,3,2,3,10,13,-3,11,netherlands,0.38,0.62,-3,1.25,1.38,2.63,1.61,8
Fortuna Sittard,8,3,1,4,6,12,-6,10,netherlands,0.38,0.5,-6,0.75,1.25,2.63,2.0,9
NEC Nijmegen,8,2,3,3,9,11,-2,9,netherlands,0.25,0.62,-2,1.12,1.12,4.0,1.61,10
PEC Zwolle,8,2,3,3,11,14,-3,9,netherlands,0.25,0.62,-3,1.38,1.12,4.0,1.61,10
FC Twente,8,2,3,3,10,14,-4,9,netherlands,0.25,0.62,-4,1.25,1.12,4.0,1.61,10
AZ Alkmaar,8,1,4,3,12,13,-1,7,netherlands,0.12,0.62,-1,1.5,0.88,8.33,1.61,11
Almere City,8,1,3,4,6,12,-6,6,netherlands,0.12,0.5,-6,0.75,0.75,8.33,2.0,12
NAC Breda,8,0,5,3,7,12,-5,5,netherlands,0.0,0.62,-5,0.88,0.62,0.0,1.61,13
RKC Waalwijk,8,0,2,6,5,21,-16,2,netherlands,0.0,0.25,-16,0.62,0.25,0.0,4.0,14
Willem II,8,0,1,7,5,17,-12,1,netherlands,0.0,0.12,-12,0.62,0.12,0.0,8.33,15
Excelsior,8,8,0,0,23,4,19,24,netherlands2,1.0,1.0,19,2.88,3.0,1.0,1.0,1
FC Volendam,8,7,0,1,21,9,12,21,netherlands2,0.88,0.88,12,2.62,2.62,1.14,1.14,2
Cambuur,8,5,1,2,15,15,0,16,netherlands2,0.62,0.75,0,1.88,2.0,1.61,1.33,3
FC Emmen,8,5,0,3,12,9,3,15,netherlands2,0.62,0.62,3,1.5,1.88,1.61,1.61,4
Telstar,8,4,2,2,15,11,4,14,netherlands2,0.5,0.75,4,1.88,1.75,2.0,1.33,5
Jong AZ,8,3,4,1,14,9,5,13,netherlands2,0.38,0.88,5,1.75,1.62,2.63,1.14,6
De Graafschap,8,4,1,3,11,8,3,13,netherlands2,0.5,0.62,3,1.38,1.62,2.0,1.61,6
FC Dordrecht,8,4,0,4,15,6,9,12,netherlands2,0.5,0.5,9,1.88,1.5,2.0,2.0,7
VVV,8,3,3,2,15,9,6,12,netherlands2,0.38,0.75,6,1.88,1.5,2.63,1.33,7
ADO Den Haag,8,3,3,2,12,13,-1,12,netherlands2,0.38,0.75,-1,1.5,1.5,2.63,1.33,7
FC Den Bosch,8,3,3,2,11,12,-1,12,netherlands2,0.38,0.75,-1,1.38,1.5,2.63,1.33,7
Vitesse Arnhem,8,2,3,3,11,9,2,9,netherlands2,0.25,0.62,2,1.38,1.12,4.0,1.61,8
TOP Oss,8,2,3,3,11,13,-2,9,netherlands2,0.25,0.62,-2,1.38,1.12,4.0,1.61,8
FC Eindhoven,8,2,3,3,12,16,-4,9,netherlands2,0.25,0.62,-4,1.5,1.12,4.0,1.61,8
MVV Maastricht,8,2,1,5,10,11,-1,7,netherlands2,0.25,0.38,-1,1.25,0.88,4.0,2.63,9
Roda JC,8,2,1,5,9,18,-9,7,netherlands2,0.25,0.38,-9,1.12,0.88,4.0,2.63,9
Jong Utrecht,8,1,2,5,5,17,-12,5,netherlands2,0.12,0.38,-12,0.62,0.62,8.33,2.63,10
Jong PSV,8,1,2,5,10,23,-13,5,netherlands2,0.12,0.38,-13,1.25,0.62,8.33,2.63,10
Helmond Sport,8,0,4,4,9,15,-6,4,netherlands2,0.0,0.5,-6,1.12,0.5,0.0,2.0,11
Jong Ajax,8,1,1,6,3,14,-11,4,netherlands2,0.12,0.25,-11,0.38,0.5,8.33,4.0,11
Real Esteli,8,8,0,0,20,10,10,24,nicaragua2,1.0,1.0,10,2.5,3.0,1.0,1.0,1
Managua FC,8,5,0,3,19,9,10,15,nicaragua2,0.62,0.62,10,2.38,1.88,1.61,1.61,2
Matagalpa,8,3,3,2,15,12,3,12,nicaragua2,0.38,0.75,3,1.88,1.5,2.63,1.33,3
Walter Ferreti,8,3,3,2,10,7,3,12,nicaragua2,0.38,0.75,3,1.25,1.5,2.63,1.33,3
Diriangen,8,3,2,3,12,14,-2,11,nicaragua2,0.38,0.62,-2,1.5,1.38,2.63,1.61,4
CS Sebaco,8,2,3,3,9,11,-2,9,nicaragua2,0.25,0.62,-2,1.12,1.12,4.0,1.61,5
Jalapa,8,2,2,4,10,11,-1,8,nicaragua2,0.25,0.5,-1,1.25,1.0,4.0,2.0,6
UNAN Managua,8,2,2,4,11,13,-2,8,nicaragua2,0.25,0.5,-2,1.38,1.0,4.0,2.0,6
D. Ocotal,8,2,1,5,9,16,-7,7,nicaragua2,0.25,0.38,-7,1.12,0.88,4.0,2.63,7
Rancho Santana,8,0,4,4,4,15,-11,4,nicaragua2,0.0,0.5,-11,0.5,0.5,0.0,2.0,8
Linfield,8,6,0,2,15,5,10,18,northernireland,0.75,0.75,10,1.88,2.25,1.33,1.33,1
Cliftonville,8,5,1,2,19,7,12,16,northernireland,0.62,0.75,12,2.38,2.0,1.61,1.33,2
Larne,8,3,5,0,11,8,3,14,northernireland,0.38,1.0,3,1.38,1.75,2.63,1.0,3
Portadown,8,4,2,2,11,9,2,14,northernireland,0.5,0.75,2,1.38,1.75,2.0,1.33,3
Coleraine,8,3,2,3,10,12,-2,11,northernireland,0.38,0.62,-2,1.25,1.38,2.63,1.61,4
Dungannon,8,3,2,3,10,12,-2,11,northernireland,0.38,0.62,-2,1.25,1.38,2.63,1.61,4
Glentoran,8,2,3,3,11,9,2,9,northernireland,0.25,0.62,2,1.38,1.12,4.0,1.61,5
Glenavon,8,2,2,4,10,10,0,8,northernireland,0.25,0.5,0,1.25,1.0,4.0,2.0,6
Crusaders,8,2,2,4,8,13,-5,8,northernireland,0.25,0.5,-5,1.0,1.0,4.0,2.0,6
Loughgall,8,2,2,4,10,17,-7,8,northernireland,0.25,0.5,-7,1.25,1.0,4.0,2.0,6
Ballymena Utd,8,2,1,5,10,16,-6,7,northernireland,0.25,0.38,-6,1.25,0.88,4.0,2.63,7
Carrick Rangers,8,1,3,4,8,15,-7,6,northernireland,0.12,0.5,-7,1.0,0.75,8.33,2.0,8
Annagh Utd,8,8,0,0,20,6,14,24,northernireland2,1.0,1.0,14,2.5,3.0,1.0,1.0,1
Newington,8,5,2,1,21,16,5,17,northernireland2,0.62,0.88,5,2.62,2.12,1.61,1.14,2
Bangor,8,4,2,2,17,13,4,14,northernireland2,0.5,0.75,4,2.12,1.75,2.0,1.33,3
Limavady,8,3,4,1,12,9,3,13,northernireland2,0.38,0.88,3,1.5,1.62,2.63,1.14,4
Institute,8,4,1,3,18,19,-1,13,northernireland2,0.5,0.62,-1,2.25,1.62,2.0,1.61,4
Ards,8,3,2,3,12,13,-1,11,northernireland2,0.38,0.62,-1,1.5,1.38,2.63,1.61,5
Ballinamallard,8,3,1,4,8,9,-1,10,northernireland2,0.38,0.5,-1,1.0,1.25,2.63,2.0,6
HW Welders,8,3,0,5,15,15,0,9,northernireland2,0.38,0.38,0,1.88,1.12,2.63,2.63,7
Newry City,8,1,3,4,11,17,-6,6,northernireland2,0.12,0.5,-6,1.38,0.75,8.33,2.0,8
Ballyclare,8,1,2,5,12,19,-7,5,northernireland2,0.12,0.38,-7,1.5,0.62,8.33,2.63,9
Armagh City,8,1,1,6,14,20,-6,4,northernireland2,0.12,0.25,-6,1.75,0.5,8.33,4.0,10
Dundela,8,1,1,6,5,14,-9,4,northernireland2,0.12,0.25,-9,0.62,0.5,8.33,4.0,10
Sileks,8,5,3,0,15,3,12,18,northmacedonia,0.62,1.0,12,1.88,2.25,1.61,1.0,1
Shkendija,8,5,3,0,17,9,8,18,northmacedonia,0.62,1.0,8,2.12,2.25,1.61,1.0,1
Vardar,8,4,4,0,14,6,8,16,northmacedonia,0.5,1.0,8,1.75,2.0,2.0,1.0,2
Tikves,8,4,2,2,11,7,4,14,northmacedonia,0.5,0.75,4,1.38,1.75,2.0,1.33,3
Rabotnicki,8,3,3,2,7,6,1,12,northmacedonia,0.38,0.75,1,0.88,1.5,2.63,1.33,4
Struga,8,2,5,1,9,6,3,11,northmacedonia,0.25,0.88,3,1.12,1.38,4.0,1.14,5
Brera Strumica,8,3,0,5,12,14,-2,9,northmacedonia,0.38,0.38,-2,1.5,1.12,2.63,2.63,6
Pelister,8,3,0,5,9,12,-3,9,northmacedonia,0.38,0.38,-3,1.12,1.12,2.63,2.63,6
Besa,8,3,0,5,10,17,-7,9,northmacedonia,0.38,0.38,-7,1.25,1.12,2.63,2.63,6
Voska Sport,8,1,2,5,5,15,-10,5,northmacedonia,0.12,0.38,-10,0.62,0.62,8.33,2.63,7
Gostivar,8,1,1,6,7,16,-9,4,northmacedonia,0.12,0.25,-9,0.88,0.5,8.33,4.0,8
Shkupi,8,0,3,5,8,15,-7,3,northmacedonia,0.0,0.38,-7,1.0,0.38,0.0,2.63,9
Brann,6,5,0,1,14,10,4,15,norway,0.83,0.83,4,2.33,2.5,1.2,1.2,1
Viking,7,4,2,1,21,12,9,14,norway,0.57,0.86,9,3.0,2.0,1.75,1.16,2
Rosenborg,6,4,2,0,9,2,7,14,norway,0.67,1.0,7,1.5,2.33,1.49,1.0,2
Bodo.Glimt,4,3,1,0,9,2,7,10,norway,0.75,1.0,7,2.25,2.5,1.33,1.0,3
Fredrikstad,5,3,1,1,8,2,6,10,norway,0.6,0.8,6,1.6,2.0,1.67,1.25,3
Kristiansund,7,3,1,3,10,12,-2,10,norway,0.43,0.57,-2,1.43,1.43,2.33,1.75,3
Sandefjord,5,3,0,2,8,6,2,9,norway,0.6,0.6,2,1.6,1.8,1.67,1.67,4
Sarpsborg 08,5,2,2,1,8,5,3,8,norway,0.4,0.8,3,1.6,1.6,2.5,1.25,5
Valerenga,6,2,1,3,8,10,-2,7,norway,0.33,0.5,-2,1.33,1.17,3.03,2.0,6
Stromsgodset,6,2,0,4,12,10,2,6,norway,0.33,0.33,2,2.0,1.0,3.03,3.03,7
Molde,5,1,2,2,4,8,-4,5,norway,0.2,0.6,-4,0.8,1.0,5.0,1.67,8
Tromso,5,1,1,3,8,11,-3,4,norway,0.2,0.4,-3,1.6,0.8,5.0,2.5,9
KFUM Oslo,5,1,1,3,5,10,-5,4,norway,0.2,0.4,-5,1.0,0.8,5.0,2.5,9
HamKam,5,1,1,3,4,11,-7,4,norway,0.2,0.4,-7,0.8,0.8,5.0,2.5,9
Bryne,5,1,0,4,6,10,-4,3,norway,0.2,0.2,-4,1.2,0.6,5.0,5.0,10
Haugesund,6,0,1,5,3,16,-13,1,norway,0.0,0.17,-13,0.5,0.17,0.0,5.88,11
Lillestrom,5,4,1,0,10,2,8,13,norway2,0.8,1.0,8,2.0,2.6,1.25,1.0,1
Egersund,5,4,1,0,11,6,5,13,norway2,0.8,1.0,5,2.2,2.6,1.25,1.0,1
Kongsvinger,5,3,1,1,14,4,10,10,norway2,0.6,0.8,10,2.8,2.0,1.67,1.25,2
Aalesund,5,2,3,0,9,6,3,9,norway2,0.4,1.0,3,1.8,1.8,2.5,1.0,3
Start,5,3,0,2,11,9,2,9,norway2,0.6,0.6,2,2.2,1.8,1.67,1.67,3
Sogndal,5,3,0,2,10,9,1,9,norway2,0.6,0.6,1,2.0,1.8,1.67,1.67,3
Odd,5,2,1,2,7,7,0,7,norway2,0.4,0.6,0,1.4,1.4,2.5,1.67,4
Raufoss,5,2,1,2,8,9,-1,7,norway2,0.4,0.6,-1,1.6,1.4,2.5,1.67,4
Hodd,5,2,1,2,4,5,-1,7,norway2,0.4,0.6,-1,0.8,1.4,2.5,1.67,4
Stabaek,5,2,1,2,5,8,-3,7,norway2,0.4,0.6,-3,1.0,1.4,2.5,1.67,4
Ranheim,5,2,0,3,4,8,-4,6,norway2,0.4,0.4,-4,0.8,1.2,2.5,2.5,5
Moss,5,2,0,3,8,14,-6,6,norway2,0.4,0.4,-6,1.6,1.2,2.5,2.5,5
Asane,5,1,2,2,6,8,-2,5,norway2,0.2,0.6,-2,1.2,1.0,5.0,1.67,6
Lyn,5,1,0,4,4,5,-1,3,norway2,0.2,0.2,-1,0.8,0.6,5.0,5.0,7
Mjondalen,5,0,2,3,5,8,-3,2,norway2,0.0,0.4,-3,1.0,0.4,0.0,2.5,8
Skeid,5,0,0,5,6,14,-8,0,norway2,0.0,0.0,-8,1.2,0.0,0.0,0.0,9
Notodden,5,3,2,0,9,5,4,11,norway3,0.6,1.0,4,1.8,2.2,1.67,1.0,1
Brann B,5,3,0,2,13,12,1,9,norway3,0.6,0.6,1,2.6,1.8,1.67,1.67,2
Sandviken,5,3,0,2,10,10,0,9,norway3,0.6,0.6,0,2.0,1.8,1.67,1.67,2
Sotra,5,2,2,1,10,5,5,8,norway3,0.4,0.8,5,2.0,1.6,2.5,1.25,3
Eik Tonsberg,5,2,2,1,8,5,3,8,norway3,0.4,0.8,3,1.6,1.6,2.5,1.25,3
Sandnes Ulf,5,2,2,1,10,8,2,8,norway3,0.4,0.8,2,2.0,1.6,2.5,1.25,3
Jerv,5,2,2,1,8,7,1,8,norway3,0.4,0.8,1,1.6,1.6,2.5,1.25,3
Arendal,5,1,4,0,7,6,1,7,norway3,0.2,1.0,1,1.4,1.4,5.0,1.0,4
Brattvag,5,2,0,3,9,10,-1,6,norway3,0.4,0.4,-1,1.8,1.2,2.5,2.5,5
Pors Grenland,5,1,2,2,6,7,-1,5,norway3,0.2,0.6,-1,1.2,1.0,5.0,1.67,6
Traef,5,1,2,2,6,7,-1,5,norway3,0.2,0.6,-1,1.2,1.0,5.0,1.67,6
Lysekloster,5,1,1,3,6,8,-2,4,norway3,0.2,0.4,-2,1.2,0.8,5.0,2.5,7
V. Haugesund,5,1,1,3,5,8,-3,4,norway3,0.2,0.4,-3,1.0,0.8,5.0,2.5,7
Flekkeroy,5,0,2,3,6,15,-9,2,norway3,0.0,0.4,-9,1.2,0.4,0.0,2.5,8
Strommen,5,5,0,0,15,4,11,15,norway4,1.0,1.0,11,3.0,3.0,1.0,1.0,1
Tromsdalen,5,4,1,0,12,6,6,13,norway4,0.8,1.0,6,2.4,2.6,1.25,1.0,2
Kjelsas,5,4,0,1,9,5,4,12,norway4,0.8,0.8,4,1.8,2.4,1.25,1.25,3
Stjordals-Blink,5,3,0,2,7,6,1,9,norway4,0.6,0.6,1,1.4,1.8,1.67,1.67,4
Grorud,5,2,1,2,9,9,0,7,norway4,0.4,0.6,0,1.8,1.4,2.5,1.67,5
Follo,5,2,1,2,7,7,0,7,norway4,0.4,0.6,0,1.4,1.4,2.5,1.67,5
Eidsvold,5,2,1,2,9,11,-2,7,norway4,0.4,0.6,-2,1.8,1.4,2.5,1.67,5
Honefoss,5,2,0,3,10,9,1,6,norway4,0.4,0.4,1,2.0,1.2,2.5,2.5,6
Levanger,5,1,2,2,11,12,-1,5,norway4,0.2,0.6,-1,2.2,1.0,5.0,1.67,7
Ull/Kisa,5,1,2,2,8,9,-1,5,norway4,0.2,0.6,-1,1.6,1.0,5.0,1.67,7
Rana,5,1,1,3,5,9,-4,4,norway4,0.2,0.4,-4,1.0,0.8,5.0,2.5,8
Strindheim,5,1,0,4,6,9,-3,3,norway4,0.2,0.2,-3,1.2,0.6,5.0,5.0,9
Asker,5,0,3,2,5,10,-5,3,norway4,0.0,0.6,-5,1.0,0.6,0.0,1.67,9
Alta,5,1,0,4,6,13,-7,3,norway4,0.2,0.2,-7,1.2,0.6,5.0,5.0,9
Junkeren,5,4,1,0,14,3,11,13,norway5,0.8,1.0,11,2.8,2.6,1.25,1.0,1
Frigg,5,4,1,0,18,8,10,13,norway5,0.8,1.0,10,3.6,2.6,1.25,1.0,1
Floya,5,4,1,0,14,6,8,13,norway5,0.8,1.0,8,2.8,2.6,1.25,1.0,1
Baerum,5,3,0,2,13,7,6,9,norway5,0.6,0.6,6,2.6,1.8,1.67,1.67,2
Gamle Oslo,5,2,2,1,12,6,6,8,norway5,0.4,0.8,6,2.4,1.6,2.5,1.25,3
Sortland,5,2,1,2,9,12,-3,7,norway5,0.4,0.6,-3,1.8,1.4,2.5,1.67,4
Tromso B,5,2,0,3,12,12,0,6,norway5,0.4,0.4,0,2.4,1.2,2.5,2.5,5
Ullern,5,2,0,3,10,10,0,6,norway5,0.4,0.4,0,2.0,1.2,2.5,2.5,5
Harstad,5,2,0,3,11,13,-2,6,norway5,0.4,0.4,-2,2.2,1.2,2.5,2.5,5
Ulfstind,5,2,0,3,4,10,-6,6,norway5,0.4,0.4,-6,0.8,1.2,2.5,2.5,5
Skjervoy,5,1,2,2,8,13,-5,5,norway5,0.2,0.6,-5,1.6,1.0,5.0,1.67,6
KFUM B,5,0,2,3,7,11,-4,2,norway5,0.0,0.4,-4,1.4,0.4,0.0,2.5,7
Funnefoss/V,5,0,2,3,10,20,-10,2,norway5,0.0,0.4,-10,2.0,0.4,0.0,2.5,7
Alta B,5,0,2,3,4,15,-11,2,norway5,0.0,0.4,-11,0.8,0.4,0.0,2.5,7
Melhus,5,5,0,0,21,2,19,15,norway6,1.0,1.0,19,4.2,3.0,1.0,1.0,1
Rosenborg B,5,4,0,1,11,6,5,12,norway6,0.8,0.8,5,2.2,2.4,1.25,1.25,2
Trygg/Lade,5,3,1,1,20,5,15,10,norway6,0.6,0.8,15,4.0,2.0,1.67,1.25,3
Spjelkavik,5,3,1,1,15,6,9,10,norway6,0.6,0.8,9,3.0,2.0,1.67,1.25,3
Volda,5,3,1,1,12,7,5,10,norway6,0.6,0.8,5,2.4,2.0,1.67,1.25,3
Aalesund B,5,3,0,2,13,14,-1,9,norway6,0.6,0.6,-1,2.6,1.8,1.67,1.67,4
Byasen,5,2,2,1,8,6,2,8,norway6,0.4,0.8,2,1.6,1.6,2.5,1.25,5
Nardo,5,2,1,2,13,9,4,7,norway6,0.4,0.6,4,2.6,1.4,2.5,1.67,6
Kvik Trondheim,5,2,1,2,6,9,-3,7,norway6,0.4,0.6,-3,1.2,1.4,2.5,1.67,6
Tiller,5,1,2,2,5,10,-5,5,norway6,0.2,0.6,-5,1.0,1.0,5.0,1.67,7
Molde B,5,1,0,4,9,13,-4,3,norway6,0.2,0.2,-4,1.8,0.6,5.0,5.0,8
Ranheim B,5,1,0,4,6,12,-6,3,norway6,0.2,0.2,-6,1.2,0.6,5.0,5.0,8
Kristiansund B,5,0,1,4,2,20,-18,1,norway6,0.0,0.2,-18,0.4,0.2,0.0,5.0,9
Surnadal,5,0,0,5,4,26,-22,0,norway6,0.0,0.0,-22,0.8,0.0,0.0,0.0,10
Lorenskog,5,4,0,1,14,5,9,12,norway7,0.8,0.8,9,2.8,2.4,1.25,1.25,1
Gjovik-Lyn,5,3,2,0,10,4,6,11,norway7,0.6,1.0,6,2.0,2.2,1.67,1.0,2
Skjetten,5,3,1,1,16,7,9,10,norway7,0.6,0.8,9,3.2,2.0,1.67,1.25,3
Lillehammer,5,3,1,1,11,6,5,10,norway7,0.6,0.8,5,2.2,2.0,1.67,1.25,3
Kongsvinger B,5,3,1,1,11,9,2,10,norway7,0.6,0.8,2,2.2,2.0,1.67,1.25,3
Bjorkelangen,5,3,1,1,10,9,1,10,norway7,0.6,0.8,1,2.0,2.0,1.67,1.25,3
Elverum,5,3,0,2,14,6,8,9,norway7,0.6,0.6,8,2.8,1.8,1.67,1.67,4
Skedsmo,5,3,0,2,16,10,6,9,norway7,0.6,0.6,6,3.2,1.8,1.67,1.67,4
Nordstrand,5,2,1,2,10,12,-2,7,norway7,0.4,0.6,-2,2.0,1.4,2.5,1.67,5
Stromsgodset B,5,2,0,3,7,9,-2,6,norway7,0.4,0.4,-2,1.4,1.2,2.5,2.5,6
Assiden IF,5,1,1,3,11,11,0,4,norway7,0.2,0.4,0,2.2,0.8,5.0,2.5,7
Lillestrom B,5,1,0,4,7,16,-9,3,norway7,0.2,0.2,-9,1.4,0.6,5.0,5.0,8
HamKam B,5,0,0,5,6,16,-10,0,norway7,0.0,0.0,-10,1.2,0.0,0.0,0.0,9
Ull/Kisa B,5,0,0,5,2,25,-23,0,norway7,0.0,0.0,-23,0.4,0.0,0.0,0.0,9
Bjarg,5,5,0,0,26,3,23,15,norway8,1.0,1.0,23,5.2,3.0,1.0,1.0,1
Gneist,6,4,2,0,19,10,9,14,norway8,0.67,1.0,9,3.17,2.33,1.49,1.0,2
Forde,5,4,1,0,11,3,8,13,norway8,0.8,1.0,8,2.2,2.6,1.25,1.0,3
Fana,5,3,1,1,17,8,9,10,norway8,0.6,0.8,9,3.4,2.0,1.67,1.25,4
Lyn B,5,3,1,1,13,10,3,10,norway8,0.6,0.8,3,2.6,2.0,1.67,1.25,4
Sandefjord B,5,2,1,2,13,16,-3,7,norway8,0.4,0.6,-3,2.6,1.4,2.5,1.67,5
OS,5,2,0,3,15,9,6,6,norway8,0.4,0.4,6,3.0,1.2,2.5,2.5,6
Fyllingsdalen,6,2,0,4,10,15,-5,6,norway8,0.33,0.33,-5,1.67,1.0,3.03,3.03,6
Askoy,5,2,0,3,6,11,-5,6,norway8,0.4,0.4,-5,1.2,1.2,2.5,2.5,6
Fjora,5,2,0,3,9,18,-9,6,norway8,0.4,0.4,-9,1.8,1.2,2.5,2.5,6
Lyngbo,5,1,2,2,7,5,2,5,norway8,0.2,0.6,2,1.4,1.0,5.0,1.67,7
Loddefjord,5,1,0,4,9,19,-10,3,norway8,0.2,0.2,-10,1.8,0.6,5.0,5.0,8
Asane B,5,1,0,4,7,25,-18,3,norway8,0.2,0.2,-18,1.4,0.6,5.0,5.0,8
Valerenga B,5,0,0,5,5,15,-10,0,norway8,0.0,0.0,-10,1.0,0.0,0.0,0.0,9
Vidar,6,5,0,1,17,4,13,15,norway9,0.83,0.83,13,2.83,2.5,1.2,1.2,1
Madla,5,3,2,0,12,5,7,11,norway9,0.6,1.0,7,2.4,2.2,1.67,1.0,2
Viking B,5,3,1,1,14,7,7,10,norway9,0.6,0.8,7,2.8,2.0,1.67,1.25,3
Vindbjart,5,3,1,1,8,5,3,10,norway9,0.6,0.8,3,1.6,2.0,1.67,1.25,3
Torvastad,5,3,1,1,10,11,-1,10,norway9,0.6,0.8,-1,2.0,2.0,1.67,1.25,3
Hinna,5,3,0,2,19,10,9,9,norway9,0.6,0.6,9,3.8,1.8,1.67,1.67,4
Djerv,5,2,0,3,15,13,2,6,norway9,0.4,0.4,2,3.0,1.2,2.5,2.5,5
Brodd,5,2,0,3,7,11,-4,6,norway9,0.4,0.4,-4,1.4,1.2,2.5,2.5,5
Sandnes Ulf B,5,2,0,3,10,17,-7,6,norway9,0.4,0.4,-7,2.0,1.2,2.5,2.5,5
Sola,6,2,0,4,10,25,-15,6,norway9,0.33,0.33,-15,1.67,1.0,3.03,3.03,5
Stord,5,1,2,2,7,10,-3,5,norway9,0.2,0.6,-3,1.4,1.0,5.0,1.67,6
Staal Jorpeland,5,1,1,3,14,17,-3,4,norway9,0.2,0.4,-3,2.8,0.8,5.0,2.5,7
Vag,5,1,0,4,14,16,-2,3,norway9,0.2,0.2,-2,2.8,0.6,5.0,5.0,8
Haugesund B,5,1,0,4,8,14,-6,3,norway9,0.2,0.2,-6,1.6,0.6,5.0,5.0,8
Kvik Halden,5,4,0,1,14,9,5,12,norway10,0.8,0.8,5,2.8,2.4,1.25,1.25,1
Sarpsborg 08 B,5,3,1,1,13,7,6,10,norway10,0.6,0.8,6,2.6,2.0,1.67,1.25,2
Odd B,5,3,0,2,13,9,4,9,norway10,0.6,0.6,4,2.6,1.8,1.67,1.67,3
Orn Horten,5,3,0,2,12,8,4,9,norway10,0.6,0.6,4,2.4,1.8,1.67,1.67,3
Stabaek B,5,3,0,2,8,9,-1,9,norway10,0.6,0.6,-1,1.6,1.8,1.67,1.67,3
Fram,5,2,2,1,13,5,8,8,norway10,0.4,0.8,8,2.6,1.6,2.5,1.25,4
Grei,5,2,2,1,10,9,1,8,norway10,0.4,0.8,1,2.0,1.6,2.5,1.25,4
Oppsal,5,2,1,2,10,9,1,7,norway10,0.4,0.6,1,2.0,1.4,2.5,1.67,5
Fredrikstad B,5,2,1,2,11,12,-1,7,norway10,0.4,0.6,-1,2.2,1.4,2.5,1.67,5
Pors Grenland B,5,2,1,2,8,10,-2,7,norway10,0.4,0.6,-2,1.6,1.4,2.5,1.67,5
Drobak-Frogn,5,1,2,2,6,13,-7,5,norway10,0.2,0.6,-7,1.2,1.0,5.0,1.67,6
Lokomotiv Oslo,5,1,1,3,5,10,-5,4,norway10,0.2,0.4,-5,1.0,0.8,5.0,2.5,7
Flint,5,1,0,4,8,13,-5,3,norway10,0.2,0.2,-5,1.6,0.6,5.0,5.0,8
IF Ready,5,0,1,4,4,12,-8,1,norway10,0.0,0.2,-8,0.8,0.2,0.0,5.0,9
Universitario,8,5,2,1,12,7,5,17,panama,0.62,0.88,5,1.5,2.12,1.61,1.14,1
Plaza Amador,8,4,3,1,12,7,5,15,panama,0.5,0.88,5,1.5,1.88,2.0,1.14,2
Tauro,8,4,2,2,13,8,5,14,panama,0.5,0.75,5,1.62,1.75,2.0,1.33,3
San Francisco,8,4,2,2,12,7,5,14,panama,0.5,0.75,5,1.5,1.75,2.0,1.33,3
Veraguas,8,4,1,3,12,14,-2,13,panama,0.5,0.62,-2,1.5,1.62,2.0,1.61,4
Independiente,8,3,3,2,12,8,4,12,panama,0.38,0.75,4,1.5,1.5,2.63,1.33,5
San Miguelito,8,3,2,3,7,9,-2,11,panama,0.38,0.62,-2,0.88,1.38,2.63,1.61,6
Arabe Unido,8,3,0,5,8,8,0,9,panama,0.38,0.38,0,1.0,1.12,2.63,2.63,7
Alianza,8,2,2,4,8,12,-4,8,panama,0.25,0.5,-4,1.0,1.0,4.0,2.0,8
Herrera,8,1,4,3,8,11,-3,7,panama,0.12,0.62,-3,1.0,0.88,8.33,1.61,9
Costa del Este,8,2,1,5,6,13,-7,7,panama,0.25,0.38,-7,0.75,0.88,4.0,2.63,9
UMECIT,8,1,2,5,6,12,-6,5,panama,0.12,0.38,-6,0.75,0.62,8.33,2.63,10
San Miguelito,8,5,2,1,8,4,4,17,panama2,0.62,0.88,4,1.0,2.12,1.61,1.14,1
Independiente,8,5,1,2,14,11,3,16,panama2,0.62,0.75,3,1.75,2.0,1.61,1.33,2
Plaza Amador,8,4,3,1,9,6,3,15,panama2,0.5,0.88,3,1.12,1.88,2.0,1.14,3
Tauro,8,4,3,1,9,6,3,15,panama2,0.5,0.88,3,1.12,1.88,2.0,1.14,3
Veraguas,8,3,3,2,11,7,4,12,panama2,0.38,0.75,4,1.38,1.5,2.63,1.33,4
Arabe Unido,8,2,5,1,7,6,1,11,panama2,0.25,0.88,1,0.88,1.38,4.0,1.14,5
Universitario,8,3,2,3,6,5,1,11,panama2,0.38,0.62,1,0.75,1.38,2.63,1.61,5
UMECIT,8,3,1,4,8,8,0,10,panama2,0.38,0.5,0,1.0,1.25,2.63,2.0,6
Costa del Este,8,2,3,3,10,15,-5,9,panama2,0.25,0.62,-5,1.25,1.12,4.0,1.61,7
Alianza,8,2,0,6,8,12,-4,6,panama2,0.25,0.25,-4,1.0,0.75,4.0,4.0,8
San Francisco,8,1,2,5,4,10,-6,5,panama2,0.12,0.38,-6,0.5,0.62,8.33,2.63,9
Herrera,8,1,1,6,4,8,-4,4,panama2,0.12,0.25,-4,0.5,0.5,8.33,4.0,10
Guarani,8,5,1,2,12,7,5,16,paraguay,0.62,0.75,5,1.5,2.0,1.61,1.33,1
Cerro Porteno,8,4,2,2,10,6,4,14,paraguay,0.5,0.75,4,1.25,1.75,2.0,1.33,2
Libertad,8,3,4,1,10,5,5,13,paraguay,0.38,0.88,5,1.25,1.62,2.63,1.14,3
Olimpia,8,3,3,2,9,7,2,12,paraguay,0.38,0.75,2,1.12,1.5,2.63,1.33,4
D. Recoleta,8,2,4,2,12,11,1,10,paraguay,0.25,0.75,1,1.5,1.25,4.0,1.33,5
S. Trinidense,8,2,4,2,8,7,1,10,paraguay,0.25,0.75,1,1.0,1.25,4.0,1.33,5
A. Tembetary,8,2,4,2,5,5,0,10,paraguay,0.25,0.75,0,0.62,1.25,4.0,1.33,5
Nacional,8,3,1,4,6,8,-2,10,paraguay,0.38,0.5,-2,0.75,1.25,2.63,2.0,5
S. Ameliano,8,2,3,3,7,6,1,9,paraguay,0.25,0.62,1,0.88,1.12,4.0,1.61,6
S. Luqueno,8,1,5,2,6,8,-2,8,paraguay,0.12,0.75,-2,0.75,1.0,8.33,1.33,7
2 de Mayo,8,1,4,3,6,13,-7,7,paraguay,0.12,0.62,-7,0.75,0.88,8.33,1.61,8
G. Caballero,8,1,3,4,3,11,-8,6,paraguay,0.12,0.5,-8,0.38,0.75,8.33,2.0,9
Universitario,8,6,1,1,23,6,17,19,peru,0.75,0.88,17,2.88,2.38,1.33,1.14,1
Cusco,8,5,1,2,17,9,8,16,peru,0.62,0.75,8,2.12,2.0,1.61,1.33,2
Alianza Lima,8,5,1,2,8,6,2,16,peru,0.62,0.75,2,1.0,2.0,1.61,1.33,2
FBC Melgar,8,4,2,2,14,11,3,14,peru,0.5,0.75,3,1.75,1.75,2.0,1.33,3
D. Garcilaso,8,4,1,3,12,5,7,13,peru,0.5,0.62,7,1.5,1.62,2.0,1.61,4
Alianza A.,8,4,1,3,12,8,4,13,peru,0.5,0.62,4,1.5,1.62,2.0,1.61,4
Sport Huancayo,8,4,1,3,15,13,2,13,peru,0.5,0.62,2,1.88,1.62,2.0,1.61,4
S. Cristal,8,4,0,4,12,10,2,12,peru,0.5,0.5,2,1.5,1.5,2.0,2.0,5
Cienciano,8,3,3,2,11,10,1,12,peru,0.38,0.75,1,1.38,1.5,2.63,1.33,5
ADT,8,3,2,3,10,12,-2,11,peru,0.38,0.62,-2,1.25,1.38,2.63,1.61,6
Cajamarca,8,3,2,3,10,14,-4,11,peru,0.38,0.62,-4,1.25,1.38,2.63,1.61,6
Sport Boys,8,2,4,2,16,16,0,10,peru,0.25,0.75,0,2.0,1.25,4.0,1.33,7
Los Chankas,8,2,3,3,9,10,-1,9,peru,0.25,0.62,-1,1.12,1.12,4.0,1.61,8
Binacional,8,2,2,4,8,16,-8,8,peru,0.25,0.5,-8,1.0,1.0,4.0,2.0,9
Juan Pablo II C,8,2,1,5,9,13,-4,7,peru,0.25,0.38,-4,1.12,0.88,4.0,2.63,10
Atletico Grau,8,1,4,3,11,16,-5,7,peru,0.12,0.62,-5,1.38,0.88,8.33,1.61,10
Comerciantes U.,8,1,3,4,11,17,-6,6,peru,0.12,0.5,-6,1.38,0.75,8.33,2.0,11
A. Huanuco,8,1,2,5,6,16,-10,5,peru,0.12,0.38,-10,0.75,0.62,8.33,2.63,12
Ayacucho,8,0,3,5,4,13,-9,3,peru,0.0,0.38,-9,0.5,0.38,0.0,2.63,13
Manila Digger,8,6,1,1,20,4,16,19,philippines,0.75,0.88,16,2.5,2.38,1.33,1.14,1
Kaya FC,8,6,1,1,16,6,10,19,philippines,0.75,0.88,10,2.0,2.38,1.33,1.14,1
Davao Aguilas,8,4,3,1,12,3,9,15,philippines,0.5,0.88,9,1.5,1.88,2.0,1.14,2
One Taguig,8,4,2,2,16,6,10,14,philippines,0.5,0.75,10,2.0,1.75,2.0,1.33,3
Stallion,8,3,2,3,15,12,3,11,philippines,0.38,0.62,3,1.88,1.38,2.63,1.61,4
DH Cebu,8,3,2,3,11,9,2,11,philippines,0.38,0.62,2,1.38,1.38,2.63,1.61,4
Maharlika,8,3,0,5,9,14,-5,9,philippines,0.38,0.38,-5,1.12,1.12,2.63,2.63,5
PFF Development,8,1,3,4,9,20,-11,6,philippines,0.12,0.5,-11,1.12,0.75,8.33,2.0,6
Mendiola,8,1,1,6,5,37,-32,4,philippines,0.12,0.25,-32,0.62,0.5,8.33,4.0,7
Loyola,8,0,1,7,5,21,-16,1,philippines,0.0,0.12,-16,0.62,0.12,0.0,8.33,8
Rakow C.,8,6,1,1,16,5,11,19,poland,0.75,0.88,11,2.0,2.38,1.33,1.14,1
Lech Poznan,8,5,1,2,21,11,10,16,poland,0.62,0.75,10,2.62,2.0,1.61,1.33,2
Pogon Szczecin,8,4,2,2,17,12,5,14,poland,0.5,0.75,5,2.12,1.75,2.0,1.33,3
Slask Wroclaw,8,4,2,2,16,12,4,14,poland,0.5,0.75,4,2.0,1.75,2.0,1.33,3
Legia Warsaw,8,4,2,2,15,11,4,14,poland,0.5,0.75,4,1.88,1.75,2.0,1.33,3
Korona Kielce,8,4,2,2,12,11,1,14,poland,0.5,0.75,1,1.5,1.75,2.0,1.33,3
Radomiak Radom,8,3,3,2,12,10,2,12,poland,0.38,0.75,2,1.5,1.5,2.63,1.33,4
Lechia Gdansk,8,4,0,4,12,11,1,12,poland,0.5,0.5,1,1.5,1.5,2.0,2.0,4
Katowice,8,4,0,4,10,12,-2,12,poland,0.5,0.5,-2,1.25,1.5,2.0,2.0,4
Widzew Lodz,8,3,2,3,8,6,2,11,poland,0.38,0.62,2,1.0,1.38,2.63,1.61,5
Motor Lublin,8,3,2,3,12,13,-1,11,poland,0.38,0.62,-1,1.5,1.38,2.63,1.61,5
Zaglebie Lubin,8,3,2,3,10,11,-1,11,poland,0.38,0.62,-1,1.25,1.38,2.63,1.61,5
Jagiellonia,8,3,2,3,8,10,-2,11,poland,0.38,0.62,-2,1.0,1.38,2.63,1.61,5
Gornik Zabrze,8,2,3,3,10,8,2,9,poland,0.25,0.62,2,1.25,1.12,4.0,1.61,6
Cracovia Krakow,8,2,1,5,11,17,-6,7,poland,0.25,0.38,-6,1.38,0.88,4.0,2.63,7
Piast Gliwice,8,1,3,4,6,13,-7,6,poland,0.12,0.5,-7,0.75,0.75,8.33,2.0,8
Puszcza Niepolo,8,1,2,5,13,25,-12,5,poland,0.12,0.38,-12,1.62,0.62,8.33,2.63,9
Stal Mielec,8,0,3,5,8,19,-11,3,poland,0.0,0.38,-11,1.0,0.38,0.0,2.63,10
Arka Gdynia,8,6,2,0,13,4,9,20,poland2,0.75,1.0,9,1.62,2.5,1.33,1.0,1
Polonia Warszaw,8,5,2,1,15,8,7,17,poland2,0.62,0.88,7,1.88,2.12,1.61,1.14,2
Tychy,8,5,2,1,12,7,5,17,poland2,0.62,0.88,5,1.5,2.12,1.61,1.14,2
Wisla Krakow,8,5,1,2,12,10,2,16,poland2,0.62,0.75,2,1.5,2.0,1.61,1.33,3
Wisla Plock,8,4,2,2,12,7,5,14,poland2,0.5,0.75,5,1.5,1.75,2.0,1.33,4
Gornik Leczna,8,4,2,2,8,4,4,14,poland2,0.5,0.75,4,1.0,1.75,2.0,1.33,4
T. Nieciecza,8,4,2,2,14,13,1,14,poland2,0.5,0.75,1,1.75,1.75,2.0,1.33,4
Miedz Legnica,8,4,2,2,10,10,0,14,poland2,0.5,0.75,0,1.25,1.75,2.0,1.33,4
Pogon Siedlce,8,3,3,2,12,9,3,12,poland2,0.38,0.75,3,1.5,1.5,2.63,1.33,5
LKS Lodz,8,3,1,4,12,12,0,10,poland2,0.38,0.5,0,1.5,1.25,2.63,2.0,6
Ruch Chorzow,8,3,1,4,11,11,0,10,poland2,0.38,0.5,0,1.38,1.25,2.63,2.0,6
Stalowa Wola,8,2,3,3,12,12,0,9,poland2,0.25,0.62,0,1.5,1.12,4.0,1.61,7
Znicz Pruszkow,8,2,3,3,10,11,-1,9,poland2,0.25,0.62,-1,1.25,1.12,4.0,1.61,7
K. Kolobrzeg,8,2,3,3,7,8,-1,9,poland2,0.25,0.62,-1,0.88,1.12,4.0,1.61,7
Odra Opole,8,2,1,5,8,9,-1,7,poland2,0.25,0.38,-1,1.0,0.88,4.0,2.63,8
Chrobry Glogow,8,1,2,5,11,16,-5,5,poland2,0.12,0.38,-5,1.38,0.62,8.33,2.63,9
Warta Poznan,8,0,1,7,3,14,-11,1,poland2,0.0,0.12,-11,0.38,0.12,0.0,8.33,10
Stal Rzeszow,8,0,1,7,5,22,-17,1,poland2,0.0,0.12,-17,0.62,0.12,0.0,8.33,10
Polonia Bytom,8,6,1,1,21,11,10,19,poland3,0.75,0.88,10,2.62,2.38,1.33,1.14,1
Chojniczanka,8,5,2,1,11,5,6,17,poland3,0.62,0.88,6,1.38,2.12,1.61,1.14,2
Podbeskidzie,8,5,2,1,12,7,5,17,poland3,0.62,0.88,5,1.5,2.12,1.61,1.14,2
Zaglebie L. B,8,5,1,2,16,7,9,16,poland3,0.62,0.75,9,2.0,2.0,1.61,1.33,3
O. Grudziadz,8,5,1,2,12,9,3,16,poland3,0.62,0.75,3,1.5,2.0,1.61,1.33,3
Rekord Bielsko,8,3,4,1,13,9,4,13,poland3,0.38,0.88,4,1.62,1.62,2.63,1.14,4
Pogon Grodzisk,8,4,1,3,14,11,3,13,poland3,0.5,0.62,3,1.75,1.62,2.0,1.61,4
Wisla Pulawy,8,4,0,4,11,16,-5,12,poland3,0.5,0.5,-5,1.38,1.5,2.0,2.0,5
Swit Skolwin,8,3,2,3,18,17,1,11,poland3,0.38,0.62,1,2.25,1.38,2.63,1.61,6
LKS Lodz B,8,3,2,3,11,11,0,11,poland3,0.38,0.62,0,1.38,1.38,2.63,1.61,6
Resovia Rzeszow,8,3,2,3,10,10,0,11,poland3,0.38,0.62,0,1.25,1.38,2.63,1.61,6
Hutnik Krakow,8,3,1,4,9,14,-5,10,poland3,0.38,0.5,-5,1.12,1.25,2.63,2.0,7
Jastrzebie,8,3,0,5,7,8,-1,9,poland3,0.38,0.38,-1,0.88,1.12,2.63,2.63,8
Wieczysta K.,8,2,1,5,10,13,-3,7,poland3,0.25,0.38,-3,1.25,0.88,4.0,2.63,9
Z. Sosnowiec,8,2,1,5,10,13,-3,7,poland3,0.25,0.38,-3,1.25,0.88,4.0,2.63,9
Olimpia Elblag,8,2,1,5,9,16,-7,7,poland3,0.25,0.38,-7,1.12,0.88,4.0,2.63,9
Kalisz,8,2,0,6,8,15,-7,6,poland3,0.25,0.25,-7,1.0,0.75,4.0,4.0,10
SKRA Czestochow,8,2,0,6,6,13,-7,6,poland3,0.25,0.25,-7,0.75,0.75,4.0,4.0,10
Benfica,8,7,1,0,26,8,18,22,portugal,0.88,1.0,18,3.25,2.75,1.14,1.0,1
Sporting CP,8,7,1,0,21,5,16,22,portugal,0.88,1.0,16,2.62,2.75,1.14,1.0,1
Guimaraes,8,6,1,1,14,7,7,19,portugal,0.75,0.88,7,1.75,2.38,1.33,1.14,2
Sporting Braga,8,5,3,0,13,5,8,18,portugal,0.62,1.0,8,1.62,2.25,1.61,1.0,3
FC Porto,8,5,0,3,11,10,1,15,portugal,0.62,0.62,1,1.38,1.88,1.61,1.61,4
Famalicao,8,4,1,3,14,10,4,13,portugal,0.5,0.62,4,1.75,1.62,2.0,1.61,5
Santa Clara,8,3,3,2,7,6,1,12,portugal,0.38,0.75,1,0.88,1.5,2.63,1.33,6
Gil Vicente,8,3,0,5,8,9,-1,9,portugal,0.38,0.38,-1,1.0,1.12,2.63,2.63,7
Arouca,8,2,3,3,7,9,-2,9,portugal,0.25,0.62,-2,0.88,1.12,4.0,1.61,7
Moreirense,8,2,3,3,8,12,-4,9,portugal,0.25,0.62,-4,1.0,1.12,4.0,1.61,7
Boavista,8,3,0,5,7,13,-6,9,portugal,0.38,0.38,-6,0.88,1.12,2.63,2.63,7
Estoril,8,2,2,4,11,13,-2,8,portugal,0.25,0.5,-2,1.38,1.0,4.0,2.0,8
Farense,8,2,2,4,7,9,-2,8,portugal,0.25,0.5,-2,0.88,1.0,4.0,2.0,8
Rio Ave,8,2,1,5,8,12,-4,7,portugal,0.25,0.38,-4,1.0,0.88,4.0,2.63,9
Nacional,8,2,1,5,6,12,-6,7,portugal,0.25,0.38,-6,0.75,0.88,4.0,2.63,9
Estrela Amadora,8,2,1,5,4,10,-6,7,portugal,0.25,0.38,-6,0.5,0.88,4.0,2.63,9
Casa Pia,8,1,3,4,6,12,-6,6,portugal,0.12,0.5,-6,0.75,0.75,8.33,2.0,10
AVS,8,0,1,7,4,23,-19,1,portugal,0.0,0.12,-19,0.5,0.12,0.0,8.33,11
Vizela,8,6,2,0,12,6,6,20,portugal2,0.75,1.0,6,1.5,2.5,1.33,1.0,1
Tondela,8,6,1,1,13,7,6,19,portugal2,0.75,0.88,6,1.62,2.38,1.33,1.14,2
Alverca,8,4,3,1,13,6,7,15,portugal2,0.5,0.88,7,1.62,1.88,2.0,1.14,3
Torreense,8,4,3,1,16,11,5,15,portugal2,0.5,0.88,5,2.0,1.88,2.0,1.14,3
Maritimo,8,3,5,0,10,6,4,14,portugal2,0.38,1.0,4,1.25,1.75,2.63,1.0,4
Uniao de Leiria,8,4,1,3,17,13,4,13,portugal2,0.5,0.62,4,2.12,1.62,2.0,1.61,5
Chaves,8,4,0,4,12,9,3,12,portugal2,0.5,0.5,3,1.5,1.5,2.0,2.0,6
Benfica B,8,3,3,2,11,9,2,12,portugal2,0.38,0.75,2,1.38,1.5,2.63,1.33,6
Felgueiras,8,2,5,1,12,8,4,11,portugal2,0.25,0.88,4,1.5,1.38,4.0,1.14,7
FC Porto B,8,3,2,3,8,7,1,11,portugal2,0.38,0.62,1,1.0,1.38,2.63,1.61,7
Academico Viseu,8,3,2,3,9,9,0,11,portugal2,0.38,0.62,0,1.12,1.38,2.63,1.61,7
Leixoes,8,3,2,3,8,10,-2,11,portugal2,0.38,0.62,-2,1.0,1.38,2.63,1.61,7
Feirense,8,3,1,4,8,9,-1,10,portugal2,0.38,0.5,-1,1.0,1.25,2.63,2.0,8
Mafra,8,2,1,5,8,14,-6,7,portugal2,0.25,0.38,-6,1.0,0.88,4.0,2.63,9
Oliveirense,8,2,1,5,7,20,-13,7,portugal2,0.25,0.38,-13,0.88,0.88,4.0,2.63,9
Portimonense,8,1,2,5,10,14,-4,5,portugal2,0.12,0.38,-4,1.25,0.62,8.33,2.63,10
Penafiel,8,1,0,7,7,15,-8,3,portugal2,0.12,0.12,-8,0.88,0.38,8.33,8.33,11
Pacos Ferreira,8,1,0,7,5,13,-8,3,portugal2,0.12,0.12,-8,0.62,0.38,8.33,8.33,11
Al Sadd,8,8,0,0,25,1,24,24,qatar,1.0,1.0,24,3.12,3.0,1.0,1.0,1
Al Duhail,8,6,0,2,12,9,3,18,qatar,0.75,0.75,3,1.5,2.25,1.33,1.33,2
Al Rayyan,8,5,0,3,20,10,10,15,qatar,0.62,0.62,10,2.5,1.88,1.61,1.61,3
Al Shamal,8,4,1,3,15,9,6,13,qatar,0.5,0.62,6,1.88,1.62,2.0,1.61,4
Al Gharafa,8,4,1,3,12,13,-1,13,qatar,0.5,0.62,-1,1.5,1.62,2.0,1.61,4
Al Arabi,8,3,1,4,11,13,-2,10,qatar,0.38,0.5,-2,1.38,1.25,2.63,2.0,5
Al Shahaniya,8,3,1,4,11,18,-7,10,qatar,0.38,0.5,-7,1.38,1.25,2.63,2.0,5
Al Wakrah,8,2,2,4,6,13,-7,8,qatar,0.25,0.5,-7,0.75,1.0,4.0,2.0,6
Qatar SC,8,1,4,3,9,11,-2,7,qatar,0.12,0.62,-2,1.12,0.88,8.33,1.61,7
Umm Salal,8,2,1,5,7,11,-4,7,qatar,0.25,0.38,-4,0.88,0.88,4.0,2.63,7
Al Ahli Doha,8,2,1,5,9,20,-11,7,qatar,0.25,0.38,-11,1.12,0.88,4.0,2.63,7
Al Khor,8,2,0,6,9,18,-9,6,qatar,0.25,0.25,-9,1.12,0.75,4.0,4.0,8
CFR Cluj,8,5,3,0,19,5,14,18,romania,0.62,1.0,14,2.38,2.25,1.61,1.0,1
FCSB,8,5,3,0,10,2,8,18,romania,0.62,1.0,8,1.25,2.25,1.61,1.0,1
Univ. Craiova,8,5,1,2,11,6,5,16,romania,0.62,0.75,5,1.38,2.0,1.61,1.33,2
Din. Bucharest,8,4,2,2,10,6,4,14,romania,0.5,0.75,4,1.25,1.75,2.0,1.33,3
Rapid Bucharest,8,4,2,2,9,6,3,14,romania,0.5,0.75,3,1.12,1.75,2.0,1.33,3
Hermannstadt,8,4,2,2,9,7,2,14,romania,0.5,0.75,2,1.12,1.75,2.0,1.33,3
U. Cluj,8,3,3,2,9,8,1,12,romania,0.38,0.75,1,1.12,1.5,2.63,1.33,4
Botosani,8,3,3,2,8,7,1,12,romania,0.38,0.75,1,1.0,1.5,2.63,1.33,4
Sepsi OSK,8,3,2,3,8,9,-1,11,romania,0.38,0.62,-1,1.0,1.38,2.63,1.61,5
Farul Constanta,8,3,1,4,8,10,-2,10,romania,0.38,0.5,-2,1.0,1.25,2.63,2.0,6
P. Iasi,8,2,3,3,8,12,-4,9,romania,0.25,0.62,-4,1.0,1.12,4.0,1.61,7
Petrolul,8,2,2,4,6,8,-2,8,romania,0.25,0.5,-2,0.75,1.0,4.0,2.0,8
UTA Arad,8,2,2,4,5,10,-5,8,romania,0.25,0.5,-5,0.62,1.0,4.0,2.0,8
Otelul,8,2,1,5,7,11,-4,7,romania,0.25,0.38,-4,0.88,0.88,4.0,2.63,9
FC Buzau,8,1,1,6,6,16,-10,4,romania,0.12,0.25,-10,0.75,0.5,8.33,4.0,10
Unirea Slobozia,8,0,1,7,4,14,-10,1,romania,0.0,0.12,-10,0.5,0.12,0.0,8.33,11
FC Krasnodar,8,7,0,1,19,8,11,21,russia,0.88,0.88,11,2.38,2.62,1.14,1.14,1
CSKA Moscow,8,6,2,0,14,5,9,20,russia,0.75,1.0,9,1.75,2.5,1.33,1.0,2
Zenit,8,5,2,1,16,6,10,17,russia,0.62,0.88,10,2.0,2.12,1.61,1.14,3
Dinamo Moscow,8,4,2,2,19,10,9,14,russia,0.5,0.75,9,2.38,1.75,2.0,1.33,4
Rubin Kazan,8,4,1,3,9,12,-3,13,russia,0.5,0.62,-3,1.12,1.62,2.0,1.61,5
Spartak Moscow,8,3,2,3,11,9,2,11,russia,0.38,0.62,2,1.38,1.38,2.63,1.61,6
Krylya Sovetov,8,3,2,3,13,13,0,11,russia,0.38,0.62,0,1.62,1.38,2.63,1.61,6
Rostov,8,3,2,3,10,11,-1,11,russia,0.38,0.62,-1,1.25,1.38,2.63,1.61,6
Akron,8,3,1,4,11,11,0,10,russia,0.38,0.5,0,1.38,1.25,2.63,2.0,7
Lokomotiv M.,8,2,4,2,10,11,-1,10,russia,0.25,0.75,-1,1.25,1.25,4.0,1.33,7
Orenburg,8,3,1,4,8,14,-6,10,russia,0.38,0.5,-6,1.0,1.25,2.63,2.0,7
Makhachkala,8,3,0,5,13,14,-1,9,russia,0.38,0.38,-1,1.62,1.12,2.63,2.63,8
Akhmat Grozny,8,1,5,2,6,8,-2,8,russia,0.12,0.75,-2,0.75,1.0,8.33,1.33,9
Khimki,8,1,3,4,8,13,-5,6,russia,0.12,0.5,-5,1.0,0.75,8.33,2.0,10
Nizhny Novgorod,8,1,1,6,4,14,-10,4,russia,0.12,0.25,-10,0.5,0.5,8.33,4.0,11
Fakel Voronezh,8,0,2,6,1,13,-12,2,russia,0.0,0.25,-12,0.12,0.25,0.0,4.0,12
Baltika,8,6,1,1,21,5,16,19,russia2,0.75,0.88,16,2.62,2.38,1.33,1.14,1
Rodina Moskva,8,6,1,1,15,5,10,19,russia2,0.75,0.88,10,1.88,2.38,1.33,1.14,1
Chernomorets,8,5,2,1,14,6,8,17,russia2,0.62,0.88,8,1.75,2.12,1.61,1.14,2
PFC Sochi,8,5,0,3,16,9,7,15,russia2,0.62,0.62,7,2.0,1.88,1.61,1.61,3
Torpedo Moscow,8,4,2,2,9,6,3,14,russia2,0.5,0.75,3,1.12,1.75,2.0,1.33,4
Shinnik,8,4,1,3,9,9,0,13,russia2,0.5,0.62,0,1.12,1.62,2.0,1.61,5
Rotor Volgograd,8,3,3,2,10,7,3,12,russia2,0.38,0.75,3,1.25,1.5,2.63,1.33,6
SKA Khabarovsk,8,4,0,4,8,8,0,12,russia2,0.5,0.5,0,1.0,1.5,2.0,2.0,6
Ural,8,3,3,2,12,13,-1,12,russia2,0.38,0.75,-1,1.5,1.5,2.63,1.33,6
Yenisey,8,3,2,3,6,9,-3,11,russia2,0.38,0.62,-3,0.75,1.38,2.63,1.61,7
Tyumen,8,3,1,4,8,9,-1,10,russia2,0.38,0.5,-1,1.0,1.25,2.63,2.0,8
Ufa,8,3,1,4,5,12,-7,10,russia2,0.38,0.5,-7,0.62,1.25,2.63,2.0,8
Kamaz,8,2,2,4,6,8,-2,8,russia2,0.25,0.5,-2,0.75,1.0,4.0,2.0,9
A. Vladikavkaz,8,2,1,5,10,18,-8,7,russia2,0.25,0.38,-8,1.25,0.88,4.0,2.63,10
Sokol Saratov,8,1,3,4,7,10,-3,6,russia2,0.12,0.5,-3,0.88,0.75,8.33,2.0,11
Arsenal Tula,8,1,3,4,4,10,-6,6,russia2,0.12,0.5,-6,0.5,0.75,8.33,2.0,11
Neftekhimik,8,1,2,5,5,10,-5,5,russia2,0.12,0.38,-5,0.62,0.62,8.33,2.63,12
Chayka,8,1,2,5,3,14,-11,5,russia2,0.12,0.38,-11,0.38,0.62,8.33,2.63,12
Al Ahli Jeddah,8,5,2,1,20,10,10,17,saudiarabia,0.62,0.88,10,2.5,2.12,1.61,1.14,1
Al Wahda,8,5,1,2,13,8,5,16,saudiarabia,0.62,0.75,5,1.62,2.0,1.61,1.33,2
Al Shabab,8,4,3,1,18,8,10,15,saudiarabia,0.5,0.88,10,2.25,1.88,2.0,1.14,3
Al Ittihad,8,4,3,1,14,11,3,15,saudiarabia,0.5,0.88,3,1.75,1.88,2.0,1.14,3
Al Fateh,8,4,2,2,18,10,8,14,saudiarabia,0.5,0.75,8,2.25,1.75,2.0,1.33,4
Al Hilal,8,4,2,2,18,12,6,14,saudiarabia,0.5,0.75,6,2.25,1.75,2.0,1.33,4
Al Nassr,8,4,1,3,17,14,3,13,saudiarabia,0.5,0.62,3,2.12,1.62,2.0,1.61,5
Al Taawon,8,4,1,3,12,11,1,13,saudiarabia,0.5,0.62,1,1.5,1.62,2.0,1.61,5
Al Quadisiya,8,3,3,2,11,8,3,12,saudiarabia,0.38,0.75,3,1.38,1.5,2.63,1.33,6
Al Akhdoud,8,3,3,2,7,6,1,12,saudiarabia,0.38,0.75,1,0.88,1.5,2.63,1.33,6
Al Ittifaq,8,3,3,2,10,10,0,12,saudiarabia,0.38,0.75,0,1.25,1.5,2.63,1.33,6
Al Feiha,8,3,3,2,9,12,-3,12,saudiarabia,0.38,0.75,-3,1.12,1.5,2.63,1.33,6
Damak,8,2,1,5,7,12,-5,7,saudiarabia,0.25,0.38,-5,0.88,0.88,4.0,2.63,7
Al Orubah,8,2,1,5,9,20,-11,7,saudiarabia,0.25,0.38,-11,1.12,0.88,4.0,2.63,7
Al Kholood,8,2,0,6,7,17,-10,6,saudiarabia,0.25,0.25,-10,0.88,0.75,4.0,4.0,8
Al Riyadh,8,1,2,5,7,12,-5,5,saudiarabia,0.12,0.38,-5,0.88,0.62,8.33,2.63,9
Al Khaleej,8,1,2,5,8,18,-10,5,saudiarabia,0.12,0.38,-10,1.0,0.62,8.33,2.63,9
Al Raed,8,1,1,6,14,20,-6,4,saudiarabia,0.12,0.25,-6,1.75,0.5,8.33,4.0,10
Neom SC,8,7,1,0,27,5,22,22,saudiarabia2,0.88,1.0,22,3.38,2.75,1.14,1.0,1
Al Bukayriyah,8,6,1,1,13,4,9,19,saudiarabia2,0.75,0.88,9,1.62,2.38,1.33,1.14,2
Al Najma,8,5,1,2,12,7,5,16,saudiarabia2,0.62,0.75,5,1.5,2.0,1.61,1.33,3
Al Batin,8,5,1,2,15,15,0,16,saudiarabia2,0.62,0.75,0,1.88,2.0,1.61,1.33,3
Al Jabalain,8,4,2,2,15,10,5,14,saudiarabia2,0.5,0.75,5,1.88,1.75,2.0,1.33,4
Al Zulfi,8,4,2,2,10,8,2,14,saudiarabia2,0.5,0.75,2,1.25,1.75,2.0,1.33,4
Abha,8,3,4,1,13,9,4,13,saudiarabia2,0.38,0.88,4,1.62,1.62,2.63,1.14,5
Al Tai,8,4,0,4,16,11,5,12,saudiarabia2,0.5,0.5,5,2.0,1.5,2.0,2.0,6
Al Jubail,8,3,3,2,8,10,-2,12,saudiarabia2,0.38,0.75,-2,1.0,1.5,2.63,1.33,6
Al Adalha,8,3,2,3,14,13,1,11,saudiarabia2,0.38,0.62,1,1.75,1.38,2.63,1.61,7
Al Hazm,8,3,2,3,10,11,-1,11,saudiarabia2,0.38,0.62,-1,1.25,1.38,2.63,1.61,7
Al Faisaly,8,2,3,3,9,12,-3,9,saudiarabia2,0.25,0.62,-3,1.12,1.12,4.0,1.61,8
Ohod,8,2,2,4,9,12,-3,8,saudiarabia2,0.25,0.5,-3,1.12,1.0,4.0,2.0,9
Jeddah,8,1,4,3,5,12,-7,7,saudiarabia2,0.12,0.62,-7,0.62,0.88,8.33,1.61,10
Al Ain,8,1,3,4,7,13,-6,6,saudiarabia2,0.12,0.5,-6,0.88,0.75,8.33,2.0,11
Al Arabi,8,1,1,6,10,20,-10,4,saudiarabia2,0.12,0.25,-10,1.25,0.5,8.33,4.0,12
Al Safa,8,0,3,5,8,20,-12,3,saudiarabia2,0.0,0.38,-12,1.0,0.38,0.0,2.63,13
Al Jandal,8,0,1,7,3,12,-9,1,saudiarabia2,0.0,0.12,-9,0.38,0.12,0.0,8.33,14
Hibernian,8,6,1,1,18,5,13,19,scotland,0.75,0.88,13,2.25,2.38,1.33,1.14,1
Celtic,8,5,1,2,26,9,17,16,scotland,0.62,0.75,17,3.25,2.0,1.61,1.33,2
Motherwell,8,4,2,2,12,13,-1,14,scotland,0.5,0.75,-1,1.5,1.75,2.0,1.33,3
Rangers,8,3,3,2,17,16,1,12,scotland,0.38,0.75,1,2.12,1.5,2.63,1.33,4
Aberdeen,8,3,3,2,11,11,0,12,scotland,0.38,0.75,0,1.38,1.5,2.63,1.33,4
St. Mirren,8,3,2,3,16,17,-1,11,scotland,0.38,0.62,-1,2.0,1.38,2.63,1.61,5
Hearts,8,3,1,4,9,9,0,10,scotland,0.38,0.5,0,1.12,1.25,2.63,2.0,6
Dundee FC,8,3,1,4,13,15,-2,10,scotland,0.38,0.5,-2,1.62,1.25,2.63,2.0,6
Kilmarnock,8,3,1,4,11,16,-5,10,scotland,0.38,0.5,-5,1.38,1.25,2.63,2.0,6
Dundee Utd,8,3,1,4,9,17,-8,10,scotland,0.38,0.5,-8,1.12,1.25,2.63,2.0,6
St. Johnstone,8,2,2,4,5,10,-5,8,scotland,0.25,0.5,-5,0.62,1.0,4.0,2.0,7
Ross County,8,1,0,7,4,13,-9,3,scotland,0.12,0.12,-9,0.5,0.38,8.33,8.33,8
Livingston,8,5,1,2,17,6,11,16,scotland2,0.62,0.75,11,2.12,2.0,1.61,1.33,1
Raith Rovers,8,4,4,0,17,7,10,16,scotland2,0.5,1.0,10,2.12,2.0,2.0,1.0,1
Partick Thistle,8,4,2,2,8,5,3,14,scotland2,0.5,0.75,3,1.0,1.75,2.0,1.33,2
Falkirk,8,4,1,3,17,8,9,13,scotland2,0.5,0.62,9,2.12,1.62,2.0,1.61,3
Greenock Morton,8,3,2,3,10,13,-3,11,scotland2,0.38,0.62,-3,1.25,1.38,2.63,1.61,4
Airdrieonians,8,2,3,3,11,9,2,9,scotland2,0.25,0.62,2,1.38,1.12,4.0,1.61,5
Ayr Utd,8,2,3,3,8,12,-4,9,scotland2,0.25,0.62,-4,1.0,1.12,4.0,1.61,5
Dunfermline,8,2,2,4,2,8,-6,8,scotland2,0.25,0.5,-6,0.25,1.0,4.0,2.0,6
Hamilton,8,2,2,4,5,13,-8,8,scotland2,0.25,0.5,-8,0.62,1.0,4.0,2.0,6
Queens Park,8,0,2,6,4,22,-18,2,scotland2,0.0,0.25,-18,0.5,0.25,0.0,4.0,7
Queen of South,8,6,2,0,17,6,11,20,scotland3,0.75,1.0,11,2.12,2.5,1.33,1.0,1
Dumbarton,8,3,3,2,17,11,6,12,scotland3,0.38,0.75,6,2.12,1.5,2.63,1.33,2
Arbroath,8,3,3,2,10,11,-1,12,scotland3,0.38,0.75,-1,1.25,1.5,2.63,1.33,2
Alloa Athletic,8,3,2,3,14,12,2,11,scotland3,0.38,0.62,2,1.75,1.38,2.63,1.61,3
Inverness,8,3,2,3,11,9,2,11,scotland3,0.38,0.62,2,1.38,1.38,2.63,1.61,3
Cove Rangers,8,2,4,2,12,12,0,10,scotland3,0.25,0.75,0,1.5,1.25,4.0,1.33,4
Annan Athletic,8,3,0,5,12,15,-3,9,scotland3,0.38,0.38,-3,1.5,1.12,2.63,2.63,5
Kelty Hearts,8,2,3,3,9,15,-6,9,scotland3,0.25,0.62,-6,1.12,1.12,4.0,1.61,5
Montrose,8,2,2,4,12,14,-2,8,scotland3,0.25,0.5,-2,1.5,1.0,4.0,2.0,6
Stenhousemuir,8,1,3,4,6,15,-9,6,scotland3,0.12,0.5,-9,0.75,0.75,8.33,2.0,7
Peterhead,8,5,1,2,12,11,1,16,scotland4,0.62,0.75,1,1.5,2.0,1.61,1.33,1
Elgin City,8,5,0,3,12,7,5,15,scotland4,0.62,0.62,5,1.5,1.88,1.61,1.61,2
Clyde,8,4,1,3,17,11,6,13,scotland4,0.5,0.62,6,2.12,1.62,2.0,1.61,3
Spartans,8,4,0,4,13,11,2,12,scotland4,0.5,0.5,2,1.62,1.5,2.0,2.0,4
East Fife,8,4,0,4,12,12,0,12,scotland4,0.5,0.5,0,1.5,1.5,2.0,2.0,4
Stirling Albion,8,3,2,3,10,11,-1,11,scotland4,0.38,0.62,-1,1.25,1.38,2.63,1.61,5
Edinburgh City,8,3,1,4,11,12,-1,10,scotland4,0.38,0.5,-1,1.38,1.25,2.63,2.0,6
Forfar Athletic,8,2,4,2,3,5,-2,10,scotland4,0.25,0.75,-2,0.38,1.25,4.0,1.33,6
Bonnyrigg Rose,8,3,1,4,7,13,-6,10,scotland4,0.38,0.5,-6,0.88,1.25,2.63,2.0,6
Stranraer,8,2,0,6,8,12,-4,6,scotland4,0.25,0.25,-4,1.0,0.75,4.0,4.0,7
Red Star,8,7,0,1,23,13,10,21,serbia,0.88,0.88,10,2.88,2.62,1.14,1.14,1
Vojvodina,8,5,0,3,14,14,0,15,serbia,0.62,0.62,0,1.75,1.88,1.61,1.61,2
IMT N. Beograd,8,4,2,2,13,8,5,14,serbia,0.5,0.75,5,1.62,1.75,2.0,1.33,3
Partizan,8,4,2,2,13,9,4,14,serbia,0.5,0.75,4,1.62,1.75,2.0,1.33,3
Backa Topola,8,4,1,3,13,9,4,13,serbia,0.5,0.62,4,1.62,1.62,2.0,1.61,4
Novi Pazar,8,3,3,2,13,11,2,12,serbia,0.38,0.75,2,1.62,1.5,2.63,1.33,5
Z. Pancevo,8,4,0,4,10,10,0,12,serbia,0.5,0.5,0,1.25,1.5,2.0,2.0,5
OFK Beograd,8,3,1,4,16,15,1,10,serbia,0.38,0.5,1,2.0,1.25,2.63,2.0,6
Radnicki Nis,8,2,4,2,11,13,-2,10,serbia,0.25,0.75,-2,1.38,1.25,4.0,1.33,6
Napredak,8,3,1,4,7,9,-2,10,serbia,0.38,0.5,-2,0.88,1.25,2.63,2.0,6
T. Odzaci,8,3,0,5,7,11,-4,9,serbia,0.38,0.38,-4,0.88,1.12,2.63,2.63,7
S. Subotica,8,2,2,4,7,9,-2,8,serbia,0.25,0.5,-2,0.88,1.0,4.0,2.0,8
Jedinstvo U.,8,2,2,4,8,11,-3,8,serbia,0.25,0.5,-3,1.0,1.0,4.0,2.0,8
Cukaricki,8,2,2,4,7,12,-5,8,serbia,0.25,0.5,-5,0.88,1.0,4.0,2.0,8
Mladost Lucani,8,1,4,3,7,12,-5,7,serbia,0.12,0.62,-5,0.88,0.88,8.33,1.61,9
Radnicki 1923,8,1,2,5,9,16,-7,5,serbia,0.12,0.38,-7,1.12,0.62,8.33,2.63,10
R. Surdulica,8,6,1,1,20,7,13,19,serbia2,0.75,0.88,13,2.5,2.38,1.33,1.14,1
Dubocica,8,5,0,3,14,9,5,15,serbia2,0.62,0.62,5,1.75,1.88,1.61,1.61,2
Vozdovac,8,4,3,1,10,6,4,15,serbia2,0.5,0.88,4,1.25,1.88,2.0,1.14,2
Graficar,8,3,4,1,13,11,2,13,serbia2,0.38,0.88,2,1.62,1.62,2.63,1.14,3
S. Mitrovica,8,3,3,2,8,4,4,12,serbia2,0.38,0.75,4,1.0,1.5,2.63,1.33,4
Trajal Krusevac,8,3,3,2,11,8,3,12,serbia2,0.38,0.75,3,1.38,1.5,2.63,1.33,4
Sloven Ruma,8,3,3,2,9,8,1,12,serbia2,0.38,0.75,1,1.12,1.5,2.63,1.33,4
Mladost,8,3,2,3,10,12,-2,11,serbia2,0.38,0.62,-2,1.25,1.38,2.63,1.61,5
Macva Sabac,8,3,2,3,6,10,-4,11,serbia2,0.38,0.62,-4,0.75,1.38,2.63,1.61,5
Javor Ivanjica,8,3,1,4,8,10,-2,10,serbia2,0.38,0.5,-2,1.0,1.25,2.63,2.0,6
Sloboda Uzice,8,3,0,5,5,10,-5,9,serbia2,0.38,0.38,-5,0.62,1.12,2.63,2.63,7
Smederevo,8,2,2,4,9,11,-2,8,serbia2,0.25,0.5,-2,1.12,1.0,4.0,2.0,8
Zemun,8,2,2,4,9,13,-4,8,serbia2,0.25,0.5,-4,1.12,1.0,4.0,2.0,8
Borac Cacak,8,2,1,5,11,14,-3,7,serbia2,0.25,0.38,-3,1.38,0.88,4.0,2.63,9
Vrsac,8,1,3,4,4,11,-7,6,serbia2,0.12,0.5,-7,0.5,0.75,8.33,2.0,10
Indija,8,1,2,5,8,14,-6,5,serbia2,0.12,0.38,-6,1.0,0.62,8.33,2.63,11
Tampines Rovers,8,6,0,2,19,5,14,18,singapore,0.75,0.75,14,2.38,2.25,1.33,1.33,1
Lion City,8,5,2,1,22,6,16,17,singapore,0.62,0.88,16,2.75,2.12,1.61,1.14,2
Khalsa,8,5,1,2,18,18,0,16,singapore,0.62,0.75,0,2.25,2.0,1.61,1.33,3
DPMM FC,8,4,2,2,13,8,5,14,singapore,0.5,0.75,5,1.62,1.75,2.0,1.33,4
Geylang,8,3,1,4,19,18,1,10,singapore,0.38,0.5,1,2.38,1.25,2.63,2.0,5
Hougang,8,2,2,4,15,18,-3,8,singapore,0.25,0.5,-3,1.88,1.0,4.0,2.0,6
A. Niigata (S),8,2,2,4,7,12,-5,8,singapore,0.25,0.5,-5,0.88,1.0,4.0,2.0,6
Tanjong Pagar,8,1,2,5,10,19,-9,5,singapore,0.12,0.38,-9,1.25,0.62,8.33,2.63,7
Young Lions,8,0,4,4,7,25,-18,4,singapore,0.0,0.5,-18,0.88,0.5,0.0,2.0,8
S. Bratislava,8,5,2,1,22,13,9,17,slovakia,0.62,0.88,9,2.75,2.12,1.61,1.14,1
Skalica,8,5,1,2,12,7,5,16,slovakia,0.62,0.75,5,1.5,2.0,1.61,1.33,2
Komarno,8,4,2,2,6,4,2,14,slovakia,0.5,0.75,2,0.75,1.75,2.0,1.33,3
DAC Streda,8,3,4,1,14,12,2,13,slovakia,0.38,0.88,2,1.75,1.62,2.63,1.14,4
Trencin,8,3,3,2,13,12,1,12,slovakia,0.38,0.75,1,1.62,1.5,2.63,1.33,5
FC Kosice,8,3,3,2,11,10,1,12,slovakia,0.38,0.75,1,1.38,1.5,2.63,1.33,5
Ruzomberok,8,3,1,4,10,10,0,10,slovakia,0.38,0.5,0,1.25,1.25,2.63,2.0,6
Z. Michalovce,8,3,1,4,13,15,-2,10,slovakia,0.38,0.5,-2,1.62,1.25,2.63,2.0,6
Zilina,8,2,3,3,11,16,-5,9,slovakia,0.25,0.62,-5,1.38,1.12,4.0,1.61,7
Podbrezova,8,1,4,3,7,9,-2,7,slovakia,0.12,0.62,-2,0.88,0.88,8.33,1.61,8
Spartak Trnava,8,1,2,5,10,15,-5,5,slovakia,0.12,0.38,-5,1.25,0.62,8.33,2.63,9
Banska Bystrica,8,1,2,5,10,16,-6,5,slovakia,0.12,0.38,-6,1.25,0.62,8.33,2.63,9
Zlate Moravce,8,7,1,0,19,4,15,22,slovakia2,0.88,1.0,15,2.38,2.75,1.14,1.0,1
Presov,8,7,0,1,14,4,10,21,slovakia2,0.88,0.88,10,1.75,2.62,1.14,1.14,2
Puchov,8,4,2,2,16,11,5,14,slovakia2,0.5,0.75,5,2.0,1.75,2.0,1.33,3
Zvolen,8,4,1,3,14,9,5,13,slovakia2,0.5,0.62,5,1.75,1.62,2.0,1.61,4
Petrzalka,8,3,4,1,12,8,4,13,slovakia2,0.38,0.88,4,1.5,1.62,2.63,1.14,4
P. Bystrica,8,3,3,2,9,8,1,12,slovakia2,0.38,0.75,1,1.12,1.5,2.63,1.33,5
Samorin,8,3,1,4,6,9,-3,10,slovakia2,0.38,0.5,-3,0.75,1.25,2.63,2.0,6
Zilina B,8,3,1,4,9,13,-4,10,slovakia2,0.38,0.5,-4,1.12,1.25,2.63,2.0,6
L. Mikulas,8,2,3,3,11,9,2,9,slovakia2,0.25,0.62,2,1.38,1.12,4.0,1.61,7
S. Bratislava B,8,2,3,3,12,14,-2,9,slovakia2,0.25,0.62,-2,1.5,1.12,4.0,1.61,7
Humenne,8,2,2,4,5,13,-8,8,slovakia2,0.25,0.5,-8,0.62,1.0,4.0,2.0,8
S. Lubovna,8,2,1,5,6,11,-5,7,slovakia2,0.25,0.38,-5,0.75,0.88,4.0,2.63,9
Pohronie,8,1,1,6,7,16,-9,4,slovakia2,0.12,0.25,-9,0.88,0.5,8.33,4.0,10
Malzenice,8,1,1,6,6,17,-11,4,slovakia2,0.12,0.25,-11,0.75,0.5,8.33,4.0,10
Koper,8,5,3,0,16,5,11,18,slovenia,0.62,1.0,11,2.0,2.25,1.61,1.0,1
NK Celje,8,5,3,0,18,8,10,18,slovenia,0.62,1.0,10,2.25,2.25,1.61,1.0,1
NK Olimpija,8,4,3,1,16,7,9,15,slovenia,0.5,0.88,9,2.0,1.88,2.0,1.14,2
Maribor,8,4,3,1,15,8,7,15,slovenia,0.5,0.88,7,1.88,1.88,2.0,1.14,2
Radomlje,8,3,1,4,11,16,-5,10,slovenia,0.38,0.5,-5,1.38,1.25,2.63,2.0,3
Domzale,8,2,2,4,8,12,-4,8,slovenia,0.25,0.5,-4,1.0,1.0,4.0,2.0,4
Primorje,8,1,4,3,9,15,-6,7,slovenia,0.12,0.62,-6,1.12,0.88,8.33,1.61,5
Nafta,8,1,3,4,12,19,-7,6,slovenia,0.12,0.5,-7,1.5,0.75,8.33,2.0,6
Bravo,8,1,3,4,7,14,-7,6,slovenia,0.12,0.5,-7,0.88,0.75,8.33,2.0,6
Mura,8,1,1,6,8,15,-7,4,slovenia,0.12,0.25,-7,1.0,0.5,8.33,4.0,7
Mamelodi S.,8,6,1,1,17,5,12,19,southafrica,0.75,0.88,12,2.12,2.38,1.33,1.14,1
Stellenbosch,8,5,2,1,9,3,6,17,southafrica,0.62,0.88,6,1.12,2.12,1.61,1.14,2
Magesi,8,5,1,2,8,5,3,16,southafrica,0.62,0.75,3,1.0,2.0,1.61,1.33,3
Orlando Pirates,8,5,1,2,8,6,2,16,southafrica,0.62,0.75,2,1.0,2.0,1.61,1.33,3
Sekhukhune,8,4,2,2,11,8,3,14,southafrica,0.5,0.75,3,1.38,1.75,2.0,1.33,4
Marumo G.,8,4,2,2,10,7,3,14,southafrica,0.5,0.75,3,1.25,1.75,2.0,1.33,4
Richards Bay,8,4,0,4,7,9,-2,12,southafrica,0.5,0.5,-2,0.88,1.5,2.0,2.0,5
SuperSport Utd,8,2,4,2,9,7,2,10,southafrica,0.25,0.75,2,1.12,1.25,4.0,1.33,6
TS Galaxy,8,2,3,3,10,10,0,9,southafrica,0.25,0.62,0,1.25,1.12,4.0,1.61,7
AmaZulu,8,2,2,4,5,8,-3,8,southafrica,0.25,0.5,-3,0.62,1.0,4.0,2.0,8
Golden Arrows,8,2,2,4,5,9,-4,8,southafrica,0.25,0.5,-4,0.62,1.0,4.0,2.0,8
Chippa Utd,8,2,2,4,4,8,-4,8,southafrica,0.25,0.5,-4,0.5,1.0,4.0,2.0,8
Polokwane,8,1,3,4,6,10,-4,6,southafrica,0.12,0.5,-4,0.75,0.75,8.33,2.0,9
Kaizer Chiefs,8,1,3,4,5,9,-4,6,southafrica,0.12,0.5,-4,0.62,0.75,8.33,2.0,9
Royal AM,8,1,2,5,9,13,-4,5,southafrica,0.12,0.38,-4,1.12,0.62,8.33,2.63,10
Cape Town City,8,0,3,5,2,9,-7,3,southafrica,0.0,0.38,-7,0.25,0.38,0.0,2.63,11
Black Leopards,8,5,2,1,13,7,6,17,southafrica2,0.62,0.88,6,1.62,2.12,1.61,1.14,1
Durban City,8,4,3,1,10,3,7,15,southafrica2,0.5,0.88,7,1.25,1.88,2.0,1.14,2
Casric Stars,8,4,3,1,12,6,6,15,southafrica2,0.5,0.88,6,1.5,1.88,2.0,1.14,2
Orbit College,8,4,3,1,8,3,5,15,southafrica2,0.5,0.88,5,1.0,1.88,2.0,1.14,2
Kruger United,8,4,2,2,8,8,0,14,southafrica2,0.5,0.75,0,1.0,1.75,2.0,1.33,3
Venda FC,8,3,3,2,9,6,3,12,southafrica2,0.38,0.75,3,1.12,1.5,2.63,1.33,4
Pretoria U.,8,3,3,2,8,7,1,12,southafrica2,0.38,0.75,1,1.0,1.5,2.63,1.33,4
Cape Town Spurs,8,2,4,2,9,5,4,10,southafrica2,0.25,0.75,4,1.12,1.25,4.0,1.33,5
Milford,8,3,1,4,7,10,-3,10,southafrica2,0.38,0.5,-3,0.88,1.25,2.63,2.0,5
Pretoria C.,8,3,1,4,6,11,-5,10,southafrica2,0.38,0.5,-5,0.75,1.25,2.63,2.0,5
Baroka,8,2,3,3,10,12,-2,9,southafrica2,0.25,0.62,-2,1.25,1.12,4.0,1.61,6
Highbury,8,2,3,3,6,8,-2,9,southafrica2,0.25,0.62,-2,0.75,1.12,4.0,1.61,6
Leruma United,8,1,5,2,8,9,-1,8,southafrica2,0.12,0.75,-1,1.0,1.0,8.33,1.33,7
JDR Stars,8,1,4,3,5,11,-6,7,southafrica2,0.12,0.62,-6,0.62,0.88,8.33,1.61,8
Hungry Lions,8,1,3,4,5,8,-3,6,southafrica2,0.12,0.5,-3,0.62,0.75,8.33,2.0,9
Upington City,8,0,3,5,2,8,-6,3,southafrica2,0.0,0.38,-6,0.25,0.38,0.0,2.63,10
Jeonbuk Motors,8,5,3,0,13,6,7,18,southkorea,0.62,1.0,7,1.62,2.25,1.61,1.0,1
Daejeon Citizen,8,4,3,1,12,9,3,15,southkorea,0.5,0.88,3,1.5,1.88,2.0,1.14,2
Pohang Steelers,8,4,2,2,10,9,1,14,southkorea,0.5,0.75,1,1.25,1.75,2.0,1.33,3
Gimcheon Sangmu,8,4,1,3,9,7,2,13,southkorea,0.5,0.62,2,1.12,1.62,2.0,1.61,4
Gwangju,8,4,1,3,9,10,-1,13,southkorea,0.5,0.62,-1,1.12,1.62,2.0,1.61,4
Ulsan,8,3,2,3,9,8,1,11,southkorea,0.38,0.62,1,1.12,1.38,2.63,1.61,5
Anyang,8,3,1,4,10,9,1,10,southkorea,0.38,0.5,1,1.25,1.25,2.63,2.0,6
Gangwon,8,3,1,4,6,6,0,10,southkorea,0.38,0.5,0,0.75,1.25,2.63,2.0,6
Seoul,8,2,3,3,8,9,-1,9,southkorea,0.25,0.62,-1,1.0,1.12,4.0,1.61,7
Suwon City,8,2,3,3,9,11,-2,9,southkorea,0.25,0.62,-2,1.12,1.12,4.0,1.61,7
Jeju Utd,8,2,1,5,7,13,-6,7,southkorea,0.25,0.38,-6,0.88,0.88,4.0,2.63,8
Daegu,8,1,0,7,8,15,-7,3,southkorea,0.12,0.12,-7,1.0,0.38,8.33,8.33,9
Incheon Utd,8,6,1,1,15,5,10,19,southkorea2,0.75,0.88,10,1.88,2.38,1.33,1.14,1
Busan IPark,8,5,2,1,15,8,7,17,southkorea2,0.62,0.88,7,1.88,2.12,1.61,1.14,2
Seoul E-Land,8,5,1,2,16,11,5,16,southkorea2,0.62,0.75,5,2.0,2.0,1.61,1.33,3
Suwon Bluewings,8,4,3,1,18,12,6,15,southkorea2,0.5,0.88,6,2.25,1.88,2.0,1.14,4
Jeonnam,8,4,3,1,10,7,3,15,southkorea2,0.5,0.88,3,1.25,1.88,2.0,1.14,4
Seongnam,8,3,3,2,8,7,1,12,southkorea2,0.38,0.75,1,1.0,1.5,2.63,1.33,5
Asan,8,2,4,2,8,6,2,10,southkorea2,0.25,0.75,2,1.0,1.25,4.0,1.33,6
Cheongju,8,3,1,4,12,15,-3,10,southkorea2,0.38,0.5,-3,1.5,1.25,2.63,2.0,6
Bucheon FC,8,2,3,3,11,13,-2,9,southkorea2,0.25,0.62,-2,1.38,1.12,4.0,1.61,7
Hwaseong,8,2,2,4,12,15,-3,8,southkorea2,0.25,0.5,-3,1.5,1.0,4.0,2.0,8
Gyeongnam,8,2,2,4,9,12,-3,8,southkorea2,0.25,0.5,-3,1.12,1.0,4.0,2.0,8
Ansan Greeners,8,2,1,5,7,14,-7,7,southkorea2,0.25,0.38,-7,0.88,0.88,4.0,2.63,9
Gimpo,8,1,2,5,7,12,-5,5,southkorea2,0.12,0.38,-5,0.88,0.62,8.33,2.63,10
Cheonan City,8,1,0,7,3,14,-11,3,southkorea2,0.12,0.12,-11,0.38,0.38,8.33,8.33,11
FC Barcelona,8,7,1,0,20,8,12,22,spain,0.88,1.0,12,2.5,2.75,1.14,1.0,1
Real Madrid,8,7,0,1,14,8,6,21,spain,0.88,0.88,6,1.75,2.62,1.14,1.14,2
Real Betis,8,6,1,1,18,9,9,19,spain,0.75,0.88,9,2.25,2.38,1.33,1.14,3
Valencia,8,5,3,0,12,7,5,18,spain,0.62,1.0,5,1.5,2.25,1.61,1.0,4
Villarreal,8,4,2,2,12,11,1,14,spain,0.5,0.75,1,1.5,1.75,2.0,1.33,5
Athletic Bilbao,8,3,4,1,6,3,3,13,spain,0.38,0.88,3,0.75,1.62,2.63,1.14,6
Celta Vigo,8,4,1,3,14,12,2,13,spain,0.5,0.62,2,1.75,1.62,2.0,1.61,6
Alaves,8,3,3,2,6,6,0,12,spain,0.38,0.75,0,0.75,1.5,2.63,1.33,7
Espanyol,8,3,2,3,11,7,4,11,spain,0.38,0.62,4,1.38,1.38,2.63,1.61,8
Atletico Madrid,8,3,2,3,13,11,2,11,spain,0.38,0.62,2,1.62,1.38,2.63,1.61,8
Osasuna,8,3,2,3,10,13,-3,11,spain,0.38,0.62,-3,1.25,1.38,2.63,1.61,8
Getafe,8,3,0,5,10,10,0,9,spain,0.38,0.38,0,1.25,1.12,2.63,2.63,9
Real Sociedad,8,2,3,3,9,10,-1,9,spain,0.25,0.62,-1,1.12,1.12,4.0,1.61,9
Mallorca,8,2,2,4,6,7,-1,8,spain,0.25,0.5,-1,0.75,1.0,4.0,2.0,10
Las Palmas,8,2,2,4,10,12,-2,8,spain,0.25,0.5,-2,1.25,1.0,4.0,2.0,10
Rayo Vallecano,8,2,2,4,8,15,-7,8,spain,0.25,0.5,-7,1.0,1.0,4.0,2.0,10
Girona,8,1,3,4,7,13,-6,6,spain,0.12,0.5,-6,0.88,0.75,8.33,2.0,11
Sevilla FC,8,1,2,5,6,10,-4,5,spain,0.12,0.38,-4,0.75,0.62,8.33,2.63,12
Leganes,8,0,4,4,9,13,-4,4,spain,0.0,0.5,-4,1.12,0.5,0.0,2.0,13
Valladolid,8,0,0,8,8,23,-15,0,spain,0.0,0.0,-15,1.0,0.0,0.0,0.0,14
Elche,8,5,3,0,11,5,6,18,spain2,0.62,1.0,6,1.38,2.25,1.61,1.0,1
Real Oviedo,8,4,3,1,10,5,5,15,spain2,0.5,0.88,5,1.25,1.88,2.0,1.14,2
Almeria,8,5,0,3,17,13,4,15,spain2,0.62,0.62,4,2.12,1.88,1.61,1.61,2
Levante,8,4,2,2,16,11,5,14,spain2,0.5,0.75,5,2.0,1.75,2.0,1.33,3
Albacete,8,4,2,2,15,14,1,14,spain2,0.5,0.75,1,1.88,1.75,2.0,1.33,3
Deportivo,8,3,4,1,14,9,5,13,spain2,0.38,0.88,5,1.75,1.62,2.63,1.14,4
Granada,8,4,1,3,11,8,3,13,spain2,0.5,0.62,3,1.38,1.62,2.0,1.61,4
Tenerife,8,3,4,1,10,7,3,13,spain2,0.38,0.88,3,1.25,1.62,2.63,1.14,4
Racing,8,4,1,3,12,10,2,13,spain2,0.5,0.62,2,1.5,1.62,2.0,1.61,4
Burgos,8,3,3,2,9,7,2,12,spain2,0.38,0.75,2,1.12,1.5,2.63,1.33,5
Cordoba,8,2,5,1,11,9,2,11,spain2,0.25,0.88,2,1.38,1.38,4.0,1.14,6
Mirandes,8,3,2,3,12,13,-1,11,spain2,0.38,0.62,-1,1.5,1.38,2.63,1.61,6
Castellon,8,2,4,2,17,15,2,10,spain2,0.25,0.75,2,2.12,1.25,4.0,1.33,7
Malaga,8,3,1,4,7,8,-1,10,spain2,0.38,0.5,-1,0.88,1.25,2.63,2.0,7
Eibar,8,1,6,1,8,8,0,9,spain2,0.12,0.88,0,1.0,1.12,8.33,1.14,8
Real Zaragoza,8,2,3,3,10,16,-6,9,spain2,0.25,0.62,-6,1.25,1.12,4.0,1.61,8
Cadiz,8,2,2,4,7,10,-3,8,spain2,0.25,0.5,-3,0.88,1.0,4.0,2.0,9
Sporting Gijon,8,2,1,5,12,16,-4,7,spain2,0.25,0.38,-4,1.5,0.88,4.0,2.63,10
Huesca,8,2,1,5,10,14,-4,7,spain2,0.25,0.38,-4,1.25,0.88,4.0,2.63,10
Eldense,8,1,3,4,5,13,-8,6,spain2,0.12,0.5,-8,0.62,0.75,8.33,2.0,11
Cartagena,8,1,2,5,9,14,-5,5,spain2,0.12,0.38,-5,1.12,0.62,8.33,2.63,12
Racing Ferrol,8,1,1,6,3,11,-8,4,spain2,0.12,0.25,-8,0.38,0.5,8.33,4.0,13
Celta Vigo B,8,5,2,1,15,7,8,17,spain3,0.62,0.88,8,1.88,2.12,1.61,1.14,1
Ourense CF,8,5,2,1,10,5,5,17,spain3,0.62,0.88,5,1.25,2.12,1.61,1.14,1
FC Andorra,8,4,3,1,11,5,6,15,spain3,0.5,0.88,6,1.38,1.88,2.0,1.14,2
Ponferradina,8,5,0,3,12,11,1,15,spain3,0.62,0.62,1,1.5,1.88,1.61,1.61,2
FC Barcelona B,8,4,2,2,15,9,6,14,spain3,0.5,0.75,6,1.88,1.75,2.0,1.33,3
Gimnastic T.,8,4,1,3,18,9,9,13,spain3,0.5,0.62,9,2.25,1.62,2.0,1.61,4
Athletic B. B,8,3,4,1,10,8,2,13,spain3,0.38,0.88,2,1.25,1.62,2.63,1.14,4
Sestao River,8,3,3,2,14,12,2,12,spain3,0.38,0.75,2,1.75,1.5,2.63,1.33,5
Zamora,8,3,3,2,8,6,2,12,spain3,0.38,0.75,2,1.0,1.5,2.63,1.33,5
Tarazona,8,3,3,2,7,5,2,12,spain3,0.38,0.75,2,0.88,1.5,2.63,1.33,5
Real Sociedad B,8,3,2,3,6,6,0,11,spain3,0.38,0.62,0,0.75,1.38,2.63,1.61,6
Lugo,8,3,0,5,5,13,-8,9,spain3,0.38,0.38,-8,0.62,1.12,2.63,2.63,7
Real Union,8,2,2,4,8,12,-4,8,spain3,0.25,0.5,-4,1.0,1.0,4.0,2.0,8
Leonesa,8,2,2,4,5,9,-4,8,spain3,0.25,0.5,-4,0.62,1.0,4.0,2.0,8
Gimnastica,8,1,5,2,6,11,-5,8,spain3,0.12,0.75,-5,0.75,1.0,8.33,1.33,8
Osasuna B,8,2,2,4,10,16,-6,8,spain3,0.25,0.5,-6,1.25,1.0,4.0,2.0,8
Arenteiro,8,1,4,3,6,8,-2,7,spain3,0.12,0.62,-2,0.75,0.88,8.33,1.61,9
Barakaldo,8,1,3,4,8,10,-2,6,spain3,0.12,0.5,-2,1.0,0.75,8.33,2.0,10
Amorebieta,8,1,3,4,6,10,-4,6,spain3,0.12,0.5,-4,0.75,0.75,8.33,2.0,10
Unionistas,8,0,3,5,2,11,-9,3,spain3,0.0,0.38,-9,0.25,0.38,0.0,2.63,11
Ceuta,8,5,3,0,10,4,6,18,spain4,0.62,1.0,6,1.25,2.25,1.61,1.0,1
Real Murcia,8,5,2,1,11,4,7,17,spain4,0.62,0.88,7,1.38,2.12,1.61,1.14,2
Algeciras,8,4,4,0,14,6,8,16,spain4,0.5,1.0,8,1.75,2.0,2.0,1.0,3
Alcorcon,8,5,0,3,11,9,2,15,spain4,0.62,0.62,2,1.38,1.88,1.61,1.61,4
Merida,8,4,2,2,10,8,2,14,spain4,0.5,0.75,2,1.25,1.75,2.0,1.33,5
Atletico M. B,8,3,3,2,10,6,4,12,spain4,0.38,0.75,4,1.25,1.5,2.63,1.33,6
Real Madrid B,8,2,5,1,10,7,3,11,spain4,0.25,0.88,3,1.25,1.38,4.0,1.14,7
Sevilla FC B,8,3,2,3,9,8,1,11,spain4,0.38,0.62,1,1.12,1.38,2.63,1.61,7
Real Betis B,8,2,4,2,9,9,0,10,spain4,0.25,0.75,0,1.12,1.25,4.0,1.33,8
Marbella,8,3,1,4,10,12,-2,10,spain4,0.38,0.5,-2,1.25,1.25,2.63,2.0,8
Sanluqueno,8,2,4,2,8,10,-2,10,spain4,0.25,0.75,-2,1.0,1.25,4.0,1.33,8
Antequera,8,3,1,4,11,16,-5,10,spain4,0.38,0.5,-5,1.38,1.25,2.63,2.0,8
Hercules,8,2,3,3,12,12,0,9,spain4,0.25,0.62,0,1.5,1.12,4.0,1.61,9
UD Ibiza,8,2,3,3,8,8,0,9,spain4,0.25,0.62,0,1.0,1.12,4.0,1.61,9
Villarreal B,8,2,3,3,8,9,-1,9,spain4,0.25,0.62,-1,1.0,1.12,4.0,1.61,9
Yeclano,8,1,4,3,6,9,-3,7,spain4,0.12,0.62,-3,0.75,0.88,8.33,1.61,10
Alcoyano,8,2,1,5,9,13,-4,7,spain4,0.25,0.38,-4,1.12,0.88,4.0,2.63,10
Recreativo H.,8,1,4,3,3,10,-7,7,spain4,0.12,0.62,-7,0.38,0.88,8.33,1.61,10
Fuenlabrada,8,1,3,4,8,12,-4,6,spain4,0.12,0.5,-4,1.0,0.75,8.33,2.0,11
Intercity,8,1,2,5,5,10,-5,5,spain4,0.12,0.38,-5,0.62,0.62,8.33,2.63,12
Pontevedra,8,6,1,1,16,11,5,19,spain5,0.75,0.88,5,2.0,2.38,1.33,1.14,1
Numancia,8,5,0,3,17,7,10,15,spain5,0.62,0.62,10,2.12,1.88,1.61,1.61,2
Escobedo,8,4,3,1,15,6,9,15,spain5,0.5,0.88,9,1.88,1.88,2.0,1.14,2
Coruxo,8,4,3,1,11,5,6,15,spain5,0.5,0.88,6,1.38,1.88,2.0,1.14,2
D. Fabril,8,4,2,2,16,8,8,14,spain5,0.5,0.75,8,2.0,1.75,2.0,1.33,3
Real Aviles,8,4,2,2,11,10,1,14,spain5,0.5,0.75,1,1.38,1.75,2.0,1.33,3
Rayo Cantabria,8,4,1,3,13,8,5,13,spain5,0.5,0.62,5,1.62,1.62,2.0,1.61,4
Langreo,8,3,3,2,10,8,2,12,spain5,0.38,0.75,2,1.25,1.5,2.63,1.33,5
Compostela,8,3,2,3,10,10,0,11,spain5,0.38,0.62,0,1.25,1.38,2.63,1.61,6
Bergantinos,8,3,2,3,12,13,-1,11,spain5,0.38,0.62,-1,1.5,1.38,2.63,1.61,6
Torrelavega,8,3,1,4,16,14,2,10,spain5,0.38,0.5,2,2.0,1.25,2.63,2.0,7
Salamanca CF,8,3,1,4,8,11,-3,10,spain5,0.38,0.5,-3,1.0,1.25,2.63,2.0,7
Marino de L.,8,2,3,3,10,10,0,9,spain5,0.25,0.62,0,1.25,1.12,4.0,1.61,8
Llanera,8,2,3,3,8,13,-5,9,spain5,0.25,0.62,-5,1.0,1.12,4.0,1.61,8
Real Avila,8,2,2,4,9,12,-3,8,spain5,0.25,0.5,-3,1.12,1.0,4.0,2.0,9
Valladolid B,8,2,1,5,9,16,-7,7,spain5,0.25,0.38,-7,1.12,0.88,4.0,2.63,10
Laredo,8,1,3,4,6,17,-11,6,spain5,0.12,0.5,-11,0.75,0.75,8.33,2.0,11
Guijuelo,8,1,0,7,4,20,-16,3,spain5,0.12,0.12,-16,0.5,0.38,8.33,8.33,12
Arenas Club,8,6,2,0,15,4,11,20,spain6,0.75,1.0,11,1.88,2.5,1.33,1.0,1
Alaves B,8,5,3,0,14,7,7,18,spain6,0.62,1.0,7,1.75,2.25,1.61,1.0,2
SD Logrones,8,5,2,1,12,6,6,17,spain6,0.62,0.88,6,1.5,2.12,1.61,1.14,3
Utebo,8,5,2,1,13,8,5,17,spain6,0.62,0.88,5,1.62,2.12,1.61,1.14,3
Teruel,8,5,1,2,11,5,6,16,spain6,0.62,0.75,6,1.38,2.0,1.61,1.33,4
Barbastro,8,4,2,2,9,5,4,14,spain6,0.5,0.75,4,1.12,1.75,2.0,1.33,5
Real Zaragoza B,8,4,2,2,12,9,3,14,spain6,0.5,0.75,3,1.5,1.75,2.0,1.33,5
UD Logrones,8,4,1,3,9,4,5,13,spain6,0.5,0.62,5,1.12,1.62,2.0,1.61,6
Tudelano,8,3,2,3,12,9,3,11,spain6,0.38,0.62,3,1.5,1.38,2.63,1.61,7
Gernika,8,3,2,3,9,11,-2,11,spain6,0.38,0.62,-2,1.12,1.38,2.63,1.61,7
Calahorra,8,3,1,4,6,9,-3,10,spain6,0.38,0.5,-3,0.75,1.25,2.63,2.0,8
Anguiano,8,2,2,4,4,10,-6,8,spain6,0.25,0.5,-6,0.5,1.0,4.0,2.0,9
Subiza,8,2,1,5,12,13,-1,7,spain6,0.25,0.38,-1,1.5,0.88,4.0,2.63,10
Eibar B,8,1,4,3,5,8,-3,7,spain6,0.12,0.62,-3,0.62,0.88,8.33,1.61,10
Alfaro,8,2,0,6,7,16,-9,6,spain6,0.25,0.25,-9,0.88,0.75,4.0,4.0,11
Ejea,8,0,5,3,6,9,-3,5,spain6,0.0,0.62,-3,0.75,0.62,0.0,1.61,12
Izarra,8,1,0,7,8,19,-11,3,spain6,0.12,0.12,-11,1.0,0.38,8.33,8.33,13
Real Sociedad C,8,1,0,7,4,16,-12,3,spain6,0.12,0.12,-12,0.5,0.38,8.33,8.33,13
Europa,8,7,1,0,16,2,14,22,spain7,0.88,1.0,14,2.0,2.75,1.14,1.0,1
Andratx,8,6,1,1,13,6,7,19,spain7,0.75,0.88,7,1.62,2.38,1.33,1.14,2
Sabadell,8,6,0,2,21,6,15,18,spain7,0.75,0.75,15,2.62,2.25,1.33,1.33,3
A. Baleares,8,5,3,0,15,5,10,18,spain7,0.62,1.0,10,1.88,2.25,1.61,1.0,3
Olot,8,5,2,1,14,8,6,17,spain7,0.62,0.88,6,1.75,2.12,1.61,1.14,4
Torrent,8,4,1,3,12,9,3,13,spain7,0.5,0.62,3,1.5,1.62,2.0,1.61,5
Cornella,8,4,1,3,12,11,1,13,spain7,0.5,0.62,1,1.5,1.62,2.0,1.61,5
SD Ibiza,8,4,1,3,10,9,1,13,spain7,0.5,0.62,1,1.25,1.62,2.0,1.61,5
Terrassa,8,4,0,4,12,11,1,12,spain7,0.5,0.5,1,1.5,1.5,2.0,2.0,6
Sant Andreu,8,3,2,3,18,13,5,11,spain7,0.38,0.62,5,2.25,1.38,2.63,1.61,7
Valencia B,8,3,2,3,11,12,-1,11,spain7,0.38,0.62,-1,1.38,1.38,2.63,1.61,7
Espanyol B,8,2,3,3,7,7,0,9,spain7,0.25,0.62,0,0.88,1.12,4.0,1.61,8
Ilicitano,8,2,2,4,7,10,-3,8,spain7,0.25,0.5,-3,0.88,1.0,4.0,2.0,9
Pena Deportiva,8,1,4,3,8,10,-2,7,spain7,0.12,0.62,-2,1.0,0.88,8.33,1.61,10
Lleida,8,1,3,4,4,10,-6,6,spain7,0.12,0.5,-6,0.5,0.75,8.33,2.0,11
Mallorca B,8,2,0,6,8,19,-11,6,spain7,0.25,0.25,-11,1.0,0.75,4.0,4.0,11
Badalona,8,0,0,8,5,24,-19,0,spain7,0.0,0.0,-19,0.62,0.0,0.0,0.0,12
Alzira,8,0,0,8,1,22,-21,0,spain7,0.0,0.0,-21,0.12,0.0,0.0,0.0,12
Antoniano,8,6,1,1,14,7,7,19,spain8,0.75,0.88,7,1.75,2.38,1.33,1.14,1
Torremolinos,8,6,0,2,17,6,11,18,spain8,0.75,0.75,11,2.12,2.25,1.33,1.33,2
CD Estepona,8,5,2,1,11,7,4,17,spain8,0.62,0.88,4,1.38,2.12,1.61,1.14,3
La Union,8,5,1,2,11,5,6,16,spain8,0.62,0.75,6,1.38,2.0,1.61,1.33,4
Villanovense,8,5,1,2,10,5,5,16,spain8,0.62,0.75,5,1.25,2.0,1.61,1.33,4
UCAM Murcia,8,4,2,2,13,8,5,14,spain8,0.5,0.75,5,1.62,1.75,2.0,1.33,5
Xerez CD,8,4,1,3,12,8,4,13,spain8,0.5,0.62,4,1.5,1.62,2.0,1.61,6
Aguilas CF,8,4,0,4,5,7,-2,12,spain8,0.5,0.5,-2,0.62,1.5,2.0,2.0,7
Cadiz B,8,3,2,3,10,8,2,11,spain8,0.38,0.62,2,1.25,1.38,2.63,1.61,8
Almeria B,8,3,2,3,8,10,-2,11,spain8,0.38,0.62,-2,1.0,1.38,2.63,1.61,8
Xerez D. FC,8,3,1,4,7,11,-4,10,spain8,0.38,0.5,-4,0.88,1.25,2.63,2.0,9
Linares,8,2,3,3,8,9,-1,9,spain8,0.25,0.62,-1,1.0,1.12,4.0,1.61,10
D. Minera,8,3,0,5,12,15,-3,9,spain8,0.38,0.38,-3,1.5,1.12,2.63,2.63,10
Don Benito,8,2,2,4,10,13,-3,8,spain8,0.25,0.5,-3,1.25,1.0,4.0,2.0,11
Orihuela,8,2,2,4,5,9,-4,8,spain8,0.25,0.5,-4,0.62,1.0,4.0,2.0,11
Linense,8,2,1,5,4,8,-4,7,spain8,0.25,0.38,-4,0.5,0.88,4.0,2.63,12
Granada B,8,1,0,7,1,14,-13,3,spain8,0.12,0.12,-13,0.12,0.38,8.33,8.33,13
San Fernando,8,0,2,6,1,11,-10,2,spain8,0.0,0.25,-10,0.12,0.25,0.0,4.0,14
S. Sebastian R.,8,6,2,0,14,4,10,20,spain9,0.75,1.0,10,1.75,2.5,1.33,1.0,1
Cacereno,8,5,3,0,17,6,11,18,spain9,0.62,1.0,11,2.12,2.25,1.61,1.0,2
Talavera CF,8,4,2,2,11,5,6,14,spain9,0.5,0.75,6,1.38,1.75,2.0,1.33,3
Guadalajara,8,4,1,3,13,11,2,13,spain9,0.5,0.62,2,1.62,1.62,2.0,1.61,4
Navalcarnero,8,4,1,3,11,9,2,13,spain9,0.5,0.62,2,1.38,1.62,2.0,1.61,4
Real Madrid C,8,4,1,3,9,7,2,13,spain9,0.5,0.62,2,1.12,1.62,2.0,1.61,4
CD Mostoles,8,4,0,4,17,13,4,12,spain9,0.5,0.5,4,2.12,1.5,2.0,2.0,5
Melilla,8,3,3,2,13,13,0,12,spain9,0.38,0.75,0,1.62,1.5,2.63,1.33,5
R. Majadahonda,8,3,3,2,6,6,0,12,spain9,0.38,0.75,0,0.75,1.5,2.63,1.33,5
Union Adarve,8,2,3,3,5,5,0,9,spain9,0.25,0.62,0,0.62,1.12,4.0,1.61,6
Illescas,8,2,3,3,10,11,-1,9,spain9,0.25,0.62,-1,1.25,1.12,4.0,1.61,6
Conquense,8,2,3,3,7,11,-4,9,spain9,0.25,0.62,-4,0.88,1.12,4.0,1.61,6
Colonia M.,8,2,3,3,10,15,-5,9,spain9,0.25,0.62,-5,1.25,1.12,4.0,1.61,6
Getafe B,8,2,2,4,10,13,-3,8,spain9,0.25,0.5,-3,1.25,1.0,4.0,2.0,7
CD Coria,8,1,4,3,8,13,-5,7,spain9,0.12,0.62,-5,1.0,0.88,8.33,1.61,8
Atletico Paso,8,1,3,4,9,14,-5,6,spain9,0.12,0.5,-5,1.12,0.75,8.33,2.0,9
Tenerife B,8,1,3,4,9,14,-5,6,spain9,0.12,0.5,-5,1.12,0.75,8.33,2.0,9
Yaiza,8,0,4,4,5,14,-9,4,spain9,0.0,0.5,-9,0.62,0.5,0.0,2.0,10
Mjallby,7,5,2,0,17,6,11,17,sweden,0.71,1.0,11,2.43,2.43,1.41,1.0,1
AIK,7,5,2,0,11,5,6,17,sweden,0.71,1.0,6,1.57,2.43,1.41,1.0,1
Hammarby,7,5,1,1,15,4,11,16,sweden,0.71,0.86,11,2.14,2.29,1.41,1.16,2
Elfsborg,7,4,1,2,12,9,3,13,sweden,0.57,0.71,3,1.71,1.86,1.75,1.41,3
Malmo FF,7,3,2,2,7,6,1,11,sweden,0.43,0.71,1,1.0,1.57,2.33,1.41,4
Degerfors,7,3,1,3,12,11,1,10,sweden,0.43,0.57,1,1.71,1.43,2.33,1.75,5
Brommapojkarna,6,3,1,2,9,8,1,10,sweden,0.5,0.67,1,1.5,1.67,2.0,1.49,5
Hacken,7,3,1,3,11,12,-1,10,sweden,0.43,0.57,-1,1.57,1.43,2.33,1.75,5
IFK Goteborg,7,3,1,3,8,11,-3,10,sweden,0.43,0.57,-3,1.14,1.43,2.33,1.75,5
Norrkoping,7,3,0,4,15,15,0,9,sweden,0.43,0.43,0,2.14,1.29,2.33,2.33,6
Djurgarden,6,2,2,2,3,4,-1,8,sweden,0.33,0.67,-1,0.5,1.33,3.03,1.49,7
GAIS,7,1,4,2,5,6,-1,7,sweden,0.14,0.71,-1,0.71,1.0,7.14,1.41,8
Halmstad,7,2,1,4,7,15,-8,7,sweden,0.29,0.43,-8,1.0,1.0,3.45,2.33,8
Sirius,7,1,3,3,8,12,-4,6,sweden,0.14,0.57,-4,1.14,0.86,7.14,1.75,9
Oster,7,1,0,6,5,12,-7,3,sweden,0.14,0.14,-7,0.71,0.43,7.14,7.14,10
Varnamo,7,0,0,7,7,16,-9,0,sweden,0.0,0.0,-9,1.0,0.0,0.0,0.0,11
Varberg BoIS,6,4,2,0,14,4,10,14,sweden2,0.67,1.0,10,2.33,2.33,1.49,1.0,1
Kalmar,6,4,2,0,13,4,9,14,sweden2,0.67,1.0,9,2.17,2.33,1.49,1.0,1
Landskrona,6,4,2,0,12,7,5,14,sweden2,0.67,1.0,5,2.0,2.33,1.49,1.0,1
Orgryte,6,3,2,1,11,6,5,11,sweden2,0.5,0.83,5,1.83,1.83,2.0,1.2,2
Ostersunds,6,3,2,1,10,8,2,11,sweden2,0.5,0.83,2,1.67,1.83,2.0,1.2,2
Oddevold,6,3,1,2,9,7,2,10,sweden2,0.5,0.67,2,1.5,1.67,2.0,1.49,3
Vasteras,6,2,3,1,8,7,1,9,sweden2,0.33,0.83,1,1.33,1.5,3.03,1.2,4
GIF Sundsvall,6,2,2,2,7,6,1,8,sweden2,0.33,0.67,1,1.17,1.33,3.03,1.49,5
Falkenberg,6,2,2,2,10,10,0,8,sweden2,0.33,0.67,0,1.67,1.33,3.03,1.49,5
Brage,6,2,2,2,5,7,-2,8,sweden2,0.33,0.67,-2,0.83,1.33,3.03,1.49,5
Sandviken,6,2,1,3,5,8,-3,7,sweden2,0.33,0.5,-3,0.83,1.17,3.03,2.0,6
Helsingborg,6,2,0,4,6,10,-4,6,sweden2,0.33,0.33,-4,1.0,1.0,3.03,3.03,7
Utsikten,6,1,2,3,10,11,-1,5,sweden2,0.17,0.5,-1,1.67,0.83,5.88,2.0,8
Trelleborg,6,1,1,4,1,8,-7,4,sweden2,0.17,0.33,-7,0.17,0.67,5.88,3.03,9
Orebro,6,0,1,5,2,11,-9,1,sweden2,0.0,0.17,-9,0.33,0.17,0.0,5.88,10
Umea,6,0,1,5,2,11,-9,1,sweden2,0.0,0.17,-9,0.33,0.17,0.0,5.88,10
FC Basel,8,6,1,1,22,5,17,19,switzerland,0.75,0.88,17,2.75,2.38,1.33,1.14,1
BSC Young Boys,8,5,1,2,12,11,1,16,switzerland,0.62,0.75,1,1.5,2.0,1.61,1.33,2
Winterthur,8,4,1,3,8,7,1,13,switzerland,0.5,0.62,1,1.0,1.62,2.0,1.61,3
Lausanne Sport,8,4,1,3,12,12,0,13,switzerland,0.5,0.62,0,1.5,1.62,2.0,1.61,3
St. Gallen,8,3,3,2,8,7,1,12,switzerland,0.38,0.75,1,1.0,1.5,2.63,1.33,4
Servette,8,3,1,4,11,13,-2,10,switzerland,0.38,0.5,-2,1.38,1.25,2.63,2.0,5
Lugano,8,3,1,4,8,10,-2,10,switzerland,0.38,0.5,-2,1.0,1.25,2.63,2.0,5
Sion,8,2,3,3,8,10,-2,9,switzerland,0.25,0.62,-2,1.0,1.12,4.0,1.61,6
Yverdon,8,2,3,3,9,15,-6,9,switzerland,0.25,0.62,-6,1.12,1.12,4.0,1.61,6
Luzern,8,2,2,4,15,13,2,8,switzerland,0.25,0.5,2,1.88,1.0,4.0,2.0,7
FC Zurich,8,2,2,4,10,16,-6,8,switzerland,0.25,0.5,-6,1.25,1.0,4.0,2.0,7
Grasshopper,8,2,1,5,9,13,-4,7,switzerland,0.25,0.38,-4,1.12,0.88,4.0,2.63,8
Thun,8,6,1,1,18,5,13,19,switzerland2,0.75,0.88,13,2.25,2.38,1.33,1.14,1
Lausanne Ouchy,8,4,2,2,11,7,4,14,switzerland2,0.5,0.75,4,1.38,1.75,2.0,1.33,2
Vaduz,8,4,1,3,12,9,3,13,switzerland2,0.5,0.62,3,1.5,1.62,2.0,1.61,3
Wil,8,3,3,2,14,18,-4,12,switzerland2,0.38,0.75,-4,1.75,1.5,2.63,1.33,4
Bellinzona,8,3,2,3,12,19,-7,11,switzerland2,0.38,0.62,-7,1.5,1.38,2.63,1.61,5
Etoile Carouge,8,2,3,3,14,10,4,9,switzerland2,0.25,0.62,4,1.75,1.12,4.0,1.61,6
Stade Nyonnais,8,3,0,5,7,12,-5,9,switzerland2,0.38,0.38,-5,0.88,1.12,2.63,2.63,6
Neuchatel Xamax,8,2,2,4,14,12,2,8,switzerland2,0.25,0.5,2,1.75,1.0,4.0,2.0,7
Aarau,8,0,7,1,12,13,-1,7,switzerland2,0.0,0.88,-1,1.5,0.88,0.0,1.14,8
Schaffhausen,8,2,1,5,10,19,-9,7,switzerland2,0.25,0.38,-9,1.25,0.88,4.0,2.63,8
Bangkok Utd,8,7,1,0,22,7,15,22,thailand,0.88,1.0,15,2.75,2.75,1.14,1.0,1
Ratchaburi,8,6,0,2,26,13,13,18,thailand,0.75,0.75,13,3.25,2.25,1.33,1.33,2
Pathum Utd,8,5,2,1,15,10,5,17,thailand,0.62,0.88,5,1.88,2.12,1.61,1.14,3
Buriram Utd,8,5,1,2,21,8,13,16,thailand,0.62,0.75,13,2.62,2.0,1.61,1.33,4
Prachuap,8,4,1,3,16,12,4,13,thailand,0.5,0.62,4,2.0,1.62,2.0,1.61,5
Port FC,8,3,3,2,13,11,2,12,thailand,0.38,0.75,2,1.62,1.5,2.63,1.33,6
Chiangrai Utd,8,3,1,4,13,13,0,10,thailand,0.38,0.5,0,1.62,1.25,2.63,2.0,7
Muang Thong Utd,8,3,1,4,12,14,-2,10,thailand,0.38,0.5,-2,1.5,1.25,2.63,2.0,7
Rayong,8,3,1,4,12,14,-2,10,thailand,0.38,0.5,-2,1.5,1.25,2.63,2.0,7
Lamphun Warrior,8,2,3,3,8,9,-1,9,thailand,0.25,0.62,-1,1.0,1.12,4.0,1.61,8
Uthai Thani,8,1,5,2,7,8,-1,8,thailand,0.12,0.75,-1,0.88,1.0,8.33,1.33,9
Sukhothai,8,1,4,3,15,18,-3,7,thailand,0.12,0.62,-3,1.88,0.88,8.33,1.61,10
Khon Kaen Utd,8,2,1,5,10,22,-12,7,thailand,0.25,0.38,-12,1.25,0.88,4.0,2.63,10
N. Ratchasima,8,1,2,5,9,20,-11,5,thailand,0.12,0.38,-11,1.12,0.62,8.33,2.63,11
Nakhon Pathom,8,1,2,5,9,20,-11,5,thailand,0.12,0.38,-11,1.12,0.62,8.33,2.63,11
N. Bua Pitchaya,8,1,2,5,5,18,-13,5,thailand,0.12,0.38,-13,0.62,0.62,8.33,2.63,11
Chonburi,8,7,0,1,16,7,9,21,thailand2,0.88,0.88,9,2.0,2.62,1.14,1.14,1
Ayutthaya Utd,8,4,2,2,19,8,11,14,thailand2,0.5,0.75,11,2.38,1.75,2.0,1.33,2
Police Tero,8,4,2,2,12,11,1,14,thailand2,0.5,0.75,1,1.5,1.75,2.0,1.33,2
Kanchanaburi,8,3,4,1,17,10,7,13,thailand2,0.38,0.88,7,2.12,1.62,2.63,1.14,3
Chainat,8,4,1,3,13,10,3,13,thailand2,0.5,0.62,3,1.62,1.62,2.0,1.61,3
Chanthaburi,8,3,3,2,11,13,-2,12,thailand2,0.38,0.75,-2,1.38,1.5,2.63,1.33,4
Mahasarakham,8,2,5,1,9,7,2,11,thailand2,0.25,0.88,2,1.12,1.38,4.0,1.14,5
Chiangmai Utd,8,3,2,3,10,10,0,11,thailand2,0.38,0.62,0,1.25,1.38,2.63,1.61,5
Nakhon Si,8,3,2,3,9,9,0,11,thailand2,0.38,0.62,0,1.12,1.38,2.63,1.61,5
Lampang,8,3,2,3,9,10,-1,11,thailand2,0.38,0.62,-1,1.12,1.38,2.63,1.61,5
Phrae Utd,8,2,4,2,16,12,4,10,thailand2,0.25,0.75,4,2.0,1.25,4.0,1.33,6
Kasetsart,8,2,3,3,8,9,-1,9,thailand2,0.25,0.62,-1,1.0,1.12,4.0,1.61,7
Bangkok FC,8,2,3,3,12,15,-3,9,thailand2,0.25,0.62,-3,1.5,1.12,4.0,1.61,7
Trat FC,8,2,2,4,10,12,-2,8,thailand2,0.25,0.5,-2,1.25,1.0,4.0,2.0,8
Sisaket Utd,8,2,1,5,5,14,-9,7,thailand2,0.25,0.38,-9,0.62,0.88,4.0,2.63,9
Pattaya United,8,1,1,6,5,18,-13,4,thailand2,0.12,0.25,-13,0.62,0.5,8.33,4.0,10
Suphanburi,8,0,3,5,9,19,-10,3,thailand2,0.0,0.38,-10,1.12,0.38,0.0,2.63,11
Samut Prakan,0,0,0,0,0,0,0,0,thailand2,0.0,0.0,0,0.0,0.0,0.0,0.0,12
Galatasaray,8,6,1,1,23,8,15,19,turkey,0.75,0.88,15,2.88,2.38,1.33,1.14,1
Fenerbahce,8,5,2,1,20,9,11,17,turkey,0.62,0.88,11,2.5,2.12,1.61,1.14,2
Kayserispor,8,5,2,1,16,6,10,17,turkey,0.62,0.88,10,2.0,2.12,1.61,1.14,2
Konyaspor,8,5,0,3,10,7,3,15,turkey,0.62,0.62,3,1.25,1.88,1.61,1.61,3
Basaksehir,8,5,0,3,14,14,0,15,turkey,0.62,0.62,0,1.75,1.88,1.61,1.61,3
Trabzonspor,8,4,2,2,14,11,3,14,turkey,0.5,0.75,3,1.75,1.75,2.0,1.33,4
Antalyaspor,8,4,1,3,7,12,-5,13,turkey,0.5,0.62,-5,0.88,1.62,2.0,1.61,5
Kasimpasa,8,3,3,2,12,9,3,12,turkey,0.38,0.75,3,1.5,1.5,2.63,1.33,6
Besiktas,8,3,2,3,11,9,2,11,turkey,0.38,0.62,2,1.38,1.38,2.63,1.61,7
Bodrumspor,8,3,2,3,7,8,-1,11,turkey,0.38,0.62,-1,0.88,1.38,2.63,1.61,7
Goztepe,8,2,4,2,11,10,1,10,turkey,0.25,0.75,1,1.38,1.25,4.0,1.33,8
Sivasspor,8,3,1,4,16,16,0,10,turkey,0.38,0.5,0,2.0,1.25,2.63,2.0,8
Samsunspor,8,3,1,4,9,10,-1,10,turkey,0.38,0.5,-1,1.12,1.25,2.63,2.0,8
Rizespor,8,3,1,4,8,9,-1,10,turkey,0.38,0.5,-1,1.0,1.25,2.63,2.0,8
Eyupspor,8,3,1,4,12,14,-2,10,turkey,0.38,0.5,-2,1.5,1.25,2.63,2.0,8
Gaziantep,8,3,1,4,8,11,-3,10,turkey,0.38,0.5,-3,1.0,1.25,2.63,2.0,8
Hatayspor,8,2,0,6,11,23,-12,6,turkey,0.25,0.25,-12,1.38,0.75,4.0,4.0,9
Alanyaspor,8,1,1,6,9,15,-6,4,turkey,0.12,0.25,-6,1.12,0.5,8.33,4.0,10
Adana Demirspor,8,0,1,7,5,22,-17,1,turkey,0.0,0.12,-17,0.62,0.12,0.0,8.33,11
Igdir,8,5,3,0,25,1,24,18,turkey2,0.62,1.0,24,3.12,2.25,1.61,1.0,1
Istanbulspor,8,6,0,2,22,8,14,18,turkey2,0.75,0.75,14,2.75,2.25,1.33,1.33,1
Genclerbirligi,8,5,2,1,13,7,6,17,turkey2,0.62,0.88,6,1.62,2.12,1.61,1.14,2
Boluspor,8,4,2,2,22,11,11,14,turkey2,0.5,0.75,11,2.75,1.75,2.0,1.33,3
Bandirmaspor,8,3,5,0,10,6,4,14,turkey2,0.38,1.0,4,1.25,1.75,2.63,1.0,3
Erokspor,8,4,2,2,14,11,3,14,turkey2,0.5,0.75,3,1.75,1.75,2.0,1.33,3
Amed SK,8,4,2,2,11,8,3,14,turkey2,0.5,0.75,3,1.38,1.75,2.0,1.33,3
Erzurum BB,8,4,1,3,10,6,4,13,turkey2,0.5,0.62,4,1.25,1.62,2.0,1.61,4
Umraniyespor,8,3,3,2,7,5,2,12,turkey2,0.38,0.75,2,0.88,1.5,2.63,1.33,5
Corum,8,3,3,2,14,13,1,12,turkey2,0.38,0.75,1,1.75,1.5,2.63,1.33,5
Sakaryaspor,8,4,0,4,11,12,-1,12,turkey2,0.5,0.5,-1,1.38,1.5,2.0,2.0,5
Kocaelispor,8,3,2,3,21,17,4,11,turkey2,0.38,0.62,4,2.62,1.38,2.63,1.61,6
Manisa BB,8,3,2,3,13,11,2,11,turkey2,0.38,0.62,2,1.62,1.38,2.63,1.61,6
F. Karagumruk,8,3,2,3,6,6,0,11,turkey2,0.38,0.62,0,0.75,1.38,2.63,1.61,6
Keciorengucu,8,3,0,5,13,12,1,9,turkey2,0.38,0.38,1,1.62,1.12,2.63,2.63,7
Pendikspor,8,2,2,4,8,13,-5,8,turkey2,0.25,0.5,-5,1.0,1.0,4.0,2.0,8
Ankaragucu,8,2,1,5,9,18,-9,7,turkey2,0.25,0.38,-9,1.12,0.88,4.0,2.63,9
Sanliurfaspor,8,2,0,6,8,15,-7,6,turkey2,0.25,0.25,-7,1.0,0.75,4.0,4.0,10
Adanaspor,8,1,0,7,6,21,-15,3,turkey2,0.12,0.12,-15,0.75,0.38,8.33,8.33,11
Y. Malatyaspor,8,0,0,8,3,45,-42,0,turkey2,0.0,0.0,-42,0.38,0.0,0.0,0.0,12
B. Petrolspor,8,7,0,1,18,4,14,21,turkey3,0.88,0.88,14,2.25,2.62,1.14,1.14,1
Sariyer,8,6,1,1,15,7,8,19,turkey3,0.75,0.88,8,1.88,2.38,1.33,1.14,2
Adana,8,5,2,1,15,8,7,17,turkey3,0.62,0.88,7,1.88,2.12,1.61,1.14,3
Kastamonuspor,8,5,2,1,13,9,4,17,turkey3,0.62,0.88,4,1.62,2.12,1.61,1.14,3
Ankaraspor,8,4,2,2,15,6,9,14,turkey3,0.5,0.75,9,1.88,1.75,2.0,1.33,4
Trabzon FK,8,4,2,2,12,5,7,14,turkey3,0.5,0.75,7,1.5,1.75,2.0,1.33,4
B. Anadolu,8,4,2,2,14,12,2,14,turkey3,0.5,0.75,2,1.75,1.75,2.0,1.33,4
Altay,8,4,1,3,13,10,3,13,turkey3,0.5,0.62,3,1.62,1.62,2.0,1.61,5
Kepez Belediyes,8,3,2,3,10,8,2,11,turkey3,0.38,0.62,2,1.25,1.38,2.63,1.61,6
Inegolspor,8,3,1,4,14,14,0,10,turkey3,0.38,0.5,0,1.75,1.25,2.63,2.0,7
Fethiyespor,8,3,1,4,6,13,-7,10,turkey3,0.38,0.5,-7,0.75,1.25,2.63,2.0,7
Karakopru,8,3,0,5,13,11,2,9,turkey3,0.38,0.38,2,1.62,1.12,2.63,2.63,8
24 Erzincanspor,8,2,2,4,11,14,-3,8,turkey3,0.25,0.5,-3,1.38,1.0,4.0,2.0,9
Altinordu,8,2,2,4,7,13,-6,8,turkey3,0.25,0.5,-6,0.88,1.0,4.0,2.0,9
Kirklarelispor,8,2,1,5,9,13,-4,7,turkey3,0.25,0.38,-4,1.12,0.88,4.0,2.63,10
Iskenderun,8,1,3,4,9,12,-3,6,turkey3,0.12,0.5,-3,1.12,0.75,8.33,2.0,11
Isparta Davrazs,8,1,1,6,10,24,-14,4,turkey3,0.12,0.25,-14,1.25,0.5,8.33,4.0,12
Afyonspor,8,0,0,8,0,24,-24,0,turkey3,0.0,0.0,-24,0.0,0.0,0.0,0.0,13
Elazigspor,8,7,0,1,16,4,12,21,turkey4,0.88,0.88,12,2.0,2.62,1.14,1.14,1
Karacabey,8,6,1,1,13,4,9,19,turkey4,0.75,0.88,9,1.62,2.38,1.33,1.14,2
Yeni Mersin,8,5,2,1,19,3,16,17,turkey4,0.62,0.88,16,2.38,2.12,1.61,1.14,3
Serik Belediyes,8,5,1,2,27,11,16,16,turkey4,0.62,0.75,16,3.38,2.0,1.61,1.33,4
Erbaaspor,8,5,0,3,20,19,1,15,turkey4,0.62,0.62,1,2.5,1.88,1.61,1.61,5
Van Spor,8,4,2,2,13,9,4,14,turkey4,0.5,0.75,4,1.62,1.75,2.0,1.33,6
Menemen B.,8,4,1,3,12,11,1,13,turkey4,0.5,0.62,1,1.5,1.62,2.0,1.61,7
Karaman,8,3,4,1,11,10,1,13,turkey4,0.38,0.88,1,1.38,1.62,2.63,1.14,7
A. Demirspor,8,3,2,3,19,14,5,11,turkey4,0.38,0.62,5,2.38,1.38,2.63,1.61,8
Aksaray B.,8,3,2,3,12,13,-1,11,turkey4,0.38,0.62,-1,1.5,1.38,2.63,1.61,8
Somaspor,8,3,2,3,10,13,-3,11,turkey4,0.38,0.62,-3,1.25,1.38,2.63,1.61,8
Beyoglu Yeni C.,8,3,1,4,15,11,4,10,turkey4,0.38,0.5,4,1.88,1.25,2.63,2.0,9
Diyarbekirspor,8,3,1,4,7,14,-7,10,turkey4,0.38,0.5,-7,0.88,1.25,2.63,2.0,9
Bucaspor,8,3,0,5,12,20,-8,9,turkey4,0.38,0.38,-8,1.5,1.12,2.63,2.63,10
Derince,8,2,1,5,13,16,-3,7,turkey4,0.25,0.38,-3,1.62,0.88,4.0,2.63,11
Arnavutkoy B.,8,2,1,5,14,19,-5,7,turkey4,0.25,0.38,-5,1.75,0.88,4.0,2.63,11
Giresunspor,8,0,1,7,4,19,-15,1,turkey4,0.0,0.12,-15,0.5,0.12,0.0,8.33,12
Nazillispor,8,0,0,8,5,32,-27,0,turkey4,0.0,0.0,-27,0.62,0.0,0.0,0.0,13
Musspor,8,7,1,0,22,6,16,22,turkey5,0.88,1.0,16,2.75,2.75,1.14,1.0,1
Bursaspor,8,6,1,1,19,6,13,19,turkey5,0.75,0.88,13,2.38,2.38,1.33,1.14,2
Karsiyaka,8,5,1,2,20,9,11,16,turkey5,0.62,0.75,11,2.5,2.0,1.61,1.33,3
Kutahyaspor,8,4,2,2,16,15,1,14,turkey5,0.5,0.75,1,2.0,1.75,2.0,1.33,4
Anadolu U.,8,4,2,2,10,9,1,14,turkey5,0.5,0.75,1,1.25,1.75,2.0,1.33,4
Artvin Hopaspor,8,4,1,3,12,7,5,13,turkey5,0.5,0.62,5,1.5,1.62,2.0,1.61,5
Duzcespor,8,4,1,3,8,10,-2,13,turkey5,0.5,0.62,-2,1.0,1.62,2.0,1.61,5
Silifke,8,4,0,4,11,11,0,12,turkey5,0.5,0.5,0,1.38,1.5,2.0,2.0,6
Ergene Velimese,8,4,0,4,8,15,-7,12,turkey5,0.5,0.5,-7,1.0,1.5,2.0,2.0,6
Tokat,8,3,2,3,12,8,4,11,turkey5,0.38,0.62,4,1.5,1.38,2.63,1.61,7
Kusadasispor,8,2,2,4,6,13,-7,8,turkey5,0.25,0.5,-7,0.75,1.0,4.0,2.0,8
K. Bulvarspor,8,2,2,4,10,20,-10,8,turkey5,0.25,0.5,-10,1.25,1.0,4.0,2.0,8
Kirsehir B.,8,1,3,4,4,10,-6,6,turkey5,0.12,0.5,-6,0.5,0.75,8.33,2.0,9
Kahramanmar.,8,1,2,5,4,8,-4,5,turkey5,0.12,0.38,-4,0.5,0.62,8.33,2.63,10
Elaziz K.,8,0,4,4,5,10,-5,4,turkey5,0.0,0.5,-5,0.62,0.5,0.0,2.0,11
Viven Bornova,8,1,0,7,7,17,-10,3,turkey5,0.12,0.12,-10,0.88,0.38,8.33,8.33,12
Tire 2021 FK,8,7,1,0,21,2,19,22,turkey6,0.88,1.0,19,2.62,2.75,1.14,1.0,1
Beykoz Ishaklis,8,6,0,2,20,8,12,18,turkey6,0.75,0.75,12,2.5,2.25,1.33,1.33,2
Mazidagi,8,5,2,1,19,5,14,17,turkey6,0.62,0.88,14,2.38,2.12,1.61,1.14,3
Muglaspor,8,5,1,2,14,6,8,16,turkey6,0.62,0.75,8,1.75,2.0,1.61,1.33,4
Cayelispor,8,4,3,1,12,5,7,15,turkey6,0.5,0.88,7,1.5,1.88,2.0,1.14,5
Balikesirspor,8,4,2,2,14,8,6,14,turkey6,0.5,0.75,6,1.75,1.75,2.0,1.33,6
Turk Metal 1963,8,4,2,2,16,13,3,14,turkey6,0.5,0.75,3,2.0,1.75,2.0,1.33,6
Inegol Kafkas,8,3,2,3,13,8,5,11,turkey6,0.38,0.62,5,1.62,1.38,2.63,1.61,7
Amasyaspor,8,3,2,3,13,11,2,11,turkey6,0.38,0.62,2,1.62,1.38,2.63,1.61,7
Usakspor,8,2,4,2,8,9,-1,10,turkey6,0.25,0.75,-1,1.0,1.25,4.0,1.33,8
Silivrispor,8,2,2,4,11,12,-1,8,turkey6,0.25,0.5,-1,1.38,1.0,4.0,2.0,9
Etimesgut,8,2,2,4,10,14,-4,8,turkey6,0.25,0.5,-4,1.25,1.0,4.0,2.0,9
Kelkit,8,2,1,5,10,15,-5,7,turkey6,0.25,0.38,-5,1.25,0.88,4.0,2.63,10
Fatsa B.,8,1,1,6,4,19,-15,4,turkey6,0.12,0.25,-15,0.5,0.5,8.33,4.0,11
Nevsehirspor,8,1,1,6,4,30,-26,4,turkey6,0.12,0.25,-26,0.5,0.5,8.33,4.0,11
Adiyaman,8,0,0,8,0,24,-24,0,turkey6,0.0,0.0,-24,0.0,0.0,0.0,0.0,12
Aliaga FAS,8,7,1,0,21,5,16,22,turkey7,0.88,1.0,16,2.62,2.75,1.14,1.0,1
Ayvalikgucu,8,5,3,0,11,4,7,18,turkey7,0.62,1.0,7,1.38,2.25,1.61,1.0,2
Corluspor,8,4,3,1,18,9,9,15,turkey7,0.5,0.88,9,2.25,1.88,2.0,1.14,3
Yozgat Bld Bozo,8,4,1,3,15,14,1,13,turkey7,0.5,0.62,1,1.88,1.62,2.0,1.61,4
Kucukcekmece,8,3,3,2,11,8,3,12,turkey7,0.38,0.75,3,1.38,1.5,2.63,1.33,5
Orduspor,8,3,2,3,16,8,8,11,turkey7,0.38,0.62,8,2.0,1.38,2.63,1.61,6
Alanya 1221,8,3,2,3,14,11,3,11,turkey7,0.38,0.62,3,1.75,1.38,2.63,1.61,6
Pazarspor,8,3,2,3,13,11,2,11,turkey7,0.38,0.62,2,1.62,1.38,2.63,1.61,6
Efeler 09,8,2,5,1,6,5,1,11,turkey7,0.25,0.88,1,0.75,1.38,4.0,1.14,6
Cankaya FK,8,3,1,4,11,21,-10,10,turkey7,0.38,0.5,-10,1.38,1.25,2.63,2.0,7
K. Idmanyurdu,8,2,3,3,8,9,-1,9,turkey7,0.25,0.62,-1,1.0,1.12,4.0,1.61,8
1923 M.,8,2,3,3,11,13,-2,9,turkey7,0.25,0.62,-2,1.38,1.12,4.0,1.61,8
Bayburt,8,2,3,3,5,12,-7,9,turkey7,0.25,0.62,-7,0.62,1.12,4.0,1.61,8
Osmaniyespor,8,2,0,6,11,24,-13,6,turkey7,0.25,0.25,-13,1.38,0.75,4.0,4.0,9
1922 Konyaspor,8,1,2,5,9,15,-6,5,turkey7,0.12,0.38,-6,1.12,0.62,8.33,2.63,10
Viransehir,8,1,0,7,4,15,-11,3,turkey7,0.12,0.12,-11,0.5,0.38,8.33,8.33,11
Sebat G.,8,6,1,1,20,10,10,19,turkey8,0.75,0.88,10,2.5,2.38,1.33,1.14,1
Kirikkale B.,8,6,1,1,15,9,6,19,turkey8,0.75,0.88,6,1.88,2.38,1.33,1.14,1
Mardin BB,8,5,3,0,22,10,12,18,turkey8,0.62,1.0,12,2.75,2.25,1.61,1.0,2
Agri 1970,8,5,3,0,11,6,5,18,turkey8,0.62,1.0,5,1.38,2.25,1.61,1.0,2
Z. Komurspor,8,5,2,1,12,5,7,17,turkey8,0.62,0.88,7,1.5,2.12,1.61,1.14,3
K. Istiklalspor,8,5,1,2,19,11,8,16,turkey8,0.62,0.75,8,2.38,2.0,1.61,1.33,4
Erciyes,8,3,1,4,12,16,-4,10,turkey8,0.38,0.5,-4,1.5,1.25,2.63,2.0,5
Nigde Belediyes,8,2,2,4,8,11,-3,8,turkey8,0.25,0.5,-3,1.0,1.0,4.0,2.0,6
Edirnespor,8,2,2,4,12,16,-4,8,turkey8,0.25,0.5,-4,1.5,1.0,4.0,2.0,6
Tepecik,8,2,2,4,10,15,-5,8,turkey8,0.25,0.5,-5,1.25,1.0,4.0,2.0,6
Turgutluspor,8,2,2,4,9,15,-6,8,turkey8,0.25,0.5,-6,1.12,1.0,4.0,2.0,6
Polatli B.,8,2,1,5,9,13,-4,7,turkey8,0.25,0.38,-4,1.12,0.88,4.0,2.63,7
Orduspor 1967,8,2,1,5,10,16,-6,7,turkey8,0.25,0.38,-6,1.25,0.88,4.0,2.63,7
Denizlispor,8,0,6,2,7,9,-2,6,turkey8,0.0,0.75,-2,0.88,0.75,0.0,1.33,8
Nilufer B.,8,1,2,5,4,9,-5,5,turkey8,0.12,0.38,-5,0.5,0.62,8.33,2.63,9
Coruhlu,8,1,0,7,11,20,-9,3,turkey8,0.12,0.12,-9,1.38,0.38,8.33,8.33,10
Al Wasl,8,6,1,1,17,6,11,19,uae,0.75,0.88,11,2.12,2.38,1.33,1.14,1
Khorfakkan,8,5,2,1,12,9,3,17,uae,0.62,0.88,3,1.5,2.12,1.61,1.14,2
Al Wahda,8,4,4,0,16,8,8,16,uae,0.5,1.0,8,2.0,2.0,2.0,1.0,3
Shabab Al Ahli,8,4,3,1,13,5,8,15,uae,0.5,0.88,8,1.62,1.88,2.0,1.14,4
Al Bataeh,8,3,4,1,8,7,1,13,uae,0.38,0.88,1,1.0,1.62,2.63,1.14,5
Al Ain,8,3,2,3,13,8,5,11,uae,0.38,0.62,5,1.62,1.38,2.63,1.61,6
Al Jazira,8,2,3,3,8,13,-5,9,uae,0.25,0.62,-5,1.0,1.12,4.0,1.61,7
Bani Yas,8,3,0,5,9,17,-8,9,uae,0.38,0.38,-8,1.12,1.12,2.63,2.63,7
Al Sharjah,8,2,2,4,8,9,-1,8,uae,0.25,0.5,-1,1.0,1.0,4.0,2.0,8
Al Nasr,8,2,2,4,11,13,-2,8,uae,0.25,0.5,-2,1.38,1.0,4.0,2.0,8
Ajman,8,2,2,4,9,15,-6,8,uae,0.25,0.5,-6,1.12,1.0,4.0,2.0,8
Dibba Al Hisn,8,2,1,5,10,12,-2,7,uae,0.25,0.38,-2,1.25,0.88,4.0,2.63,9
Ittihad Kalba,8,2,1,5,7,11,-4,7,uae,0.25,0.38,-4,0.88,0.88,4.0,2.63,9
Al Urooba,8,2,1,5,7,15,-8,7,uae,0.25,0.38,-8,0.88,0.88,4.0,2.63,9
Oleksandria,8,7,1,0,14,3,11,22,ukraine,0.88,1.0,11,1.75,2.75,1.14,1.0,1
Dynamo Kyiv,8,6,2,0,19,5,14,20,ukraine,0.75,1.0,14,2.38,2.5,1.33,1.0,2
Shakhtar,8,5,2,1,18,8,10,17,ukraine,0.62,0.88,10,2.25,2.12,1.61,1.14,3
Karpaty Lviv,8,4,4,0,15,7,8,16,ukraine,0.5,1.0,8,1.88,2.0,2.0,1.0,4
Polessya,8,3,3,2,11,11,0,12,ukraine,0.38,0.75,0,1.38,1.5,2.63,1.33,5
Kryvbas KR,8,3,2,3,9,5,4,11,ukraine,0.38,0.62,4,1.12,1.38,2.63,1.61,6
Kolos Kovalivka,8,3,2,3,10,7,3,11,ukraine,0.38,0.62,3,1.25,1.38,2.63,1.61,6
Rukh Lviv,8,3,2,3,6,8,-2,11,ukraine,0.38,0.62,-2,0.75,1.38,2.63,1.61,6
Veres,8,3,1,4,9,13,-4,10,ukraine,0.38,0.5,-4,1.12,1.25,2.63,2.0,7
Obolon,8,3,1,4,7,13,-6,10,ukraine,0.38,0.5,-6,0.88,1.25,2.63,2.0,7
Vorskla Poltava,8,2,2,4,6,8,-2,8,ukraine,0.25,0.5,-2,0.75,1.0,4.0,2.0,8
Inhulets,8,2,2,4,3,8,-5,8,ukraine,0.25,0.5,-5,0.38,1.0,4.0,2.0,8
Zorya Luhansk,8,2,2,4,8,14,-6,8,ukraine,0.25,0.5,-6,1.0,1.0,4.0,2.0,8
LNZ Cherkasy,8,1,3,4,5,9,-4,6,ukraine,0.12,0.5,-4,0.62,0.75,8.33,2.0,9
Livyi Bereh,8,1,1,6,6,15,-9,4,ukraine,0.12,0.25,-9,0.75,0.5,8.33,4.0,10
Chornomorets,8,1,0,7,4,16,-12,3,ukraine,0.12,0.12,-12,0.5,0.38,8.33,8.33,11
Dnipro-1,0,0,0,0,0,0,0,0,ukraine,0.0,0.0,0,0.0,0.0,0.0,0.0,12
Nacional,8,5,2,1,20,7,13,17,uruguay,0.62,0.88,13,2.5,2.12,1.61,1.14,1
Juventud,8,5,1,2,12,7,5,16,uruguay,0.62,0.75,5,1.5,2.0,1.61,1.33,2
Liverpool M.,8,4,3,1,10,4,6,15,uruguay,0.5,0.88,6,1.25,1.88,2.0,1.14,3
Racing CM,8,4,3,1,8,4,4,15,uruguay,0.5,0.88,4,1.0,1.88,2.0,1.14,3
Penarol,8,5,0,3,10,9,1,15,uruguay,0.62,0.62,1,1.25,1.88,1.61,1.61,3
Boston River,8,5,0,3,9,9,0,15,uruguay,0.62,0.62,0,1.12,1.88,1.61,1.61,3
Defensor S.,8,3,3,2,8,6,2,12,uruguay,0.38,0.75,2,1.0,1.5,2.63,1.33,4
Progreso,8,3,3,2,9,9,0,12,uruguay,0.38,0.75,0,1.12,1.5,2.63,1.33,4
Cerro Largo,8,3,3,2,7,8,-1,12,uruguay,0.38,0.75,-1,0.88,1.5,2.63,1.33,4
Montevideo City,8,2,3,3,9,11,-2,9,uruguay,0.25,0.62,-2,1.12,1.12,4.0,1.61,5
Miramar Misione,8,2,1,5,9,14,-5,7,uruguay,0.25,0.38,-5,1.12,0.88,4.0,2.63,6
Cerro,8,1,4,3,7,12,-5,7,uruguay,0.12,0.62,-5,0.88,0.88,8.33,1.61,6
River Plate,8,2,1,5,4,9,-5,7,uruguay,0.25,0.38,-5,0.5,0.88,4.0,2.63,6
Plaza Colonia,8,1,3,4,5,8,-3,6,uruguay,0.12,0.5,-3,0.62,0.75,8.33,2.0,7
Danubio,8,0,4,4,4,9,-5,4,uruguay,0.0,0.5,-5,0.5,0.5,0.0,2.0,8
Wanderers,8,0,3,5,5,11,-6,3,uruguay,0.0,0.38,-6,0.62,0.38,0.0,2.63,9
Nacional,7,5,1,1,18,5,13,16,uruguay2,0.71,0.86,13,2.57,2.29,1.41,1.16,1
Penarol,7,4,2,1,10,5,5,14,uruguay2,0.57,0.86,5,1.43,2.0,1.75,1.16,2
Danubio,7,4,2,1,11,11,0,14,uruguay2,0.57,0.86,0,1.57,2.0,1.75,1.16,2
Wanderers,7,4,1,2,11,9,2,13,uruguay2,0.57,0.71,2,1.57,1.86,1.75,1.41,3
Defensor S.,7,3,2,2,7,5,2,11,uruguay2,0.43,0.71,2,1.0,1.57,2.33,1.41,4
Cerro Largo,7,3,2,2,6,7,-1,11,uruguay2,0.43,0.71,-1,0.86,1.57,2.33,1.41,4
Cerro,7,3,1,3,8,5,3,10,uruguay2,0.43,0.57,3,1.14,1.43,2.33,1.75,5
Fenix,7,3,1,3,10,9,1,10,uruguay2,0.43,0.57,1,1.43,1.43,2.33,1.75,5
Miramar Misione,7,3,1,3,7,10,-3,10,uruguay2,0.43,0.57,-3,1.0,1.43,2.33,1.75,5
River Plate,7,2,2,3,8,9,-1,8,uruguay2,0.29,0.57,-1,1.14,1.14,3.45,1.75,6
Progreso,7,2,2,3,8,11,-3,8,uruguay2,0.29,0.57,-3,1.14,1.14,3.45,1.75,6
Rampla Juniors,7,2,2,3,8,12,-4,8,uruguay2,0.29,0.57,-4,1.14,1.14,3.45,1.75,6
Boston River,7,2,1,4,6,8,-2,7,uruguay2,0.29,0.43,-2,0.86,1.0,3.45,2.33,7
Racing CM,7,1,3,3,8,10,-2,6,uruguay2,0.14,0.57,-2,1.14,0.86,7.14,1.75,8
D. Maldonado,7,1,3,3,5,9,-4,6,uruguay2,0.14,0.57,-4,0.71,0.86,7.14,1.75,8
Liverpool M.,7,1,0,6,4,10,-6,3,uruguay2,0.14,0.14,-6,0.57,0.43,7.14,7.14,9
Vancouver,8,5,2,1,14,6,8,17,usa,0.62,0.88,8,1.75,2.12,1.61,1.14,1
Inter Miami,8,5,2,1,14,8,6,17,usa,0.62,0.88,6,1.75,2.12,1.61,1.14,1
Columbus Crew,8,5,2,1,13,8,5,17,usa,0.62,0.88,5,1.62,2.12,1.61,1.14,1
Cincinnati,8,5,1,2,11,9,2,16,usa,0.62,0.75,2,1.38,2.0,1.61,1.33,2
Portland,8,4,3,1,19,13,6,15,usa,0.5,0.88,6,2.38,1.88,2.0,1.14,3
Charlotte,8,5,0,3,14,9,5,15,usa,0.62,0.62,5,1.75,1.88,1.61,1.61,3
New England,8,5,0,3,9,6,3,15,usa,0.62,0.62,3,1.12,1.88,1.61,1.61,3
Orlando City,8,3,5,0,11,4,7,14,usa,0.38,1.0,7,1.38,1.75,2.63,1.0,4
Nashville SC,8,4,1,3,18,12,6,13,usa,0.5,0.62,6,2.25,1.62,2.0,1.61,5
Minnesota Utd,8,3,4,1,13,9,4,13,usa,0.38,0.88,4,1.62,1.62,2.63,1.14,5
Philadelphia,8,4,1,3,11,7,4,13,usa,0.5,0.62,4,1.38,1.62,2.0,1.61,5
New York City,8,4,1,3,9,9,0,13,usa,0.5,0.62,0,1.12,1.62,2.0,1.61,5
Austin,8,4,1,3,6,11,-5,13,usa,0.5,0.62,-5,0.75,1.62,2.0,1.61,5
Seattle,8,3,3,2,10,7,3,12,usa,0.38,0.75,3,1.25,1.5,2.63,1.33,6
Los Angeles FC,8,3,2,3,13,11,2,11,usa,0.38,0.62,2,1.62,1.38,2.63,1.61,7
Colorado Rapids,8,3,2,3,11,13,-2,11,usa,0.38,0.62,-2,1.38,1.38,2.63,1.61,7
New York RB,8,3,2,3,10,12,-2,11,usa,0.38,0.62,-2,1.25,1.38,2.63,1.61,7
Dallas,8,3,2,3,8,12,-4,11,usa,0.38,0.62,-4,1.0,1.38,2.63,1.61,7
San Diego,8,3,1,4,16,14,2,10,usa,0.38,0.5,2,2.0,1.25,2.63,2.0,8
Sporting KC,8,3,1,4,15,16,-1,10,usa,0.38,0.5,-1,1.88,1.25,2.63,2.0,8
Real Salt Lake,8,3,0,5,9,10,-1,9,usa,0.38,0.38,-1,1.12,1.12,2.63,2.63,9
Houston Dynamo,8,2,3,3,8,10,-2,9,usa,0.25,0.62,-2,1.0,1.12,4.0,1.61,9
Chicago Fire,8,2,3,3,11,15,-4,9,usa,0.25,0.62,-4,1.38,1.12,4.0,1.61,9
SJ Earthquakes,8,2,1,5,18,18,0,7,usa,0.25,0.38,0,2.25,0.88,4.0,2.63,10
DC United,8,2,1,5,7,18,-11,7,usa,0.25,0.38,-11,0.88,0.88,4.0,2.63,10
Toronto,8,1,3,4,4,8,-4,6,usa,0.12,0.5,-4,0.5,0.75,8.33,2.0,11
Atlanta Utd,8,1,3,4,9,16,-7,6,usa,0.12,0.5,-7,1.12,0.75,8.33,2.0,11
St. Louis City,8,1,2,5,5,12,-7,5,usa,0.12,0.38,-7,0.62,0.62,8.33,2.63,12
LA Galaxy,8,0,3,5,7,14,-7,3,usa,0.0,0.38,-7,0.88,0.38,0.0,2.63,13
Loudoun Utd,8,6,0,2,13,7,6,18,usa2,0.75,0.75,6,1.62,2.25,1.33,1.33,1
Louisville City,7,5,2,0,12,4,8,17,usa2,0.71,1.0,8,1.71,2.43,1.41,1.0,2
San Antonio,8,5,1,2,13,9,4,16,usa2,0.62,0.75,4,1.62,2.0,1.61,1.33,3
Charleston,7,5,0,2,15,9,6,15,usa2,0.71,0.71,6,2.14,2.14,1.41,1.41,4
Monterey Bay,8,4,3,1,12,6,6,15,usa2,0.5,0.88,6,1.5,1.88,2.0,1.14,4
Detroit City,8,4,3,1,13,9,4,15,usa2,0.5,0.88,4,1.62,1.88,2.0,1.14,4
New Mexico,7,5,0,2,8,7,1,15,usa2,0.71,0.71,1,1.14,2.14,1.41,1.41,4
FC Tulsa,7,4,0,3,9,6,3,12,usa2,0.57,0.57,3,1.29,1.71,1.75,1.75,5
El Paso,8,3,3,2,15,13,2,12,usa2,0.38,0.75,2,1.88,1.5,2.63,1.33,5
North Carolina,8,3,2,3,10,9,1,11,usa2,0.38,0.62,1,1.25,1.38,2.63,1.61,6
Las Vegas L.,7,3,2,2,6,7,-1,11,usa2,0.43,0.71,-1,0.86,1.57,2.33,1.41,6
Orange County,7,3,1,3,10,12,-2,10,usa2,0.43,0.57,-2,1.43,1.43,2.33,1.75,7
Sacramento R.,7,2,3,2,9,9,0,9,usa2,0.29,0.71,0,1.29,1.29,3.45,1.41,8
Colorado S.,8,1,4,3,13,15,-2,7,usa2,0.12,0.62,-2,1.62,0.88,8.33,1.61,9
Lexington,8,1,4,3,8,10,-2,7,usa2,0.12,0.62,-2,1.0,0.88,8.33,1.61,9
Phoenix Rising,8,1,4,3,14,17,-3,7,usa2,0.12,0.62,-3,1.75,0.88,8.33,1.61,9
Pittsburgh,7,2,1,4,6,9,-3,7,usa2,0.29,0.43,-3,0.86,1.0,3.45,2.33,9
Miami FC,7,2,1,4,7,11,-4,7,usa2,0.29,0.43,-4,1.0,1.0,3.45,2.33,9
Oakland Roots,8,2,1,5,9,14,-5,7,usa2,0.25,0.38,-5,1.12,0.88,4.0,2.63,9
Indy Eleven,6,1,3,2,11,12,-1,6,usa2,0.17,0.67,-1,1.83,1.0,5.88,1.49,10
Birmingham L.,7,1,3,3,9,12,-3,6,usa2,0.14,0.57,-3,1.29,0.86,7.14,1.75,10
Rhode Island,6,1,2,3,5,8,-3,5,usa2,0.17,0.5,-3,0.83,0.83,5.88,2.0,11
Tampa Bay,7,1,1,5,7,11,-4,4,usa2,0.14,0.29,-4,1.0,0.57,7.14,3.45,12
Hartford A.,6,1,0,5,4,11,-7,3,usa2,0.17,0.17,-7,0.67,0.5,5.88,5.88,13
Spokane V.,7,4,2,1,15,6,9,14,usa3,0.57,0.86,9,2.14,2.0,1.75,1.16,1
Naples,7,4,2,1,9,3,6,14,usa3,0.57,0.86,6,1.29,2.0,1.75,1.16,1
One Knoxville,5,3,2,0,7,3,4,11,usa3,0.6,1.0,4,1.4,2.2,1.67,1.0,2
Richmond K.,8,3,2,3,17,15,2,11,usa3,0.38,0.62,2,2.12,1.38,2.63,1.61,2
Charlotte I.,6,3,2,1,9,7,2,11,usa3,0.5,0.83,2,1.5,1.83,2.0,1.2,2
Greenville,7,2,2,3,8,10,-2,8,usa3,0.29,0.57,-2,1.14,1.14,3.45,1.75,3
Tormenta,6,2,1,3,11,13,-2,7,usa3,0.33,0.5,-2,1.83,1.17,3.03,2.0,4
Chattanooga RW,5,1,3,1,6,6,0,6,usa3,0.2,0.8,0,1.2,1.2,5.0,1.25,5
Forward Madison,5,1,3,1,4,5,-1,6,usa3,0.2,0.8,-1,0.8,1.2,5.0,1.25,5
Alta,5,2,0,3,7,9,-2,6,usa3,0.4,0.4,-2,1.4,1.2,2.5,2.5,5
Westchester SC,5,1,2,2,9,11,-2,5,usa3,0.2,0.6,-2,1.8,1.0,5.0,1.67,6
Union Omaha,4,1,1,2,3,5,-2,4,usa3,0.25,0.5,-2,0.75,1.0,4.0,2.0,7
Portland Hearts,4,0,3,1,2,3,-1,3,usa3,0.0,0.75,-1,0.5,0.75,0.0,1.33,8
Texoma,6,0,1,5,6,17,-11,1,usa3,0.0,0.17,-11,1.0,0.17,0.0,5.88,9
Carabobo,8,5,3,0,8,2,6,18,venezuela,0.62,1.0,6,1.0,2.25,1.61,1.0,1
D. La Guaira,8,5,2,1,12,7,5,17,venezuela,0.62,0.88,5,1.5,2.12,1.61,1.14,2
D. Tachira,8,4,3,1,15,9,6,15,venezuela,0.5,0.88,6,1.88,1.88,2.0,1.14,3
UCV,8,4,3,1,12,8,4,15,venezuela,0.5,0.88,4,1.5,1.88,2.0,1.14,3
Monagas,8,4,2,2,15,11,4,14,venezuela,0.5,0.75,4,1.88,1.75,2.0,1.33,4
A. Anzoategui,8,3,4,1,14,11,3,13,venezuela,0.38,0.88,3,1.75,1.62,2.63,1.14,5
Puerto Cabello,8,3,3,2,7,6,1,12,venezuela,0.38,0.75,1,0.88,1.5,2.63,1.33,6
Metropolitanos,8,2,3,3,11,12,-1,9,venezuela,0.25,0.62,-1,1.38,1.12,4.0,1.61,7
Rayo Zuliano,8,3,0,5,9,11,-2,9,venezuela,0.38,0.38,-2,1.12,1.12,2.63,2.63,7
Caracas,8,2,3,3,9,12,-3,9,venezuela,0.25,0.62,-3,1.12,1.12,4.0,1.61,7
Portuguesa,8,2,2,4,10,13,-3,8,venezuela,0.25,0.5,-3,1.25,1.0,4.0,2.0,8
Yaracuyanos,8,1,2,5,8,16,-8,5,venezuela,0.12,0.38,-8,1.0,0.62,8.33,2.63,9
Zamora,8,1,1,6,5,10,-5,4,venezuela,0.12,0.25,-5,0.62,0.5,8.33,4.0,10
E. Merida,8,1,1,6,10,17,-7,4,venezuela,0.12,0.25,-7,1.25,0.5,8.33,4.0,10
AGMK,8,6,1,1,15,8,7,19,uzbekistan,0.75,0.88,7,1.88,2.38,1.33,1.14,1
Nasaf Qarshi,8,5,3,0,15,4,11,18,uzbekistan,0.62,1.0,11,1.88,2.25,1.61,1.0,2
Bunyodkor,8,4,3,1,11,5,6,15,uzbekistan,0.5,0.88,6,1.38,1.88,2.0,1.14,3
D. Samarqand,7,4,3,0,8,3,5,15,uzbekistan,0.57,1.0,5,1.14,2.14,1.75,1.0,3
Neftchi,7,3,3,1,11,10,1,12,uzbekistan,0.43,0.86,1,1.57,1.71,2.33,1.16,4
Kokand-1912,8,3,3,2,6,6,0,12,uzbekistan,0.38,0.75,0,0.75,1.5,2.63,1.33,4
Navbahor,8,3,2,3,14,11,3,11,uzbekistan,0.38,0.62,3,1.75,1.38,2.63,1.61,5
Termez Surkhon,8,3,1,4,7,10,-3,10,uzbekistan,0.38,0.5,-3,0.88,1.25,2.63,2.0,6
Qizilqum,7,3,1,3,7,11,-4,10,uzbekistan,0.43,0.57,-4,1.0,1.43,2.33,1.75,6
Mashal,8,3,1,4,5,12,-7,10,uzbekistan,0.38,0.5,-7,0.62,1.25,2.63,2.0,6
Pakhtakor,8,3,0,5,13,10,3,9,uzbekistan,0.38,0.38,3,1.62,1.12,2.63,2.63,7
Andijan,8,2,3,3,12,13,-1,9,uzbekistan,0.25,0.62,-1,1.5,1.12,4.0,1.61,7
Xorazm,7,2,2,3,6,7,-1,8,uzbekistan,0.29,0.57,-1,0.86,1.14,3.45,1.75,8
Sogdiana,8,2,1,5,9,11,-2,7,uzbekistan,0.25,0.38,-2,1.12,0.88,4.0,2.63,9
Buxoro,8,2,0,6,9,14,-5,6,uzbekistan,0.25,0.25,-5,1.12,0.75,4.0,4.0,10
Shurtan,8,0,1,7,2,15,-13,1,uzbekistan,0.0,0.12,-13,0.25,0.12,0.0,8.33,11
Nam Dinh,8,5,3,0,15,4,11,18,vietnam,0.62,1.0,11,1.88,2.25,1.61,1.0,1
Ha Noi,8,5,2,1,15,8,7,17,vietnam,0.62,0.88,7,1.88,2.12,1.61,1.14,2
Cong An Nhan,8,4,3,1,13,7,6,15,vietnam,0.5,0.88,6,1.62,1.88,2.0,1.14,3
Hong Linh Ha T.,8,4,3,1,9,5,4,15,vietnam,0.5,0.88,4,1.12,1.88,2.0,1.14,3
Hai Phong,8,4,2,2,6,4,2,14,vietnam,0.5,0.75,2,0.75,1.75,2.0,1.33,4
Viettel,8,3,2,3,15,12,3,11,vietnam,0.38,0.62,3,1.88,1.38,2.63,1.61,5
Ho Chi Minh,8,2,4,2,7,8,-1,10,vietnam,0.25,0.75,-1,0.88,1.25,4.0,1.33,6
Song Lam Nghe,8,1,5,2,6,7,-1,8,vietnam,0.12,0.75,-1,0.75,1.0,8.33,1.33,7
Thanh Hoa,8,1,4,3,9,11,-2,7,vietnam,0.12,0.62,-2,1.12,0.88,8.33,1.61,8
Gia Lai,8,2,1,5,9,12,-3,7,vietnam,0.25,0.38,-3,1.12,0.88,4.0,2.63,8
Binh Dinh,8,2,1,5,6,11,-5,7,vietnam,0.25,0.38,-5,0.75,0.88,4.0,2.63,8
Binh Duong,8,2,1,5,7,17,-10,7,vietnam,0.25,0.38,-10,0.88,0.88,4.0,2.63,8
Quang Nam,8,1,3,4,10,14,-4,6,vietnam,0.12,0.5,-4,1.25,0.75,8.33,2.0,9
Da Nang,8,1,3,4,6,14,-8,6,vietnam,0.12,0.5,-8,0.75,0.75,8.33,2.0,9
Phu Dong,8,7,1,0,17,1,16,22,vietnam2,0.88,1.0,16,2.12,2.75,1.14,1.0,1
PVF-CAND,8,6,1,1,17,7,10,19,vietnam2,0.75,0.88,10,2.12,2.38,1.33,1.14,2
Binh Phuoc,8,5,2,1,14,5,9,17,vietnam2,0.62,0.88,9,1.75,2.12,1.61,1.14,3
Dong Nai,8,2,4,2,6,3,3,10,vietnam2,0.25,0.75,3,0.75,1.25,4.0,1.33,4
Ho Chi Minh B,8,2,4,2,7,8,-1,10,vietnam2,0.25,0.75,-1,0.88,1.25,4.0,1.33,4
Dong Thap,8,2,2,4,8,8,0,8,vietnam2,0.25,0.5,0,1.0,1.0,4.0,2.0,5
Hoa Binh,8,1,5,2,6,8,-2,8,vietnam2,0.12,0.75,-2,0.75,1.0,8.33,1.33,5
Ba Ria Vung Tau,8,2,2,4,5,16,-11,8,vietnam2,0.25,0.5,-11,0.62,1.0,4.0,2.0,5
S. Khanh Hoa,8,2,1,5,5,12,-7,7,vietnam2,0.25,0.38,-7,0.62,0.88,4.0,2.63,6
Long An,8,1,3,4,2,9,-7,6,vietnam2,0.12,0.5,-7,0.25,0.75,8.33,2.0,7
Hue,8,2,0,6,6,14,-8,6,vietnam2,0.25,0.25,-8,0.75,0.75,4.0,4.0,7
The New Saints,8,7,0,1,21,4,17,21,wales,0.88,0.88,17,2.62,2.62,1.14,1.14,1
Flint,8,6,1,1,18,11,7,19,wales,0.75,0.88,7,2.25,2.38,1.33,1.14,2
Barry,8,5,1,2,18,11,7,16,wales,0.62,0.75,7,2.25,2.0,1.61,1.33,3
Connahs Quay,8,4,1,3,13,7,6,13,wales,0.5,0.62,6,1.62,1.62,2.0,1.61,4
Penybont,8,4,1,3,13,14,-1,13,wales,0.5,0.62,-1,1.62,1.62,2.0,1.61,4
Caernarfon,8,3,1,4,14,14,0,10,wales,0.38,0.5,0,1.75,1.25,2.63,2.0,5
Briton Ferry,8,3,1,4,9,15,-6,10,wales,0.38,0.5,-6,1.12,1.25,2.63,2.0,5
Cardiff MU,8,2,3,3,8,13,-5,9,wales,0.25,0.62,-5,1.0,1.12,4.0,1.61,6
Haverfordwest,8,1,4,3,7,13,-6,7,wales,0.12,0.62,-6,0.88,0.88,8.33,1.61,7
Newtown,8,1,3,4,10,16,-6,6,wales,0.12,0.5,-6,1.25,0.75,8.33,2.0,8
Bala Town,8,1,2,5,7,16,-9,5,wales,0.12,0.38,-9,0.88,0.62,8.33,2.63,9
Aberystwyth,8,1,1,6,6,14,-8,4,wales,0.12,0.25,-8,0.75,0.5,8.33,4.0,10
