Equipe,GP,W,D,L,GF,GA,GD,Pts_Overall,Liga,PIO,PIO_HA,GD_Overall,GF_AVG_Overall,Odd_Justa_MO,Odd_Justa_HA,Rank_Overall
Vllaznia S.,8,3,4,1,12,6,6,13,Albania - Abissnet Superiore,0.38,0.88,6,1.5,2.63,1.14,1
Dinamo Tirana,8,3,4,1,11,6,5,13,Albania - Abissnet Superiore,0.38,0.88,5,1.38,2.63,1.14,1
Laci,8,3,3,2,11,10,1,12,Albania - Abissnet Superiore,0.38,0.75,1,1.38,2.63,1.33,2
Skenderbeu K.,8,3,2,3,8,7,1,11,Albania - Abissnet Superiore,0.38,0.62,1,1.0,2.63,1.61,3
KF Tirana,8,2,4,2,10,10,0,10,Albania - Abissnet Superiore,0.25,0.75,0,1.25,4.0,1.33,4
AF Elbasani,8,1,5,2,7,7,0,8,Albania - Abissnet Superiore,0.12,0.75,0,0.88,8.33,1.33,5
Bylis,8,2,1,5,7,17,-10,7,Albania - Abissnet Superiore,0.25,0.38,-10,0.88,4.0,2.63,6
Partizani T.,8,1,3,4,6,12,-6,6,Albania - Abissnet Superiore,0.12,0.5,-6,0.75,8.33,2.0,7
Teuta Durres,8,1,3,4,5,11,-6,6,Albania - Abissnet Superiore,0.12,0.5,-6,0.62,8.33,2.0,7
MC Alger,8,6,2,0,17,7,10,20,Algeria - Ligue 1,0.75,1.0,10,2.12,1.33,1.0,1
JS Saoura,8,5,0,3,11,6,5,15,Algeria - Ligue 1,0.62,0.62,5,1.38,1.61,1.61,2
CR Belouizdad,8,4,2,2,10,6,4,14,Algeria - Ligue 1,0.5,0.75,4,1.25,2.0,1.33,3
El Bayadh,8,4,2,2,6,6,0,14,Algeria - Ligue 1,0.5,0.75,0,0.75,2.0,1.33,3
ASO Chlef,8,3,4,1,9,6,3,13,Algeria - Ligue 1,0.38,0.88,3,1.12,2.63,1.14,4
USM Alger,8,3,3,2,8,6,2,12,Algeria - Ligue 1,0.38,0.75,2,1.0,2.63,1.33,5
JS Kabylie,8,3,3,2,10,9,1,12,Algeria - Ligue 1,0.38,0.75,1,1.25,2.63,1.33,5
Paradou AC,8,3,1,4,10,12,-2,10,Algeria - Ligue 1,0.38,0.5,-2,1.25,2.63,2.0,6
ES Setif,8,2,3,3,4,5,-1,9,Algeria - Ligue 1,0.25,0.62,-1,0.5,4.0,1.61,7
Mostaganem,8,2,2,4,5,7,-2,8,Algeria - Ligue 1,0.25,0.5,-2,0.62,4.0,2.0,8
Khenchela,8,2,2,4,8,16,-8,8,Algeria - Ligue 1,0.25,0.5,-8,1.0,4.0,2.0,8
Biskra,8,1,4,3,2,6,-4,7,Algeria - Ligue 1,0.12,0.62,-4,0.25,8.33,1.61,9
CS Constantine,8,1,3,4,6,10,-4,6,Algeria - Ligue 1,0.12,0.5,-4,0.75,8.33,2.0,10
O. Akbou,8,0,4,4,3,7,-4,4,Algeria - Ligue 1,0.0,0.5,-4,0.38,0.0,2.0,11
NC Magra,8,0,4,4,4,9,-5,4,Algeria - Ligue 1,0.0,0.5,-5,0.5,0.0,2.0,11
MC Oran,8,1,0,7,3,13,-10,3,Algeria - Ligue 1,0.12,0.12,-10,0.38,8.33,8.33,12
Huracan,8,6,1,1,12,3,9,19,Argentina - Liga Profesional,0.75,0.88,9,1.5,1.33,1.14,1
Boca Juniors,8,6,1,1,12,5,7,19,Argentina - Liga Profesional,0.75,0.88,7,1.5,1.33,1.14,1
Tigre,8,6,0,2,11,5,6,18,Argentina - Liga Profesional,0.75,0.75,6,1.38,1.33,1.33,2
Independiente,8,5,2,1,13,6,7,17,Argentina - Liga Profesional,0.62,0.88,7,1.62,1.61,1.14,3
Defensa y J.,8,5,2,1,12,5,7,17,Argentina - Liga Profesional,0.62,0.88,7,1.5,1.61,1.14,3
Argentinos Jrs,8,5,2,1,10,6,4,17,Argentina - Liga Profesional,0.62,0.88,4,1.25,1.61,1.14,3
Estudiantes,8,4,3,1,13,8,5,15,Argentina - Liga Profesional,0.5,0.88,5,1.62,2.0,1.14,4
Rosario Central,8,4,3,1,8,4,4,15,Argentina - Liga Profesional,0.5,0.88,4,1.0,2.0,1.14,4
River Plate,8,4,3,1,6,2,4,15,Argentina - Liga Profesional,0.5,0.88,4,0.75,2.0,1.14,4
Barracas C.,8,3,4,1,12,8,4,13,Argentina - Liga Profesional,0.38,0.88,4,1.5,2.63,1.14,5
San Lorenzo,8,3,3,2,7,7,0,12,Argentina - Liga Profesional,0.38,0.75,0,0.88,2.63,1.33,6
Central Cordoba,8,3,2,3,14,11,3,11,Argentina - Liga Profesional,0.38,0.62,3,1.75,2.63,1.61,7
Gimnasia,8,3,2,3,7,6,1,11,Argentina - Liga Profesional,0.38,0.62,1,0.88,2.63,1.61,7
Godoy Cruz,8,2,5,1,6,6,0,11,Argentina - Liga Profesional,0.25,0.88,0,0.75,4.0,1.14,7
Lanus,8,2,4,2,5,4,1,10,Argentina - Liga Profesional,0.25,0.75,1,0.62,4.0,1.33,8
Racing Club,8,3,0,5,13,11,2,9,Argentina - Liga Profesional,0.38,0.38,2,1.62,2.63,2.63,9
D. Riestra,8,1,6,1,6,4,2,9,Argentina - Liga Profesional,0.12,0.88,2,0.75,8.33,1.14,9
Platense,8,2,3,3,5,6,-1,9,Argentina - Liga Profesional,0.25,0.62,-1,0.62,4.0,1.61,9
I. Rivadavia,8,2,3,3,9,11,-2,9,Argentina - Liga Profesional,0.25,0.62,-2,1.12,4.0,1.61,9
Newells,8,2,2,4,5,9,-4,8,Argentina - Liga Profesional,0.25,0.5,-4,0.62,4.0,2.0,10
Belgrano,8,2,2,4,6,15,-9,8,Argentina - Liga Profesional,0.25,0.5,-9,0.75,4.0,2.0,10
T. de Cordoba,8,1,4,3,5,7,-2,7,Argentina - Liga Profesional,0.12,0.62,-2,0.62,8.33,1.61,11
Sarmiento,8,1,4,3,6,13,-7,7,Argentina - Liga Profesional,0.12,0.62,-7,0.75,8.33,1.61,11
SM San Juan,8,1,3,4,4,7,-3,6,Argentina - Liga Profesional,0.12,0.5,-3,0.5,8.33,2.0,12
Banfield,8,1,2,5,5,7,-2,5,Argentina - Liga Profesional,0.12,0.38,-2,0.62,8.33,2.63,13
Instituto,8,1,2,5,3,8,-5,5,Argentina - Liga Profesional,0.12,0.38,-5,0.38,8.33,2.63,13
Aldosivi,8,1,2,5,8,14,-6,5,Argentina - Liga Profesional,0.12,0.38,-6,1.0,8.33,2.63,13
Union Santa Fe,8,1,2,5,3,9,-6,5,Argentina - Liga Profesional,0.12,0.38,-6,0.38,8.33,2.63,13
Velez Sarsfield,8,1,2,5,1,10,-9,5,Argentina - Liga Profesional,0.12,0.38,-9,0.12,8.33,2.63,13
CA Estudiantes,6,4,2,0,10,4,6,14,Argentina - Primera Nacional,0.67,1.0,6,1.67,1.49,1.0,1
Colon Santa Fe,6,4,1,1,7,4,3,13,Argentina - Primera Nacional,0.67,0.83,3,1.17,1.49,1.2,2
G. Mendoza,5,3,2,0,5,1,4,11,Argentina - Primera Nacional,0.6,1.0,4,1.0,1.67,1.0,3
Tristan Suarez,6,3,2,1,6,3,3,11,Argentina - Primera Nacional,0.5,0.83,3,1.0,2.0,1.2,3
SM Tucuman,6,2,4,0,4,2,2,10,Argentina - Primera Nacional,0.33,1.0,2,0.67,3.03,1.0,4
D. de Belgrano,5,2,3,0,5,1,4,9,Argentina - Primera Nacional,0.4,1.0,4,1.0,2.5,1.0,5
All Boys,6,2,3,1,7,4,3,9,Argentina - Primera Nacional,0.33,0.83,3,1.17,3.03,1.2,5
San Miguel,6,3,0,3,8,6,2,9,Argentina - Primera Nacional,0.5,0.5,2,1.33,2.0,2.0,5
Chaco For Ever,6,3,0,3,7,5,2,9,Argentina - Primera Nacional,0.5,0.5,2,1.17,2.0,2.0,5
Atlanta,5,2,3,0,3,1,2,9,Argentina - Primera Nacional,0.4,1.0,2,0.6,2.5,1.0,5
Deportivo Maipu,5,3,0,2,6,5,1,9,Argentina - Primera Nacional,0.6,0.6,1,1.2,1.67,1.67,5
Quilmes,6,2,3,1,6,5,1,9,Argentina - Primera Nacional,0.33,0.83,1,1.0,3.03,1.2,5
Racing Cordoba,5,3,0,2,7,7,0,9,Argentina - Primera Nacional,0.6,0.6,0,1.4,1.67,1.67,5
E. Rio Cuarto,5,2,2,1,6,4,2,8,Argentina - Primera Nacional,0.4,0.8,2,1.2,2.5,1.25,6
Ferro Carril,5,2,2,1,4,2,2,8,Argentina - Primera Nacional,0.4,0.8,2,0.8,2.5,1.25,6
Los Andes,5,2,2,1,6,5,1,8,Argentina - Primera Nacional,0.4,0.8,1,1.2,2.5,1.25,6
Gimnasia y Tiro,5,2,2,1,4,3,1,8,Argentina - Primera Nacional,0.4,0.8,1,0.8,2.5,1.25,6
Chacarita J.,6,2,2,2,5,5,0,8,Argentina - Primera Nacional,0.33,0.67,0,0.83,3.03,1.49,6
Central Norte,6,2,2,2,5,6,-1,8,Argentina - Primera Nacional,0.33,0.67,-1,0.83,3.03,1.49,6
San Telmo,6,2,2,2,5,6,-1,8,Argentina - Primera Nacional,0.33,0.67,-1,0.83,3.03,1.49,6
Temperley,5,2,1,2,4,4,0,7,Argentina - Primera Nacional,0.4,0.6,0,0.8,2.5,1.67,7
Agropecuario,6,2,1,3,5,7,-2,7,Argentina - Primera Nacional,0.33,0.5,-2,0.83,3.03,2.0,7
Deportivo Moron,6,1,3,2,4,4,0,6,Argentina - Primera Nacional,0.17,0.67,0,0.67,5.88,1.49,8
Gimnasia Jujuy,5,1,3,1,2,2,0,6,Argentina - Primera Nacional,0.2,0.8,0,0.4,5.0,1.25,8
Patronato,5,1,2,2,4,5,-1,5,Argentina - Primera Nacional,0.2,0.6,-1,0.8,5.0,1.67,9
Almirante Brown,5,1,2,2,6,9,-3,5,Argentina - Primera Nacional,0.2,0.6,-3,1.2,5.0,1.67,9
Nueva Chicago,6,1,2,3,4,7,-3,5,Argentina - Primera Nacional,0.17,0.5,-3,0.67,5.88,2.0,9
Defensores U.,5,1,2,2,3,6,-3,5,Argentina - Primera Nacional,0.2,0.6,-3,0.6,5.0,1.67,9
D. Madryn,5,1,1,3,4,6,-2,4,Argentina - Primera Nacional,0.2,0.4,-2,0.8,5.0,2.5,10
Argentino Merlo,8,6,1,1,15,6,9,19,Argentina - Primera B,0.75,0.88,9,1.88,1.33,1.14,1
A. Quilmes,8,5,2,1,12,4,8,17,Argentina - Primera B,0.62,0.88,8,1.5,1.61,1.14,2
Comunicaciones,8,5,2,1,12,6,6,17,Argentina - Primera B,0.62,0.88,6,1.5,1.61,1.14,2
Villa Dalmine,8,5,2,1,7,2,5,17,Argentina - Primera B,0.62,0.88,5,0.88,1.61,1.14,2
Deportivo Merlo,8,4,3,1,8,4,4,15,Argentina - Primera B,0.5,0.88,4,1.0,2.0,1.14,3
Excursionistas,8,4,2,2,16,9,7,14,Argentina - Primera B,0.5,0.75,7,2.0,2.0,1.33,4
D. Armenio,8,4,1,3,13,8,5,13,Argentina - Primera B,0.5,0.62,5,1.62,2.0,1.61,5
Colegiales,8,4,1,3,9,7,2,13,Argentina - Primera B,0.5,0.62,2,1.12,2.0,1.61,5
Midland,8,3,3,2,10,7,3,12,Argentina - Primera B,0.38,0.75,3,1.25,2.63,1.33,6
Sacachispas,8,3,2,3,4,6,-2,11,Argentina - Primera B,0.38,0.62,-2,0.5,2.63,1.61,7
Liniers,8,2,4,2,5,5,0,10,Argentina - Primera B,0.25,0.75,0,0.62,4.0,1.33,8
S. Italiano,8,2,3,3,9,9,0,9,Argentina - Primera B,0.25,0.62,0,1.12,4.0,1.61,9
Flandria,8,2,3,3,7,9,-2,9,Argentina - Primera B,0.25,0.62,-2,0.88,4.0,1.61,9
SM Burzaco,8,3,0,5,5,9,-4,9,Argentina - Primera B,0.38,0.38,-4,0.62,2.63,2.63,9
Dock Sud,8,2,2,4,5,8,-3,8,Argentina - Primera B,0.25,0.5,-3,0.62,4.0,2.0,10
Los Andes,8,2,2,4,5,9,-4,8,Argentina - Primera B,0.25,0.5,-4,0.62,4.0,2.0,10
Acassuso,8,2,2,4,5,12,-7,8,Argentina - Primera B,0.25,0.5,-7,0.62,4.0,2.0,10
UAI Urquiza,8,2,2,4,10,18,-8,8,Argentina - Primera B,0.25,0.5,-8,1.25,4.0,2.0,10
V. San Carlos,8,2,1,5,5,9,-4,7,Argentina - Primera B,0.25,0.38,-4,0.62,4.0,2.63,11
D. Laferrere,8,1,4,3,4,9,-5,7,Argentina - Primera B,0.12,0.62,-5,0.5,8.33,1.61,11
Canuelas,8,2,0,6,6,11,-5,6,Argentina - Primera B,0.25,0.25,-5,0.75,4.0,4.0,12
Fenix,8,1,1,6,5,12,-7,4,Argentina - Primera B,0.12,0.25,-7,0.62,8.33,4.0,13
Ciudad Bolivar,1,1,0,0,3,1,2,3,Argentina - Torneo Federal,1.0,1.0,2,3.0,1.0,1.0,1
D. Rincon,1,1,0,0,1,0,1,3,Argentina - Torneo Federal,1.0,1.0,1,1.0,1.0,1.0,1
J. Antoniana,1,1,0,0,1,0,1,3,Argentina - Torneo Federal,1.0,1.0,1,1.0,1.0,1.0,1
SM Mendoza,1,1,0,0,1,0,1,3,Argentina - Torneo Federal,1.0,1.0,1,1.0,1.0,1.0,1
Costa Brava,1,0,1,0,1,1,0,1,Argentina - Torneo Federal,0.0,1.0,0,1.0,0.0,1.0,2
Juventud U. U.,1,0,1,0,1,1,0,1,Argentina - Torneo Federal,0.0,1.0,0,1.0,0.0,1.0,2
Santamarina,1,0,1,0,1,1,0,1,Argentina - Torneo Federal,0.0,1.0,0,1.0,0.0,1.0,2
Villa Mitre,1,0,1,0,1,1,0,1,Argentina - Torneo Federal,0.0,1.0,0,1.0,0.0,1.0,2
9 Julio Rafaela,0,0,0,0,0,0,0,0,Argentina - Torneo Federal,0.0,0.0,0,0.0,0.0,0.0,3
A. Rafaela,0,0,0,0,0,0,0,0,Argentina - Torneo Federal,0.0,0.0,0,0.0,0.0,0.0,3
Argentino MM,0,0,0,0,0,0,0,0,Argentina - Torneo Federal,0.0,0.0,0,0.0,0.0,0.0,3
Bartolom√© Mitre,0,0,0,0,0,0,0,0,Argentina - Torneo Federal,0.0,0.0,0,0.0,0.0,0.0,3
Ben Hur,0,0,0,0,0,0,0,0,Argentina - Torneo Federal,0.0,0.0,0,0.0,0.0,0.0,3
Boca Unidos,0,0,0,0,0,0,0,0,Argentina - Torneo Federal,0.0,0.0,0,0.0,0.0,0.0,3
Circulo D.,0,0,0,0,0,0,0,0,Argentina - Torneo Federal,0.0,0.0,0,0.0,0.0,0.0,3
Crucero del N.,0,0,0,0,0,0,0,0,Argentina - Torneo Federal,0.0,0.0,0,0.0,0.0,0.0,3
D. Belgrano VR,0,0,0,0,0,0,0,0,Argentina - Torneo Federal,0.0,0.0,0,0.0,0.0,0.0,3
Douglas Haig,0,0,0,0,0,0,0,0,Argentina - Torneo Federal,0.0,0.0,0,0.0,0.0,0.0,3
El Linqueno,0,0,0,0,0,0,0,0,Argentina - Torneo Federal,0.0,0.0,0,0.0,0.0,0.0,3
Germinal,0,0,0,0,0,0,0,0,Argentina - Torneo Federal,0.0,0.0,0,0.0,0.0,0.0,3
Gimnasia Chivil,0,0,0,0,0,0,0,0,Argentina - Torneo Federal,0.0,0.0,0,0.0,0.0,0.0,3
Gimnasia E.,0,0,0,0,0,0,0,0,Argentina - Torneo Federal,0.0,0.0,0,0.0,0.0,0.0,3
Guillermo Brown,0,0,0,0,0,0,0,0,Argentina - Torneo Federal,0.0,0.0,0,0.0,0.0,0.0,3
Gutierrez,0,0,0,0,0,0,0,0,Argentina - Torneo Federal,0.0,0.0,0,0.0,0.0,0.0,3
I. Chivilcoy,0,0,0,0,0,0,0,0,Argentina - Torneo Federal,0.0,0.0,0,0.0,0.0,0.0,3
Kimberley,0,0,0,0,0,0,0,0,Argentina - Torneo Federal,0.0,0.0,0,0.0,0.0,0.0,3
Olimpo Bahia B.,0,0,0,0,0,0,0,0,Argentina - Torneo Federal,0.0,0.0,0,0.0,0.0,0.0,3
S. Belgrano,0,0,0,0,0,0,0,0,Argentina - Torneo Federal,0.0,0.0,0,0.0,0.0,0.0,3
S. Estudiantes,0,0,0,0,0,0,0,0,Argentina - Torneo Federal,0.0,0.0,0,0.0,0.0,0.0,3
Noah,8,8,0,0,34,3,31,24,Armenia - Premier League,1.0,1.0,31,4.25,1.0,1.0,1
Urartu,8,6,0,2,18,9,9,18,Armenia - Premier League,0.75,0.75,9,2.25,1.33,1.33,2
Van,8,4,2,2,14,7,7,14,Armenia - Premier League,0.5,0.75,7,1.75,2.0,1.33,3
Ararat-Armenia,8,3,3,2,13,8,5,12,Armenia - Premier League,0.38,0.75,5,1.62,2.63,1.33,4
Pyunik,8,4,0,4,14,10,4,12,Armenia - Premier League,0.5,0.5,4,1.75,2.0,2.0,4
Shirak,8,3,2,3,7,13,-6,11,Armenia - Premier League,0.38,0.62,-6,0.88,2.63,1.61,5
BKMA,8,2,3,3,11,14,-3,9,Armenia - Premier League,0.25,0.62,-3,1.38,4.0,1.61,6
West Armenia,8,2,1,5,5,21,-16,7,Armenia - Premier League,0.25,0.38,-16,0.62,4.0,2.63,7
Ararat Yerevan,8,1,3,4,5,15,-10,6,Armenia - Premier League,0.12,0.5,-10,0.62,8.33,2.0,8
Alashkert,8,0,2,6,4,17,-13,2,Armenia - Premier League,0.0,0.25,-13,0.5,0.0,4.0,9
Gandzasar,8,0,0,8,2,27,-25,0,Armenia - Premier League,0.0,0.0,-25,0.25,0.0,0.0,10
Western United,8,5,2,1,23,11,12,17,Australia - A-League,0.62,0.88,12,2.88,1.61,1.14,1
Auckland,8,4,4,0,20,11,9,16,Australia - A-League,0.5,1.0,9,2.5,2.0,1.0,2
WS Wanderers,8,5,1,2,19,11,8,16,Australia - A-League,0.62,0.75,8,2.38,1.61,1.33,2
Newcastle Jets,8,4,3,1,16,13,3,15,Australia - A-League,0.5,0.88,3,2.0,2.0,1.14,3
Melbourne V.,8,4,2,2,13,10,3,14,Australia - A-League,0.5,0.75,3,1.62,2.0,1.33,4
Sydney FC,8,3,3,2,16,11,5,12,Australia - A-League,0.38,0.75,5,2.0,2.63,1.33,5
Melbourne City,8,3,1,4,6,8,-2,10,Australia - A-League,0.38,0.5,-2,0.75,2.63,2.0,6
Brisbane Roar,8,2,3,3,11,12,-1,9,Australia - A-League,0.25,0.62,-1,1.38,4.0,1.61,7
Macarthur FC,8,2,1,5,11,16,-5,7,Australia - A-League,0.25,0.38,-5,1.38,4.0,2.63,8
Adelaide Utd,8,1,3,4,14,21,-7,6,Australia - A-League,0.12,0.5,-7,1.75,8.33,2.0,9
Wellington,8,1,3,4,5,14,-9,6,Australia - A-League,0.12,0.5,-9,0.62,8.33,2.0,9
Central Coast,8,0,5,3,8,17,-9,5,Australia - A-League,0.0,0.62,-9,1.0,0.0,1.61,10
Perth Glory,8,0,3,5,6,15,-9,3,Australia - A-League,0.0,0.38,-9,0.75,0.0,2.63,11
Avondale,6,6,0,0,20,6,14,18,Australia - NPL Victoria,1.0,1.0,14,3.33,1.0,1.0,1
Dandenong T.,6,4,1,1,10,7,3,13,Australia - NPL Victoria,0.67,0.83,3,1.67,1.49,1.2,2
Preston Lions,6,3,2,1,9,7,2,11,Australia - NPL Victoria,0.5,0.83,2,1.5,2.0,1.2,3
Oakleigh C.,6,3,1,2,11,5,6,10,Australia - NPL Victoria,0.5,0.67,6,1.83,2.0,1.49,4
Heidelberg Utd,6,3,1,2,13,9,4,10,Australia - NPL Victoria,0.5,0.67,4,2.17,2.0,1.49,4
Hume City,6,3,1,2,10,10,0,10,Australia - NPL Victoria,0.5,0.67,0,1.67,2.0,1.49,4
Dandenong City,6,1,4,1,13,10,3,7,Australia - NPL Victoria,0.17,0.83,3,2.17,5.88,1.2,5
St. Albans,6,2,1,3,11,12,-1,7,Australia - NPL Victoria,0.33,0.5,-1,1.83,3.03,2.0,5
South Melbourne,6,2,1,3,7,10,-3,7,Australia - NPL Victoria,0.33,0.5,-3,1.17,3.03,2.0,5
Melbourne K.,6,2,0,4,8,14,-6,6,Australia - NPL Victoria,0.33,0.33,-6,1.33,3.03,3.03,6
Altona Magic,6,1,2,3,3,6,-3,5,Australia - NPL Victoria,0.17,0.5,-3,0.5,5.88,2.0,7
M. Victory B,6,1,2,3,8,12,-4,5,Australia - NPL Victoria,0.17,0.5,-4,1.33,5.88,2.0,7
Green Gully,6,1,2,3,6,10,-4,5,Australia - NPL Victoria,0.17,0.5,-4,1.0,5.88,2.0,7
Port Melbourne,6,1,0,5,2,13,-11,3,Australia - NPL Victoria,0.17,0.17,-11,0.33,5.88,5.88,8
Peninsula,2,2,0,0,7,1,6,6,Australia - NPL Queensland,1.0,1.0,6,3.5,1.0,1.0,1
Gold C. Knights,2,2,0,0,5,1,4,6,Australia - NPL Queensland,1.0,1.0,4,2.5,1.0,1.0,1
Gold C. Utd,2,2,0,0,5,1,4,6,Australia - NPL Queensland,1.0,1.0,4,2.5,1.0,1.0,1
Moreton City E.,2,2,0,0,5,2,3,6,Australia - NPL Queensland,1.0,1.0,3,2.5,1.0,1.0,1
Eastern Suburbs,2,1,1,0,5,3,2,4,Australia - NPL Queensland,0.5,1.0,2,2.5,2.0,1.0,2
Q. Lions,2,1,0,1,4,3,1,3,Australia - NPL Queensland,0.5,0.5,1,2.0,2.0,2.0,3
Olympic FC,2,1,0,1,3,2,1,3,Australia - NPL Queensland,0.5,0.5,1,1.5,2.0,2.0,3
St George W.,2,0,1,1,1,3,-2,1,Australia - NPL Queensland,0.0,0.5,-2,0.5,0.0,2.0,4
Brisbane City,2,0,0,2,3,7,-4,0,Australia - NPL Queensland,0.0,0.0,-4,1.5,0.0,0.0,5
SC Wanderers,2,0,0,2,1,5,-4,0,Australia - NPL Queensland,0.0,0.0,-4,0.5,0.0,0.0,5
Wynnum Wolves,2,0,0,2,1,5,-4,0,Australia - NPL Queensland,0.0,0.0,-4,0.5,0.0,0.0,5
Brisbane Roar B,2,0,0,2,0,7,-7,0,Australia - NPL Queensland,0.0,0.0,-7,0.0,0.0,0.0,5
Wolfsberger AC,8,6,1,1,21,10,11,19,Austria - Bundesliga,0.75,0.88,11,2.62,1.33,1.14,1
Austria Wien,8,6,1,1,15,6,9,19,Austria - Bundesliga,0.75,0.88,9,1.88,1.33,1.14,1
Salzburg,8,4,4,0,15,5,10,16,Austria - Bundesliga,0.5,1.0,10,1.88,2.0,1.0,2
Sturm Graz,8,4,2,2,18,11,7,14,Austria - Bundesliga,0.5,0.75,7,2.25,2.0,1.33,3
LASK Linz,8,4,2,2,10,9,1,14,Austria - Bundesliga,0.5,0.75,1,1.25,2.0,1.33,3
BW Linz,8,4,1,3,10,10,0,13,Austria - Bundesliga,0.5,0.62,0,1.25,2.0,1.61,4
Hartberg,8,2,4,2,7,10,-3,10,Austria - Bundesliga,0.25,0.75,-3,0.88,4.0,1.33,5
Tirol,8,1,4,3,9,11,-2,7,Austria - Bundesliga,0.12,0.62,-2,1.12,8.33,1.61,6
Grazer AK,8,2,1,5,11,17,-6,7,Austria - Bundesliga,0.25,0.38,-6,1.38,4.0,2.63,6
Altach,8,1,3,4,6,15,-9,6,Austria - Bundesliga,0.12,0.5,-9,0.75,8.33,2.0,7
Rapid Wien,8,1,2,5,11,12,-1,5,Austria - Bundesliga,0.12,0.38,-1,1.38,8.33,2.63,8
A. Klagenfurt,8,1,2,5,7,15,-8,5,Austria - Bundesliga,0.12,0.38,-8,0.88,8.33,2.63,8
Ried,8,7,0,1,17,4,13,21,Austria - 2. Liga,0.88,0.88,13,2.12,1.14,1.14,1
Admira Wacker,8,6,2,0,20,8,12,20,Austria - 2. Liga,0.75,1.0,12,2.5,1.33,1.0,2
St. Polten,8,6,2,0,18,6,12,20,Austria - 2. Liga,0.75,1.0,12,2.25,1.33,1.0,2
Voitsberg,8,5,0,3,15,6,9,15,Austria - 2. Liga,0.62,0.62,9,1.88,1.61,1.61,3
Sturm Graz B,8,4,2,2,11,8,3,14,Austria - 2. Liga,0.5,0.75,3,1.38,2.0,1.33,4
First Vienna,8,4,1,3,17,12,5,13,Austria - 2. Liga,0.5,0.62,5,2.12,2.0,1.61,5
Bregenz,8,4,0,4,14,15,-1,12,Austria - 2. Liga,0.5,0.5,-1,1.75,2.0,2.0,6
Rapid Wien B,8,3,1,4,11,12,-1,10,Austria - 2. Liga,0.38,0.5,-1,1.38,2.63,2.0,7
Floridsdorfer,8,2,3,3,7,11,-4,9,Austria - 2. Liga,0.25,0.62,-4,0.88,4.0,1.61,8
Amstetten,8,2,1,5,11,13,-2,7,Austria - 2. Liga,0.25,0.38,-2,1.38,4.0,2.63,9
Stripfing,8,1,4,3,10,12,-2,7,Austria - 2. Liga,0.12,0.62,-2,1.25,8.33,1.61,9
Liefering,8,2,1,5,10,16,-6,7,Austria - 2. Liga,0.25,0.38,-6,1.25,4.0,2.63,9
Kapfenberger,8,1,3,4,10,16,-6,6,Austria - 2. Liga,0.12,0.5,-6,1.25,8.33,2.0,10
A. Lustenau,8,1,3,4,4,10,-6,6,Austria - 2. Liga,0.12,0.5,-6,0.5,8.33,2.0,10
SV Horn,8,1,2,5,4,13,-9,5,Austria - 2. Liga,0.12,0.38,-9,0.5,8.33,2.63,11
Lafnitz,8,0,3,5,5,24,-19,3,Austria - 2. Liga,0.0,0.38,-19,0.62,0.0,2.63,12
Zira,8,6,1,1,15,6,9,19,Azerbaijan - Premier League,0.75,0.88,9,1.88,1.33,1.14,1
Qarabag,8,4,2,2,15,7,8,14,Azerbaijan - Premier League,0.5,0.75,8,1.88,2.0,1.33,2
Shamakhi,8,3,2,3,7,6,1,11,Azerbaijan - Premier League,0.38,0.62,1,0.88,2.63,1.61,3
Neftci,8,3,2,3,7,7,0,11,Azerbaijan - Premier League,0.38,0.62,0,0.88,2.63,1.61,3
Turan,8,3,2,3,9,12,-3,11,Azerbaijan - Premier League,0.38,0.62,-3,1.12,2.63,1.61,3
Kapaz,8,2,3,3,5,9,-4,9,Azerbaijan - Premier League,0.25,0.62,-4,0.62,4.0,1.61,4
Sebail,8,2,3,3,4,9,-5,9,Azerbaijan - Premier League,0.25,0.62,-5,0.5,4.0,1.61,4
Sabah,8,1,5,2,8,9,-1,8,Azerbaijan - Premier League,0.12,0.75,-1,1.0,8.33,1.33,5
Araz,8,1,5,2,6,8,-2,8,Azerbaijan - Premier League,0.12,0.75,-2,0.75,8.33,1.33,5
Sumqayit,8,1,2,5,3,9,-6,5,Azerbaijan - Premier League,0.12,0.38,-6,0.38,8.33,2.63,6
Al-Muharraq,8,7,0,1,20,6,14,21,Bahrain - Premier League,0.88,0.88,14,2.5,1.14,1.14,1
Khalidiya,8,6,0,2,17,9,8,18,Bahrain - Premier League,0.75,0.75,8,2.12,1.33,1.33,2
Al Riffa,8,5,1,2,12,6,6,16,Bahrain - Premier League,0.62,0.75,6,1.5,1.61,1.33,3
Al-Najma,8,4,1,3,15,11,4,13,Bahrain - Premier League,0.5,0.62,4,1.88,2.0,1.61,4
Malkiya,8,3,4,1,7,7,0,13,Bahrain - Premier League,0.38,0.88,0,0.88,2.63,1.14,4
Al Shabbab,8,3,2,3,11,10,1,11,Bahrain - Premier League,0.38,0.62,1,1.38,2.63,1.61,5
Al Ahli M.,8,3,1,4,15,14,1,10,Bahrain - Premier League,0.38,0.5,1,1.88,2.63,2.0,6
Bahrain SC,8,2,3,3,8,11,-3,9,Bahrain - Premier League,0.25,0.62,-3,1.0,4.0,1.61,7
Manama,8,2,2,4,6,12,-6,8,Bahrain - Premier League,0.25,0.5,-6,0.75,4.0,2.0,8
Sitra,8,1,4,3,6,9,-3,7,Bahrain - Premier League,0.12,0.62,-3,0.75,8.33,1.61,9
East Riffa,8,0,4,4,4,11,-7,4,Bahrain - Premier League,0.0,0.5,-7,0.5,0.0,2.0,10
AAli FC,8,0,2,6,4,19,-15,2,Bahrain - Premier League,0.0,0.25,-15,0.5,0.0,4.0,11
Mohammedan,8,7,0,1,17,4,13,21,Bangladesh - Premier League,0.88,0.88,13,2.12,1.14,1.14,1
Bashundhara K.,8,5,2,1,22,5,17,17,Bangladesh - Premier League,0.62,0.88,17,2.75,1.61,1.14,2
Abahani,8,5,2,1,14,2,12,17,Bangladesh - Premier League,0.62,0.88,12,1.75,1.61,1.14,2
Fortis,8,3,4,1,10,5,5,13,Bangladesh - Premier League,0.38,0.88,5,1.25,2.63,1.14,3
Brothers Union,8,3,2,3,11,7,4,11,Bangladesh - Premier League,0.38,0.62,4,1.38,2.63,1.61,4
B. Police,8,3,1,4,9,13,-4,10,Bangladesh - Premier League,0.38,0.5,-4,1.12,2.63,2.0,5
Rahmatgonj,8,3,0,5,19,16,3,9,Bangladesh - Premier League,0.38,0.38,3,2.38,2.63,2.63,6
Fakirerpool,8,3,0,5,10,23,-13,9,Bangladesh - Premier League,0.38,0.38,-13,1.25,2.63,2.63,6
Dhaka Wanderers,8,1,1,6,5,27,-22,4,Bangladesh - Premier League,0.12,0.25,-22,0.62,8.33,4.0,7
Chittagong,8,1,0,7,2,17,-15,3,Bangladesh - Premier League,0.12,0.12,-15,0.25,8.33,8.33,8
Neman Grodno,1,1,0,0,3,0,3,3,Belarus - Vysshaya Liga,1.0,1.0,3,3.0,1.0,1.0,1
Naftan,1,1,0,0,2,1,1,3,Belarus - Vysshaya Liga,1.0,1.0,1,2.0,1.0,1.0,1
BATE Borisov,1,1,0,0,1,0,1,3,Belarus - Vysshaya Liga,1.0,1.0,1,1.0,1.0,1.0,1
Isloch,1,0,1,0,2,2,0,1,Belarus - Vysshaya Liga,0.0,1.0,0,2.0,0.0,1.0,2
Slavia Mozyr,1,0,1,0,2,2,0,1,Belarus - Vysshaya Liga,0.0,1.0,0,2.0,0.0,1.0,2
Gomel,1,0,1,0,1,1,0,1,Belarus - Vysshaya Liga,0.0,1.0,0,1.0,0.0,1.0,2
T. Zhodino,1,0,1,0,1,1,0,1,Belarus - Vysshaya Liga,0.0,1.0,0,1.0,0.0,1.0,2
Arsenal D.,0,0,0,0,0,0,0,0,Belarus - Vysshaya Liga,0.0,0.0,0,0.0,0.0,0.0,3
Dinamo Brest,0,0,0,0,0,0,0,0,Belarus - Vysshaya Liga,0.0,0.0,0,0.0,0.0,0.0,3
Dinamo Minsk,0,0,0,0,0,0,0,0,Belarus - Vysshaya Liga,0.0,0.0,0,0.0,0.0,0.0,3
Maxline,0,0,0,0,0,0,0,0,Belarus - Vysshaya Liga,0.0,0.0,0,0.0,0.0,0.0,3
Slutsk,0,0,0,0,0,0,0,0,Belarus - Vysshaya Liga,0.0,0.0,0,0.0,0.0,0.0,3
Smorgon,0,0,0,0,0,0,0,0,Belarus - Vysshaya Liga,0.0,0.0,0,0.0,0.0,0.0,3
FC Minsk,1,0,0,1,1,2,-1,0,Belarus - Vysshaya Liga,0.0,0.0,-1,1.0,0.0,0.0,3
Vitebsk,1,0,0,1,0,1,-1,0,Belarus - Vysshaya Liga,0.0,0.0,-1,0.0,0.0,0.0,3
Molodechno,1,0,0,1,0,3,-3,0,Belarus - Vysshaya Liga,0.0,0.0,-3,0.0,0.0,0.0,3
Maxline,8,7,0,1,22,6,16,21,Belarus - First League,0.88,0.88,16,2.75,1.14,1.14,1
Belshina,8,5,2,1,16,9,7,17,Belarus - First League,0.62,0.88,7,2.0,1.61,1.14,2
Baranovichi,8,5,1,2,14,11,3,16,Belarus - First League,0.62,0.75,3,1.75,1.61,1.33,3
Niva,8,5,0,3,12,8,4,15,Belarus - First League,0.62,0.62,4,1.5,1.61,1.61,4
Lokomotiv Gomel,8,4,2,2,14,7,7,14,Belarus - First League,0.5,0.75,7,1.75,2.0,1.33,5
Lida,8,3,4,1,15,7,8,13,Belarus - First League,0.38,0.88,8,1.88,2.63,1.14,6
Molodechno,8,4,1,3,12,9,3,13,Belarus - First League,0.5,0.62,3,1.5,2.0,1.61,6
Volna Pinsk,8,4,0,4,15,12,3,12,Belarus - First League,0.5,0.5,3,1.88,2.0,2.0,7
Bumprom,8,3,2,3,13,10,3,11,Belarus - First League,0.38,0.62,3,1.62,2.63,1.61,8
ABFF U17,8,3,2,3,5,9,-4,11,Belarus - First League,0.38,0.62,-4,0.62,2.63,1.61,8
BATE B,8,3,1,4,11,21,-10,10,Belarus - First League,0.38,0.5,-10,1.38,2.63,2.0,9
Dinamo Minsk B,8,2,3,3,11,9,2,9,Belarus - First League,0.25,0.62,2,1.38,4.0,1.61,10
Orsha,8,2,3,3,13,16,-3,9,Belarus - First League,0.25,0.62,-3,1.62,4.0,1.61,10
S. Soligorsk B,8,3,0,5,4,13,-9,9,Belarus - First League,0.38,0.38,-9,0.5,2.63,2.63,10
Slonim,8,2,2,4,4,13,-9,8,Belarus - First League,0.25,0.5,-9,0.5,4.0,2.0,11
Ostrovets,8,2,1,5,10,14,-4,7,Belarus - First League,0.25,0.38,-4,1.25,4.0,2.63,12
Energetik-BGU,8,1,2,5,8,8,0,5,Belarus - First League,0.12,0.38,0,1.0,8.33,2.63,13
T. Zhodhino B,8,1,0,7,8,25,-17,3,Belarus - First League,0.12,0.12,-17,1.0,8.33,8.33,14
KRC Genk,8,6,2,0,11,5,6,20,Belgium - Pro League,0.75,1.0,6,1.38,1.33,1.0,1
Royale Union SG,8,6,0,2,18,6,12,18,Belgium - Pro League,0.75,0.75,12,2.25,1.33,1.33,2
Anderlecht,8,5,0,3,11,6,5,15,Belgium - Pro League,0.62,0.62,5,1.38,1.61,1.61,3
Gent,8,3,5,0,10,7,3,14,Belgium - Pro League,0.38,1.0,3,1.25,2.63,1.0,4
Club Brugge,8,3,3,2,14,11,3,12,Belgium - Pro League,0.38,0.75,3,1.75,2.63,1.33,5
Antwerp,8,3,3,2,10,10,0,12,Belgium - Pro League,0.38,0.75,0,1.25,2.63,1.33,5
Westerlo,8,3,2,3,13,12,1,11,Belgium - Pro League,0.38,0.62,1,1.62,2.63,1.61,6
Charleroi,8,2,4,2,12,7,5,10,Belgium - Pro League,0.25,0.75,5,1.5,4.0,1.33,7
Standard Liege,8,3,1,4,9,14,-5,10,Belgium - Pro League,0.38,0.5,-5,1.12,2.63,2.0,7
Sint-Truiden,8,2,3,3,13,12,1,9,Belgium - Pro League,0.25,0.62,1,1.62,4.0,1.61,8
OH Leuven,8,2,3,3,6,8,-2,9,Belgium - Pro League,0.25,0.62,-2,0.75,4.0,1.61,8
Cercle Brugge,8,1,5,2,7,9,-2,8,Belgium - Pro League,0.12,0.75,-2,0.88,8.33,1.33,9
KV Mechelen,8,2,2,4,8,12,-4,8,Belgium - Pro League,0.25,0.5,-4,1.0,4.0,2.0,9
Kortrijk,8,1,2,5,9,14,-5,5,Belgium - Pro League,0.12,0.38,-5,1.12,8.33,2.63,10
Beerschot,8,1,2,5,6,15,-9,5,Belgium - Pro League,0.12,0.38,-9,0.75,8.33,2.63,10
Dender,8,1,1,6,5,16,-11,4,Belgium - Pro League,0.12,0.25,-11,0.62,8.33,4.0,11
RWDM,8,7,1,0,8,0,8,22,Belgium - Challenger Pro League,0.88,1.0,8,1.0,1.14,1.0,1
Patro Eisden,8,5,2,1,13,6,7,17,Belgium - Challenger Pro League,0.62,0.88,7,1.62,1.61,1.14,2
Beveren,8,5,2,1,15,10,5,17,Belgium - Challenger Pro League,0.62,0.88,5,1.88,1.61,1.14,2
La Louviere,8,4,3,1,16,6,10,15,Belgium - Challenger Pro League,0.5,0.88,10,2.0,2.0,1.14,3
Club Brugge B,8,5,0,3,14,9,5,15,Belgium - Challenger Pro League,0.62,0.62,5,1.75,1.61,1.61,3
Lokeren-Temse,8,4,2,2,9,11,-2,14,Belgium - Challenger Pro League,0.5,0.75,-2,1.12,2.0,1.33,4
RFC Liege,8,4,1,3,13,11,2,13,Belgium - Challenger Pro League,0.5,0.62,2,1.62,2.0,1.61,5
Zulte-Waregem,8,3,3,2,12,9,3,12,Belgium - Challenger Pro League,0.38,0.75,3,1.5,2.63,1.33,6
Lierse K.,8,3,2,3,10,7,3,11,Belgium - Challenger Pro League,0.38,0.62,3,1.25,2.63,1.61,7
Eupen,8,2,3,3,11,13,-2,9,Belgium - Challenger Pro League,0.25,0.62,-2,1.38,4.0,1.61,8
Francs Borains,8,3,0,5,8,13,-5,9,Belgium - Challenger Pro League,0.38,0.38,-5,1.0,2.63,2.63,8
Anderlecht B,8,2,2,4,17,15,2,8,Belgium - Challenger Pro League,0.25,0.5,2,2.12,4.0,2.0,9
Lommel SK,8,1,1,6,7,17,-10,4,Belgium - Challenger Pro League,0.12,0.25,-10,0.88,8.33,4.0,10
Seraing,8,0,3,5,8,17,-9,3,Belgium - Challenger Pro League,0.0,0.38,-9,1.0,0.0,2.63,11
KRC Genk B,8,0,2,6,6,17,-11,2,Belgium - Challenger Pro League,0.0,0.25,-11,0.75,0.0,4.0,12
Deinze,0,0,0,0,0,0,0,0,Belgium - Challenger Pro League,0.0,0.0,0,0.0,0.0,0.0,13
Bolivar,8,5,1,2,19,13,6,16,Bolivia - Primera Div. - Apertura,0.62,0.75,6,2.38,1.61,1.33,1
The Strongest,8,5,1,2,17,15,2,16,Bolivia - Primera Div. - Apertura,0.62,0.75,2,2.12,1.61,1.33,1
SA Bulo Bulo,8,4,2,2,15,7,8,14,Bolivia - Primera Div. - Apertura,0.5,0.75,8,1.88,2.0,1.33,2
Aurora,8,4,2,2,14,7,7,14,Bolivia - Primera Div. - Apertura,0.5,0.75,7,1.75,2.0,1.33,2
Nacional Potosi,8,4,2,2,13,11,2,14,Bolivia - Primera Div. - Apertura,0.5,0.75,2,1.62,2.0,1.33,2
U. de Vinto,8,4,2,2,8,7,1,14,Bolivia - Primera Div. - Apertura,0.5,0.75,1,1.0,2.0,1.33,2
Blooming,8,4,2,2,12,12,0,14,Bolivia - Primera Div. - Apertura,0.5,0.75,0,1.5,2.0,1.33,2
I. Petrolero,8,3,2,3,10,11,-1,11,Bolivia - Primera Div. - Apertura,0.38,0.62,-1,1.25,2.63,1.61,3
Gualberto V. SJ,8,3,2,3,12,14,-2,11,Bolivia - Primera Div. - Apertura,0.38,0.62,-2,1.5,2.63,1.61,3
Real Tomayapo,8,3,2,3,10,12,-2,11,Bolivia - Primera Div. - Apertura,0.38,0.62,-2,1.25,2.63,1.61,3
Guabira,8,3,1,4,12,11,1,10,Bolivia - Primera Div. - Apertura,0.38,0.5,1,1.5,2.63,2.0,4
Oriente P.,8,3,1,4,9,13,-4,10,Bolivia - Primera Div. - Apertura,0.38,0.5,-4,1.12,2.63,2.0,4
Royal Pari,8,2,2,4,7,10,-3,8,Bolivia - Primera Div. - Apertura,0.25,0.5,-3,0.88,4.0,2.0,5
Always Ready,8,1,3,4,6,10,-4,6,Bolivia - Primera Div. - Apertura,0.12,0.5,-4,0.75,8.33,2.0,6
Wilstermann,8,1,2,5,12,14,-2,5,Bolivia - Primera Div. - Apertura,0.12,0.38,-2,1.5,8.33,2.63,7
Santa Cruz,8,1,1,6,8,17,-9,4,Bolivia - Primera Div. - Apertura,0.12,0.25,-9,1.0,8.33,4.0,8
Bolivar,8,6,1,1,28,11,17,19,Bolivia - Primera Div. - Clausura,0.75,0.88,17,3.5,1.33,1.14,1
The Strongest,8,6,0,2,26,11,15,18,Bolivia - Primera Div. - Clausura,0.75,0.75,15,3.25,1.33,1.33,2
Always Ready,8,4,1,3,20,13,7,13,Bolivia - Primera Div. - Clausura,0.5,0.62,7,2.5,2.0,1.61,3
Gualberto V. SJ,8,4,1,3,18,12,6,13,Bolivia - Primera Div. - Clausura,0.5,0.62,6,2.25,2.0,1.61,3
Nacional Potosi,8,4,1,3,16,12,4,13,Bolivia - Primera Div. - Clausura,0.5,0.62,4,2.0,2.0,1.61,3
Royal Pari,8,4,1,3,11,10,1,13,Bolivia - Primera Div. - Clausura,0.5,0.62,1,1.38,2.0,1.61,3
Aurora,8,3,3,2,19,14,5,12,Bolivia - Primera Div. - Clausura,0.38,0.75,5,2.38,2.63,1.33,4
Real Tomayapo,8,4,0,4,14,12,2,12,Bolivia - Primera Div. - Clausura,0.5,0.5,2,1.75,2.0,2.0,4
Blooming,8,3,3,2,10,13,-3,12,Bolivia - Primera Div. - Clausura,0.38,0.75,-3,1.25,2.63,1.33,4
Guabira,8,3,2,3,10,10,0,11,Bolivia - Primera Div. - Clausura,0.38,0.62,0,1.25,2.63,1.61,5
Wilstermann,8,2,4,2,11,13,-2,10,Bolivia - Primera Div. - Clausura,0.25,0.75,-2,1.38,4.0,1.33,6
I. Petrolero,8,3,0,5,13,20,-7,9,Bolivia - Primera Div. - Clausura,0.38,0.38,-7,1.62,2.63,2.63,7
SA Bulo Bulo,8,2,2,4,14,22,-8,8,Bolivia - Primera Div. - Clausura,0.25,0.5,-8,1.75,4.0,2.0,8
Oriente P.,8,2,1,5,14,23,-9,7,Bolivia - Primera Div. - Clausura,0.25,0.38,-9,1.75,4.0,2.63,9
U. de Vinto,8,2,1,5,8,17,-9,7,Bolivia - Primera Div. - Clausura,0.25,0.38,-9,1.0,4.0,2.63,9
Santa Cruz,8,1,0,7,7,27,-20,3,Bolivia - Primera Div. - Clausura,0.12,0.12,-20,0.88,8.33,8.33,10
Corinthians,8,8,0,0,20,5,15,24,Brazil - Serie A,1.0,1.0,15,2.5,1.0,1.0,1
Botafogo,8,5,3,0,11,3,8,18,Brazil - Serie A,0.62,1.0,8,1.38,1.61,1.0,2
Flamengo,8,4,4,0,12,6,6,16,Brazil - Serie A,0.5,1.0,6,1.5,2.0,1.0,3
Vitoria,8,4,3,1,12,8,4,15,Brazil - Serie A,0.5,0.88,4,1.5,2.0,1.14,4
Internacional,8,4,1,3,12,9,3,13,Brazil - Serie A,0.5,0.62,3,1.5,2.0,1.61,5
Palmeiras,8,4,1,3,9,10,-1,13,Brazil - Serie A,0.5,0.62,-1,1.12,2.0,1.61,5
Fortaleza,8,3,3,2,14,9,5,12,Brazil - Serie A,0.38,0.75,5,1.75,2.63,1.33,6
Juventude,8,3,2,3,12,15,-3,11,Brazil - Serie A,0.38,0.62,-3,1.5,2.63,1.61,7
Bragantino,8,2,4,2,10,9,1,10,Brazil - Serie A,0.25,0.75,1,1.25,4.0,1.33,8
Gremio,8,2,4,2,11,12,-1,10,Brazil - Serie A,0.25,0.75,-1,1.38,4.0,1.33,8
Fluminense,8,2,4,2,8,9,-1,10,Brazil - Serie A,0.25,0.75,-1,1.0,4.0,1.33,8
Vasco da Gama,8,3,1,4,10,15,-5,10,Brazil - Serie A,0.38,0.5,-5,1.25,2.63,2.0,8
Sao Paulo,8,2,3,3,12,11,1,9,Brazil - Serie A,0.25,0.62,1,1.5,4.0,1.61,9
Athletico PR,8,2,2,4,8,9,-1,8,Brazil - Serie A,0.25,0.5,-1,1.0,4.0,2.0,10
Atletico GO,8,2,2,4,7,11,-4,8,Brazil - Serie A,0.25,0.5,-4,0.88,4.0,2.0,10
Cruzeiro,8,2,2,4,7,11,-4,8,Brazil - Serie A,0.25,0.5,-4,0.88,4.0,2.0,10
Bahia,8,2,1,5,9,15,-6,7,Brazil - Serie A,0.25,0.38,-6,1.12,4.0,2.63,11
Atletico MG,8,1,3,4,5,9,-4,6,Brazil - Serie A,0.12,0.5,-4,0.62,8.33,2.0,12
Cuiaba,8,0,3,5,4,9,-5,3,Brazil - Serie A,0.0,0.38,-5,0.5,0.0,2.63,13
Criciuma,8,0,2,6,5,18,-13,2,Brazil - Serie A,0.0,0.25,-13,0.62,0.0,4.0,14
Goias,8,7,1,0,17,2,15,22,Brazil - Serie B,0.88,1.0,15,2.12,1.14,1.0,1
Ceara,8,6,1,1,12,4,8,19,Brazil - Serie B,0.75,0.88,8,1.5,1.33,1.14,2
Mirassol,8,5,2,1,13,5,8,17,Brazil - Serie B,0.62,0.88,8,1.62,1.61,1.14,3
Paysandu,8,5,2,1,12,7,5,17,Brazil - Serie B,0.62,0.88,5,1.5,1.61,1.14,3
Santos,8,5,0,3,14,9,5,15,Brazil - Serie B,0.62,0.62,5,1.75,1.61,1.61,4
Operario PR,8,4,3,1,9,8,1,15,Brazil - Serie B,0.5,0.88,1,1.12,2.0,1.14,4
Sport Recife,8,4,1,3,17,9,8,13,Brazil - Serie B,0.5,0.62,8,2.12,2.0,1.61,5
America MG,8,3,2,3,12,10,2,11,Brazil - Serie B,0.38,0.62,2,1.5,2.63,1.61,6
Avai,8,3,2,3,11,10,1,11,Brazil - Serie B,0.38,0.62,1,1.38,2.63,1.61,6
Novorizontino,8,3,1,4,8,7,1,10,Brazil - Serie B,0.38,0.5,1,1.0,2.63,2.0,7
CRB,8,3,1,4,9,9,0,10,Brazil - Serie B,0.38,0.5,0,1.12,2.63,2.0,7
Botafogo SP,8,3,1,4,8,12,-4,10,Brazil - Serie B,0.38,0.5,-4,1.0,2.63,2.0,7
Amazonas,8,3,1,4,4,8,-4,10,Brazil - Serie B,0.38,0.5,-4,0.5,2.63,2.0,7
Chapecoense,8,3,1,4,7,13,-6,10,Brazil - Serie B,0.38,0.5,-6,0.88,2.63,2.0,7
Coritiba,8,3,0,5,12,15,-3,9,Brazil - Serie B,0.38,0.38,-3,1.5,2.63,2.63,8
Vila Nova,8,3,0,5,8,16,-8,9,Brazil - Serie B,0.38,0.38,-8,1.0,2.63,2.63,8
Guarani,8,2,2,4,4,10,-6,8,Brazil - Serie B,0.25,0.5,-6,0.5,4.0,2.0,9
Ituano,8,2,0,6,9,14,-5,6,Brazil - Serie B,0.25,0.25,-5,1.12,4.0,4.0,10
Brusque,8,2,0,6,4,11,-7,6,Brazil - Serie B,0.25,0.25,-7,0.5,4.0,4.0,10
Ponte Preta,8,1,0,7,5,15,-10,3,Brazil - Serie B,0.12,0.12,-10,0.62,8.33,8.33,11
Botafogo PB,8,5,2,1,15,11,4,17,Brazil - Serie C,0.62,0.88,4,1.88,1.61,1.14,1
Athletic Club,8,4,4,0,15,7,8,16,Brazil - Serie C,0.5,1.0,8,1.88,2.0,1.0,2
Ferroviaria,8,4,3,1,11,5,6,15,Brazil - Serie C,0.5,0.88,6,1.38,2.0,1.14,3
CSA,8,4,2,2,11,8,3,14,Brazil - Serie C,0.5,0.75,3,1.38,2.0,1.33,4
Sao Bernardo,8,4,2,2,9,7,2,14,Brazil - Serie C,0.5,0.75,2,1.12,2.0,1.33,4
Remo,8,4,1,3,11,7,4,13,Brazil - Serie C,0.5,0.62,4,1.38,2.0,1.61,5
Nautico,8,3,3,2,18,11,7,12,Brazil - Serie C,0.38,0.75,7,2.25,2.63,1.33,6
Ypiranga,8,3,3,2,9,9,0,12,Brazil - Serie C,0.38,0.75,0,1.12,2.63,1.33,6
Londrina,8,3,3,2,8,8,0,12,Brazil - Serie C,0.38,0.75,0,1.0,2.63,1.33,6
Caxias,8,4,0,4,7,8,-1,12,Brazil - Serie C,0.5,0.5,-1,0.88,2.0,2.0,6
Confianca,8,3,2,3,11,10,1,11,Brazil - Serie C,0.38,0.62,1,1.38,2.63,1.61,7
Volta Redonda,8,3,2,3,11,14,-3,11,Brazil - Serie C,0.38,0.62,-3,1.38,2.63,1.61,7
Floresta,8,2,4,2,7,9,-2,10,Brazil - Serie C,0.25,0.75,-2,0.88,4.0,1.33,8
Sampaio Correa,8,2,3,3,7,8,-1,9,Brazil - Serie C,0.25,0.62,-1,0.88,4.0,1.61,9
ABC,8,2,3,3,7,9,-2,9,Brazil - Serie C,0.25,0.62,-2,0.88,4.0,1.61,9
Figueirense,8,1,4,3,5,10,-5,7,Brazil - Serie C,0.12,0.62,-5,0.62,8.33,1.61,10
EC Sao Jose,8,1,3,4,5,7,-2,6,Brazil - Serie C,0.12,0.5,-2,0.62,8.33,2.0,11
Aparecidense,8,1,3,4,4,10,-6,6,Brazil - Serie C,0.12,0.5,-6,0.5,8.33,2.0,11
Tombense,8,0,5,3,7,10,-3,5,Brazil - Serie C,0.0,0.62,-3,0.88,0.0,1.61,12
Ferroviario,8,0,4,4,8,16,-8,4,Brazil - Serie C,0.0,0.5,-8,1.0,0.0,2.0,13
Nova Iguacu,8,7,1,0,11,2,9,22,Brazil - Serie D,0.88,1.0,9,1.38,1.14,1.0,1
Brasiliense,8,6,1,1,17,5,12,19,Brazil - Serie D,0.75,0.88,12,2.12,1.33,1.14,2
Maringa,8,6,1,1,16,5,11,19,Brazil - Serie D,0.75,0.88,11,2.0,1.33,1.14,2
Retro,8,6,0,2,15,6,9,18,Brazil - Serie D,0.75,0.75,9,1.88,1.33,1.33,3
Juazeirense,8,6,0,2,10,6,4,18,Brazil - Serie D,0.75,0.75,4,1.25,1.33,1.33,3
P. do Solimoes,8,5,2,1,13,8,5,17,Brazil - Serie D,0.62,0.88,5,1.62,1.61,1.14,4
America RN,8,5,2,1,9,4,5,17,Brazil - Serie D,0.62,0.88,5,1.12,1.61,1.14,4
Manauara,8,4,4,0,17,4,13,16,Brazil - Serie D,0.5,1.0,13,2.12,2.0,1.0,5
Porto Velho,8,5,1,2,21,9,12,16,Brazil - Serie D,0.62,0.75,12,2.62,1.61,1.33,5
Manaus,8,5,1,2,15,8,7,16,Brazil - Serie D,0.62,0.75,7,1.88,1.61,1.33,5
Costa Rica MS,8,5,1,2,11,5,6,16,Brazil - Serie D,0.62,0.75,6,1.38,1.61,1.33,5
Altos,8,5,1,2,12,7,5,16,Brazil - Serie D,0.62,0.75,5,1.5,1.61,1.33,5
CSE,8,5,1,2,13,9,4,16,Brazil - Serie D,0.62,0.75,4,1.62,1.61,1.33,5
Iguatu,8,5,1,2,7,3,4,16,Brazil - Serie D,0.62,0.75,4,0.88,1.61,1.33,5
Portuguesa RJ,8,4,3,1,11,3,8,15,Brazil - Serie D,0.5,0.88,8,1.38,2.0,1.14,6
Maranhao,8,4,3,1,12,5,7,15,Brazil - Serie D,0.5,0.88,7,1.5,2.0,1.14,6
Treze,8,4,3,1,12,5,7,15,Brazil - Serie D,0.5,0.88,7,1.5,2.0,1.14,6
Itabaiana,8,5,0,3,13,7,6,15,Brazil - Serie D,0.62,0.62,6,1.62,1.61,1.61,6
Mixto,8,4,3,1,11,6,5,15,Brazil - Serie D,0.5,0.88,5,1.38,2.0,1.14,6
Santo Andre,8,4,2,2,8,5,3,14,Brazil - Serie D,0.5,0.75,3,1.0,2.0,1.33,7
Brasil de P.,8,4,1,3,14,10,4,13,Brazil - Serie D,0.5,0.62,4,1.75,2.0,1.61,8
CRAC,8,3,4,1,8,4,4,13,Brazil - Serie D,0.38,0.88,4,1.0,2.63,1.14,8
Cianorte,8,4,1,3,9,7,2,13,Brazil - Serie D,0.5,0.62,2,1.12,2.0,1.61,8
Sousa,8,4,1,3,9,7,2,13,Brazil - Serie D,0.5,0.62,2,1.12,2.0,1.61,8
Real Noroeste,8,4,1,3,11,10,1,13,Brazil - Serie D,0.5,0.62,1,1.38,2.0,1.61,8
Agua Santa,8,4,1,3,6,6,0,13,Brazil - Serie D,0.5,0.62,0,0.75,2.0,1.61,8
Atletico CE,8,3,3,2,9,6,3,12,Brazil - Serie D,0.38,0.75,3,1.12,2.63,1.33,9
Itabuna,8,3,3,2,8,5,3,12,Brazil - Serie D,0.38,0.75,3,1.0,2.63,1.33,9
Cameta,8,3,3,2,12,10,2,12,Brazil - Serie D,0.38,0.75,2,1.5,2.63,1.33,9
Flamengo,8,7,1,0,22,0,22,22,Brazil - Carioca,0.88,1.0,22,2.75,1.14,1.0,1
Fluminense,8,4,3,1,12,7,5,15,Brazil - Carioca,0.5,0.88,5,1.5,2.0,1.14,2
Vasco da Gama,8,4,2,2,11,7,4,14,Brazil - Carioca,0.5,0.75,4,1.38,2.0,1.33,3
Volta Redonda,8,4,2,2,11,10,1,14,Brazil - Carioca,0.5,0.75,1,1.38,2.0,1.33,3
Sampaio Correa,8,3,3,2,11,9,2,12,Brazil - Carioca,0.38,0.75,2,1.38,2.63,1.33,4
Madureira,8,3,2,3,7,5,2,11,Brazil - Carioca,0.38,0.62,2,0.88,2.63,1.61,5
Boavista,8,1,7,0,7,5,2,10,Brazil - Carioca,0.12,1.0,2,0.88,8.33,1.0,6
Botafogo,8,3,1,4,7,8,-1,10,Brazil - Carioca,0.38,0.5,-1,0.88,2.63,2.0,6
Nova Iguacu,8,2,3,3,4,7,-3,9,Brazil - Carioca,0.25,0.62,-3,0.5,4.0,1.61,7
CFRJ . Marica,8,1,2,5,7,15,-8,5,Brazil - Carioca,0.12,0.38,-8,0.88,8.33,2.63,8
Portuguesa RJ,8,1,1,6,9,21,-12,4,Brazil - Carioca,0.12,0.25,-12,1.12,8.33,4.0,9
Bangu,8,0,3,5,4,18,-14,3,Brazil - Carioca,0.0,0.38,-14,0.5,0.0,2.63,10
Atletico MG,8,4,4,0,9,2,7,16,Brazil - Mineiro,0.5,1.0,7,1.12,2.0,1.0,1
Tombense,8,5,1,2,8,5,3,16,Brazil - Mineiro,0.62,0.75,3,1.0,1.61,1.33,1
Betim,8,4,3,1,12,5,7,15,Brazil - Mineiro,0.5,0.88,7,1.5,2.0,1.14,2
America MG,8,3,4,1,14,5,9,13,Brazil - Mineiro,0.38,0.88,9,1.75,2.63,1.14,3
Athletic Club,8,4,0,4,12,12,0,12,Brazil - Mineiro,0.5,0.5,0,1.5,2.0,2.0,4
Cruzeiro,8,3,2,3,11,9,2,11,Brazil - Mineiro,0.38,0.62,2,1.38,2.63,1.61,5
Democrata GV,8,3,2,3,8,9,-1,11,Brazil - Mineiro,0.38,0.62,-1,1.0,2.63,1.61,5
Uberlandia,8,2,3,3,10,10,0,9,Brazil - Mineiro,0.25,0.62,0,1.25,4.0,1.61,6
Itabirito,8,2,2,4,7,11,-4,8,Brazil - Mineiro,0.25,0.5,-4,0.88,4.0,2.0,7
Pouso Alegre,8,2,2,4,7,15,-8,8,Brazil - Mineiro,0.25,0.5,-8,0.88,4.0,2.0,7
Aymores,8,1,4,3,3,5,-2,7,Brazil - Mineiro,0.12,0.62,-2,0.38,8.33,1.61,8
Villa Nova,8,1,1,6,4,17,-13,4,Brazil - Mineiro,0.12,0.25,-13,0.5,8.33,4.0,9
Anapolis,8,6,0,2,13,6,7,18,Brazil - Goiano,0.75,0.75,7,1.62,1.33,1.33,1
Vila Nova,8,4,3,1,8,5,3,15,Brazil - Goiano,0.5,0.88,3,1.0,2.0,1.14,2
Atletico GO,8,4,2,2,10,6,4,14,Brazil - Goiano,0.5,0.75,4,1.25,2.0,1.33,3
CRAC,8,4,2,2,7,4,3,14,Brazil - Goiano,0.5,0.75,3,0.88,2.0,1.33,3
Goias,8,4,2,2,7,5,2,14,Brazil - Goiano,0.5,0.75,2,0.88,2.0,1.33,3
Goianesia,8,2,4,2,11,9,2,10,Brazil - Goiano,0.25,0.75,2,1.38,4.0,1.33,4
ABECAT Ouvidore,8,3,1,4,8,10,-2,10,Brazil - Goiano,0.38,0.5,-2,1.0,2.63,2.0,4
Goiatuba EC,8,2,4,2,4,6,-2,10,Brazil - Goiano,0.25,0.75,-2,0.5,4.0,1.33,4
Jataiense,8,3,0,5,10,10,0,9,Brazil - Goiano,0.38,0.38,0,1.25,2.63,2.63,5
Goiania,8,2,1,5,8,14,-6,7,Brazil - Goiano,0.25,0.38,-6,1.0,4.0,2.63,6
Aparecidense,8,1,3,4,4,7,-3,6,Brazil - Goiano,0.12,0.5,-3,0.5,8.33,2.0,7
Inhumas,8,1,2,5,5,13,-8,5,Brazil - Goiano,0.12,0.38,-8,0.62,8.33,2.63,8
Santa Cruz,8,6,1,1,13,3,10,19,Brazil - Pernambucano,0.75,0.88,10,1.62,1.33,1.14,1
Nautico,8,5,0,3,14,8,6,15,Brazil - Pernambucano,0.62,0.62,6,1.75,1.61,1.61,2
Sport Recife,8,4,2,2,16,7,9,14,Brazil - Pernambucano,0.5,0.75,9,2.0,2.0,1.33,3
Maguary PE,8,4,2,2,10,9,1,14,Brazil - Pernambucano,0.5,0.75,1,1.25,2.0,1.33,3
Retro,8,3,3,2,7,7,0,12,Brazil - Pernambucano,0.38,0.75,0,0.88,2.63,1.33,4
Decisao,8,3,3,2,10,11,-1,12,Brazil - Pernambucano,0.38,0.75,-1,1.25,2.63,1.33,4
Jaguar,8,3,1,4,10,16,-6,10,Brazil - Pernambucano,0.38,0.5,-6,1.25,2.63,2.0,5
Central,8,2,2,4,8,9,-1,8,Brazil - Pernambucano,0.25,0.5,-1,1.0,4.0,2.0,6
Afogados,8,0,4,4,4,12,-8,4,Brazil - Pernambucano,0.0,0.5,-8,0.5,0.0,2.0,7
Petrolina,8,0,2,6,3,13,-10,2,Brazil - Pernambucano,0.0,0.25,-10,0.38,0.0,4.0,8
Corinthians,8,5,3,0,13,7,6,18,Brazil - Paulista,0.62,1.0,6,1.62,1.61,1.0,1
Palmeiras,8,4,4,0,15,6,9,16,Brazil - Paulista,0.5,1.0,9,1.88,2.0,1.0,2
Ponte Preta,8,5,1,2,9,6,3,16,Brazil - Paulista,0.62,0.75,3,1.12,1.61,1.33,2
Santos,8,4,2,2,15,8,7,14,Brazil - Paulista,0.5,0.75,7,1.88,2.0,1.33,3
Bragantino,8,4,2,2,10,5,5,14,Brazil - Paulista,0.5,0.75,5,1.25,2.0,1.33,3
Sao Bernardo,8,4,2,2,12,11,1,14,Brazil - Paulista,0.5,0.75,1,1.5,2.0,1.33,3
Novorizontino,8,3,4,1,8,6,2,13,Brazil - Paulista,0.38,0.88,2,1.0,2.63,1.14,4
Portuguesa,8,2,5,1,12,10,2,11,Brazil - Paulista,0.25,0.88,2,1.5,4.0,1.14,5
Velo Clube,8,2,4,2,10,10,0,10,Brazil - Paulista,0.25,0.75,0,1.25,4.0,1.33,6
Sao Paulo,8,2,3,3,12,11,1,9,Brazil - Paulista,0.25,0.62,1,1.5,4.0,1.61,7
Botafogo SP,8,2,3,3,8,10,-2,9,Brazil - Paulista,0.25,0.62,-2,1.0,4.0,1.61,7
Mirassol,8,2,1,5,10,17,-7,7,Brazil - Paulista,0.25,0.38,-7,1.25,4.0,2.63,8
Guarani,8,1,3,4,10,13,-3,6,Brazil - Paulista,0.12,0.5,-3,1.25,8.33,2.0,9
Agua Santa,8,0,4,4,5,13,-8,4,Brazil - Paulista,0.0,0.5,-8,0.62,0.0,2.0,10
Noroeste,8,0,3,5,9,16,-7,3,Brazil - Paulista,0.0,0.38,-7,1.12,0.0,2.63,11
Inter Limeira,8,0,3,5,5,15,-10,3,Brazil - Paulista,0.0,0.38,-10,0.62,0.0,2.63,11
Treze,8,5,2,1,17,7,10,17,Brazil - Paraibano,0.62,0.88,10,2.12,1.61,1.14,1
Sousa,8,5,2,1,12,3,9,17,Brazil - Paraibano,0.62,0.88,9,1.5,1.61,1.14,1
Botafogo PB,8,5,1,2,15,6,9,16,Brazil - Paraibano,0.62,0.75,9,1.88,1.61,1.33,2
Serra Branca,8,4,2,2,20,8,12,14,Brazil - Paraibano,0.5,0.75,12,2.5,2.0,1.33,3
Campinense,8,4,2,2,14,9,5,14,Brazil - Paraibano,0.5,0.75,5,1.75,2.0,1.33,3
Pombal,8,2,3,3,7,8,-1,9,Brazil - Paraibano,0.25,0.62,-1,0.88,4.0,1.61,4
Nacional Patos,8,2,3,3,13,17,-4,9,Brazil - Paraibano,0.25,0.62,-4,1.62,4.0,1.61,4
EC de Patos,8,2,1,5,11,16,-5,7,Brazil - Paraibano,0.25,0.38,-5,1.38,4.0,2.63,5
Auto Esporte,8,1,3,4,8,15,-7,6,Brazil - Paraibano,0.12,0.5,-7,1.0,8.33,2.0,6
Picuiense,8,0,1,7,5,33,-28,1,Brazil - Paraibano,0.0,0.12,-28,0.62,0.0,8.33,7
Santa Catarina,8,4,3,1,14,9,5,15,Brazil - Catarinense,0.5,0.88,5,1.75,2.0,1.14,1
Brusque,8,4,2,2,12,6,6,14,Brazil - Catarinense,0.5,0.75,6,1.5,2.0,1.33,2
Avai,8,4,1,3,12,6,6,13,Brazil - Catarinense,0.5,0.62,6,1.5,2.0,1.61,3
Criciuma,8,3,4,1,10,4,6,13,Brazil - Catarinense,0.38,0.88,6,1.25,2.63,1.14,3
Figueirense,8,4,1,3,16,11,5,13,Brazil - Catarinense,0.5,0.62,5,2.0,2.0,1.61,3
Barra FC,8,3,3,2,6,7,-1,12,Brazil - Catarinense,0.38,0.75,-1,0.75,2.63,1.33,4
Marcilio Dias,8,2,4,2,7,8,-1,10,Brazil - Catarinense,0.25,0.75,-1,0.88,4.0,1.33,5
Concordia,8,3,1,4,8,15,-7,10,Brazil - Catarinense,0.38,0.5,-7,1.0,2.63,2.0,5
Chapecoense,8,1,6,1,10,9,1,9,Brazil - Catarinense,0.12,0.88,1,1.25,8.33,1.14,6
Joinville,8,2,3,3,9,14,-5,9,Brazil - Catarinense,0.25,0.62,-5,1.12,4.0,1.61,6
Caravaggio,8,2,1,5,5,12,-7,7,Brazil - Catarinense,0.25,0.38,-7,0.62,4.0,2.63,7
Hercilio Luz,8,1,2,5,6,13,-7,5,Brazil - Catarinense,0.12,0.38,-7,0.75,8.33,2.63,8
Internacional,8,6,2,0,16,4,12,20,Brazil - Gaucho,0.75,1.0,12,2.0,1.33,1.0,1
Juventude,8,6,1,1,14,6,8,19,Brazil - Gaucho,0.75,0.88,8,1.75,1.33,1.14,2
Gremio,8,5,2,1,19,3,16,17,Brazil - Gaucho,0.62,0.88,16,2.38,1.61,1.14,3
Caxias,8,4,2,2,8,9,-1,14,Brazil - Gaucho,0.5,0.75,-1,1.0,2.0,1.33,4
Ypiranga,8,3,3,2,6,6,0,12,Brazil - Gaucho,0.38,0.75,0,0.75,2.63,1.33,5
Guarany de Bage,8,2,3,3,6,6,0,9,Brazil - Gaucho,0.25,0.62,0,0.75,4.0,1.61,6
Sao Luiz,8,2,3,3,7,13,-6,9,Brazil - Gaucho,0.25,0.62,-6,0.88,4.0,1.61,6
Brasil de P.,8,1,4,3,5,10,-5,7,Brazil - Gaucho,0.12,0.62,-5,0.62,8.33,1.61,7
Monsoon,8,2,1,5,7,14,-7,7,Brazil - Gaucho,0.25,0.38,-7,0.88,4.0,2.63,7
Pelotas,8,1,3,4,6,13,-7,6,Brazil - Gaucho,0.12,0.5,-7,0.75,8.33,2.0,8
EC Sao Jose,8,0,5,3,5,10,-5,5,Brazil - Gaucho,0.0,0.62,-5,0.62,0.0,1.61,9
Avenida,8,0,3,5,4,9,-5,3,Brazil - Gaucho,0.0,0.38,-5,0.5,0.0,2.63,10
Levski Sofia,8,6,2,0,19,8,11,20,Bulgaria - Parva Liga,0.75,1.0,11,2.38,1.33,1.0,1
Slavia Sofia,8,5,3,0,17,11,6,18,Bulgaria - Parva Liga,0.62,1.0,6,2.12,1.61,1.0,2
Ludogorets,8,5,2,1,16,7,9,17,Bulgaria - Parva Liga,0.62,0.88,9,2.0,1.61,1.14,3
CSKA Sofia,8,4,3,1,15,7,8,15,Bulgaria - Parva Liga,0.5,0.88,8,1.88,2.0,1.14,4
Septemvri Sofia,8,4,2,2,13,8,5,14,Bulgaria - Parva Liga,0.5,0.75,5,1.62,2.0,1.33,5
Beroe,8,4,1,3,14,9,5,13,Bulgaria - Parva Liga,0.5,0.62,5,1.75,2.0,1.61,6
Cherno More,8,3,4,1,13,8,5,13,Bulgaria - Parva Liga,0.38,0.88,5,1.62,2.63,1.14,6
CSKA 1948 Sofia,8,3,3,2,10,10,0,12,Bulgaria - Parva Liga,0.38,0.75,0,1.25,2.63,1.33,7
Lok. Plovdiv,8,3,1,4,7,8,-1,10,Bulgaria - Parva Liga,0.38,0.5,-1,0.88,2.63,2.0,8
Arda,8,2,4,2,7,10,-3,10,Bulgaria - Parva Liga,0.25,0.75,-3,0.88,4.0,1.33,8
Lokomotiv Sofia,8,3,0,5,12,12,0,9,Bulgaria - Parva Liga,0.38,0.38,0,1.5,2.63,2.63,9
Spartak Varna,8,1,3,4,7,15,-8,6,Bulgaria - Parva Liga,0.12,0.5,-8,0.88,8.33,2.0,10
Botev Plovdiv,8,1,2,5,7,16,-9,5,Bulgaria - Parva Liga,0.12,0.38,-9,0.88,8.33,2.63,11
L. Krumovgrad,8,0,4,4,1,7,-6,4,Bulgaria - Parva Liga,0.0,0.5,-6,0.12,0.0,2.0,12
Hebar,8,1,1,6,8,20,-12,4,Bulgaria - Parva Liga,0.12,0.25,-12,1.0,8.33,4.0,12
Botev Vratsa,8,0,2,6,5,18,-13,2,Bulgaria - Parva Liga,0.0,0.25,-13,0.62,0.0,4.0,13
Coquimbo Unido,5,3,2,0,7,2,5,11,Chile - Primera Division,0.6,1.0,5,1.4,1.67,1.0,1
Huachipato,5,3,1,1,9,4,5,10,Chile - Primera Division,0.6,0.8,5,1.8,1.67,1.25,2
Audax Italiano,5,3,1,1,11,7,4,10,Chile - Primera Division,0.6,0.8,4,2.2,1.67,1.25,2
Palestino,4,3,0,1,8,4,4,9,Chile - Primera Division,0.75,0.75,4,2.0,1.33,1.33,3
U. de Chile,4,2,1,1,8,3,5,7,Chile - Primera Division,0.5,0.75,5,2.0,2.0,1.33,4
Union La Calera,4,2,1,1,7,3,4,7,Chile - Primera Division,0.5,0.75,4,1.75,2.0,1.33,4
Cobresal,4,2,1,1,7,5,2,7,Chile - Primera Division,0.5,0.75,2,1.75,2.0,1.33,4
U. Catolica,4,2,1,1,5,3,2,7,Chile - Primera Division,0.5,0.75,2,1.25,2.0,1.33,4
Colo-Colo,4,2,0,2,6,4,2,6,Chile - Primera Division,0.5,0.5,2,1.5,2.0,2.0,5
OHiggins,4,1,3,0,4,3,1,6,Chile - Primera Division,0.25,1.0,1,1.0,4.0,1.0,5
Nublense,4,1,2,1,4,8,-4,5,Chile - Primera Division,0.25,0.75,-4,1.0,4.0,1.33,6
La Serena,4,1,1,2,4,7,-3,4,Chile - Primera Division,0.25,0.5,-3,1.0,4.0,2.0,7
D. Limache,5,0,2,3,6,10,-4,2,Chile - Primera Division,0.0,0.4,-4,1.2,0.0,2.5,8
Everton,5,0,2,3,2,9,-7,2,Chile - Primera Division,0.0,0.4,-7,0.4,0.0,2.5,8
D. Iquique,4,0,0,4,3,11,-8,0,Chile - Primera Division,0.0,0.0,-8,0.75,0.0,0.0,9
Union Espanola,3,0,0,3,0,8,-8,0,Chile - Primera Division,0.0,0.0,-8,0.0,0.0,0.0,9
Copiapo,4,2,2,0,7,3,4,8,Chile - Primera B,0.5,1.0,4,1.75,2.0,1.0,1
S. Wanderers,3,2,1,0,5,0,5,7,Chile - Primera B,0.67,1.0,5,1.67,1.49,1.0,2
U. Concepcion,4,2,1,1,5,3,2,7,Chile - Primera B,0.5,0.75,2,1.25,2.0,1.33,2
San Luis,4,1,3,0,5,4,1,6,Chile - Primera B,0.25,1.0,1,1.25,4.0,1.0,3
Recoleta,3,2,0,1,4,5,-1,6,Chile - Primera B,0.67,0.67,-1,1.33,1.49,1.49,3
S. Morning,3,1,2,0,4,3,1,5,Chile - Primera B,0.33,1.0,1,1.33,3.03,1.0,4
Curico Unido,3,1,2,0,3,2,1,5,Chile - Primera B,0.33,1.0,1,1.0,3.03,1.0,4
Rangers,4,1,2,1,6,6,0,5,Chile - Primera B,0.25,0.75,0,1.5,4.0,1.33,4
Deportes Temuco,3,1,1,1,5,5,0,4,Chile - Primera B,0.33,0.67,0,1.67,3.03,1.49,5
San Marcos,3,1,1,1,3,3,0,4,Chile - Primera B,0.33,0.67,0,1.0,3.03,1.49,5
Antofagasta,3,1,1,1,3,5,-2,4,Chile - Primera B,0.33,0.67,-2,1.0,3.03,1.49,5
Magallanes,3,1,0,2,4,3,1,3,Chile - Primera B,0.33,0.33,1,1.33,3.03,3.03,6
Cobreloa,4,0,3,1,3,5,-2,3,Chile - Primera B,0.0,0.75,-2,0.75,0.0,1.33,6
Concepcion,3,0,1,2,3,6,-3,1,Chile - Primera B,0.0,0.33,-3,1.0,0.0,3.03,7
U. San Felipe,4,0,1,3,2,5,-3,1,Chile - Primera B,0.0,0.25,-3,0.5,0.0,4.0,7
CD Santa Cruz,3,0,1,2,3,7,-4,1,Chile - Primera B,0.0,0.33,-4,1.0,0.0,3.03,7
Shanghai Port,2,2,0,0,5,1,4,6,China - Super League,1.0,1.0,4,2.5,1.0,1.0,1
Shandong T.,2,1,1,0,4,1,3,4,China - Super League,0.5,1.0,3,2.0,2.0,1.0,2
Beijing Guoan,2,1,1,0,4,2,2,4,China - Super League,0.5,1.0,2,2.0,2.0,1.0,2
Qingdao West C.,2,1,1,0,4,2,2,4,China - Super League,0.5,1.0,2,2.0,2.0,1.0,2
Meizhou Hakka,2,1,1,0,4,3,1,4,China - Super League,0.5,1.0,1,2.0,2.0,1.0,2
S. Shenhua,2,1,1,0,4,3,1,4,China - Super League,0.5,1.0,1,2.0,2.0,1.0,2
Tianjin T.,2,1,1,0,4,3,1,4,China - Super League,0.5,1.0,1,2.0,2.0,1.0,2
Chengdu,2,1,0,1,2,2,0,3,China - Super League,0.5,0.5,0,1.0,2.0,2.0,3
Sichuan Jiuniu,2,1,0,1,2,3,-1,3,China - Super League,0.5,0.5,-1,1.0,2.0,2.0,3
Zhejiang,2,0,2,0,2,2,0,2,China - Super League,0.0,1.0,0,1.0,0.0,1.0,4
Qingdao Hainiu,2,0,1,1,2,3,-1,1,China - Super League,0.0,0.5,-1,1.0,0.0,2.0,5
Henan SL,2,0,1,1,1,2,-1,1,China - Super League,0.0,0.5,-1,0.5,0.0,2.0,5
Yunnan Yukun,2,0,1,1,1,3,-2,1,China - Super League,0.0,0.5,-2,0.5,0.0,2.0,5
Dalian Yingbo,2,0,1,1,2,5,-3,1,China - Super League,0.0,0.5,-3,1.0,0.0,2.0,5
Changchun Yatai,2,0,0,2,1,4,-3,0,China - Super League,0.0,0.0,-3,0.5,0.0,0.0,6
Wuhan Three T.,2,0,0,2,0,3,-3,0,China - Super League,0.0,0.0,-3,0.0,0.0,0.0,6
Guangdong GZP,1,1,0,0,4,0,4,3,China - League One,1.0,1.0,4,4.0,1.0,1.0,1
Liaoning Tieren,1,1,0,0,3,0,3,3,China - League One,1.0,1.0,3,3.0,1.0,1.0,1
Nantong Zhiyun,1,1,0,0,1,0,1,3,China - League One,1.0,1.0,1,1.0,1.0,1.0,1
Chongqing T.,1,0,1,0,1,1,0,1,China - League One,0.0,1.0,0,1.0,0.0,1.0,2
Qingdao RL,1,0,1,0,1,1,0,1,China - League One,0.0,1.0,0,1.0,0.0,1.0,2
Dalian Kuncheng,0,0,0,0,0,0,0,0,China - League One,0.0,0.0,0,0.0,0.0,0.0,3
Foshan Nanshi,0,0,0,0,0,0,0,0,China - League One,0.0,0.0,0,0.0,0.0,0.0,3
Heilongjiang IC,0,0,0,0,0,0,0,0,China - League One,0.0,0.0,0,0.0,0.0,0.0,3
Nanjing City,0,0,0,0,0,0,0,0,China - League One,0.0,0.0,0,0.0,0.0,0.0,3
S. Gongfu,0,0,0,0,0,0,0,0,China - League One,0.0,0.0,0,0.0,0.0,0.0,3
Shaanxi Union,0,0,0,0,0,0,0,0,China - League One,0.0,0.0,0,0.0,0.0,0.0,3
Shenzhen J.,0,0,0,0,0,0,0,0,China - League One,0.0,0.0,0,0.0,0.0,0.0,3
Suzhou Dongwu,0,0,0,0,0,0,0,0,China - League One,0.0,0.0,0,0.0,0.0,0.0,3
Shanghai Jiadin,1,0,0,1,0,1,-1,0,China - League One,0.0,0.0,-1,0.0,0.0,0.0,3
Guangxi Baoyun,1,0,0,1,0,3,-3,0,China - League One,0.0,0.0,-3,0.0,0.0,0.0,3
Yanbian Longdin,1,0,0,1,0,4,-4,0,China - League One,0.0,0.0,-4,0.0,0.0,0.0,3
Dalian Kuncheng,8,6,0,2,10,3,7,18,China - League Two,0.75,0.75,7,1.25,1.33,1.33,1
Shenzhen J.,8,5,1,2,9,5,4,16,China - League Two,0.62,0.75,4,1.12,1.61,1.33,2
Langfang Glory,8,4,2,2,10,4,6,14,China - League Two,0.5,0.75,6,1.25,2.0,1.33,3
Xian Ronghai,8,4,2,2,13,8,5,14,China - League Two,0.5,0.75,5,1.62,2.0,1.33,3
Shaanxi Union,8,4,2,2,10,7,3,14,China - League Two,0.5,0.75,3,1.25,2.0,1.33,3
Jiangxi DH,8,4,1,3,11,5,6,13,China - League Two,0.5,0.62,6,1.38,2.0,1.61,4
Ganzhou Ruishi,8,3,4,1,14,11,3,13,China - League Two,0.38,0.88,3,1.75,2.63,1.14,4
Guangxi Lanhang,8,3,4,1,14,13,1,13,China - League Two,0.38,0.88,1,1.75,2.63,1.14,4
Haikou M.,8,4,1,3,12,13,-1,13,China - League Two,0.5,0.62,-1,1.5,2.0,1.61,4
Guangdong GZP,8,3,3,2,9,6,3,12,China - League Two,0.38,0.75,3,1.12,2.63,1.33,5
Rizhao Yuqi,8,3,3,2,12,10,2,12,China - League Two,0.38,0.75,2,1.5,2.63,1.33,5
Shandong T. B,8,4,0,4,12,11,1,12,China - League Two,0.5,0.5,1,1.5,2.0,2.0,5
Guangxi H.,8,3,0,5,8,12,-4,9,China - League Two,0.38,0.38,-4,1.0,2.63,2.63,6
Hunan Billows,8,2,3,3,8,14,-6,9,China - League Two,0.25,0.62,-6,1.0,4.0,1.61,6
Beijing IT,8,2,2,4,8,11,-3,8,China - League Two,0.25,0.5,-3,1.0,4.0,2.0,7
Taian Tiankuang,8,2,2,4,10,14,-4,8,China - League Two,0.25,0.5,-4,1.25,4.0,2.0,7
Quanzhou Yassin,8,2,2,4,6,12,-6,8,China - League Two,0.25,0.5,-6,0.75,4.0,2.0,7
Hubei Istar,8,1,3,4,11,14,-3,6,China - League Two,0.12,0.5,-3,1.38,8.33,2.0,8
Shanghai Port B,8,2,0,6,7,13,-6,6,China - League Two,0.25,0.25,-6,0.88,4.0,4.0,8
Nantong Haimen,8,0,3,5,8,16,-8,3,China - League Two,0.0,0.38,-8,1.0,0.0,2.63,9
I. Medelin,8,5,3,0,11,2,9,18,Colombia - Primera A - Apertura,0.62,1.0,9,1.38,1.61,1.0,1
A. Nacional,8,5,2,1,18,6,12,17,Colombia - Primera A - Apertura,0.62,0.88,12,2.25,1.61,1.14,2
America de Cali,8,5,2,1,16,5,11,17,Colombia - Primera A - Apertura,0.62,0.88,11,2.0,1.61,1.14,2
Deportivo Pasto,8,5,1,2,10,5,5,16,Colombia - Primera A - Apertura,0.62,0.75,5,1.25,1.61,1.33,3
Santa Fe,8,4,3,1,14,6,8,15,Colombia - Primera A - Apertura,0.5,0.88,8,1.75,2.0,1.14,4
Junior,8,3,4,1,10,6,4,13,Colombia - Primera A - Apertura,0.38,0.88,4,1.25,2.63,1.14,5
Deportes Tolima,8,3,4,1,8,4,4,13,Colombia - Primera A - Apertura,0.38,0.88,4,1.0,2.63,1.14,5
Deportivo Cali,8,3,4,1,7,4,3,13,Colombia - Primera A - Apertura,0.38,0.88,3,0.88,2.63,1.14,5
Millonarios,8,4,1,3,12,10,2,13,Colombia - Primera A - Apertura,0.5,0.62,2,1.5,2.0,1.61,5
Once Caldas,8,4,0,4,9,10,-1,12,Colombia - Primera A - Apertura,0.5,0.5,-1,1.12,2.0,2.0,6
A. Petrolera,8,3,3,2,8,10,-2,12,Colombia - Primera A - Apertura,0.38,0.75,-2,1.0,2.63,1.33,6
D. Pereira,8,3,2,3,6,8,-2,11,Colombia - Primera A - Apertura,0.38,0.62,-2,0.75,2.63,1.61,7
Boyaca Chico,8,2,3,3,5,11,-6,9,Colombia - Primera A - Apertura,0.25,0.62,-6,0.62,4.0,1.61,8
Llaneros,8,2,2,4,10,13,-3,8,Colombia - Primera A - Apertura,0.25,0.5,-3,1.25,4.0,2.0,9
Fortaleza CEIF,8,2,2,4,6,13,-7,8,Colombia - Primera A - Apertura,0.25,0.5,-7,0.75,4.0,2.0,9
Envigado,8,2,1,5,6,15,-9,7,Colombia - Primera A - Apertura,0.25,0.38,-9,0.75,4.0,2.63,10
A. Bucaramanga,8,1,3,4,3,9,-6,6,Colombia - Primera A - Apertura,0.12,0.5,-6,0.38,8.33,2.0,11
R. Aguilas,7,0,4,3,5,8,-3,4,Colombia - Primera A - Apertura,0.0,0.57,-3,0.71,0.0,1.75,12
Union Magdalena,8,0,4,4,5,11,-6,4,Colombia - Primera A - Apertura,0.0,0.5,-6,0.62,0.0,2.0,12
La Equidad,8,0,2,6,4,10,-6,2,Colombia - Primera A - Apertura,0.0,0.25,-6,0.5,0.0,4.0,13
I. Medelin,8,5,2,1,15,6,9,17,Colombia - Primera A - Clausura,0.62,0.88,9,1.88,1.61,1.14,1
Millonarios,8,5,2,1,11,4,7,17,Colombia - Primera A - Clausura,0.62,0.88,7,1.38,1.61,1.14,1
Junior,8,4,3,1,11,4,7,15,Colombia - Primera A - Clausura,0.5,0.88,7,1.38,2.0,1.14,2
Santa Fe,8,4,3,1,12,6,6,15,Colombia - Primera A - Clausura,0.5,0.88,6,1.5,2.0,1.14,2
D. Pereira,8,4,3,1,12,9,3,15,Colombia - Primera A - Clausura,0.5,0.88,3,1.5,2.0,1.14,2
Deportes Tolima,8,4,2,2,9,4,5,14,Colombia - Primera A - Clausura,0.5,0.75,5,1.12,2.0,1.33,3
Deportivo Pasto,8,4,1,3,14,11,3,13,Colombia - Primera A - Clausura,0.5,0.62,3,1.75,2.0,1.61,4
A. Nacional,8,3,4,1,9,7,2,13,Colombia - Primera A - Clausura,0.38,0.88,2,1.12,2.63,1.14,4
A. Bucaramanga,8,3,3,2,12,7,5,12,Colombia - Primera A - Clausura,0.38,0.75,5,1.5,2.63,1.33,5
America de Cali,8,3,2,3,10,10,0,11,Colombia - Primera A - Clausura,0.38,0.62,0,1.25,2.63,1.61,6
Fortaleza CEIF,8,3,1,4,9,8,1,10,Colombia - Primera A - Clausura,0.38,0.5,1,1.12,2.63,2.0,7
La Equidad,8,2,3,3,12,13,-1,9,Colombia - Primera A - Clausura,0.25,0.62,-1,1.5,4.0,1.61,8
Patriotas,8,2,2,4,12,14,-2,8,Colombia - Primera A - Clausura,0.25,0.5,-2,1.5,4.0,2.0,9
Deportivo Cali,8,2,2,4,5,9,-4,8,Colombia - Primera A - Clausura,0.25,0.5,-4,0.62,4.0,2.0,9
A. Petrolera,8,2,2,4,7,12,-5,8,Colombia - Primera A - Clausura,0.25,0.5,-5,0.88,4.0,2.0,9
Jaguares de C.,8,2,2,4,7,14,-7,8,Colombia - Primera A - Clausura,0.25,0.5,-7,0.88,4.0,2.0,9
Envigado,8,2,1,5,5,9,-4,7,Colombia - Primera A - Clausura,0.25,0.38,-4,0.62,4.0,2.63,10
Boyaca Chico,8,2,1,5,5,15,-10,7,Colombia - Primera A - Clausura,0.25,0.38,-10,0.62,4.0,2.63,10
Once Caldas,8,1,2,5,4,12,-8,5,Colombia - Primera A - Clausura,0.12,0.38,-8,0.5,8.33,2.63,11
R. Aguilas,8,1,1,6,4,15,-11,4,Colombia - Primera A - Clausura,0.12,0.25,-11,0.5,8.33,4.0,12
Saprissa,8,5,2,1,13,7,6,17,Costa Rica - Primera Div. - Apertura,0.62,0.88,6,1.62,1.61,1.14,1
Alajuelense,8,5,1,2,13,6,7,16,Costa Rica - Primera Div. - Apertura,0.62,0.75,7,1.62,1.61,1.33,2
Santos Guapiles,8,5,1,2,14,8,6,16,Costa Rica - Primera Div. - Apertura,0.62,0.75,6,1.75,1.61,1.33,2
Guanacasteca,8,4,1,3,11,11,0,13,Costa Rica - Primera Div. - Apertura,0.5,0.62,0,1.38,2.0,1.61,3
Herediano,8,3,3,2,11,9,2,12,Costa Rica - Primera Div. - Apertura,0.38,0.75,2,1.38,2.63,1.33,4
San Carlos,8,2,5,1,11,11,0,11,Costa Rica - Primera Div. - Apertura,0.25,0.88,0,1.38,4.0,1.14,5
Cartagines,8,3,1,4,15,18,-3,10,Costa Rica - Primera Div. - Apertura,0.38,0.5,-3,1.88,2.63,2.0,6
Zeledon,8,3,1,4,9,12,-3,10,Costa Rica - Primera Div. - Apertura,0.38,0.5,-3,1.12,2.63,2.0,6
M. Liberia,8,2,2,4,9,11,-2,8,Costa Rica - Primera Div. - Apertura,0.25,0.5,-2,1.12,4.0,2.0,7
Sporting SJ,8,2,1,5,10,11,-1,7,Costa Rica - Primera Div. - Apertura,0.25,0.38,-1,1.25,4.0,2.63,8
Santa Ana,8,2,1,5,7,11,-4,7,Costa Rica - Primera Div. - Apertura,0.25,0.38,-4,0.88,4.0,2.63,8
Puntarenas,8,2,1,5,8,16,-8,7,Costa Rica - Primera Div. - Apertura,0.25,0.38,-8,1.0,4.0,2.63,8
Banik Ostrava,8,7,0,1,14,3,11,21,CzechRepublic - 1. Liga,0.88,0.88,11,1.75,1.14,1.14,1
Sparta Prague,8,7,0,1,16,6,10,21,CzechRepublic - 1. Liga,0.88,0.88,10,2.0,1.14,1.14,1
Slavia Prague,8,6,0,2,11,5,6,18,CzechRepublic - 1. Liga,0.75,0.75,6,1.38,1.33,1.33,2
Viktoria Plzen,8,5,1,2,18,10,8,16,CzechRepublic - 1. Liga,0.62,0.75,8,2.25,1.61,1.33,3
Sigma Olomouc,8,5,0,3,15,8,7,15,CzechRepublic - 1. Liga,0.62,0.62,7,1.88,1.61,1.61,4
Jablonec,8,4,2,2,16,9,7,14,CzechRepublic - 1. Liga,0.5,0.75,7,2.0,2.0,1.33,5
Hradec Kralove,8,3,3,2,12,9,3,12,CzechRepublic - 1. Liga,0.38,0.75,3,1.5,2.63,1.33,6
Bohemians,8,3,3,2,9,9,0,12,CzechRepublic - 1. Liga,0.38,0.75,0,1.12,2.63,1.33,6
Teplice,8,3,2,3,7,8,-1,11,CzechRepublic - 1. Liga,0.38,0.62,-1,0.88,2.63,1.61,7
Slovan Liberec,8,2,4,2,8,7,1,10,CzechRepublic - 1. Liga,0.25,0.75,1,1.0,4.0,1.33,8
Dukla Praha,8,1,5,2,5,7,-2,8,CzechRepublic - 1. Liga,0.12,0.75,-2,0.62,8.33,1.33,9
Karvina,8,1,4,3,10,15,-5,7,CzechRepublic - 1. Liga,0.12,0.62,-5,1.25,8.33,1.61,10
Mlada Boleslav,8,2,0,6,9,14,-5,6,CzechRepublic - 1. Liga,0.25,0.25,-5,1.12,4.0,4.0,11
Slovacko,8,1,2,5,6,14,-8,5,CzechRepublic - 1. Liga,0.12,0.38,-8,0.75,8.33,2.63,12
Pardubice,8,0,2,6,1,16,-15,2,CzechRepublic - 1. Liga,0.0,0.25,-15,0.12,0.0,4.0,13
C. Budejovice,8,0,1,7,6,23,-17,1,CzechRepublic - 1. Liga,0.0,0.12,-17,0.75,0.0,8.33,14
FC Kobenhavn,8,4,4,0,12,7,5,16,Denmark - Superligaen,0.5,1.0,5,1.5,2.0,1.0,1
Nordsjaelland,8,5,1,2,14,11,3,16,Denmark - Superligaen,0.62,0.75,3,1.75,1.61,1.33,1
FC Midtjylland,8,5,0,3,12,9,3,15,Denmark - Superligaen,0.62,0.62,3,1.5,1.61,1.61,2
Randers FC,8,4,2,2,14,8,6,14,Denmark - Superligaen,0.5,0.75,6,1.75,2.0,1.33,3
AGF Aarhus,8,3,4,1,14,7,7,13,Denmark - Superligaen,0.38,0.88,7,1.75,2.63,1.14,4
Brondby IF,8,3,4,1,18,12,6,13,Denmark - Superligaen,0.38,0.88,6,2.25,2.63,1.14,4
Silkeborg,8,3,2,3,11,8,3,11,Denmark - Superligaen,0.38,0.62,3,1.38,2.63,1.61,5
Viborg,8,2,2,4,9,14,-5,8,Denmark - Superligaen,0.25,0.5,-5,1.12,4.0,2.0,6
Lyngby,8,1,3,4,6,10,-4,6,Denmark - Superligaen,0.12,0.5,-4,0.75,8.33,2.0,7
SonderjyskE,8,1,3,4,11,18,-7,6,Denmark - Superligaen,0.12,0.5,-7,1.38,8.33,2.0,7
Vejle BK,8,1,3,4,9,17,-8,6,Denmark - Superligaen,0.12,0.5,-8,1.12,8.33,2.0,7
Aalborg BK,8,0,4,4,7,16,-9,4,Denmark - Superligaen,0.0,0.5,-9,0.88,0.0,2.0,8
AC Horsens,8,5,1,2,17,11,6,16,Denmark - 1st Division,0.62,0.75,6,2.12,1.61,1.33,1
Hillerod,8,4,3,1,15,8,7,15,Denmark - 1st Division,0.5,0.88,7,1.88,2.0,1.14,2
Kolding IF,8,4,2,2,8,4,4,14,Denmark - 1st Division,0.5,0.75,4,1.0,2.0,1.33,3
Hvidovre,8,4,1,3,7,6,1,13,Denmark - 1st Division,0.5,0.62,1,0.88,2.0,1.61,4
Odense BK,8,2,6,0,14,10,4,12,Denmark - 1st Division,0.25,1.0,4,1.75,4.0,1.0,5
Fredericia,8,4,0,4,11,9,2,12,Denmark - 1st Division,0.5,0.5,2,1.38,2.0,2.0,5
Esbjerg,8,4,0,4,10,9,1,12,Denmark - 1st Division,0.5,0.5,1,1.25,2.0,2.0,5
HB Koge,8,3,3,2,8,11,-3,12,Denmark - 1st Division,0.38,0.75,-3,1.0,2.63,1.33,5
Hobro,8,2,2,4,9,12,-3,8,Denmark - 1st Division,0.25,0.5,-3,1.12,4.0,2.0,6
Vendsyssel,8,1,3,4,8,11,-3,6,Denmark - 1st Division,0.12,0.5,-3,1.0,8.33,2.0,7
Roskilde,8,2,0,6,7,13,-6,6,Denmark - 1st Division,0.25,0.25,-6,0.88,4.0,4.0,7
B 93,8,1,3,4,10,20,-10,6,Denmark - 1st Division,0.12,0.5,-10,1.25,8.33,2.0,7
Aarhus Fremad,8,5,1,2,11,5,6,16,Denmark - 2nd Division,0.62,0.75,6,1.38,1.61,1.33,1
Naestved,8,5,1,2,9,6,3,16,Denmark - 2nd Division,0.62,0.75,3,1.12,1.61,1.33,1
Fremad Amager,8,4,1,3,8,6,2,13,Denmark - 2nd Division,0.5,0.62,2,1.0,2.0,1.61,2
AB Copenhagen,8,3,3,2,11,7,4,12,Denmark - 2nd Division,0.38,0.75,4,1.38,2.63,1.33,3
Skive,8,2,4,2,10,11,-1,10,Denmark - 2nd Division,0.25,0.75,-1,1.25,4.0,1.33,4
Ishoj,8,2,4,2,7,8,-1,10,Denmark - 2nd Division,0.25,0.75,-1,0.88,4.0,1.33,4
Thisted,8,2,3,3,12,12,0,9,Denmark - 2nd Division,0.25,0.62,0,1.5,4.0,1.61,5
BK Frem,8,2,3,3,9,10,-1,9,Denmark - 2nd Division,0.25,0.62,-1,1.12,4.0,1.61,5
Middelfart,8,2,3,3,10,12,-2,9,Denmark - 2nd Division,0.25,0.62,-2,1.25,4.0,1.61,5
Nykobing,8,2,2,4,11,11,0,8,Denmark - 2nd Division,0.25,0.5,0,1.38,4.0,2.0,6
Helsingor,8,1,5,2,6,9,-3,8,Denmark - 2nd Division,0.12,0.75,-3,0.75,8.33,1.33,6
Hellerup IK,8,2,2,4,4,11,-7,8,Denmark - 2nd Division,0.25,0.5,-7,0.5,4.0,2.0,6
Libertad,5,3,1,1,10,7,3,10,Ecuador - Liga Pro 1st Stage,0.6,0.8,3,2.0,1.67,1.25,1
U. Catolica,5,2,3,0,10,3,7,9,Ecuador - Liga Pro 1st Stage,0.4,1.0,7,2.0,2.5,1.0,2
Barcelona SC,4,3,0,1,8,7,1,9,Ecuador - Liga Pro 1st Stage,0.75,0.75,1,2.0,1.33,1.33,2
LDU Quito,4,2,2,0,8,1,7,8,Ecuador - Liga Pro 1st Stage,0.5,1.0,7,2.0,2.0,1.0,3
Macara,4,2,2,0,4,2,2,8,Ecuador - Liga Pro 1st Stage,0.5,1.0,2,1.0,2.0,1.0,3
Cuniburo,5,2,2,1,7,6,1,8,Ecuador - Liga Pro 1st Stage,0.4,0.8,1,1.4,2.5,1.25,3
Mushuc Runa,5,2,1,2,7,5,2,7,Ecuador - Liga Pro 1st Stage,0.4,0.6,2,1.4,2.5,1.67,4
D. Cuenca,5,2,1,2,4,4,0,7,Ecuador - Liga Pro 1st Stage,0.4,0.6,0,0.8,2.5,1.67,4
Orense,5,2,0,3,5,11,-6,6,Ecuador - Liga Pro 1st Stage,0.4,0.4,-6,1.0,2.5,2.5,5
I. del Valle,4,1,2,1,6,4,2,5,Ecuador - Liga Pro 1st Stage,0.25,0.75,2,1.5,4.0,1.33,6
Aucas,4,1,2,1,7,6,1,5,Ecuador - Liga Pro 1st Stage,0.25,0.75,1,1.75,4.0,1.33,6
Delfin,5,1,2,2,4,7,-3,5,Ecuador - Liga Pro 1st Stage,0.2,0.6,-3,0.8,5.0,1.67,6
Manta,5,1,1,3,9,13,-4,4,Ecuador - Liga Pro 1st Stage,0.2,0.4,-4,1.8,5.0,2.5,7
El Nacional,4,0,2,2,4,6,-2,2,Ecuador - Liga Pro 1st Stage,0.0,0.5,-2,1.0,0.0,2.0,8
Tecnico U.,4,0,2,2,4,8,-4,2,Ecuador - Liga Pro 1st Stage,0.0,0.5,-4,1.0,0.0,2.0,8
Emelec,4,0,1,3,1,8,-7,1,Ecuador - Liga Pro 1st Stage,0.0,0.25,-7,0.25,0.0,4.0,9
22 de Julio,0,0,0,0,0,0,0,0,Ecuador - Serie B,0.0,0.0,0,0.0,0.0,0.0,1
Chacaritas,0,0,0,0,0,0,0,0,Ecuador - Serie B,0.0,0.0,0,0.0,0.0,0.0,1
Cumbaya,0,0,0,0,0,0,0,0,Ecuador - Serie B,0.0,0.0,0,0.0,0.0,0.0,1
Gualaceo,0,0,0,0,0,0,0,0,Ecuador - Serie B,0.0,0.0,0,0.0,0.0,0.0,1
Guayaquil City,0,0,0,0,0,0,0,0,Ecuador - Serie B,0.0,0.0,0,0.0,0.0,0.0,1
I. Juniors,0,0,0,0,0,0,0,0,Ecuador - Serie B,0.0,0.0,0,0.0,0.0,0.0,1
Imbabura,0,0,0,0,0,0,0,0,Ecuador - Serie B,0.0,0.0,0,0.0,0.0,0.0,1
Leones Norte,0,0,0,0,0,0,0,0,Ecuador - Serie B,0.0,0.0,0,0.0,0.0,0.0,1
Nueve Octubre,0,0,0,0,0,0,0,0,Ecuador - Serie B,0.0,0.0,0,0.0,0.0,0.0,1
San Antonio,0,0,0,0,0,0,0,0,Ecuador - Serie B,0.0,0.0,0,0.0,0.0,0.0,1
Vargas Torres,0,0,0,0,0,0,0,0,Ecuador - Serie B,0.0,0.0,0,0.0,0.0,0.0,1
Vinotinto,0,0,0,0,0,0,0,0,Ecuador - Serie B,0.0,0.0,0,0.0,0.0,0.0,1
Pyramids FC,8,7,1,0,15,3,12,22,Egypt - Premier League,0.88,1.0,12,1.88,1.14,1.0,1
Al Ahly,8,6,1,1,14,6,8,19,Egypt - Premier League,0.75,0.88,8,1.75,1.33,1.14,2
Zamalek,8,4,3,1,12,6,6,15,Egypt - Premier League,0.5,0.88,6,1.5,2.0,1.14,3
National Bank,8,4,3,1,14,9,5,15,Egypt - Premier League,0.5,0.88,5,1.75,2.0,1.14,3
El Gouna,8,4,2,2,9,4,5,14,Egypt - Premier League,0.5,0.75,5,1.12,2.0,1.33,4
Pharco,8,4,2,2,9,7,2,14,Egypt - Premier League,0.5,0.75,2,1.12,2.0,1.33,4
Al Masry,8,3,4,1,10,5,5,13,Egypt - Premier League,0.38,0.88,5,1.25,2.63,1.14,5
ZED FC,8,2,5,1,11,7,4,11,Egypt - Premier League,0.25,0.88,4,1.38,4.0,1.14,6
Haras El Hodood,8,3,1,4,8,10,-2,10,Egypt - Premier League,0.38,0.5,-2,1.0,2.63,2.0,7
El Geish,8,2,3,3,6,8,-2,9,Egypt - Premier League,0.25,0.62,-2,0.75,4.0,1.61,8
Ghazl El M.,8,3,0,5,9,12,-3,9,Egypt - Premier League,0.38,0.38,-3,1.12,2.63,2.63,8
Petrojet,8,2,3,3,9,12,-3,9,Egypt - Premier League,0.25,0.62,-3,1.12,4.0,1.61,8
Smouha,8,3,0,5,4,11,-7,9,Egypt - Premier League,0.38,0.38,-7,0.5,2.63,2.63,8
Ceramica C.,8,2,2,4,10,11,-1,8,Egypt - Premier League,0.25,0.5,-1,1.25,4.0,2.0,9
Modern Sport,8,1,2,5,8,13,-5,5,Egypt - Premier League,0.12,0.38,-5,1.0,8.33,2.63,10
Al Ittihad,8,1,2,5,6,12,-6,5,Egypt - Premier League,0.12,0.38,-6,0.75,8.33,2.63,10
ENPPI,8,1,2,5,5,13,-8,5,Egypt - Premier League,0.12,0.38,-8,0.62,8.33,2.63,10
Ismaily,8,1,2,5,4,14,-10,5,Egypt - Premier League,0.12,0.38,-10,0.5,8.33,2.63,10
Liverpool,8,6,2,0,19,7,12,20,Premier League,0.75,1.0,12,2.38,1.33,1.0,1
Crystal Palace,8,6,0,2,15,5,10,18,Premier League,0.75,0.75,10,1.88,1.33,1.33,3
Brighton,8,5,1,2,16,13,3,16,Premier League,0.62,0.75,3,2.0,1.61,1.33,5
Arsenal,8,4,3,1,13,6,7,15,Premier League,0.5,0.88,7,1.62,2.0,1.14,6
Everton,8,3,5,0,14,8,6,14,Premier League,0.38,1.0,6,1.75,2.63,1.0,7
Manchester City,8,4,1,3,17,11,6,13,Premier League,0.5,0.62,6,2.12,2.0,1.61,8
Nottm Forest,8,4,1,3,19,15,4,13,Premier League,0.5,0.62,4,2.38,2.0,1.61,8
Chelsea,8,4,1,3,14,12,2,13,Premier League,0.5,0.62,2,1.75,2.0,1.61,8
Brentford,8,4,1,3,10,8,2,13,Premier League,0.5,0.62,2,1.25,2.0,1.61,8
Fulham,8,4,0,4,11,11,0,12,Premier League,0.5,0.5,0,1.38,2.0,2.0,9
Newcastle Utd,8,4,0,4,13,16,-3,12,Premier League,0.5,0.5,-3,1.62,2.0,2.0,9
Manchester Utd,8,3,2,3,11,12,-1,11,Premier League,0.38,0.62,-1,1.38,2.63,1.61,10
Bournemouth,8,3,1,4,16,11,5,10,Premier League,0.38,0.5,5,2.0,2.63,2.0,11
Tottenham,8,3,1,4,13,11,2,10,Premier League,0.38,0.5,2,1.62,2.63,2.0,11
Wolverhampton,8,3,1,4,9,10,-1,10,Premier League,0.38,0.5,-1,1.12,2.63,2.0,11
Aston Villa,8,2,4,2,10,13,-3,10,Premier League,0.25,0.75,-3,1.25,4.0,1.33,11
West Ham Utd,8,2,2,4,6,8,-2,8,Premier League,0.25,0.5,-2,0.75,4.0,2.0,12
Southampton,8,1,0,7,8,23,-15,3,Premier League,0.12,0.12,-15,1.0,8.33,8.33,15
Leicester City,8,1,0,7,2,18,-16,3,Premier League,0.12,0.12,-16,0.25,8.33,8.33,15
Ipswich Town,8,0,1,7,8,25,-17,1,Premier League,0.0,0.12,-17,1.0,0.0,8.33,16
Burnley,8,6,2,0,16,2,14,20,Premier League,0.75,1.0,14,2.0,1.33,1.0,1
Sheffield Utd,8,6,1,1,12,7,5,19,Premier League,0.75,0.88,5,1.5,1.33,1.14,2
Coventry City,8,6,0,2,14,10,4,18,Premier League,0.75,0.75,4,1.75,1.33,1.33,3
Leeds Utd,8,5,2,1,16,6,10,17,Premier League,0.62,0.88,10,2.0,1.61,1.14,4
Bristol City,8,4,3,1,11,6,5,15,Premier League,0.5,0.88,5,1.38,2.0,1.14,6
West Brom,8,3,4,1,9,7,2,13,Premier League,0.38,0.88,2,1.12,2.63,1.14,8
Portsmouth,8,4,0,4,10,9,1,12,Premier League,0.5,0.5,1,1.25,2.0,2.0,9
Hull City,8,3,3,2,8,7,1,12,Premier League,0.38,0.75,1,1.0,2.63,1.33,9
Sunderland,8,3,2,3,10,11,-1,11,Premier League,0.38,0.62,-1,1.25,2.63,1.61,10
Derby County,8,3,2,3,8,10,-2,11,Premier League,0.38,0.62,-2,1.0,2.63,1.61,10
Watford,8,3,2,3,7,9,-2,11,Premier League,0.38,0.62,-2,0.88,2.63,1.61,10
Millwall,8,3,2,3,7,12,-5,11,Premier League,0.38,0.62,-5,0.88,2.63,1.61,10
Preston,8,2,4,2,6,6,0,10,Premier League,0.25,0.75,0,0.75,4.0,1.33,11
Middlesbrough,8,3,1,4,8,9,-1,10,Premier League,0.38,0.5,-1,1.0,2.63,2.0,11
Swansea City,8,3,1,4,6,7,-1,10,Premier League,0.38,0.5,-1,0.75,2.63,2.0,11
Sheffield Wed,8,3,1,4,11,13,-2,10,Premier League,0.38,0.5,-2,1.38,2.63,2.0,11
Cardiff City,8,2,2,4,9,11,-2,8,Premier League,0.25,0.5,-2,1.12,4.0,2.0,12
Plymouth,8,2,2,4,11,14,-3,8,Premier League,0.25,0.5,-3,1.38,4.0,2.0,12
Luton Town,8,2,2,4,4,11,-7,8,Premier League,0.25,0.5,-7,0.5,4.0,2.0,12
QP Rangers,8,2,1,5,11,11,0,7,Premier League,0.25,0.38,0,1.38,4.0,2.63,13
Norwich City,8,1,4,3,11,12,-1,7,Premier League,0.12,0.62,-1,1.38,8.33,1.61,13
Blackburn,8,2,1,5,8,11,-3,7,Premier League,0.25,0.38,-3,1.0,4.0,2.63,13
Stoke City,8,2,1,5,9,14,-5,7,Premier League,0.25,0.38,-5,1.12,4.0,2.63,13
Oxford Utd,8,1,2,5,5,11,-6,5,Premier League,0.12,0.38,-6,0.62,8.33,2.63,14
Charlton,8,6,1,1,11,4,7,19,League One,0.75,0.88,7,1.38,1.33,1.14,1
Birmingham City,8,5,2,1,9,5,4,17,League One,0.62,0.88,4,1.12,1.61,1.14,2
Bolton,8,5,1,2,16,12,4,16,League One,0.62,0.75,4,2.0,1.61,1.33,3
Wrexham,8,5,1,2,8,5,3,16,League One,0.62,0.75,3,1.0,1.61,1.33,3
Stockport,8,4,3,1,9,6,3,15,League One,0.5,0.88,3,1.12,2.0,1.14,4
Reading,8,3,5,0,9,5,4,14,League One,0.38,1.0,4,1.12,2.63,1.0,5
Blackpool,8,3,3,2,13,9,4,12,League One,0.38,0.75,4,1.62,2.63,1.33,6
Huddersfield,8,4,0,4,11,8,3,12,League One,0.5,0.5,3,1.38,2.0,2.0,6
Peterborough,8,3,3,2,9,8,1,12,League One,0.38,0.75,1,1.12,2.63,1.33,6
Northampton,8,3,3,2,9,9,0,12,League One,0.38,0.75,0,1.12,2.63,1.33,6
Exeter City,8,3,3,2,8,9,-1,12,League One,0.38,0.75,-1,1.0,2.63,1.33,6
Burton Albion,8,3,2,3,8,9,-1,11,League One,0.38,0.62,-1,1.0,2.63,1.61,7
Lincoln City,8,3,1,4,18,11,7,10,League One,0.38,0.5,7,2.25,2.63,2.0,8
Wycombe,8,2,4,2,7,5,2,10,League One,0.25,0.75,2,0.88,4.0,1.33,8
Bristol Rovers,8,3,1,4,10,15,-5,10,League One,0.38,0.5,-5,1.25,2.63,2.0,8
Stevenage,8,2,3,3,7,8,-1,9,League One,0.25,0.62,-1,0.88,4.0,1.61,9
Wigan Athletic,8,2,3,3,6,8,-2,9,League One,0.25,0.62,-2,0.75,4.0,1.61,9
Leyton Orient,8,3,0,5,10,13,-3,9,League One,0.38,0.38,-3,1.25,2.63,2.63,9
Barnsley,8,3,0,5,10,14,-4,9,League One,0.38,0.38,-4,1.25,2.63,2.63,9
Rotherham,8,2,2,4,7,9,-2,8,League One,0.25,0.5,-2,0.88,4.0,2.0,10
Mansfield,8,1,4,3,8,13,-5,7,League One,0.12,0.62,-5,1.0,8.33,1.61,11
Cambridge Utd,8,2,0,6,5,10,-5,6,League One,0.25,0.25,-5,0.62,4.0,4.0,12
Crawley Town,8,0,3,5,6,18,-12,3,League One,0.0,0.38,-12,0.75,0.0,2.63,13
Shrewsbury,8,0,2,6,4,13,-9,2,League One,0.0,0.25,-9,0.5,0.0,4.0,14
Colchester Utd,8,5,3,0,10,3,7,18,League Two,0.62,1.0,7,1.25,1.61,1.0,1
Bradford,8,5,1,2,9,3,6,16,League Two,0.62,0.75,6,1.12,1.61,1.33,2
Bromley,8,5,1,2,9,5,4,16,League Two,0.62,0.75,4,1.12,1.61,1.33,2
Grimsby,8,4,2,2,11,9,2,14,League Two,0.5,0.75,2,1.38,2.0,1.33,3
Swindon Town,8,3,4,1,17,12,5,13,League Two,0.38,0.88,5,2.12,2.63,1.14,4
Port Vale,8,3,4,1,12,8,4,13,League Two,0.38,0.88,4,1.5,2.63,1.14,4
Barrow,8,4,1,3,13,11,2,13,League Two,0.5,0.62,2,1.62,2.0,1.61,4
Chesterfield,8,4,0,4,15,12,3,12,League Two,0.5,0.5,3,1.88,2.0,2.0,5
Cheltenham,8,3,3,2,14,13,1,12,League Two,0.38,0.75,1,1.75,2.63,1.33,5
AFC Wimbledon,8,3,2,3,7,6,1,11,League Two,0.38,0.62,1,0.88,2.63,1.61,6
Doncaster,8,3,2,3,12,12,0,11,League Two,0.38,0.62,0,1.5,2.63,1.61,6
Harrogate,8,3,2,3,5,8,-3,11,League Two,0.38,0.62,-3,0.62,2.63,1.61,6
Accrington,8,3,1,4,11,9,2,10,League Two,0.38,0.5,2,1.38,2.63,2.0,7
Walsall,8,2,4,2,12,11,1,10,League Two,0.25,0.75,1,1.5,4.0,1.33,7
Tranmere,8,2,4,2,7,7,0,10,League Two,0.25,0.75,0,0.88,4.0,1.33,7
Gillingham,8,2,4,2,6,7,-1,10,League Two,0.25,0.75,-1,0.75,4.0,1.33,7
Newport,8,3,1,4,8,14,-6,10,League Two,0.38,0.5,-6,1.0,2.63,2.0,7
Fleetwood,8,2,3,3,10,11,-1,9,League Two,0.25,0.62,-1,1.25,4.0,1.61,8
Crewe Alexandra,8,2,3,3,9,13,-4,9,League Two,0.25,0.62,-4,1.12,4.0,1.61,8
Notts County,8,2,2,4,9,11,-2,8,League Two,0.25,0.5,-2,1.12,4.0,2.0,9
Salford City,8,2,2,4,8,12,-4,8,League Two,0.25,0.5,-4,1.0,4.0,2.0,9
Morecambe,8,2,1,5,6,10,-4,7,League Two,0.25,0.38,-4,0.75,4.0,2.63,10
Carlisle Utd,8,1,3,4,4,7,-3,6,League Two,0.12,0.5,-3,0.5,8.33,2.0,11
Milton Keynes,8,1,1,6,4,13,-9,4,League Two,0.12,0.25,-9,0.5,8.33,4.0,12
Barnet,8,7,1,0,20,2,18,22,England - National League,0.88,1.0,18,2.5,1.14,1.0,1
Halifax Town,8,5,2,1,12,7,5,17,England - National League,0.62,0.88,5,1.5,1.61,1.14,2
Boston Utd,8,4,2,2,12,7,5,14,England - National League,0.5,0.75,5,1.5,2.0,1.33,3
Southend Utd,8,3,5,0,15,11,4,14,England - National League,0.38,1.0,4,1.88,2.63,1.0,3
Aldershot Town,8,4,2,2,14,11,3,14,England - National League,0.5,0.75,3,1.75,2.0,1.33,3
York City,8,4,2,2,12,9,3,14,England - National League,0.5,0.75,3,1.5,2.0,1.33,3
Tamworth,8,3,4,1,15,10,5,13,England - National League,0.38,0.88,5,1.88,2.63,1.14,4
Rochdale,8,3,4,1,11,8,3,13,England - National League,0.38,0.88,3,1.38,2.63,1.14,4
Eastleigh,8,3,3,2,12,9,3,12,England - National League,0.38,0.75,3,1.5,2.63,1.33,5
Braintree Town,8,3,2,3,11,10,1,11,England - National League,0.38,0.62,1,1.38,2.63,1.61,6
AFC Fylde,8,3,2,3,9,10,-1,11,England - National League,0.38,0.62,-1,1.12,2.63,1.61,6
Forest Green,8,2,4,2,9,9,0,10,England - National League,0.25,0.75,0,1.12,4.0,1.33,7
Woking,8,2,4,2,9,11,-2,10,England - National League,0.25,0.75,-2,1.12,4.0,1.33,7
Altrincham,8,3,1,4,10,13,-3,10,England - National League,0.38,0.5,-3,1.25,2.63,2.0,7
Wealdstone,8,3,1,4,13,20,-7,10,England - National League,0.38,0.5,-7,1.62,2.63,2.0,7
Oldham,8,1,5,2,6,8,-2,8,England - National League,0.12,0.75,-2,0.75,8.33,1.33,8
Gateshead FC,8,2,2,4,10,13,-3,8,England - National League,0.25,0.5,-3,1.25,4.0,2.0,8
Maidenhead Utd,8,2,2,4,7,11,-4,8,England - National League,0.25,0.5,-4,0.88,4.0,2.0,8
Yeovil Town,8,2,1,5,7,15,-8,7,England - National League,0.25,0.38,-8,0.88,4.0,2.63,9
Sutton Utd,8,1,3,4,8,13,-5,6,England - National League,0.12,0.5,-5,1.0,8.33,2.0,10
Solihull Moors,8,1,2,5,7,14,-7,5,England - National League,0.12,0.38,-7,0.88,8.33,2.63,11
Ebbsfleet Utd,8,1,2,5,6,13,-7,5,England - National League,0.12,0.38,-7,0.75,8.33,2.63,11
Hartlepool,8,0,4,4,8,12,-4,4,England - National League,0.0,0.5,-4,1.0,0.0,2.0,12
Dagenham & R.,8,0,3,5,6,15,-9,3,England - National League,0.0,0.38,-9,0.75,0.0,2.63,13
Marine,8,6,1,1,11,5,6,19,England - National L. North,0.75,0.88,6,1.38,1.33,1.14,1
Scunthorpe,8,5,3,0,11,3,8,18,England - National L. North,0.62,1.0,8,1.38,1.61,1.0,2
Kidderminster,8,5,1,2,21,7,14,16,England - National L. North,0.62,0.75,14,2.62,1.61,1.33,3
Spennymoor,8,5,1,2,14,6,8,16,England - National L. North,0.62,0.75,8,1.75,1.61,1.33,3
Brackley Town,8,5,1,2,16,9,7,16,England - National L. North,0.62,0.75,7,2.0,1.61,1.33,3
Chester,8,4,3,1,13,6,7,15,England - National L. North,0.5,0.88,7,1.62,2.0,1.14,4
Peterborough S.,8,4,3,1,13,8,5,15,England - National L. North,0.5,0.88,5,1.62,2.0,1.14,4
Curzon,8,4,2,2,10,6,4,14,England - National L. North,0.5,0.75,4,1.25,2.0,1.33,5
Hereford Utd,8,4,1,3,11,9,2,13,England - National L. North,0.5,0.62,2,1.38,2.0,1.61,6
Scarborough,8,4,0,4,13,9,4,12,England - National L. North,0.5,0.5,4,1.62,2.0,2.0,7
South Shields,8,4,0,4,11,16,-5,12,England - National L. North,0.5,0.5,-5,1.38,2.0,2.0,7
Buxton,8,3,2,3,12,6,6,11,England - National L. North,0.38,0.62,6,1.5,2.63,1.61,8
Radcliffe,8,3,1,4,11,10,1,10,England - National L. North,0.38,0.5,1,1.38,2.63,2.0,9
Chorley,8,3,1,4,13,14,-1,10,England - National L. North,0.38,0.5,-1,1.62,2.63,2.0,9
Southport,8,3,1,4,6,7,-1,10,England - National L. North,0.38,0.5,-1,0.75,2.63,2.0,9
Kings Lynn,8,3,1,4,7,10,-3,10,England - National L. North,0.38,0.5,-3,0.88,2.63,2.0,9
Darlington,8,3,1,4,9,13,-4,10,England - National L. North,0.38,0.5,-4,1.12,2.63,2.0,9
Leamington,8,2,3,3,8,10,-2,9,England - National L. North,0.25,0.62,-2,1.0,4.0,1.61,10
Needham Market,8,2,2,4,8,12,-4,8,England - National L. North,0.25,0.5,-4,1.0,4.0,2.0,11
Warrington,8,1,2,5,8,14,-6,5,England - National L. North,0.12,0.38,-6,1.0,8.33,2.63,12
Rushall,8,1,1,6,4,19,-15,4,England - National L. North,0.12,0.25,-15,0.5,8.33,4.0,13
Oxford City,8,0,3,5,4,18,-14,3,England - National L. North,0.0,0.38,-14,0.5,0.0,2.63,14
Alfreton Town,8,0,2,6,5,16,-11,2,England - National L. North,0.0,0.25,-11,0.62,0.0,4.0,15
Farsley Celtic,8,0,0,8,2,27,-25,0,England - National L. North,0.0,0.0,-25,0.25,0.0,0.0,16
Truro City,8,6,1,1,18,8,10,19,England - National L. South,0.75,0.88,10,2.25,1.33,1.14,1
Worthing,8,6,0,2,16,11,5,18,England - National L. South,0.75,0.75,5,2.0,1.33,1.33,2
Eastbourne,8,5,2,1,18,8,10,17,England - National L. South,0.62,0.88,10,2.25,1.61,1.14,3
Boreham Wood,8,5,1,2,14,7,7,16,England - National L. South,0.62,0.75,7,1.75,1.61,1.33,4
Dorking,8,4,3,1,11,6,5,15,England - National L. South,0.5,0.88,5,1.38,2.0,1.14,5
Torquay Utd,8,4,3,1,14,10,4,15,England - National L. South,0.5,0.88,4,1.75,2.0,1.14,5
Hemel Hempstead,8,4,3,1,12,9,3,15,England - National L. South,0.5,0.88,3,1.5,2.0,1.14,5
Weston-s.-Mare,8,4,2,2,11,7,4,14,England - National L. South,0.5,0.75,4,1.38,2.0,1.33,6
Farnborough,8,4,2,2,12,9,3,14,England - National L. South,0.5,0.75,3,1.5,2.0,1.33,6
Maidstone Utd,8,3,3,2,10,6,4,12,England - National L. South,0.38,0.75,4,1.25,2.63,1.33,7
Enfield Town,8,4,0,4,11,17,-6,12,England - National L. South,0.5,0.5,-6,1.38,2.0,2.0,7
Chelmsford City,8,3,2,3,11,10,1,11,England - National L. South,0.38,0.62,1,1.38,2.63,1.61,8
Hornchurch,8,3,2,3,13,13,0,11,England - National L. South,0.38,0.62,0,1.62,2.63,1.61,8
Bath City,8,3,2,3,7,7,0,11,England - National L. South,0.38,0.62,0,0.88,2.63,1.61,8
Tonbridge,8,3,0,5,6,8,-2,9,England - National L. South,0.38,0.38,-2,0.75,2.63,2.63,9
Weymouth,8,2,3,3,11,15,-4,9,England - National L. South,0.25,0.62,-4,1.38,4.0,1.61,9
Slough Town,8,2,2,4,11,12,-1,8,England - National L. South,0.25,0.5,-1,1.38,4.0,2.0,10
St Albans,8,2,2,4,9,10,-1,8,England - National L. South,0.25,0.5,-1,1.12,4.0,2.0,10
Chippenham,8,2,2,4,8,17,-9,8,England - National L. South,0.25,0.5,-9,1.0,4.0,2.0,10
Chesham Utd,8,2,1,5,7,15,-8,7,England - National L. South,0.25,0.38,-8,0.88,4.0,2.63,11
Salisbury,8,1,3,4,14,17,-3,6,England - National L. South,0.12,0.5,-3,1.75,8.33,2.0,12
Welling Utd,8,0,3,5,7,14,-7,3,England - National L. South,0.0,0.38,-7,0.88,0.0,2.63,13
Hampton & R.,8,1,0,7,7,15,-8,3,England - National L. South,0.12,0.12,-8,0.88,8.33,8.33,13
Aveley,8,0,1,7,6,18,-12,1,England - National L. South,0.0,0.12,-12,0.75,0.0,8.33,14
Carshalton,8,6,1,1,17,11,6,19,England - Isthmian league,0.75,0.88,6,2.12,1.33,1.14,1
Billericay Town,8,6,0,2,21,13,8,18,England - Isthmian league,0.75,0.75,8,2.62,1.33,1.33,2
Wingate & F.,8,5,2,1,17,6,11,17,England - Isthmian league,0.62,0.88,11,2.12,1.61,1.14,3
Horsham,8,5,1,2,12,7,5,16,England - Isthmian league,0.62,0.75,5,1.5,1.61,1.33,4
Dartford,8,5,1,2,13,10,3,16,England - Isthmian league,0.62,0.75,3,1.62,1.61,1.33,4
Chichester City,8,4,2,2,13,10,3,14,England - Isthmian league,0.5,0.75,3,1.62,2.0,1.33,5
Cray Wanderers,8,4,1,3,15,11,4,13,England - Isthmian league,0.5,0.62,4,1.88,2.0,1.61,6
Hashtag United,8,3,4,1,17,15,2,13,England - Isthmian league,0.38,0.88,2,2.12,2.63,1.14,6
Lewes,8,4,1,3,12,13,-1,13,England - Isthmian league,0.5,0.62,-1,1.5,2.0,1.61,6
Chatham Town,8,3,2,3,11,9,2,11,England - Isthmian league,0.38,0.62,2,1.38,2.63,1.61,7
Dulwich Hamlet,8,3,2,3,10,11,-1,11,England - Isthmian league,0.38,0.62,-1,1.25,2.63,1.61,7
Potters Bar,8,3,2,3,9,10,-1,11,England - Isthmian league,0.38,0.62,-1,1.12,2.63,1.61,7
Bognor Regis,8,2,4,2,14,13,1,10,England - Isthmian league,0.25,0.75,1,1.75,4.0,1.33,8
Cray Valley PM,8,2,4,2,10,9,1,10,England - Isthmian league,0.25,0.75,1,1.25,4.0,1.33,8
Cheshunt,8,3,1,4,10,11,-1,10,England - Isthmian league,0.38,0.5,-1,1.25,2.63,2.0,8
Folkestone,8,3,1,4,13,15,-2,10,England - Isthmian league,0.38,0.5,-2,1.62,2.63,2.0,8
Canvey Island,8,3,1,4,9,13,-4,10,England - Isthmian league,0.38,0.5,-4,1.12,2.63,2.0,8
Dover Athletic,8,2,2,4,8,11,-3,8,England - Isthmian league,0.25,0.5,-3,1.0,4.0,2.0,9
Whitehawk,8,2,1,5,12,13,-1,7,England - Isthmian league,0.25,0.38,-1,1.5,4.0,2.63,10
Hastings Utd,8,1,2,5,4,10,-6,5,England - Isthmian league,0.12,0.38,-6,0.5,8.33,2.63,11
Hendon,8,0,4,4,11,18,-7,4,England - Isthmian league,0.0,0.5,-7,1.38,0.0,2.0,12
Bowers & Pitsea,8,0,0,8,2,22,-20,0,England - Isthmian league,0.0,0.0,-20,0.25,0.0,0.0,13
Macclesfield,8,7,1,0,23,4,19,22,England - Northern league,0.88,1.0,19,2.88,1.14,1.0,1
Worksop Town,8,7,0,1,24,10,14,21,England - Northern league,0.88,0.88,14,3.0,1.14,1.14,2
Gainsborough,8,4,4,0,14,6,8,16,England - Northern league,0.5,1.0,8,1.75,2.0,1.0,3
Stockton Town,8,5,1,2,12,9,3,16,England - Northern league,0.62,0.75,3,1.5,1.61,1.33,3
Morpeth Town,8,5,1,2,11,9,2,16,England - Northern league,0.62,0.75,2,1.38,1.61,1.33,3
Rylands,8,4,2,2,14,10,4,14,England - Northern league,0.5,0.75,4,1.75,2.0,1.33,4
FC United,8,4,2,2,13,13,0,14,England - Northern league,0.5,0.75,0,1.62,2.0,1.33,4
Prescot Cables,8,4,1,3,7,7,0,13,England - Northern league,0.5,0.62,0,0.88,2.0,1.61,5
Hyde Utd,8,3,3,2,10,8,2,12,England - Northern league,0.38,0.75,2,1.25,2.63,1.33,6
Leek Town,8,3,2,3,11,10,1,11,England - Northern league,0.38,0.62,1,1.38,2.63,1.61,7
Bamber Bridge,8,3,1,4,15,11,4,10,England - Northern league,0.38,0.5,4,1.88,2.63,2.0,8
Ilkeston Town,8,2,4,2,10,8,2,10,England - Northern league,0.25,0.75,2,1.25,4.0,1.33,8
Workington,8,3,1,4,11,12,-1,10,England - Northern league,0.38,0.5,-1,1.38,2.63,2.0,8
Guiseley,8,2,3,3,8,9,-1,9,England - Northern league,0.25,0.62,-1,1.0,4.0,1.61,9
Ashton Utd,8,2,3,3,8,10,-2,9,England - Northern league,0.25,0.62,-2,1.0,4.0,1.61,9
Lancaster City,8,3,0,5,9,12,-3,9,England - Northern league,0.38,0.38,-3,1.12,2.63,2.63,9
Basford Utd,8,2,2,4,7,11,-4,8,England - Northern league,0.25,0.5,-4,0.88,4.0,2.0,10
Whitby Town,8,2,2,4,7,12,-5,8,England - Northern league,0.25,0.5,-5,0.88,4.0,2.0,10
Hebburn Town,8,1,3,4,6,10,-4,6,England - Northern league,0.12,0.5,-4,0.75,8.33,2.0,11
Mickleover,8,1,1,6,3,20,-17,4,England - Northern league,0.12,0.25,-17,0.38,8.33,4.0,12
Matlock,8,0,3,5,6,13,-7,3,England - Northern league,0.0,0.38,-7,0.75,0.0,2.63,13
Blyth Spartans,8,0,2,6,7,22,-15,2,England - Northern league,0.0,0.25,-15,0.88,0.0,4.0,14
Harborough Town,8,5,2,1,13,5,8,17,England - Southern Central,0.62,0.88,8,1.62,1.61,1.14,1
Halesowen Town,8,5,2,1,13,6,7,17,England - Southern Central,0.62,0.88,7,1.62,1.61,1.14,1
Bedford Town,8,5,1,2,13,10,3,16,England - Southern Central,0.62,0.75,3,1.62,1.61,1.33,2
Stamford,8,4,3,1,10,6,4,15,England - Southern Central,0.5,0.88,4,1.25,2.0,1.14,3
Kettering Town,8,4,2,2,13,8,5,14,England - Southern Central,0.5,0.75,5,1.62,2.0,1.33,4
Telford Utd,8,3,5,0,13,8,5,14,England - Southern Central,0.38,1.0,5,1.62,2.63,1.0,4
Bromsgrove,8,4,1,3,13,12,1,13,England - Southern Central,0.5,0.62,1,1.62,2.0,1.61,5
Leiston,8,4,1,3,13,13,0,13,England - Southern Central,0.5,0.62,0,1.62,2.0,1.61,5
Spalding United,8,4,0,4,11,12,-1,12,England - Southern Central,0.5,0.5,-1,1.38,2.0,2.0,6
Stourbridge,8,3,2,3,12,10,2,11,England - Southern Central,0.38,0.62,2,1.5,2.63,1.61,7
Stratford Town,8,3,2,3,12,10,2,11,England - Southern Central,0.38,0.62,2,1.5,2.63,1.61,7
St. Ives Town,8,2,5,1,14,13,1,11,England - Southern Central,0.25,0.88,1,1.75,4.0,1.14,7
Alvechurch,8,3,2,3,7,7,0,11,England - Southern Central,0.38,0.62,0,0.88,2.63,1.61,7
Barwell,8,3,1,4,13,14,-1,10,England - Southern Central,0.38,0.5,-1,1.62,2.63,2.0,8
B. Stortford,8,2,4,2,10,11,-1,10,England - Southern Central,0.25,0.75,-1,1.25,4.0,1.33,8
Royston,8,2,4,2,6,8,-2,10,England - Southern Central,0.25,0.75,-2,0.75,4.0,1.33,8
Banbury Utd,8,2,3,3,4,6,-2,9,England - Southern Central,0.25,0.62,-2,0.5,4.0,1.61,9
Lowestoft,8,1,3,4,8,15,-7,6,England - Southern Central,0.12,0.5,-7,1.0,8.33,2.0,10
Hitchin Town,8,1,2,5,8,14,-6,5,England - Southern Central,0.12,0.38,-6,1.0,8.33,2.63,11
Biggleswade,8,1,2,5,8,15,-7,5,England - Southern Central,0.12,0.38,-7,1.0,8.33,2.63,11
AFC Sudbury,8,1,2,5,7,15,-8,5,England - Southern Central,0.12,0.38,-8,0.88,8.33,2.63,11
Redditch Utd,8,0,3,5,4,10,-6,3,England - Southern Central,0.0,0.38,-6,0.5,0.0,2.63,12
Levadia,3,3,0,0,10,3,7,9,Estonia - Meistriliiga,1.0,1.0,7,3.33,1.0,1.0,1
Paide,3,2,0,1,6,2,4,6,Estonia - Meistriliiga,0.67,0.67,4,2.0,1.49,1.49,2
Flora,3,1,1,1,6,3,3,4,Estonia - Meistriliiga,0.33,0.67,3,2.0,3.03,1.49,3
Narva Trans,3,1,1,1,3,4,-1,4,Estonia - Meistriliiga,0.33,0.67,-1,1.0,3.03,1.49,3
Kuressaare,2,1,0,1,3,2,1,3,Estonia - Meistriliiga,0.5,0.5,1,1.5,2.0,2.0,4
Tammeka,2,1,0,1,4,4,0,3,Estonia - Meistriliiga,0.5,0.5,0,2.0,2.0,2.0,4
Nomme Kalju,2,1,0,1,3,4,-1,3,Estonia - Meistriliiga,0.5,0.5,-1,1.5,2.0,2.0,4
Harju JK,2,1,0,1,2,5,-3,3,Estonia - Meistriliiga,0.5,0.5,-3,1.0,2.0,2.0,4
Vaprus,3,1,0,2,2,5,-3,3,Estonia - Meistriliiga,0.33,0.33,-3,0.67,3.03,3.03,4
Tallinna Kalev,3,0,0,3,1,8,-7,0,Estonia - Meistriliiga,0.0,0.0,-7,0.33,0.0,0.0,5
Nomme Utd,3,3,0,0,6,2,4,9,Estonia - Esiliiga,1.0,1.0,4,2.0,1.0,1.0,1
Elva,3,2,1,0,8,4,4,7,Estonia - Esiliiga,0.67,1.0,4,2.67,1.49,1.0,2
Flora B,2,2,0,0,4,0,4,6,Estonia - Esiliiga,1.0,1.0,4,2.0,1.0,1.0,3
Nomme Kalju B,3,2,0,1,4,3,1,6,Estonia - Esiliiga,0.67,0.67,1,1.33,1.49,1.49,3
Tartu Welco,3,1,1,1,5,6,-1,4,Estonia - Esiliiga,0.33,0.67,-1,1.67,3.03,1.49,4
Viimsi,3,1,1,1,4,5,-1,4,Estonia - Esiliiga,0.33,0.67,-1,1.33,3.03,1.49,4
Tallinna K. B,2,0,1,1,2,3,-1,1,Estonia - Esiliiga,0.0,0.5,-1,1.0,0.0,2.0,5
FC Tallinn,2,0,0,2,1,4,-3,0,Estonia - Esiliiga,0.0,0.0,-3,0.5,0.0,0.0,6
Levadia B,2,0,0,2,1,4,-3,0,Estonia - Esiliiga,0.0,0.0,-3,0.5,0.0,0.0,6
Tammeka B,3,0,0,3,2,6,-4,0,Estonia - Esiliiga,0.0,0.0,-4,0.67,0.0,0.0,6
Klaksvik,1,1,0,0,3,1,2,3,FaroeIslands - Premier League,1.0,1.0,2,3.0,1.0,1.0,1
NSI Runavik,1,1,0,0,4,3,1,3,FaroeIslands - Premier League,1.0,1.0,1,4.0,1.0,1.0,1
HB Torshavn,1,1,0,0,3,2,1,3,FaroeIslands - Premier League,1.0,1.0,1,3.0,1.0,1.0,1
TB Tvoroyri,1,0,1,0,1,1,0,1,FaroeIslands - Premier League,0.0,1.0,0,1.0,0.0,1.0,2
Vikingur,1,0,1,0,1,1,0,1,FaroeIslands - Premier League,0.0,1.0,0,1.0,0.0,1.0,2
Streymur,0,0,0,0,0,0,0,0,FaroeIslands - Premier League,0.0,0.0,0,0.0,0.0,0.0,3
Suduroy,0,0,0,0,0,0,0,0,FaroeIslands - Premier League,0.0,0.0,0,0.0,0.0,0.0,3
B36 Torshavn,1,0,0,1,3,4,-1,0,FaroeIslands - Premier League,0.0,0.0,-1,3.0,0.0,0.0,3
B68 Toftir,1,0,0,1,2,3,-1,0,FaroeIslands - Premier League,0.0,0.0,-1,2.0,0.0,0.0,3
07 Vestur,1,0,0,1,1,3,-2,0,FaroeIslands - Premier League,0.0,0.0,-2,1.0,0.0,0.0,3
B71 Sandur,2,2,0,0,4,0,4,6,FaroeIslands - 1. Deild,1.0,1.0,4,2.0,1.0,1.0,1
Streymur B,2,2,0,0,3,1,2,6,FaroeIslands - 1. Deild,1.0,1.0,2,1.5,1.0,1.0,1
Skala,2,1,1,0,4,0,4,4,FaroeIslands - 1. Deild,0.5,1.0,4,2.0,2.0,1.0,2
AB Argir,2,1,1,0,3,1,2,4,FaroeIslands - 1. Deild,0.5,1.0,2,1.5,2.0,1.0,2
Vikingur B,2,1,0,1,3,2,1,3,FaroeIslands - 1. Deild,0.5,0.5,1,1.5,2.0,2.0,3
NSI Runavik B,2,0,1,1,3,4,-1,1,FaroeIslands - 1. Deild,0.0,0.5,-1,1.5,0.0,2.0,4
Klaksvik B,2,0,1,1,2,3,-1,1,FaroeIslands - 1. Deild,0.0,0.5,-1,1.0,0.0,2.0,4
B36 Torshavn B,2,0,1,1,3,5,-2,1,FaroeIslands - 1. Deild,0.0,0.5,-2,1.5,0.0,2.0,4
IF Fuglafjordur,2,0,1,1,3,5,-2,1,FaroeIslands - 1. Deild,0.0,0.5,-2,1.5,0.0,2.0,4
07 Vestur B,2,0,0,2,0,7,-7,0,FaroeIslands - 1. Deild,0.0,0.0,-7,0.0,0.0,0.0,5
Ilves,8,6,1,1,17,4,13,19,Finland - Veikkausliiga,0.75,0.88,13,2.12,1.33,1.14,1
KuPS,8,6,0,2,12,4,8,18,Finland - Veikkausliiga,0.75,0.75,8,1.5,1.33,1.33,2
Inter Turku,8,5,1,2,13,7,6,16,Finland - Veikkausliiga,0.62,0.75,6,1.62,1.61,1.33,3
Gnistan,8,4,2,2,12,11,1,14,Finland - Veikkausliiga,0.5,0.75,1,1.5,2.0,1.33,4
HJK Helsinki,8,3,2,3,10,7,3,11,Finland - Veikkausliiga,0.38,0.62,3,1.25,2.63,1.61,5
VPS,8,3,2,3,13,14,-1,11,Finland - Veikkausliiga,0.38,0.62,-1,1.62,2.63,1.61,5
Mariehamn,8,3,0,5,10,12,-2,9,Finland - Veikkausliiga,0.38,0.38,-2,1.25,2.63,2.63,6
Lahti,8,1,5,2,6,10,-4,8,Finland - Veikkausliiga,0.12,0.75,-4,0.75,8.33,1.33,7
Oulu,8,2,1,5,7,9,-2,7,Finland - Veikkausliiga,0.25,0.38,-2,0.88,4.0,2.63,8
Haka,8,2,1,5,9,15,-6,7,Finland - Veikkausliiga,0.25,0.38,-6,1.12,4.0,2.63,8
Ekenas IF,8,1,4,3,6,15,-9,7,Finland - Veikkausliiga,0.12,0.62,-9,0.75,8.33,1.61,8
SJK,8,1,2,5,7,16,-9,5,Finland - Veikkausliiga,0.12,0.38,-9,0.88,8.33,2.63,9
JaPS,8,5,1,2,17,13,4,16,Finland - Ykkosliga,0.62,0.75,4,2.12,1.61,1.33,1
JIPPO,8,5,0,3,17,9,8,15,Finland - Ykkosliga,0.62,0.62,8,2.12,1.61,1.61,2
PK-35,8,4,3,1,8,5,3,15,Finland - Ykkosliga,0.5,0.88,3,1.0,2.0,1.14,2
Jaro,8,5,0,3,15,14,1,15,Finland - Ykkosliga,0.62,0.62,1,1.88,1.61,1.61,2
KTP,8,4,2,2,26,14,12,14,Finland - Ykkosliga,0.5,0.75,12,3.25,2.0,1.33,3
KaPa,8,3,1,4,20,25,-5,10,Finland - Ykkosliga,0.38,0.5,-5,2.5,2.63,2.0,4
TPS,8,2,3,3,13,11,2,9,Finland - Ykkosliga,0.25,0.62,2,1.62,4.0,1.61,5
SalPa,8,2,1,5,8,18,-10,7,Finland - Ykkosliga,0.25,0.38,-10,1.0,4.0,2.63,6
SJK Akatemia,8,0,5,3,13,18,-5,5,Finland - Ykkosliga,0.0,0.62,-5,1.62,0.0,1.61,7
Mikkelin,8,1,2,5,9,19,-10,5,Finland - Ykkosliga,0.12,0.38,-10,1.12,8.33,2.63,7
KPV Kokkola,8,6,1,1,16,7,9,19,Finland - Ykkonen,0.75,0.88,9,2.0,1.33,1.14,1
Klubi-04,8,5,0,3,16,11,5,15,Finland - Ykkonen,0.62,0.62,5,2.0,1.61,1.61,2
JJK,8,5,0,3,14,15,-1,15,Finland - Ykkonen,0.62,0.62,-1,1.75,1.61,1.61,2
Atlantis,8,4,2,2,22,18,4,14,Finland - Ykkonen,0.5,0.75,4,2.75,2.0,1.33,3
OLS Oulu,8,4,2,2,21,19,2,14,Finland - Ykkonen,0.5,0.75,2,2.62,2.0,1.33,3
PKKU,8,4,1,3,24,18,6,13,Finland - Ykkonen,0.5,0.62,6,3.0,2.0,1.61,4
Rovaniemi,8,3,1,4,13,12,1,10,Finland - Ykkonen,0.38,0.5,1,1.62,2.63,2.0,5
VIFK,8,3,1,4,18,18,0,10,Finland - Ykkonen,0.38,0.5,0,2.25,2.63,2.0,5
Jazz Pori,8,3,1,4,18,20,-2,10,Finland - Ykkonen,0.38,0.5,-2,2.25,2.63,2.0,5
EPS,8,3,1,4,17,20,-3,10,Finland - Ykkonen,0.38,0.5,-3,2.12,2.63,2.0,5
KuPS Ak.,8,2,0,6,12,20,-8,6,Finland - Ykkonen,0.25,0.25,-8,1.5,4.0,4.0,6
Vaajakoski,8,0,2,6,10,23,-13,2,Finland - Ykkonen,0.0,0.25,-13,1.25,0.0,4.0,7
PEPO,8,4,4,0,15,9,6,16,Finland - Kakkonen Group A,0.5,1.0,6,1.88,2.0,1.0,1
Reipas,8,4,2,2,18,10,8,14,Finland - Kakkonen Group A,0.5,0.75,8,2.25,2.0,1.33,2
PPJ,8,4,1,3,17,12,5,13,Finland - Kakkonen Group A,0.5,0.62,5,2.12,2.0,1.61,3
NJS,8,3,4,1,16,12,4,13,Finland - Kakkonen Group A,0.38,0.88,4,2.0,2.63,1.14,3
Atlantis B,8,4,1,3,13,13,0,13,Finland - Kakkonen Group A,0.5,0.62,0,1.62,2.0,1.61,3
MYPA,8,3,3,2,13,13,0,12,Finland - Kakkonen Group A,0.38,0.75,0,1.62,2.63,1.33,4
Kiffen,8,3,2,3,12,9,3,11,Finland - Kakkonen Group A,0.38,0.62,3,1.5,2.63,1.61,5
JaPS B,8,2,1,5,11,19,-8,7,Finland - Kakkonen Group A,0.25,0.38,-8,1.38,4.0,2.63,6
GrIFK,8,1,3,4,9,15,-6,6,Finland - Kakkonen Group A,0.12,0.5,-6,1.12,8.33,2.0,7
Futura,8,1,1,6,7,19,-12,4,Finland - Kakkonen Group A,0.12,0.25,-12,0.88,8.33,4.0,8
Inter Turku B,8,7,1,0,30,7,23,22,Finland - Kakkonen Group B,0.88,1.0,23,3.75,1.14,1.0,1
HJS Akatemia,8,6,1,1,20,6,14,19,Finland - Kakkonen Group B,0.75,0.88,14,2.5,1.33,1.14,2
Tampere Utd,8,5,1,2,21,10,11,16,Finland - Kakkonen Group B,0.62,0.75,11,2.62,1.61,1.33,3
VJS,8,5,0,3,21,13,8,15,Finland - Kakkonen Group B,0.62,0.62,8,2.62,1.61,1.61,4
Ilves B,8,4,0,4,17,17,0,12,Finland - Kakkonen Group B,0.5,0.5,0,2.12,2.0,2.0,5
P-Iirot,8,4,0,4,11,11,0,12,Finland - Kakkonen Group B,0.5,0.5,0,1.38,2.0,2.0,5
TPV,8,2,3,3,16,19,-3,9,Finland - Kakkonen Group B,0.25,0.62,-3,2.0,4.0,1.61,6
Honka,8,2,3,3,14,17,-3,9,Finland - Kakkonen Group B,0.25,0.62,-3,1.75,4.0,1.61,6
Ilves-Kissat,8,2,1,5,17,30,-13,7,Finland - Kakkonen Group B,0.25,0.38,-13,2.12,4.0,2.63,7
Poxyt,8,1,0,7,10,22,-12,3,Finland - Kakkonen Group B,0.12,0.12,-12,1.25,8.33,8.33,8
EBK,8,0,0,8,8,35,-27,0,Finland - Kakkonen Group B,0.0,0.0,-27,1.0,0.0,0.0,9
TP-47,8,6,2,0,25,9,16,20,Finland - Kakkonen Group C,0.75,1.0,16,3.12,1.33,1.0,1
Narpes Kraft,8,6,0,2,26,15,11,18,Finland - Kakkonen Group C,0.75,0.75,11,3.25,1.33,1.33,2
GBK,8,5,0,3,15,13,2,15,Finland - Kakkonen Group C,0.62,0.62,2,1.88,1.61,1.61,3
JBK,8,4,2,2,14,10,4,14,Finland - Kakkonen Group C,0.5,0.75,4,1.75,2.0,1.33,4
Kuopion Elo,8,3,2,3,19,18,1,11,Finland - Kakkonen Group C,0.38,0.62,1,2.38,2.63,1.61,5
JS Hercules,8,3,2,3,18,18,0,11,Finland - Kakkonen Group C,0.38,0.62,0,2.25,2.63,1.61,5
SJK Akatemia B,8,2,1,5,16,21,-5,7,Finland - Kakkonen Group C,0.25,0.38,-5,2.0,4.0,2.63,6
OPS,8,2,1,5,14,23,-9,7,Finland - Kakkonen Group C,0.25,0.38,-9,1.75,4.0,2.63,6
JPS,8,1,3,4,19,17,2,6,Finland - Kakkonen Group C,0.12,0.5,2,2.38,8.33,2.0,7
OTP,8,1,0,7,12,33,-21,3,Finland - Kakkonen Group C,0.12,0.12,-21,1.5,8.33,8.33,8
Paris SG,8,7,1,0,24,9,15,22,France - Ligue 1,0.88,1.0,15,3.0,1.14,1.0,1
Nice,8,5,2,1,14,6,8,17,France - Ligue 1,0.62,0.88,8,1.75,1.61,1.14,2
Strasbourg,8,5,2,1,9,3,6,17,France - Ligue 1,0.62,0.88,6,1.12,1.61,1.14,2
Monaco,8,5,1,2,22,12,10,16,France - Ligue 1,0.62,0.75,10,2.75,1.61,1.33,3
Lyon,8,4,2,2,17,9,8,14,France - Ligue 1,0.5,0.75,8,2.12,2.0,1.33,4
Brest,8,4,2,2,12,10,2,14,France - Ligue 1,0.5,0.75,2,1.5,2.0,1.33,4
Marseille,8,4,1,3,13,10,3,13,France - Ligue 1,0.5,0.62,3,1.62,2.0,1.61,5
Lille,8,4,0,4,12,11,1,12,France - Ligue 1,0.5,0.5,1,1.5,2.0,2.0,6
Rennes,8,4,0,4,11,10,1,12,France - Ligue 1,0.5,0.5,1,1.38,2.0,2.0,6
Lens,8,4,0,4,9,11,-2,12,France - Ligue 1,0.5,0.5,-2,1.12,2.0,2.0,6
Toulouse,8,2,4,2,13,8,5,10,France - Ligue 1,0.25,0.75,5,1.62,4.0,1.33,7
Auxerre,8,2,4,2,13,11,2,10,France - Ligue 1,0.25,0.75,2,1.62,4.0,1.33,7
Nantes,8,3,1,4,8,15,-7,10,France - Ligue 1,0.38,0.5,-7,1.0,2.63,2.0,7
Le Havre,8,2,3,3,11,15,-4,9,France - Ligue 1,0.25,0.62,-4,1.38,4.0,1.61,8
Montpellier,8,2,0,6,5,17,-12,6,France - Ligue 1,0.25,0.25,-12,0.62,4.0,4.0,9
Angers,8,1,2,5,5,15,-10,5,France - Ligue 1,0.12,0.38,-10,0.62,8.33,2.63,10
Saint-Etienne,8,0,4,4,9,20,-11,4,France - Ligue 1,0.0,0.5,-11,1.12,0.0,2.0,11
Reims,8,0,2,6,3,15,-12,2,France - Ligue 1,0.0,0.25,-12,0.38,0.0,4.0,12
Metz,8,6,1,1,20,7,13,19,France - Ligue 2,0.75,0.88,13,2.5,1.33,1.14,1
Lorient,8,6,0,2,18,9,9,18,France - Ligue 2,0.75,0.75,9,2.25,1.33,1.33,2
Paris FC,8,6,0,2,15,10,5,18,France - Ligue 2,0.75,0.75,5,1.88,1.33,1.33,2
AC Ajaccio,8,5,1,2,12,9,3,16,France - Ligue 2,0.62,0.75,3,1.5,1.61,1.33,3
USL Dunkerque,8,5,0,3,13,10,3,15,France - Ligue 2,0.62,0.62,3,1.62,1.61,1.61,4
Martigues,8,4,1,3,10,6,4,13,France - Ligue 2,0.5,0.62,4,1.25,2.0,1.61,5
Guingamp,8,4,1,3,10,9,1,13,France - Ligue 2,0.5,0.62,1,1.25,2.0,1.61,5
Laval,8,4,1,3,7,6,1,13,France - Ligue 2,0.5,0.62,1,0.88,2.0,1.61,5
Troyes,8,4,0,4,9,5,4,12,France - Ligue 2,0.5,0.5,4,1.12,2.0,2.0,6
SC Bastia,8,3,3,2,7,9,-2,12,France - Ligue 2,0.38,0.75,-2,0.88,2.63,1.33,6
Grenoble,8,2,4,2,9,9,0,10,France - Ligue 2,0.25,0.75,0,1.12,4.0,1.33,7
Red Star,8,3,1,4,9,10,-1,10,France - Ligue 2,0.38,0.5,-1,1.12,2.63,2.0,7
Rodez Aveyron,8,2,2,4,15,12,3,8,France - Ligue 2,0.25,0.5,3,1.88,4.0,2.0,8
Pau FC,8,1,4,3,8,16,-8,7,France - Ligue 2,0.12,0.62,-8,1.0,8.33,1.61,9
Annecy,8,2,1,5,6,14,-8,7,France - Ligue 2,0.25,0.38,-8,0.75,4.0,2.63,9
Amiens,8,2,1,5,7,16,-9,7,France - Ligue 2,0.25,0.38,-9,0.88,4.0,2.63,9
Caen,8,1,1,6,4,12,-8,4,France - Ligue 2,0.12,0.25,-8,0.5,8.33,4.0,10
Clermont,8,0,2,6,5,15,-10,2,France - Ligue 2,0.0,0.25,-10,0.62,0.0,4.0,11
Le Mans,8,7,1,0,18,3,15,22,France - National,0.88,1.0,15,2.25,1.14,1.0,1
Valenciennes,8,4,4,0,7,2,5,16,France - National,0.5,1.0,5,0.88,2.0,1.0,2
Nancy,8,5,0,3,11,8,3,15,France - National,0.62,0.62,3,1.38,1.61,1.61,3
Chateauroux,8,4,2,2,9,8,1,14,France - National,0.5,0.75,1,1.12,2.0,1.33,4
Boulogne,8,3,4,1,11,7,4,13,France - National,0.38,0.88,4,1.38,2.63,1.14,5
Versailles,8,3,3,2,15,14,1,12,France - National,0.38,0.75,1,1.88,2.63,1.33,6
Villefranche,8,4,0,4,10,10,0,12,France - National,0.5,0.5,0,1.25,2.0,2.0,6
Rouen,8,3,2,3,11,11,0,11,France - National,0.38,0.62,0,1.38,2.63,1.61,7
Bourg-en-Bresse,8,2,4,2,5,5,0,10,France - National,0.25,0.75,0,0.62,4.0,1.33,8
Aubagne,8,3,1,4,6,9,-3,10,France - National,0.38,0.5,-3,0.75,2.63,2.0,8
Nimes,8,2,3,3,8,7,1,9,France - National,0.25,0.62,1,1.0,4.0,1.61,9
Paris 13 A.,8,2,3,3,6,8,-2,9,France - National,0.25,0.62,-2,0.75,4.0,1.61,9
Orleans,8,2,2,4,12,15,-3,8,France - National,0.25,0.5,-3,1.5,4.0,2.0,10
Dijon,8,1,5,2,9,14,-5,8,France - National,0.12,0.75,-5,1.12,8.33,1.33,10
Concarneau,8,2,1,5,11,15,-4,7,France - National,0.25,0.38,-4,1.38,4.0,2.63,11
Quevilly Rouen,8,1,2,5,8,14,-6,5,France - National,0.12,0.38,-6,1.0,8.33,2.63,12
Sochaux,8,0,4,4,5,10,-5,4,France - National,0.0,0.5,-5,0.62,0.0,2.0,13
Iberia,4,3,1,0,6,1,5,10,Georgia - Erovnuli Liga,0.75,1.0,5,1.5,1.33,1.0,1
Telavi,4,2,1,1,4,4,0,7,Georgia - Erovnuli Liga,0.5,0.75,0,1.0,2.0,1.33,2
Dinamo Batumi,3,1,2,0,3,2,1,5,Georgia - Erovnuli Liga,0.33,1.0,1,1.0,3.03,1.0,3
Dinamo Tbilisi,3,1,2,0,3,2,1,5,Georgia - Erovnuli Liga,0.33,1.0,1,1.0,3.03,1.0,3
Dila Gori,3,1,1,1,2,2,0,4,Georgia - Erovnuli Liga,0.33,0.67,0,0.67,3.03,1.49,4
Samgurali,2,1,0,1,4,3,1,3,Georgia - Erovnuli Liga,0.5,0.5,1,2.0,2.0,2.0,5
Torpedo Kutaisi,4,1,0,3,4,7,-3,3,Georgia - Erovnuli Liga,0.25,0.25,-3,1.0,4.0,4.0,5
Kolkheti Poti,2,0,1,1,0,1,-1,1,Georgia - Erovnuli Liga,0.0,0.5,-1,0.0,0.0,2.0,6
Gagra,3,0,1,2,2,4,-2,1,Georgia - Erovnuli Liga,0.0,0.33,-2,0.67,0.0,3.03,6
Gareji Sagarejo,2,0,1,1,1,3,-2,1,Georgia - Erovnuli Liga,0.0,0.5,-2,0.5,0.0,2.0,6
Bolnisi,2,1,1,0,4,1,3,4,Georgia - Erovnuli Liga 2,0.5,1.0,3,2.0,2.0,1.0,1
Iberia B,2,1,1,0,4,2,2,4,Georgia - Erovnuli Liga 2,0.5,1.0,2,2.0,2.0,1.0,1
Spaeri,2,1,1,0,5,4,1,4,Georgia - Erovnuli Liga 2,0.5,1.0,1,2.5,2.0,1.0,1
Rustavi,1,1,0,0,3,2,1,3,Georgia - Erovnuli Liga 2,1.0,1.0,1,3.0,1.0,1.0,2
L. Tbilisi,2,0,2,0,2,2,0,2,Georgia - Erovnuli Liga 2,0.0,1.0,0,1.0,0.0,1.0,3
Samtredia,1,0,1,0,1,1,0,1,Georgia - Erovnuli Liga 2,0.0,1.0,0,1.0,0.0,1.0,4
Merani Martvili,2,0,1,1,3,4,-1,1,Georgia - Erovnuli Liga 2,0.0,0.5,-1,1.5,0.0,2.0,4
Gonio,2,0,1,1,2,3,-1,1,Georgia - Erovnuli Liga 2,0.0,0.5,-1,1.0,0.0,2.0,4
D. Tbilisi B,2,0,1,1,4,6,-2,1,Georgia - Erovnuli Liga 2,0.0,0.5,-2,2.0,0.0,2.0,4
Meshakhte,2,0,1,1,1,4,-3,1,Georgia - Erovnuli Liga 2,0.0,0.5,-3,0.5,0.0,2.0,4
Bayern Munich,8,5,2,1,19,9,10,17,Germany - Bundesliga,0.62,0.88,10,2.38,1.61,1.14,1
FSV Mainz,8,5,2,1,13,5,8,17,Germany - Bundesliga,0.62,0.88,8,1.62,1.61,1.14,1
FC Augsburg,8,4,4,0,8,2,6,16,Germany - Bundesliga,0.5,1.0,6,1.0,2.0,1.0,2
Monchengladbach,8,5,1,2,16,11,5,16,Germany - Bundesliga,0.62,0.75,5,2.0,1.61,1.33,2
Leverkusen,8,4,3,1,14,7,7,15,Germany - Bundesliga,0.5,0.88,7,1.75,2.0,1.14,3
Freiburg,8,4,3,1,11,4,7,15,Germany - Bundesliga,0.5,0.88,7,1.38,2.0,1.14,3
RB Leipzig,8,2,5,1,9,6,3,11,Germany - Bundesliga,0.25,0.88,3,1.12,4.0,1.14,4
Wolfsburg,8,2,5,1,9,8,1,11,Germany - Bundesliga,0.25,0.88,1,1.12,4.0,1.14,4
Dortmund,8,3,1,4,13,10,3,10,Germany - Bundesliga,0.38,0.5,3,1.62,2.63,2.0,5
Bochum,8,2,3,3,11,13,-2,9,Germany - Bundesliga,0.25,0.62,-2,1.38,4.0,1.61,6
E. Frankfurt,8,2,3,3,11,15,-4,9,Germany - Bundesliga,0.25,0.62,-4,1.38,4.0,1.61,6
Hoffenheim,8,2,3,3,9,13,-4,9,Germany - Bundesliga,0.25,0.62,-4,1.12,4.0,1.61,6
Stuttgart,8,2,2,4,12,13,-1,8,Germany - Bundesliga,0.25,0.5,-1,1.5,4.0,2.0,7
Sankt Pauli,8,2,2,4,6,9,-3,8,Germany - Bundesliga,0.25,0.5,-3,0.75,4.0,2.0,7
Union Berlin,8,2,2,4,8,14,-6,8,Germany - Bundesliga,0.25,0.5,-6,1.0,4.0,2.0,7
Werder Bremen,8,2,1,5,9,19,-10,7,Germany - Bundesliga,0.25,0.38,-10,1.12,4.0,2.63,8
Holstein Kiel,8,1,3,4,12,18,-6,6,Germany - Bundesliga,0.12,0.5,-6,1.5,8.33,2.0,9
Heidenheim,8,0,2,6,5,15,-10,2,Germany - Bundesliga,0.0,0.25,-10,0.62,0.0,4.0,10
Hamburger SV,8,5,2,1,18,9,9,17,Germany - 2. Bundesliga,0.62,0.88,9,2.25,1.61,1.14,1
Paderborn,8,5,2,1,14,6,8,17,Germany - 2. Bundesliga,0.62,0.88,8,1.75,1.61,1.14,1
FC Nurnberg,8,5,1,2,12,9,3,16,Germany - 2. Bundesliga,0.62,0.75,3,1.5,1.61,1.33,2
FC Koln,8,5,1,2,8,7,1,16,Germany - 2. Bundesliga,0.62,0.75,1,1.0,1.61,1.33,2
Kaiserslautern,8,4,2,2,14,12,2,14,Germany - 2. Bundesliga,0.5,0.75,2,1.75,2.0,1.33,3
Dusseldorf,8,4,2,2,13,13,0,14,Germany - 2. Bundesliga,0.5,0.75,0,1.62,2.0,1.33,3
Greuther Furth,8,4,1,3,13,12,1,13,Germany - 2. Bundesliga,0.5,0.62,1,1.62,2.0,1.61,4
Elversberg,8,3,3,2,12,5,7,12,Germany - 2. Bundesliga,0.38,0.75,7,1.5,2.63,1.33,5
Hannover 96,8,2,6,0,11,9,2,12,Germany - 2. Bundesliga,0.25,1.0,2,1.38,4.0,1.0,5
Schalke 04,8,4,0,4,11,13,-2,12,Germany - 2. Bundesliga,0.5,0.5,-2,1.38,2.0,2.0,5
Magdeburg,8,3,2,3,18,15,3,11,Germany - 2. Bundesliga,0.38,0.62,3,2.25,2.63,1.61,6
Braunschweig,8,2,4,2,7,8,-1,10,Germany - 2. Bundesliga,0.25,0.75,-1,0.88,4.0,1.33,7
Preuss. Munster,8,2,1,5,7,10,-3,7,Germany - 2. Bundesliga,0.25,0.38,-3,0.88,4.0,2.63,8
Karlsruher SC,8,2,1,5,10,15,-5,7,Germany - 2. Bundesliga,0.25,0.38,-5,1.25,4.0,2.63,8
Darmstadt,8,2,0,6,7,12,-5,6,Germany - 2. Bundesliga,0.25,0.25,-5,0.88,4.0,4.0,9
Ulm,8,1,2,5,9,12,-3,5,Germany - 2. Bundesliga,0.12,0.38,-3,1.12,8.33,2.63,10
Regensburg,8,1,2,5,5,14,-9,5,Germany - 2. Bundesliga,0.12,0.38,-9,0.62,8.33,2.63,10
Hertha Berlin,8,1,1,6,6,15,-9,4,Germany - 2. Bundesliga,0.12,0.25,-9,0.75,8.33,4.0,11
RW Essen,8,5,2,1,11,5,6,17,Germany - 3. Liga,0.62,0.88,6,1.38,1.61,1.14,1
Osnabruck,8,5,1,2,14,8,6,16,Germany - 3. Liga,0.62,0.75,6,1.75,1.61,1.33,2
Hansa Rostock,8,5,1,2,14,11,3,16,Germany - 3. Liga,0.62,0.75,3,1.75,1.61,1.33,2
Bielefeld,8,5,0,3,15,8,7,15,Germany - 3. Liga,0.62,0.62,7,1.88,1.61,1.61,3
Dynamo Dresden,8,4,2,2,13,7,6,14,Germany - 3. Liga,0.5,0.75,6,1.62,2.0,1.33,4
1860 Munchen,8,4,2,2,11,12,-1,14,Germany - 3. Liga,0.5,0.75,-1,1.38,2.0,1.33,4
VfB Stuttgart B,8,4,1,3,11,11,0,13,Germany - 3. Liga,0.5,0.62,0,1.38,2.0,1.61,5
Saarbrucken,8,4,0,4,11,12,-1,12,Germany - 3. Liga,0.5,0.5,-1,1.38,2.0,2.0,6
Mannheim,8,3,2,3,14,10,4,11,Germany - 3. Liga,0.38,0.62,4,1.75,2.63,1.61,7
Erzgebirge Aue,8,3,2,3,9,10,-1,11,Germany - 3. Liga,0.38,0.62,-1,1.12,2.63,1.61,7
FC Ingolstadt,8,3,2,3,9,11,-2,11,Germany - 3. Liga,0.38,0.62,-2,1.12,2.63,1.61,7
Verl,8,3,2,3,9,13,-4,11,Germany - 3. Liga,0.38,0.62,-4,1.12,2.63,1.61,7
Wehen Wiesbaden,8,3,1,4,8,10,-2,10,Germany - 3. Liga,0.38,0.5,-2,1.0,2.63,2.0,8
Viktoria Koln,8,2,3,3,10,10,0,9,Germany - 3. Liga,0.25,0.62,0,1.25,4.0,1.61,9
Energie Cottbus,8,2,3,3,8,10,-2,9,Germany - 3. Liga,0.25,0.62,-2,1.0,4.0,1.61,9
Alemannia A.,8,1,3,4,9,11,-2,6,Germany - 3. Liga,0.12,0.5,-2,1.12,8.33,2.0,10
Dortmund B,8,1,3,4,4,8,-4,6,Germany - 3. Liga,0.12,0.5,-4,0.5,8.33,2.0,10
Sandhausen,8,1,2,5,11,15,-4,5,Germany - 3. Liga,0.12,0.38,-4,1.38,8.33,2.63,11
Unterhaching,8,1,2,5,10,14,-4,5,Germany - 3. Liga,0.12,0.38,-4,1.25,8.33,2.63,11
Hannover 96 B,8,1,2,5,11,21,-10,5,Germany - 3. Liga,0.12,0.38,-10,1.38,8.33,2.63,11
Asante Kotoko,8,5,2,1,13,5,8,17,Ghana - Premier League,0.62,0.88,8,1.62,1.61,1.14,1
Hearts of Oak,8,5,2,1,10,4,6,17,Ghana - Premier League,0.62,0.88,6,1.25,1.61,1.14,1
Bibiani GS,8,4,2,2,9,5,4,14,Ghana - Premier League,0.5,0.75,4,1.12,2.0,1.33,2
Young Apostles,8,4,2,2,7,5,2,14,Ghana - Premier League,0.5,0.75,2,0.88,2.0,1.33,2
Bechem Utd,8,4,1,3,9,7,2,13,Ghana - Premier League,0.5,0.62,2,1.12,2.0,1.61,3
Heart of Lions,8,4,1,3,8,8,0,13,Ghana - Premier League,0.5,0.62,0,1.0,2.0,1.61,3
Vision,8,3,3,2,10,11,-1,12,Ghana - Premier League,0.38,0.75,-1,1.25,2.63,1.33,4
Dreams,8,3,3,2,6,7,-1,12,Ghana - Premier League,0.38,0.75,-1,0.75,2.63,1.33,4
Medeama,8,3,2,3,10,9,1,11,Ghana - Premier League,0.38,0.62,1,1.25,2.63,1.61,5
Samartex,8,2,5,1,5,4,1,11,Ghana - Premier League,0.25,0.88,1,0.62,4.0,1.14,5
Berekum Chelsea,8,3,2,3,8,9,-1,11,Ghana - Premier League,0.38,0.62,-1,1.0,2.63,1.61,5
Nations,8,3,1,4,9,8,1,10,Ghana - Premier League,0.38,0.5,1,1.12,2.63,2.0,6
Aduana Stars,8,2,4,2,4,4,0,10,Ghana - Premier League,0.25,0.75,0,0.5,4.0,1.33,6
Holy Stars,8,2,3,3,11,10,1,9,Ghana - Premier League,0.25,0.62,1,1.38,4.0,1.61,7
Nsoatreman,8,2,2,4,5,7,-2,8,Ghana - Premier League,0.25,0.5,-2,0.62,4.0,2.0,8
Karela,8,1,3,4,5,9,-4,6,Ghana - Premier League,0.12,0.5,-4,0.62,8.33,2.0,9
Legon Cities,8,2,0,6,4,10,-6,6,Ghana - Premier League,0.25,0.25,-6,0.5,4.0,4.0,9
Accra Lions,8,1,1,6,5,13,-8,4,Ghana - Premier League,0.12,0.25,-8,0.62,8.33,4.0,10
St Josephs,8,7,1,0,26,6,20,22,Gibraltar - Premier Division,0.88,1.0,20,3.25,1.14,1.0,1
Lincoln RI,8,6,1,1,21,5,16,19,Gibraltar - Premier Division,0.75,0.88,16,2.62,1.33,1.14,2
Europa FC,8,5,1,2,18,8,10,16,Gibraltar - Premier Division,0.62,0.75,10,2.25,1.61,1.33,3
Lions FC,8,5,1,2,14,11,3,16,Gibraltar - Premier Division,0.62,0.75,3,1.75,1.61,1.33,3
Magpies,8,4,0,4,17,12,5,12,Gibraltar - Premier Division,0.5,0.5,5,2.12,2.0,2.0,4
Manchester 62,8,3,2,3,15,14,1,11,Gibraltar - Premier Division,0.38,0.62,1,1.88,2.63,1.61,5
College 1975,8,3,1,4,12,11,1,10,Gibraltar - Premier Division,0.38,0.5,1,1.5,2.63,2.0,6
Lynx,8,2,1,5,8,23,-15,7,Gibraltar - Premier Division,0.25,0.38,-15,1.0,4.0,2.63,7
Glacis Utd,8,2,0,6,13,24,-11,6,Gibraltar - Premier Division,0.25,0.25,-11,1.62,4.0,4.0,8
Europa Point,8,0,2,6,7,23,-16,2,Gibraltar - Premier Division,0.0,0.25,-16,0.88,0.0,4.0,9
Mons Calpe,8,0,1,7,7,25,-18,1,Gibraltar - Premier Division,0.0,0.12,-18,0.88,0.0,8.33,10
Olympiakos,8,6,2,0,13,4,9,20,Greece - Super League,0.75,1.0,9,1.62,1.33,1.0,1
AEK Athens,8,5,1,2,13,4,9,16,Greece - Super League,0.62,0.75,9,1.62,1.61,1.33,2
Aris,8,4,3,1,9,6,3,15,Greece - Super League,0.5,0.88,3,1.12,2.0,1.14,3
Panathinaikos,8,4,2,2,11,10,1,14,Greece - Super League,0.5,0.75,1,1.38,2.0,1.33,4
PAOK,8,4,1,3,18,6,12,13,Greece - Super League,0.5,0.62,12,2.25,2.0,1.61,5
Atromitos,8,4,1,3,9,8,1,13,Greece - Super League,0.5,0.62,1,1.12,2.0,1.61,5
OFI Crete,8,4,0,4,13,14,-1,12,Greece - Super League,0.5,0.5,-1,1.62,2.0,2.0,6
Levadiakos,8,3,1,4,10,8,2,10,Greece - Super League,0.38,0.5,2,1.25,2.63,2.0,7
Panaitolikos,8,3,1,4,5,6,-1,10,Greece - Super League,0.38,0.5,-1,0.62,2.63,2.0,7
Asteras T.,8,3,1,4,7,11,-4,10,Greece - Super League,0.38,0.5,-4,0.88,2.63,2.0,7
Panserraikos,8,3,1,4,9,16,-7,10,Greece - Super League,0.38,0.5,-7,1.12,2.63,2.0,7
A. Kallithea,8,3,0,5,8,11,-3,9,Greece - Super League,0.38,0.38,-3,1.0,2.63,2.63,8
Lamia,8,2,0,6,4,18,-14,6,Greece - Super League,0.25,0.25,-14,0.5,4.0,4.0,9
Volos,8,0,2,6,4,11,-7,2,Greece - Super League,0.0,0.25,-7,0.5,0.0,4.0,10
Malacateco,8,6,0,2,15,5,10,18,Guatemala - Liga Nacional - Apertura,0.75,0.75,10,1.88,1.33,1.33,1
Xelaju,8,5,2,1,16,5,11,17,Guatemala - Liga Nacional - Apertura,0.62,0.88,11,2.0,1.61,1.14,2
Municipal,8,4,2,2,13,13,0,14,Guatemala - Liga Nacional - Apertura,0.5,0.75,0,1.62,2.0,1.33,3
Coban Imperial,8,4,1,3,13,9,4,13,Guatemala - Liga Nacional - Apertura,0.5,0.62,4,1.62,2.0,1.61,4
Antigua GFC,8,3,3,2,14,11,3,12,Guatemala - Liga Nacional - Apertura,0.38,0.75,3,1.75,2.63,1.33,5
Xinabajul,8,3,2,3,15,14,1,11,Guatemala - Liga Nacional - Apertura,0.38,0.62,1,1.88,2.63,1.61,6
Comunicaciones,8,3,2,3,12,13,-1,11,Guatemala - Liga Nacional - Apertura,0.38,0.62,-1,1.5,2.63,1.61,6
Guastatoya,8,2,4,2,12,10,2,10,Guatemala - Liga Nacional - Apertura,0.25,0.75,2,1.5,4.0,1.33,7
Mixco,8,3,1,4,7,11,-4,10,Guatemala - Liga Nacional - Apertura,0.38,0.5,-4,0.88,2.63,2.0,7
Achuapa,8,2,3,3,6,10,-4,9,Guatemala - Liga Nacional - Apertura,0.25,0.62,-4,0.75,4.0,1.61,8
Marquense,8,0,3,5,4,16,-12,3,Guatemala - Liga Nacional - Apertura,0.0,0.38,-12,0.5,0.0,2.63,9
Zacapa Tellioz,8,0,2,6,3,14,-11,2,Guatemala - Liga Nacional - Apertura,0.0,0.25,-11,0.38,0.0,4.0,10
Olimpia,8,6,2,0,16,4,12,20,Honduras - Liga Nacional - Apertura,0.75,1.0,12,2.0,1.33,1.0,1
Genesis,8,4,3,1,16,8,8,15,Honduras - Liga Nacional - Apertura,0.5,0.88,8,2.0,2.0,1.14,2
Motagua,8,4,2,2,18,14,4,14,Honduras - Liga Nacional - Apertura,0.5,0.75,4,2.25,2.0,1.33,3
Olancho,8,3,4,1,15,10,5,13,Honduras - Liga Nacional - Apertura,0.38,0.88,5,1.88,2.63,1.14,4
Marathon,8,2,4,2,9,8,1,10,Honduras - Liga Nacional - Apertura,0.25,0.75,1,1.12,4.0,1.33,5
Juticalpa,8,2,2,4,7,14,-7,8,Honduras - Liga Nacional - Apertura,0.25,0.5,-7,0.88,4.0,2.0,6
UPNFM,8,2,2,4,6,16,-10,8,Honduras - Liga Nacional - Apertura,0.25,0.5,-10,0.75,4.0,2.0,6
Real Espana,8,1,4,3,6,7,-1,7,Honduras - Liga Nacional - Apertura,0.12,0.62,-1,0.75,8.33,1.61,7
Real Sociedad,8,1,3,4,10,17,-7,6,Honduras - Liga Nacional - Apertura,0.12,0.5,-7,1.25,8.33,2.0,8
Victoria,8,1,2,5,13,18,-5,5,Honduras - Liga Nacional - Apertura,0.12,0.38,-5,1.62,8.33,2.63,9
LM Warriors,8,6,1,1,18,11,7,19,Hong Kong - Premier League,0.75,0.88,7,2.25,1.33,1.14,1
Tai Po,8,6,0,2,21,11,10,18,Hong Kong - Premier League,0.75,0.75,10,2.62,1.33,1.33,2
Kitchee,8,5,1,2,18,8,10,16,Hong Kong - Premier League,0.62,0.75,10,2.25,1.61,1.33,3
Eastern,8,5,1,2,18,11,7,16,Hong Kong - Premier League,0.62,0.75,7,2.25,1.61,1.33,3
HK Rangers,8,2,2,4,15,19,-4,8,Hong Kong - Premier League,0.25,0.5,-4,1.88,4.0,2.0,4
Kowloon City,8,2,2,4,12,20,-8,8,Hong Kong - Premier League,0.25,0.5,-8,1.5,4.0,2.0,4
North District,8,2,1,5,15,24,-9,7,Hong Kong - Premier League,0.25,0.38,-9,1.88,4.0,2.63,5
Southern D.,8,1,2,5,9,12,-3,5,Hong Kong - Premier League,0.12,0.38,-3,1.12,8.33,2.63,6
Hong Kong FC,8,1,1,6,4,15,-11,4,Hong Kong - Premier League,0.12,0.25,-11,0.5,8.33,4.0,7
Paks,8,5,2,1,20,10,10,17,Hungary - NB I,0.62,0.88,10,2.5,1.61,1.14,1
Gyor,8,4,3,1,13,7,6,15,Hungary - NB I,0.5,0.88,6,1.62,2.0,1.14,2
Puskas A.,8,4,1,3,12,11,1,13,Hungary - NB I,0.5,0.62,1,1.5,2.0,1.61,3
Ferencvaros,8,3,3,2,9,8,1,12,Hungary - NB I,0.38,0.75,1,1.12,2.63,1.33,4
Zalaegerszegi,8,3,3,2,9,9,0,12,Hungary - NB I,0.38,0.75,0,1.12,2.63,1.33,4
Kecskemeti TE,8,2,5,1,13,9,4,11,Hungary - NB I,0.25,0.88,4,1.62,4.0,1.14,5
MTK Budapest,8,3,2,3,15,15,0,11,Hungary - NB I,0.38,0.62,0,1.88,2.63,1.61,5
Fehervar,8,3,1,4,10,12,-2,10,Hungary - NB I,0.38,0.5,-2,1.25,2.63,2.0,6
DVTK,8,2,2,4,9,15,-6,8,Hungary - NB I,0.25,0.5,-6,1.12,4.0,2.0,7
Debrecen,8,2,1,5,11,12,-1,7,Hungary - NB I,0.25,0.38,-1,1.38,4.0,2.63,8
Nyiregyhaza,8,1,3,4,3,8,-5,6,Hungary - NB I,0.12,0.5,-5,0.38,8.33,2.0,9
Ujpest,8,0,4,4,6,19,-13,4,Hungary - NB I,0.0,0.5,-13,0.75,0.0,2.0,10
Kisvarda,8,4,3,1,16,9,7,15,Hungary - NB II,0.5,0.88,7,2.0,2.0,1.14,1
Szentlorinc,8,4,3,1,11,5,6,15,Hungary - NB II,0.5,0.88,6,1.38,2.0,1.14,1
Kazincbarcika,8,3,5,0,8,3,5,14,Hungary - NB II,0.38,1.0,5,1.0,2.63,1.0,2
Vasas,8,4,2,2,8,3,5,14,Hungary - NB II,0.5,0.75,5,1.0,2.0,1.33,2
Honved,8,4,1,3,15,10,5,13,Hungary - NB II,0.5,0.62,5,1.88,2.0,1.61,3
Szeged,8,4,1,3,9,7,2,13,Hungary - NB II,0.5,0.62,2,1.12,2.0,1.61,3
Csakvari,8,4,1,3,14,13,1,13,Hungary - NB II,0.5,0.62,1,1.75,2.0,1.61,3
Bekescsaba,8,4,1,3,8,9,-1,13,Hungary - NB II,0.5,0.62,-1,1.0,2.0,1.61,3
Ajka,8,3,1,4,9,11,-2,10,Hungary - NB II,0.38,0.5,-2,1.12,2.63,2.0,4
Tatabanya,8,3,1,4,8,12,-4,10,Hungary - NB II,0.38,0.5,-4,1.0,2.63,2.0,4
Mezokovesd,8,2,3,3,8,8,0,9,Hungary - NB II,0.25,0.62,0,1.0,4.0,1.61,5
BVSC,8,2,3,3,5,7,-2,9,Hungary - NB II,0.25,0.62,-2,0.62,4.0,1.61,5
Soroksar,8,2,3,3,10,14,-4,9,Hungary - NB II,0.25,0.62,-4,1.25,4.0,1.61,5
Kozarmisleny,8,2,1,5,9,17,-8,7,Hungary - NB II,0.25,0.38,-8,1.12,4.0,2.63,6
Gyirmot,8,1,3,4,10,14,-4,6,Hungary - NB II,0.12,0.5,-4,1.25,8.33,2.0,7
Budafoki,8,2,0,6,10,16,-6,6,Hungary - NB II,0.25,0.25,-6,1.25,4.0,4.0,7
Breidablik,8,7,1,0,20,9,11,22,Iceland - Besta deild,0.88,1.0,11,2.5,1.14,1.0,1
Vikingur R.,8,6,1,1,24,12,12,19,Iceland - Besta deild,0.75,0.88,12,3.0,1.33,1.14,2
Stjarnan,8,5,2,1,17,8,9,17,Iceland - Besta deild,0.62,0.88,9,2.12,1.61,1.14,3
KR Reykjavik,8,5,1,2,26,12,14,16,Iceland - Besta deild,0.62,0.75,14,3.25,1.61,1.33,4
KA Akureyri,8,4,1,3,16,15,1,13,Iceland - Besta deild,0.5,0.62,1,2.0,2.0,1.61,5
Valur,8,3,3,2,22,14,8,12,Iceland - Besta deild,0.38,0.75,8,2.75,2.63,1.33,6
Vestri,8,2,2,4,11,14,-3,8,Iceland - Besta deild,0.25,0.5,-3,1.38,4.0,2.0,7
HK Kopavogur,8,2,2,4,12,22,-10,8,Iceland - Besta deild,0.25,0.5,-10,1.5,4.0,2.0,7
IA Akranes,8,2,0,6,12,22,-10,6,Iceland - Besta deild,0.25,0.25,-10,1.5,4.0,4.0,8
Hafnarfjordur,8,1,2,5,10,20,-10,5,Iceland - Besta deild,0.12,0.38,-10,1.25,8.33,2.63,9
Fylkir,8,1,2,5,8,18,-10,5,Iceland - Besta deild,0.12,0.38,-10,1.0,8.33,2.63,9
Fram,8,1,1,6,11,23,-12,4,Iceland - Besta deild,0.12,0.25,-12,1.38,8.33,4.0,10
Afturelding,8,6,1,1,18,7,11,19,Iceland - 1. Deild,0.75,0.88,11,2.25,1.33,1.14,1
Keflavik,8,5,2,1,17,9,8,17,Iceland - 1. Deild,0.62,0.88,8,2.12,1.61,1.14,2
Leiknir R.,8,4,4,0,18,10,8,16,Iceland - 1. Deild,0.5,1.0,8,2.25,2.0,1.0,3
IBV,8,4,2,2,22,12,10,14,Iceland - 1. Deild,0.5,0.75,10,2.75,2.0,1.33,4
IR Reykjavik,8,3,4,1,10,10,0,13,Iceland - 1. Deild,0.38,0.88,0,1.25,2.63,1.14,5
Throttur R.,8,3,2,3,15,12,3,11,Iceland - 1. Deild,0.38,0.62,3,1.88,2.63,1.61,6
Grindavik,8,2,3,3,18,19,-1,9,Iceland - 1. Deild,0.25,0.62,-1,2.25,4.0,1.61,7
Thor Akureyri,8,2,3,3,11,16,-5,9,Iceland - 1. Deild,0.25,0.62,-5,1.38,4.0,1.61,7
Njardvik,8,1,5,2,8,11,-3,8,Iceland - 1. Deild,0.12,0.75,-3,1.0,8.33,1.33,8
Fjolnir,8,1,3,4,6,14,-8,6,Iceland - 1. Deild,0.12,0.5,-8,0.75,8.33,2.0,9
Dalvik / Reynir,8,1,1,6,10,25,-15,4,Iceland - 1. Deild,0.12,0.25,-15,1.25,8.33,4.0,10
Grotta,8,1,0,7,9,17,-8,3,Iceland - 1. Deild,0.12,0.12,-8,1.12,8.33,8.33,11
Throttur Vogar,8,6,2,0,29,7,22,20,Iceland - 2. Deild,0.75,1.0,22,3.62,1.33,1.0,1
Selfoss,8,6,1,1,22,12,10,19,Iceland - 2. Deild,0.75,0.88,10,2.75,1.33,1.14,2
Volsungur,8,5,3,0,21,7,14,18,Iceland - 2. Deild,0.62,1.0,14,2.62,1.61,1.0,3
V. Olafsvik,8,5,1,2,19,13,6,16,Iceland - 2. Deild,0.62,0.75,6,2.38,1.61,1.33,4
Haukar,8,3,1,4,16,14,2,10,Iceland - 2. Deild,0.38,0.5,2,2.0,2.63,2.0,5
Fjardabyggd/L.,8,3,1,4,23,24,-1,10,Iceland - 2. Deild,0.38,0.5,-1,2.88,2.63,2.0,5
AEggir,8,2,4,2,9,12,-3,10,Iceland - 2. Deild,0.25,0.75,-3,1.12,4.0,1.33,5
Hottur/Huginn,8,3,0,5,11,23,-12,9,Iceland - 2. Deild,0.38,0.38,-12,1.38,2.63,2.63,6
KFG,8,2,2,4,12,16,-4,8,Iceland - 2. Deild,0.25,0.5,-4,1.5,4.0,2.0,7
Reynir,8,2,1,5,11,16,-5,7,Iceland - 2. Deild,0.25,0.38,-5,1.38,4.0,2.63,8
Fjallabyggd,8,2,1,5,12,22,-10,7,Iceland - 2. Deild,0.25,0.38,-10,1.5,4.0,2.63,8
Kormakur/Hvot,8,0,1,7,5,24,-19,1,Iceland - 2. Deild,0.0,0.12,-19,0.62,0.0,8.33,9
Mohun Bagan,8,6,2,0,16,2,14,20,India - Super League,0.75,1.0,14,2.0,1.33,1.0,1
Goa,8,6,0,2,13,7,6,18,India - Super League,0.75,0.75,6,1.62,1.33,1.33,2
NorthEast Utd,8,4,2,2,15,7,8,14,India - Super League,0.5,0.75,8,1.88,2.0,1.33,3
East Bengal,8,4,2,2,11,11,0,14,India - Super League,0.5,0.75,0,1.38,2.0,1.33,3
Mumbai City,8,3,3,2,10,6,4,12,India - Super League,0.38,0.75,4,1.25,2.63,1.33,4
Odisha FC,8,3,3,2,13,11,2,12,India - Super League,0.38,0.75,2,1.62,2.63,1.33,4
Bengaluru,8,3,1,4,11,10,1,10,India - Super League,0.38,0.5,1,1.38,2.63,2.0,5
Chennaiyin,8,3,1,4,11,12,-1,10,India - Super League,0.38,0.5,-1,1.38,2.63,2.0,5
Jamshedpur,8,3,1,4,12,16,-4,10,India - Super League,0.38,0.5,-4,1.5,2.63,2.0,5
Kerala Blasters,8,2,3,3,7,10,-3,9,India - Super League,0.25,0.62,-3,0.88,4.0,1.61,6
Punjab,8,2,2,4,11,15,-4,8,India - Super League,0.25,0.5,-4,1.38,4.0,2.0,7
Hyderabad,8,2,2,4,10,16,-6,8,India - Super League,0.25,0.5,-6,1.25,4.0,2.0,7
Mohammedan,8,0,2,6,4,19,-15,2,India - Super League,0.0,0.25,-15,0.5,0.0,4.0,8
Churchill B.,8,4,4,0,19,9,10,16,India - I-League,0.5,1.0,10,2.38,2.0,1.0,1
Real Kashmir,8,5,1,2,11,10,1,16,India - I-League,0.62,0.75,1,1.38,1.61,1.33,1
Inter Kashi,8,4,2,2,12,10,2,14,India - I-League,0.5,0.75,2,1.5,2.0,1.33,2
Sreenidi Deccan,8,4,2,2,11,10,1,14,India - I-League,0.5,0.75,1,1.38,2.0,1.33,2
Shillong Lajong,8,4,1,3,17,18,-1,13,India - I-League,0.5,0.62,-1,2.12,2.0,1.61,3
Gokulam,8,4,0,4,19,14,5,12,India - I-League,0.5,0.5,5,2.38,2.0,2.0,4
Dempo,8,3,2,3,18,14,4,11,India - I-League,0.38,0.62,4,2.25,2.63,1.61,5
Rajasthan,8,2,3,3,13,11,2,9,India - I-League,0.25,0.62,2,1.62,4.0,1.61,6
Namdhari,8,2,3,3,11,11,0,9,India - I-League,0.25,0.62,0,1.38,4.0,1.61,6
SC Bengaluru,8,2,3,3,8,15,-7,9,India - I-League,0.25,0.62,-7,1.0,4.0,1.61,6
Aizawl,8,1,2,5,6,15,-9,5,India - I-League,0.12,0.38,-9,0.75,8.33,2.63,7
Delhi FC,8,1,1,6,7,15,-8,4,India - I-League,0.12,0.25,-8,0.88,8.33,4.0,8
Dewa Utd,8,6,0,2,20,9,11,18,Indonesia - Liga 1,0.75,0.75,11,2.5,1.33,1.33,1
Malut United,8,5,3,0,13,6,7,18,Indonesia - Liga 1,0.62,1.0,7,1.62,1.61,1.0,1
Persib,8,5,2,1,16,9,7,17,Indonesia - Liga 1,0.62,0.88,7,2.0,1.61,1.14,2
Arema,8,4,2,2,19,13,6,14,Indonesia - Liga 1,0.5,0.75,6,2.38,2.0,1.33,3
Barito Putera,8,4,2,2,15,11,4,14,Indonesia - Liga 1,0.5,0.75,4,1.88,2.0,1.33,3
Persis Solo,8,3,4,1,13,10,3,13,Indonesia - Liga 1,0.38,0.88,3,1.62,2.63,1.14,4
Madura Utd,8,3,3,2,10,9,1,12,Indonesia - Liga 1,0.38,0.75,1,1.25,2.63,1.33,5
Borneo,8,4,0,4,8,10,-2,12,Indonesia - Liga 1,0.5,0.5,-2,1.0,2.0,2.0,5
Persebaya S.,8,3,2,3,9,10,-1,11,Indonesia - Liga 1,0.38,0.62,-1,1.12,2.63,1.61,6
PSBS Biak N.,8,2,4,2,8,8,0,10,Indonesia - Liga 1,0.25,0.75,0,1.0,4.0,1.33,7
Persija,8,2,3,3,13,13,0,9,Indonesia - Liga 1,0.25,0.62,0,1.62,4.0,1.61,8
PSM,8,2,3,3,10,10,0,9,Indonesia - Liga 1,0.25,0.62,0,1.25,4.0,1.61,8
Bali Utd,8,2,3,3,10,13,-3,9,Indonesia - Liga 1,0.25,0.62,-3,1.25,4.0,1.61,8
Semen Padang,8,2,3,3,11,17,-6,9,Indonesia - Liga 1,0.25,0.62,-6,1.38,4.0,1.61,8
Persita,8,1,3,4,7,11,-4,6,Indonesia - Liga 1,0.12,0.5,-4,0.88,8.33,2.0,9
PSIS Semarang,8,1,3,4,9,14,-5,6,Indonesia - Liga 1,0.12,0.5,-5,1.12,8.33,2.0,9
Persik Kediri,8,0,4,4,7,13,-6,4,Indonesia - Liga 1,0.0,0.5,-6,0.88,0.0,2.0,10
PSS Sleman,8,1,0,7,9,21,-12,3,Indonesia - Liga 1,0.12,0.12,-12,1.12,8.33,8.33,11
Persepolis,8,5,3,0,10,3,7,18,Iran - Pro League,0.62,1.0,7,1.25,1.61,1.0,1
Tractor Sazi,8,5,2,1,15,4,11,17,Iran - Pro League,0.62,0.88,11,1.88,1.61,1.14,2
Gol Gohar,8,5,2,1,9,3,6,17,Iran - Pro League,0.62,0.88,6,1.12,1.61,1.14,2
Foolad,8,5,1,2,12,9,3,16,Iran - Pro League,0.62,0.75,3,1.5,1.61,1.33,3
Sepahan,8,3,5,0,12,6,6,14,Iran - Pro League,0.38,1.0,6,1.5,2.63,1.0,4
K. Khorramabad,8,4,1,3,9,7,2,13,Iran - Pro League,0.5,0.62,2,1.12,2.0,1.61,5
Shams A. Qazvin,8,3,2,3,9,8,1,11,Iran - Pro League,0.38,0.62,1,1.12,2.63,1.61,6
Malavan,8,3,2,3,5,6,-1,11,Iran - Pro League,0.38,0.62,-1,0.62,2.63,1.61,6
Esteghlal,8,2,4,2,5,4,1,10,Iran - Pro League,0.25,0.75,1,0.62,4.0,1.33,7
Aluminium Arak,8,2,3,3,7,8,-1,9,Iran - Pro League,0.25,0.62,-1,0.88,4.0,1.61,8
Chadormalu,8,2,2,4,6,7,-1,8,Iran - Pro League,0.25,0.5,-1,0.75,4.0,2.0,9
Zob Ahan,8,1,4,3,6,9,-3,7,Iran - Pro League,0.12,0.62,-3,0.75,8.33,1.61,10
E. Khuzestan,8,1,4,3,5,10,-5,7,Iran - Pro League,0.12,0.62,-5,0.62,8.33,1.61,10
Mes Rafsanjan,8,1,4,3,5,11,-6,7,Iran - Pro League,0.12,0.62,-6,0.62,8.33,1.61,10
N. Mazandaran,8,1,2,5,4,8,-4,5,Iran - Pro League,0.12,0.38,-4,0.5,8.33,2.63,11
Havadar,8,1,1,6,4,19,-15,4,Iran - Pro League,0.12,0.25,-15,0.5,8.33,4.0,12
Drogheda Utd,6,3,2,1,7,3,4,11,Ireland - Premier Division,0.5,0.83,4,1.17,2.0,1.2,1
St. Patricks,6,3,1,2,10,6,4,10,Ireland - Premier Division,0.5,0.67,4,1.67,2.0,1.49,2
Galway Utd,6,2,4,0,8,6,2,10,Ireland - Premier Division,0.33,1.0,2,1.33,3.03,1.0,2
Shelbourne,6,2,3,1,7,5,2,9,Ireland - Premier Division,0.33,0.83,2,1.17,3.03,1.2,3
Waterford,6,3,0,3,7,9,-2,9,Ireland - Premier Division,0.5,0.5,-2,1.17,2.0,2.0,3
Shamrock Rovers,5,2,1,2,5,5,0,7,Ireland - Premier Division,0.4,0.6,0,1.0,2.5,1.67,4
Derry City,6,2,1,3,5,8,-3,7,Ireland - Premier Division,0.33,0.5,-3,0.83,3.03,2.0,4
Cork City,5,1,3,1,7,7,0,6,Ireland - Premier Division,0.2,0.8,0,1.4,5.0,1.25,5
Bohemians,6,2,0,4,5,7,-2,6,Ireland - Premier Division,0.33,0.33,-2,0.83,3.03,3.03,5
Sligo Rovers,6,1,1,4,8,13,-5,4,Ireland - Premier Division,0.17,0.33,-5,1.33,5.88,3.03,6
Dundalk,5,4,1,0,8,3,5,13,Ireland - First Division,0.8,1.0,5,1.6,1.25,1.0,1
Cobh Ramblers,5,3,2,0,11,4,7,11,Ireland - First Division,0.6,1.0,7,2.2,1.67,1.0,2
Wexford,4,3,0,1,6,1,5,9,Ireland - First Division,0.75,0.75,5,1.5,1.33,1.33,3
Treaty Utd,5,2,1,2,12,7,5,7,Ireland - First Division,0.4,0.6,5,2.4,2.5,1.67,4
Athlone Town,5,2,1,2,4,8,-4,7,Ireland - First Division,0.4,0.6,-4,0.8,2.5,1.67,4
Bray Wanderers,4,2,0,2,3,5,-2,6,Ireland - First Division,0.5,0.5,-2,0.75,2.0,2.0,5
Kerry,5,1,1,3,4,5,-1,4,Ireland - First Division,0.2,0.4,-1,0.8,5.0,2.5,6
Longford Town,4,1,1,2,4,9,-5,4,Ireland - First Division,0.25,0.5,-5,1.0,4.0,2.0,6
UC Dublin,4,0,2,2,3,7,-4,2,Ireland - First Division,0.0,0.5,-4,0.75,0.0,2.0,7
Finn Harps,5,0,1,4,3,9,-6,1,Ireland - First Division,0.0,0.2,-6,0.6,0.0,5.0,8
M. Tel Aviv,8,6,1,1,18,7,11,19,Israel - Ligat HaAl,0.75,0.88,11,2.25,1.33,1.14,1
H. Beer Sheva,8,5,2,1,15,6,9,17,Israel - Ligat HaAl,0.62,0.88,9,1.88,1.61,1.14,2
Kiryat Shmona,8,4,2,2,11,7,4,14,Israel - Ligat HaAl,0.5,0.75,4,1.38,2.0,1.33,3
Maccabi Netanya,8,4,2,2,10,8,2,14,Israel - Ligat HaAl,0.5,0.75,2,1.25,2.0,1.33,3
Hapoel Haifa,8,4,2,2,14,14,0,14,Israel - Ligat HaAl,0.5,0.75,0,1.75,2.0,1.33,3
B. Jerusalem,8,3,4,1,11,7,4,13,Israel - Ligat HaAl,0.38,0.88,4,1.38,2.63,1.14,4
Maccabi Haifa,8,3,3,2,15,13,2,12,Israel - Ligat HaAl,0.38,0.75,2,1.88,2.63,1.33,5
H. Jerusalem,8,2,4,2,12,9,3,10,Israel - Ligat HaAl,0.25,0.75,3,1.5,4.0,1.33,6
Ashdod,8,2,3,3,11,11,0,9,Israel - Ligat HaAl,0.25,0.62,0,1.38,4.0,1.61,7
Ironi Tiberias,8,2,3,3,7,14,-7,9,Israel - Ligat HaAl,0.25,0.62,-7,0.88,4.0,1.61,7
Hapoel Hadera,8,2,2,4,8,12,-4,8,Israel - Ligat HaAl,0.25,0.5,-4,1.0,4.0,2.0,8
M. Bnei Raina,8,2,1,5,5,11,-6,7,Israel - Ligat HaAl,0.25,0.38,-6,0.62,4.0,2.63,9
M. Petah Tikva,8,1,1,6,6,12,-6,4,Israel - Ligat HaAl,0.12,0.25,-6,0.75,8.33,4.0,10
Sakhnin,8,1,0,7,4,13,-9,3,Israel - Ligat HaAl,0.12,0.12,-9,0.5,8.33,8.33,11
Hapoel Tel Aviv,8,7,1,0,20,2,18,22,Israel - Leumit League,0.88,1.0,18,2.5,1.14,1.0,1
H. Petah Tikva,8,7,1,0,17,2,15,22,Israel - Leumit League,0.88,1.0,15,2.12,1.14,1.0,1
Kafr Qasim,8,4,2,2,10,6,4,14,Israel - Leumit League,0.5,0.75,4,1.25,2.0,1.33,2
Bnei Yehuda,8,4,1,3,8,6,2,13,Israel - Leumit League,0.5,0.62,2,1.0,2.0,1.61,3
Hapoel Raanana,8,4,1,3,8,6,2,13,Israel - Leumit League,0.5,0.62,2,1.0,2.0,1.61,3
Hapoel Akko,8,4,1,3,7,9,-2,13,Israel - Leumit League,0.5,0.62,-2,0.88,2.0,1.61,3
H. Ironi Rishon,8,3,3,2,14,11,3,12,Israel - Leumit League,0.38,0.75,3,1.75,2.63,1.33,4
H. Kfar Shalem,8,3,2,3,13,10,3,11,Israel - Leumit League,0.38,0.62,3,1.62,2.63,1.61,5
H. Kfar Saba,8,3,1,4,10,10,0,10,Israel - Leumit League,0.38,0.5,0,1.25,2.63,2.0,6
M. Herziliya,8,3,1,4,9,13,-4,10,Israel - Leumit League,0.38,0.5,-4,1.12,2.63,2.0,6
Maccabi Jaffa,8,2,3,3,5,10,-5,9,Israel - Leumit League,0.25,0.62,-5,0.62,4.0,1.61,7
H. Ramat Gan,8,2,2,4,11,6,5,8,Israel - Leumit League,0.25,0.5,5,1.38,4.0,2.0,8
Hapoel Afula,8,2,2,4,5,11,-6,8,Israel - Leumit League,0.25,0.5,-6,0.62,4.0,2.0,8
H. Umm al-Fahm,8,2,2,4,5,12,-7,8,Israel - Leumit League,0.25,0.5,-7,0.62,4.0,2.0,8
Ramat Hasharon,8,1,1,6,5,23,-18,4,Israel - Leumit League,0.12,0.25,-18,0.62,8.33,4.0,9
H. Nof Hagalil,8,0,1,7,0,11,-11,1,Israel - Leumit League,0.0,0.12,-11,0.0,0.0,8.33,10
AS Roma,8,7,1,0,15,4,11,22,Italy - Serie A,0.88,1.0,11,1.88,1.14,1.0,1
Juventus,8,6,0,2,13,8,5,18,Italy - Serie A,0.75,0.75,5,1.62,1.33,1.33,2
Bologna,8,5,2,1,12,8,4,17,Italy - Serie A,0.62,0.88,4,1.5,1.61,1.14,3
Atalanta,8,4,3,1,19,5,14,15,Italy - Serie A,0.5,0.88,14,2.38,2.0,1.14,4
Lazio,8,4,3,1,16,8,8,15,Italy - Serie A,0.5,0.88,8,2.0,2.0,1.14,4
Torino,8,4,3,1,13,8,5,15,Italy - Serie A,0.5,0.88,5,1.62,2.0,1.14,4
Udinese,8,4,2,2,11,7,4,14,Italy - Serie A,0.5,0.75,4,1.38,2.0,1.33,5
Inter Milan,8,4,2,2,12,9,3,14,Italy - Serie A,0.5,0.75,3,1.5,2.0,1.33,5
Napoli,8,3,4,1,13,11,2,13,Italy - Serie A,0.38,0.88,2,1.62,2.63,1.14,6
AC Milan,8,4,1,3,12,10,2,13,Italy - Serie A,0.5,0.62,2,1.5,2.0,1.61,6
Genoa,8,3,3,2,10,7,3,12,Italy - Serie A,0.38,0.75,3,1.25,2.63,1.33,7
Fiorentina,8,4,0,4,10,9,1,12,Italy - Serie A,0.5,0.5,1,1.25,2.0,2.0,7
Hellas Verona,8,3,1,4,5,11,-6,10,Italy - Serie A,0.38,0.5,-6,0.62,2.63,2.0,8
Cagliari,8,2,2,4,9,10,-1,8,Italy - Serie A,0.25,0.5,-1,1.12,4.0,2.0,9
Como,8,2,1,5,9,12,-3,7,Italy - Serie A,0.25,0.38,-3,1.12,4.0,2.63,10
Parma,8,1,2,5,9,13,-4,5,Italy - Serie A,0.12,0.38,-4,1.12,8.33,2.63,11
Venezia,8,0,5,3,5,9,-4,5,Italy - Serie A,0.0,0.62,-4,0.62,0.0,1.61,11
Lecce,8,1,2,5,6,12,-6,5,Italy - Serie A,0.12,0.38,-6,0.75,8.33,2.63,11
Monza,8,0,2,6,4,18,-14,2,Italy - Serie A,0.0,0.25,-14,0.5,0.0,4.0,12
Empoli,8,0,2,6,3,18,-15,2,Italy - Serie A,0.0,0.25,-15,0.38,0.0,4.0,12
Sassuolo,8,5,2,1,12,4,8,17,Italy - Serie B,0.62,0.88,8,1.5,1.61,1.14,1
Catanzaro,8,4,3,1,11,10,1,15,Italy - Serie B,0.5,0.88,1,1.38,2.0,1.14,2
Sudtirol,8,4,2,2,17,11,6,14,Italy - Serie B,0.5,0.75,6,2.12,2.0,1.33,3
Spezia,8,3,4,1,11,8,3,13,Italy - Serie B,0.38,0.88,3,1.38,2.63,1.14,4
Juve Stabia,8,4,1,3,12,10,2,13,Italy - Serie B,0.5,0.62,2,1.5,2.0,1.61,4
Cesena,8,3,4,1,10,8,2,13,Italy - Serie B,0.38,0.88,2,1.25,2.63,1.14,4
Cremonese,8,3,3,2,16,11,5,12,Italy - Serie B,0.38,0.75,5,2.0,2.63,1.33,5
Frosinone,8,3,3,2,9,10,-1,12,Italy - Serie B,0.38,0.75,-1,1.12,2.63,1.33,5
Pisa,8,3,2,3,9,8,1,11,Italy - Serie B,0.38,0.62,1,1.12,2.63,1.61,6
Bari,8,2,5,1,8,8,0,11,Italy - Serie B,0.25,0.88,0,1.0,4.0,1.14,6
Sampdoria,8,2,4,2,8,8,0,10,Italy - Serie B,0.25,0.75,0,1.0,4.0,1.33,7
Palermo,8,2,3,3,13,12,1,9,Italy - Serie B,0.25,0.62,1,1.62,4.0,1.61,8
Modena,8,2,3,3,10,9,1,9,Italy - Serie B,0.25,0.62,1,1.25,4.0,1.61,8
Salernitana,8,2,3,3,5,7,-2,9,Italy - Serie B,0.25,0.62,-2,0.62,4.0,1.61,8
Cittadella,8,3,0,5,5,12,-7,9,Italy - Serie B,0.38,0.38,-7,0.62,2.63,2.63,8
Cosenza,8,2,1,5,4,12,-8,7,Italy - Serie B,0.25,0.38,-8,0.5,4.0,2.63,9
Reggiana,8,1,3,4,7,11,-4,6,Italy - Serie B,0.12,0.5,-4,0.88,8.33,2.0,10
Brescia,8,1,3,4,6,10,-4,6,Italy - Serie B,0.12,0.5,-4,0.75,8.33,2.0,10
Mantova,8,1,3,4,9,15,-6,6,Italy - Serie B,0.12,0.5,-6,1.12,8.33,2.0,10
Carrarese,8,1,2,5,9,16,-7,5,Italy - Serie B,0.12,0.38,-7,1.12,8.33,2.63,11
Virtus Verona,8,6,1,1,19,7,12,19,Italy - Serie C - Group A,0.75,0.88,12,2.38,1.33,1.14,1
Giana Erminio,8,6,1,1,14,7,7,19,Italy - Serie C - Group A,0.75,0.88,7,1.75,1.33,1.14,1
Vicenza,8,5,2,1,14,6,8,17,Italy - Serie C - Group A,0.62,0.88,8,1.75,1.61,1.14,2
Pergolettese,8,4,3,1,9,5,4,15,Italy - Serie C - Group A,0.5,0.88,4,1.12,2.0,1.14,3
Triestina,8,4,3,1,9,6,3,15,Italy - Serie C - Group A,0.5,0.88,3,1.12,2.0,1.14,3
FeralpiSalo,8,4,2,2,11,8,3,14,Italy - Serie C - Group A,0.5,0.75,3,1.38,2.0,1.33,4
AlbinoLeffe,8,3,3,2,7,9,-2,12,Italy - Serie C - Group A,0.38,0.75,-2,0.88,2.63,1.33,5
Padova,8,3,2,3,13,8,5,11,Italy - Serie C - Group A,0.38,0.62,5,1.62,2.63,1.61,6
Novara,8,3,2,3,7,7,0,11,Italy - Serie C - Group A,0.38,0.62,0,0.88,2.63,1.61,6
Arzignano,8,3,2,3,8,10,-2,11,Italy - Serie C - Group A,0.38,0.62,-2,1.0,2.63,1.61,6
Trento,8,2,4,2,10,7,3,10,Italy - Serie C - Group A,0.25,0.75,3,1.25,4.0,1.33,7
Lecco,8,2,4,2,5,6,-1,10,Italy - Serie C - Group A,0.25,0.75,-1,0.62,4.0,1.33,7
Renate,8,3,1,4,7,10,-3,10,Italy - Serie C - Group A,0.38,0.5,-3,0.88,2.63,2.0,7
Pro Patria,8,2,2,4,8,10,-2,8,Italy - Serie C - Group A,0.25,0.5,-2,1.0,4.0,2.0,8
Lumezzane,8,1,4,3,7,10,-3,7,Italy - Serie C - Group A,0.12,0.62,-3,0.88,8.33,1.61,9
Alcione,8,1,4,3,6,9,-3,7,Italy - Serie C - Group A,0.12,0.62,-3,0.75,8.33,1.61,9
Caldiero Terme,8,1,3,4,10,15,-5,6,Italy - Serie C - Group A,0.12,0.5,-5,1.25,8.33,2.0,10
Pro Vercelli,8,1,3,4,4,9,-5,6,Italy - Serie C - Group A,0.12,0.5,-5,0.5,8.33,2.0,10
Clodiense,8,1,1,6,6,17,-11,4,Italy - Serie C - Group A,0.12,0.25,-11,0.75,8.33,4.0,11
Atalanta B,8,0,3,5,5,13,-8,3,Italy - Serie C - Group A,0.0,0.38,-8,0.62,0.0,2.63,12
Ternana,8,7,0,1,14,4,10,21,Italy - Serie C - Group B,0.88,0.88,10,1.75,1.14,1.14,1
Entella,8,5,3,0,13,6,7,18,Italy - Serie C - Group B,0.62,1.0,7,1.62,1.61,1.0,2
Pescara,8,4,3,1,17,10,7,15,Italy - Serie C - Group B,0.5,0.88,7,2.12,2.0,1.14,3
Pineto,8,4,2,2,12,9,3,14,Italy - Serie C - Group B,0.5,0.75,3,1.5,2.0,1.33,4
Rimini,8,4,1,3,10,6,4,13,Italy - Serie C - Group B,0.5,0.62,4,1.25,2.0,1.61,5
Lucchese,8,3,3,2,12,12,0,12,Italy - Serie C - Group B,0.38,0.75,0,1.5,2.63,1.33,6
Pianese,8,4,0,4,7,7,0,12,Italy - Serie C - Group B,0.5,0.5,0,0.88,2.0,2.0,6
Torres,8,3,3,2,5,5,0,12,Italy - Serie C - Group B,0.38,0.75,0,0.62,2.63,1.33,6
Gubbio,8,3,3,2,6,7,-1,12,Italy - Serie C - Group B,0.38,0.75,-1,0.75,2.63,1.33,6
Athletic Carpi,8,3,2,3,10,9,1,11,Italy - Serie C - Group B,0.38,0.62,1,1.25,2.63,1.61,7
Perugia,8,3,2,3,7,7,0,11,Italy - Serie C - Group B,0.38,0.62,0,0.88,2.63,1.61,7
Vis Pesaro,8,2,4,2,7,7,0,10,Italy - Serie C - Group B,0.25,0.75,0,0.88,4.0,1.33,8
Arezzo,8,3,1,4,6,6,0,10,Italy - Serie C - Group B,0.38,0.5,0,0.75,2.63,2.0,8
Pontedera,8,3,1,4,9,13,-4,10,Italy - Serie C - Group B,0.38,0.5,-4,1.12,2.63,2.0,8
Campobasso,8,3,0,5,6,11,-5,9,Italy - Serie C - Group B,0.38,0.38,-5,0.75,2.63,2.63,9
Ascoli,8,3,0,5,6,12,-6,9,Italy - Serie C - Group B,0.38,0.38,-6,0.75,2.63,2.63,9
Legnago Salus,8,2,2,4,8,9,-1,8,Italy - Serie C - Group B,0.25,0.5,-1,1.0,4.0,2.0,10
Sestri Levante,8,1,3,4,7,9,-2,6,Italy - Serie C - Group B,0.12,0.5,-2,0.88,8.33,2.0,11
AC Milan B,8,1,2,5,7,12,-5,5,Italy - Serie C - Group B,0.12,0.38,-5,0.88,8.33,2.63,12
SPAL,8,1,1,6,5,13,-8,4,Italy - Serie C - Group B,0.12,0.25,-8,0.62,8.33,4.0,13
A. Cerignola,8,7,1,0,13,4,9,22,Italy - Serie C - Group C,0.88,1.0,9,1.62,1.14,1.0,1
Avellino,8,7,0,1,14,5,9,21,Italy - Serie C - Group C,0.88,0.88,9,1.75,1.14,1.14,2
Crotone,8,4,2,2,14,8,6,14,Italy - Serie C - Group C,0.5,0.75,6,1.75,2.0,1.33,3
Monopoli,8,4,2,2,10,7,3,14,Italy - Serie C - Group C,0.5,0.75,3,1.25,2.0,1.33,3
Catania,8,3,4,1,13,9,4,13,Italy - Serie C - Group C,0.38,0.88,4,1.62,2.63,1.14,4
Juventus U23,8,3,3,2,9,6,3,12,Italy - Serie C - Group C,0.38,0.75,3,1.12,2.63,1.33,5
Altamura,8,2,5,1,9,7,2,11,Italy - Serie C - Group C,0.25,0.88,2,1.12,4.0,1.14,6
Foggia,8,3,2,3,13,13,0,11,Italy - Serie C - Group C,0.38,0.62,0,1.62,2.63,1.61,6
Picerno,8,1,7,0,7,5,2,10,Italy - Serie C - Group C,0.12,1.0,2,0.88,8.33,1.0,7
Giugliano,8,3,1,4,12,14,-2,10,Italy - Serie C - Group C,0.38,0.5,-2,1.5,2.63,2.0,7
Potenza,8,2,3,3,16,18,-2,9,Italy - Serie C - Group C,0.25,0.62,-2,2.0,4.0,1.61,8
ACR Messina,8,1,4,3,7,9,-2,7,Italy - Serie C - Group C,0.12,0.62,-2,0.88,8.33,1.61,9
Benevento,8,0,7,1,6,8,-2,7,Italy - Serie C - Group C,0.0,0.88,-2,0.75,0.0,1.14,9
Cavese,8,1,4,3,10,13,-3,7,Italy - Serie C - Group C,0.12,0.62,-3,1.25,8.33,1.61,9
Trapani,8,2,1,5,5,11,-6,7,Italy - Serie C - Group C,0.25,0.38,-6,0.62,4.0,2.63,9
Sorrento,8,1,3,4,5,9,-4,6,Italy - Serie C - Group C,0.12,0.5,-4,0.62,8.33,2.0,10
Latina,8,1,2,5,7,18,-11,5,Italy - Serie C - Group C,0.12,0.38,-11,0.88,8.33,2.63,11
Casertana,8,0,3,5,4,10,-6,3,Italy - Serie C - Group C,0.0,0.38,-6,0.5,0.0,2.63,12
Taranto,0,0,0,0,0,0,0,0,Italy - Serie C - Group C,0.0,0.0,0,0.0,0.0,0.0,13
Turris,0,0,0,0,0,0,0,0,Italy - Serie C - Group C,0.0,0.0,0,0.0,0.0,0.0,13
NovaRomentin,8,6,1,1,17,5,12,19,Italy - Serie D - Group A,0.75,0.88,12,2.12,1.33,1.14,1
Ligorna,8,6,1,1,16,8,8,19,Italy - Serie D - Group A,0.75,0.88,8,2.0,1.33,1.14,1
Citta di Varese,8,5,1,2,9,4,5,16,Italy - Serie D - Group A,0.62,0.75,5,1.12,1.61,1.33,2
Lavagnese,8,4,3,1,14,5,9,15,Italy - Serie D - Group A,0.5,0.88,9,1.75,2.0,1.14,3
Bra,8,4,3,1,12,8,4,15,Italy - Serie D - Group A,0.5,0.88,4,1.5,2.0,1.14,3
Gozzano,8,3,4,1,7,4,3,13,Italy - Serie D - Group A,0.38,0.88,3,0.88,2.63,1.14,4
Fossano,8,4,1,3,9,10,-1,13,Italy - Serie D - Group A,0.5,0.62,-1,1.12,2.0,1.61,4
Saluzzo,8,3,3,2,10,8,2,12,Italy - Serie D - Group A,0.38,0.75,2,1.25,2.63,1.33,5
Derthona,8,3,2,3,9,9,0,11,Italy - Serie D - Group A,0.38,0.62,0,1.12,2.63,1.61,6
Sanremese,8,2,4,2,8,10,-2,10,Italy - Serie D - Group A,0.25,0.75,-2,1.0,4.0,1.33,7
Vado,8,2,3,3,8,7,1,9,Italy - Serie D - Group A,0.25,0.62,1,1.0,4.0,1.61,8
Asti,8,2,3,3,9,10,-1,9,Italy - Serie D - Group A,0.25,0.62,-1,1.12,4.0,1.61,8
Chisola,8,2,3,3,7,8,-1,9,Italy - Serie D - Group A,0.25,0.62,-1,0.88,4.0,1.61,8
Vogherese,8,1,5,2,5,9,-4,8,Italy - Serie D - Group A,0.12,0.75,-4,0.62,8.33,1.33,9
Cairese,8,1,3,4,5,10,-5,6,Italy - Serie D - Group A,0.12,0.5,-5,0.62,8.33,2.0,10
Pro Imperia,8,1,2,5,10,17,-7,5,Italy - Serie D - Group A,0.12,0.38,-7,1.25,8.33,2.63,11
Oltrepo,8,1,2,5,4,11,-7,5,Italy - Serie D - Group A,0.12,0.38,-7,0.5,8.33,2.63,11
Chieri,8,1,2,5,5,17,-12,5,Italy - Serie D - Group A,0.12,0.38,-12,0.62,8.33,2.63,11
Borgaro Nobis,8,0,2,6,5,13,-8,2,Italy - Serie D - Group A,0.0,0.25,-8,0.62,0.0,4.0,12
Albenga,0,0,0,0,0,0,0,0,Italy - Serie D - Group A,0.0,0.0,0,0.0,0.0,0.0,13
Pro Palazzolo,8,5,2,1,21,7,14,17,Italy - Serie D - Group B,0.62,0.88,14,2.62,1.61,1.14,1
USD Casatese,8,5,2,1,13,6,7,17,Italy - Serie D - Group B,0.62,0.88,7,1.62,1.61,1.14,1
Varesina,8,5,1,2,13,9,4,16,Italy - Serie D - Group B,0.62,0.75,4,1.62,1.61,1.33,2
Crema,8,4,2,2,14,8,6,14,Italy - Serie D - Group B,0.5,0.75,6,1.75,2.0,1.33,3
Sondrio,8,4,2,2,11,8,3,14,Italy - Serie D - Group B,0.5,0.75,3,1.38,2.0,1.33,3
Club Milano,8,4,1,3,11,11,0,13,Italy - Serie D - Group B,0.5,0.62,0,1.38,2.0,1.61,4
Vigasio,8,3,3,2,7,6,1,12,Italy - Serie D - Group B,0.38,0.75,1,0.88,2.63,1.33,5
F. Caratese,8,3,3,2,11,11,0,12,Italy - Serie D - Group B,0.38,0.75,0,1.38,2.63,1.33,5
Ciliverghe,8,4,0,4,12,16,-4,12,Italy - Serie D - Group B,0.5,0.5,-4,1.5,2.0,2.0,5
Chievo,8,3,2,3,10,11,-1,11,Italy - Serie D - Group B,0.38,0.62,-1,1.25,2.63,1.61,6
Breno,8,2,4,2,14,17,-3,10,Italy - Serie D - Group B,0.25,0.75,-3,1.75,4.0,1.33,7
Ospitaletto,8,2,3,3,10,11,-1,9,Italy - Serie D - Group B,0.25,0.62,-1,1.25,4.0,1.61,8
Desenxano,8,2,3,3,6,7,-1,9,Italy - Serie D - Group B,0.25,0.62,-1,0.75,4.0,1.61,8
Fanfulla,8,2,3,3,8,10,-2,9,Italy - Serie D - Group B,0.25,0.62,-2,1.0,4.0,1.61,8
Pro Sesto,8,2,3,3,7,9,-2,9,Italy - Serie D - Group B,0.25,0.62,-2,0.88,4.0,1.61,8
Sangiuliano C.,8,2,2,4,6,10,-4,8,Italy - Serie D - Group B,0.25,0.5,-4,0.75,4.0,2.0,9
Castellanzese,8,1,4,3,9,12,-3,7,Italy - Serie D - Group B,0.12,0.62,-3,1.12,8.33,1.61,10
Arconatese,8,1,4,3,8,11,-3,7,Italy - Serie D - Group B,0.12,0.62,-3,1.0,8.33,1.61,10
SantAngelo,8,0,5,3,8,12,-4,5,Italy - Serie D - Group B,0.0,0.62,-4,1.0,0.0,1.61,11
Magenta,8,1,1,6,7,14,-7,4,Italy - Serie D - Group B,0.12,0.25,-7,0.88,8.33,4.0,12
Cjarlins Muzane,8,5,2,1,14,7,7,17,Italy - Serie D - Group C,0.62,0.88,7,1.75,1.61,1.14,1
Mestre,8,5,2,1,9,5,4,17,Italy - Serie D - Group C,0.62,0.88,4,1.12,1.61,1.14,1
Real Calepina,8,4,4,0,10,6,4,16,Italy - Serie D - Group C,0.5,1.0,4,1.25,2.0,1.0,2
D. Bellunesi,8,4,2,2,16,12,4,14,Italy - Serie D - Group C,0.5,0.75,4,2.0,2.0,1.33,3
Este,8,4,2,2,11,7,4,14,Italy - Serie D - Group C,0.5,0.75,4,1.38,2.0,1.33,3
Luparense,8,3,4,1,11,7,4,13,Italy - Serie D - Group C,0.38,0.88,4,1.38,2.63,1.14,4
Adriese,8,3,4,1,9,8,1,13,Italy - Serie D - Group C,0.38,0.88,1,1.12,2.63,1.14,4
Villa Alme,8,3,3,2,17,13,4,12,Italy - Serie D - Group C,0.38,0.75,4,2.12,2.63,1.33,5
Portogruaro,8,3,3,2,8,4,4,12,Italy - Serie D - Group C,0.38,0.75,4,1.0,2.63,1.33,5
Ciserano,8,2,5,1,10,8,2,11,Italy - Serie D - Group C,0.25,0.88,2,1.25,4.0,1.14,6
Brusaporto,8,2,4,2,9,8,1,10,Italy - Serie D - Group C,0.25,0.75,1,1.12,4.0,1.33,7
Brian Lignano,8,1,6,1,9,7,2,9,Italy - Serie D - Group C,0.12,0.88,2,1.12,8.33,1.14,8
Montecchio M.,8,2,3,3,9,10,-1,9,Italy - Serie D - Group C,0.25,0.62,-1,1.12,4.0,1.61,8
Bassano Virtus,8,2,3,3,9,11,-2,9,Italy - Serie D - Group C,0.25,0.62,-2,1.12,4.0,1.61,8
Chions,8,1,5,2,8,9,-1,8,Italy - Serie D - Group C,0.12,0.75,-1,1.0,8.33,1.33,9
Campodarsego,8,1,5,2,6,9,-3,8,Italy - Serie D - Group C,0.12,0.75,-3,0.75,8.33,1.33,9
Calvi Noale,8,2,2,4,8,13,-5,8,Italy - Serie D - Group C,0.25,0.5,-5,1.0,4.0,2.0,9
Treviso,8,2,0,6,5,10,-5,6,Italy - Serie D - Group C,0.25,0.25,-5,0.62,4.0,4.0,10
Caravaggio,8,0,2,6,7,15,-8,2,Italy - Serie D - Group C,0.0,0.25,-8,0.88,0.0,4.0,11
Lavis,8,0,1,7,3,19,-16,1,Italy - Serie D - Group C,0.0,0.12,-16,0.38,0.0,8.33,12
Forli,8,7,0,1,15,3,12,21,Italy - Serie D - Group D,0.88,0.88,12,1.88,1.14,1.14,1
Ravenna,8,6,2,0,16,4,12,20,Italy - Serie D - Group D,0.75,1.0,12,2.0,1.33,1.0,2
Pistoiese,8,4,3,1,11,4,7,15,Italy - Serie D - Group D,0.5,0.88,7,1.38,2.0,1.14,3
Cittadella Vis,8,4,2,2,14,8,6,14,Italy - Serie D - Group D,0.5,0.75,6,1.75,2.0,1.33,4
Zenith Prato,8,4,1,3,13,7,6,13,Italy - Serie D - Group D,0.5,0.62,6,1.62,2.0,1.61,5
Progresso,8,4,1,3,7,7,0,13,Italy - Serie D - Group D,0.5,0.62,0,0.88,2.0,1.61,5
Prato,8,4,1,3,6,8,-2,13,Italy - Serie D - Group D,0.5,0.62,-2,0.75,2.0,1.61,5
Lentigione,8,3,3,2,11,8,3,12,Italy - Serie D - Group D,0.38,0.75,3,1.38,2.63,1.33,6
Piacenza,8,3,3,2,5,4,1,12,Italy - Serie D - Group D,0.38,0.75,1,0.62,2.63,1.33,6
Tau Altopascio,8,3,2,3,9,6,3,11,Italy - Serie D - Group D,0.38,0.62,3,1.12,2.63,1.61,7
Sammaurese,8,2,3,3,8,5,3,9,Italy - Serie D - Group D,0.25,0.62,3,1.0,4.0,1.61,8
San Marino C.,8,2,2,4,7,8,-1,8,Italy - Serie D - Group D,0.25,0.5,-1,0.88,4.0,2.0,9
Tuttocuoio,8,2,2,4,7,12,-5,8,Italy - Serie D - Group D,0.25,0.5,-5,0.88,4.0,2.0,9
Imolese,8,2,2,4,6,12,-6,8,Italy - Serie D - Group D,0.25,0.5,-6,0.75,4.0,2.0,9
Corticella,8,2,2,4,3,10,-7,8,Italy - Serie D - Group D,0.25,0.5,-7,0.38,4.0,2.0,9
Sasso Marconi,8,2,1,5,8,13,-5,7,Italy - Serie D - Group D,0.25,0.38,-5,1.0,4.0,2.63,10
Fiorenzuola,8,1,1,6,4,12,-8,4,Italy - Serie D - Group D,0.12,0.25,-8,0.5,8.33,4.0,11
United Riccione,8,1,1,6,3,22,-19,4,Italy - Serie D - Group D,0.12,0.25,-19,0.38,8.33,4.0,11
Livorno,8,6,1,1,18,13,5,19,Italy - Serie D - Group E,0.75,0.88,5,2.25,1.33,1.14,1
Fulgens Foligno,8,4,2,2,17,11,6,14,Italy - Serie D - Group E,0.5,0.75,6,2.12,2.0,1.33,2
Figline,8,4,1,3,12,7,5,13,Italy - Serie D - Group E,0.5,0.62,5,1.5,2.0,1.61,3
Ostia Mare,8,3,4,1,12,10,2,13,Italy - Serie D - Group E,0.38,0.88,2,1.5,2.63,1.14,3
San Donato,8,4,1,3,7,7,0,13,Italy - Serie D - Group E,0.5,0.62,0,0.88,2.0,1.61,3
Seravezza,8,3,3,2,10,8,2,12,Italy - Serie D - Group E,0.38,0.75,2,1.25,2.63,1.33,4
Flaminia,8,3,2,3,13,9,4,11,Italy - Serie D - Group E,0.38,0.62,4,1.62,2.63,1.61,5
Fezzanese,8,2,5,1,11,11,0,11,Italy - Serie D - Group E,0.25,0.88,0,1.38,4.0,1.14,5
FC Siena,8,2,5,1,6,6,0,11,Italy - Serie D - Group E,0.25,0.88,0,0.75,4.0,1.14,5
Sangiovannese,8,2,4,2,8,7,1,10,Italy - Serie D - Group E,0.25,0.75,1,1.0,4.0,1.33,6
Gavorrano,8,2,4,2,9,9,0,10,Italy - Serie D - Group E,0.25,0.75,0,1.12,4.0,1.33,6
Orvietana,8,2,3,3,10,12,-2,9,Italy - Serie D - Group E,0.25,0.62,-2,1.25,4.0,1.61,7
Grosseto,8,2,3,3,7,10,-3,9,Italy - Serie D - Group E,0.25,0.62,-3,0.88,4.0,1.61,7
T. Traiana,8,2,2,4,6,9,-3,8,Italy - Serie D - Group E,0.25,0.5,-3,0.75,4.0,2.0,8
S. Trestina,8,2,2,4,6,15,-9,8,Italy - Serie D - Group E,0.25,0.5,-9,0.75,4.0,2.0,8
Ghiviborgo,8,2,1,5,12,13,-1,7,Italy - Serie D - Group E,0.25,0.38,-1,1.5,4.0,2.63,9
Montevarchi,8,1,4,3,4,7,-3,7,Italy - Serie D - Group E,0.12,0.62,-3,0.5,8.33,1.61,9
Poggibonsi,8,1,3,4,4,8,-4,6,Italy - Serie D - Group E,0.12,0.5,-4,0.5,8.33,2.0,10
Teramo,8,5,1,2,16,7,9,16,Italy - Serie D - Group F,0.62,0.75,9,2.0,1.61,1.33,1
San Nicolo,8,5,1,2,14,9,5,16,Italy - Serie D - Group F,0.62,0.75,5,1.75,1.61,1.33,1
Chieti,8,4,3,1,13,9,4,15,Italy - Serie D - Group F,0.5,0.88,4,1.62,2.0,1.14,2
Sambenedettese,8,3,4,1,10,6,4,13,Italy - Serie D - Group F,0.38,0.88,4,1.25,2.63,1.14,3
Civitanovese,8,3,4,1,9,5,4,13,Italy - Serie D - Group F,0.38,0.88,4,1.12,2.63,1.14,3
LAquila,8,3,3,2,10,7,3,12,Italy - Serie D - Group F,0.38,0.75,3,1.25,2.63,1.33,4
Sora,8,3,3,2,8,6,2,12,Italy - Serie D - Group F,0.38,0.75,2,1.0,2.63,1.33,4
Avezzano,8,2,5,1,8,10,-2,11,Italy - Serie D - Group F,0.25,0.88,-2,1.0,4.0,1.14,5
Fossombrone,8,2,4,2,9,7,2,10,Italy - Serie D - Group F,0.25,0.75,2,1.12,4.0,1.33,6
V. Senigallia,8,2,4,2,8,10,-2,10,Italy - Serie D - Group F,0.25,0.75,-2,1.0,4.0,1.33,6
Recanatese,8,2,4,2,11,14,-3,10,Italy - Serie D - Group F,0.25,0.75,-3,1.38,4.0,1.33,6
Termoli Calcio,8,1,6,1,8,8,0,9,Italy - Serie D - Group F,0.12,0.88,0,1.0,8.33,1.14,7
Roma City,8,1,5,2,6,7,-1,8,Italy - Serie D - Group F,0.12,0.75,-1,0.75,8.33,1.33,8
Ancona 1905,8,1,4,3,11,13,-2,7,Italy - Serie D - Group F,0.12,0.62,-2,1.38,8.33,1.61,9
Atletico Ascoli,8,1,4,3,6,9,-3,7,Italy - Serie D - Group F,0.12,0.62,-3,0.75,8.33,1.61,9
Castelfidardo,8,1,3,4,6,10,-4,6,Italy - Serie D - Group F,0.12,0.5,-4,0.75,8.33,2.0,10
Fermana,8,1,2,5,7,12,-5,5,Italy - Serie D - Group F,0.12,0.38,-5,0.88,8.33,2.63,11
Isernia,8,0,4,4,4,15,-11,4,Italy - Serie D - Group F,0.0,0.5,-11,0.5,0.0,2.0,12
Guidonia,8,6,1,1,17,7,10,19,Italy - Serie D - Group G,0.75,0.88,10,2.12,1.33,1.14,1
Savoia,8,6,1,1,17,9,8,19,Italy - Serie D - Group G,0.75,0.88,8,2.12,1.33,1.14,1
CynthiAlbalonga,8,6,0,2,15,7,8,18,Italy - Serie D - Group G,0.75,0.75,8,1.88,1.33,1.33,2
Olbia,8,4,2,2,10,5,5,14,Italy - Serie D - Group G,0.5,0.75,5,1.25,2.0,1.33,3
Sarnese,8,4,2,2,17,13,4,14,Italy - Serie D - Group G,0.5,0.75,4,2.12,2.0,1.33,3
Gelbison,8,4,2,2,13,11,2,14,Italy - Serie D - Group G,0.5,0.75,2,1.62,2.0,1.33,3
Cassino,8,3,3,2,10,6,4,12,Italy - Serie D - Group G,0.38,0.75,4,1.25,2.63,1.33,4
Atletico Uri,8,3,3,2,13,10,3,12,Italy - Serie D - Group G,0.38,0.75,3,1.62,2.63,1.33,4
Trastevere,8,4,0,4,11,11,0,12,Italy - Serie D - Group G,0.5,0.5,0,1.38,2.0,2.0,4
Paganese,8,3,2,3,9,9,0,11,Italy - Serie D - Group G,0.38,0.62,0,1.12,2.63,1.61,5
Ilvamaddalena,8,3,1,4,7,6,1,10,Italy - Serie D - Group G,0.38,0.5,1,0.88,2.63,2.0,6
Puteolana,8,3,1,4,7,9,-2,10,Italy - Serie D - Group G,0.38,0.5,-2,0.88,2.63,2.0,6
S. Ogliastra,8,3,1,4,9,14,-5,10,Italy - Serie D - Group G,0.38,0.5,-5,1.12,2.63,2.0,6
R. Monterotondo,8,2,3,3,8,10,-2,9,Italy - Serie D - Group G,0.25,0.62,-2,1.0,4.0,1.61,7
A. Lodigiani,8,2,1,5,10,11,-1,7,Italy - Serie D - Group G,0.25,0.38,-1,1.25,4.0,2.63,8
Latte Dolce,8,2,0,6,7,17,-10,6,Italy - Serie D - Group G,0.25,0.25,-10,0.88,4.0,4.0,9
Terracina,8,1,1,6,6,19,-13,4,Italy - Serie D - Group G,0.12,0.25,-13,0.75,8.33,4.0,10
Anzio,8,0,2,6,6,18,-12,2,Italy - Serie D - Group G,0.0,0.25,-12,0.75,0.0,4.0,11
Casarano,8,5,3,0,17,4,13,18,Italy - Serie D - Group H,0.62,1.0,13,2.12,1.61,1.0,1
Nocerina,8,5,3,0,12,2,10,18,Italy - Serie D - Group H,0.62,1.0,10,1.5,1.61,1.0,1
Martina Franca,8,4,3,1,11,7,4,15,Italy - Serie D - Group H,0.5,0.88,4,1.38,2.0,1.14,2
Citta di Fasano,8,4,2,2,9,5,4,14,Italy - Serie D - Group H,0.5,0.75,4,1.12,2.0,1.33,3
Francavilla,8,4,1,3,9,7,2,13,Italy - Serie D - Group H,0.5,0.62,2,1.12,2.0,1.61,4
Brindisi,8,3,3,2,13,11,2,12,Italy - Serie D - Group H,0.38,0.75,2,1.62,2.63,1.33,5
Manfredonia,8,3,3,2,6,7,-1,12,Italy - Serie D - Group H,0.38,0.75,-1,0.75,2.63,1.33,5
Ugento,8,3,2,3,11,12,-1,11,Italy - Serie D - Group H,0.38,0.62,-1,1.38,2.63,1.61,6
Ischia,8,2,4,2,6,5,1,10,Italy - Serie D - Group H,0.25,0.75,1,0.75,4.0,1.33,7
Nardo,8,3,1,4,7,7,0,10,Italy - Serie D - Group H,0.38,0.5,0,0.88,2.63,2.0,7
Fidelis Andria,8,3,1,4,7,9,-2,10,Italy - Serie D - Group H,0.38,0.5,-2,0.88,2.63,2.0,7
Gravina,8,2,3,3,9,10,-1,9,Italy - Serie D - Group H,0.25,0.62,-1,1.12,4.0,1.61,8
Angri Calcio,8,2,3,3,10,12,-2,9,Italy - Serie D - Group H,0.25,0.62,-2,1.25,4.0,1.61,8
Matera,8,2,2,4,7,11,-4,8,Italy - Serie D - Group H,0.25,0.5,-4,0.88,4.0,2.0,9
Real Acerrana,8,2,2,4,9,15,-6,8,Italy - Serie D - Group H,0.25,0.5,-6,1.12,4.0,2.0,9
USD Palmese,8,1,4,3,7,11,-4,7,Italy - Serie D - Group H,0.12,0.62,-4,0.88,8.33,1.61,10
V. Francavilla,8,0,5,3,6,11,-5,5,Italy - Serie D - Group H,0.0,0.62,-5,0.75,0.0,1.61,11
Costa DAmalfi,8,0,3,5,5,15,-10,3,Italy - Serie D - Group H,0.0,0.38,-10,0.62,0.0,2.63,12
Siracusa,8,7,0,1,22,5,17,21,Italy - Serie D - Group I,0.88,0.88,17,2.75,1.14,1.14,1
Reggina,8,7,0,1,19,2,17,21,Italy - Serie D - Group I,0.88,0.88,17,2.38,1.14,1.14,1
Scafatese,8,5,2,1,11,3,8,17,Italy - Serie D - Group I,0.62,0.88,8,1.38,1.61,1.14,2
Igea Virtus,8,5,1,2,14,8,6,16,Italy - Serie D - Group I,0.62,0.75,6,1.75,1.61,1.33,3
Vibonese,8,5,0,3,14,7,7,15,Italy - Serie D - Group I,0.62,0.62,7,1.75,1.61,1.61,4
Nissa,8,4,3,1,12,9,3,15,Italy - Serie D - Group I,0.5,0.88,3,1.5,2.0,1.14,4
Ragusa,8,4,0,4,12,7,5,12,Italy - Serie D - Group I,0.5,0.5,5,1.5,2.0,2.0,5
Acireale,8,3,3,2,9,11,-2,12,Italy - Serie D - Group I,0.38,0.75,-2,1.12,2.63,1.33,5
Sambiase,8,3,2,3,9,8,1,11,Italy - Serie D - Group I,0.38,0.62,1,1.12,2.63,1.61,6
Pompei,8,3,2,3,5,9,-4,11,Italy - Serie D - Group I,0.38,0.62,-4,0.62,2.63,1.61,6
Paterno,8,2,4,2,9,10,-1,10,Italy - Serie D - Group I,0.25,0.75,-1,1.12,4.0,1.33,7
CD S. Agata,8,2,3,3,10,12,-2,9,Italy - Serie D - Group I,0.25,0.62,-2,1.25,4.0,1.61,8
CastrumFavara,8,2,3,3,5,9,-4,9,Italy - Serie D - Group I,0.25,0.62,-4,0.62,4.0,1.61,8
Sancataldese,8,2,2,4,9,11,-2,8,Italy - Serie D - Group I,0.25,0.5,-2,1.12,4.0,2.0,9
Licata,8,1,2,5,5,19,-14,5,Italy - Serie D - Group I,0.12,0.38,-14,0.62,8.33,2.63,10
Enna,8,0,4,4,4,11,-7,4,Italy - Serie D - Group I,0.0,0.5,-7,0.5,0.0,2.0,11
Locri 1909,8,0,2,6,5,18,-13,2,Italy - Serie D - Group I,0.0,0.25,-13,0.62,0.0,4.0,12
Akragas,8,0,1,7,2,17,-15,1,Italy - Serie D - Group I,0.0,0.12,-15,0.25,0.0,8.33,13
Inter Milan U20,8,6,1,1,21,7,14,19,Italy - Primavera 1,0.75,0.88,14,2.62,1.33,1.14,1
Roma U20,8,6,0,2,12,6,6,18,Italy - Primavera 1,0.75,0.75,6,1.5,1.33,1.33,2
Sassuolo U20,8,5,2,1,12,8,4,17,Italy - Primavera 1,0.62,0.88,4,1.5,1.61,1.14,3
Fiorentina U20,8,5,0,3,15,12,3,15,Italy - Primavera 1,0.62,0.62,3,1.88,1.61,1.61,4
Juventus U20,8,5,0,3,21,19,2,15,Italy - Primavera 1,0.62,0.62,2,2.62,1.61,1.61,4
H. Verona U20,8,4,2,2,16,5,11,14,Italy - Primavera 1,0.5,0.75,11,2.0,2.0,1.33,5
Cagliari U20,8,4,2,2,9,9,0,14,Italy - Primavera 1,0.5,0.75,0,1.12,2.0,1.33,5
Cesena U20,8,4,1,3,19,16,3,13,Italy - Primavera 1,0.5,0.62,3,2.38,2.0,1.61,6
Genoa U20,8,4,1,3,14,13,1,13,Italy - Primavera 1,0.5,0.62,1,1.75,2.0,1.61,6
Milan U20,8,3,3,2,11,10,1,12,Italy - Primavera 1,0.38,0.75,1,1.38,2.63,1.33,7
Lazio U20,8,3,3,2,11,11,0,12,Italy - Primavera 1,0.38,0.75,0,1.38,2.63,1.33,7
Monza U20,8,4,0,4,18,19,-1,12,Italy - Primavera 1,0.5,0.5,-1,2.25,2.0,2.0,7
Lecce U20,8,3,1,4,7,12,-5,10,Italy - Primavera 1,0.38,0.5,-5,0.88,2.63,2.0,8
Atalanta U20,8,3,0,5,9,11,-2,9,Italy - Primavera 1,0.38,0.38,-2,1.12,2.63,2.63,9
Bologna U20,8,2,3,3,6,10,-4,9,Italy - Primavera 1,0.25,0.62,-4,0.75,4.0,1.61,9
Cremonese U20,8,1,5,2,9,9,0,8,Italy - Primavera 1,0.12,0.75,0,1.12,8.33,1.33,10
Torino U20,8,2,2,4,9,13,-4,8,Italy - Primavera 1,0.25,0.5,-4,1.12,4.0,2.0,10
Udinese U20,8,1,1,6,7,19,-12,4,Italy - Primavera 1,0.12,0.25,-12,0.88,8.33,4.0,11
Empoli U20,8,0,3,5,7,13,-6,3,Italy - Primavera 1,0.0,0.38,-6,0.88,0.0,2.63,12
Sampdoria U20,8,0,3,5,8,16,-8,3,Italy - Primavera 1,0.0,0.38,-8,1.0,0.0,2.63,12
Arnett Gardens,8,6,2,0,22,8,14,20,Jamaica - Premier League,0.75,1.0,14,2.75,1.33,1.0,1
Mount Pleasant,8,5,1,2,18,6,12,16,Jamaica - Premier League,0.62,0.75,12,2.25,1.61,1.33,2
Racing United,8,4,4,0,13,7,6,16,Jamaica - Premier League,0.5,1.0,6,1.62,2.0,1.0,2
Montego Bay,8,4,3,1,9,6,3,15,Jamaica - Premier League,0.5,0.88,3,1.12,2.0,1.14,3
Cavalier,8,3,4,1,11,7,4,13,Jamaica - Premier League,0.38,0.88,4,1.38,2.63,1.14,4
Dunbeholden,8,4,1,3,8,10,-2,13,Jamaica - Premier League,0.5,0.62,-2,1.0,2.0,1.61,4
Harbour View,8,3,3,2,9,6,3,12,Jamaica - Premier League,0.38,0.75,3,1.12,2.63,1.33,5
Portmore Utd,8,2,5,1,5,4,1,11,Jamaica - Premier League,0.25,0.88,1,0.62,4.0,1.14,6
Tivoli Gardens,8,2,3,3,15,16,-1,9,Jamaica - Premier League,0.25,0.62,-1,1.88,4.0,1.61,7
Humble Lions,8,2,1,5,10,21,-11,7,Jamaica - Premier League,0.25,0.38,-11,1.25,4.0,2.63,8
Vere Utd,8,1,2,5,9,13,-4,5,Jamaica - Premier League,0.12,0.38,-4,1.12,8.33,2.63,9
Waterhouse,8,1,2,5,6,12,-6,5,Jamaica - Premier League,0.12,0.38,-6,0.75,8.33,2.63,9
Molynes Utd,8,1,2,5,8,19,-11,5,Jamaica - Premier League,0.12,0.38,-11,1.0,8.33,2.63,9
Chapelton,8,0,2,6,4,16,-12,2,Jamaica - Premier League,0.0,0.25,-12,0.5,0.0,4.0,10
Kashima Antlers,6,4,1,1,12,4,8,13,Japan - J1 League,0.67,0.83,8,2.0,1.49,1.2,1
Machida Zelvia,6,4,0,2,7,4,3,12,Japan - J1 League,0.67,0.67,3,1.17,1.49,1.49,2
S. Hiroshima,5,3,2,0,6,3,3,11,Japan - J1 League,0.6,1.0,3,1.2,1.67,1.0,3
Kashiwa Reysol,6,3,2,1,8,6,2,11,Japan - J1 League,0.5,0.83,2,1.33,2.0,1.2,3
Shonan Bellmare,6,3,2,1,7,5,2,11,Japan - J1 League,0.5,0.83,2,1.17,2.0,1.2,3
Avispa Fukuoka,6,3,0,3,5,5,0,9,Japan - J1 League,0.5,0.5,0,0.83,2.0,2.0,4
Gamba Osaka,6,3,0,3,6,10,-4,9,Japan - J1 League,0.5,0.5,-4,1.0,2.0,2.0,4
K. Frontale,5,2,2,1,7,3,4,8,Japan - J1 League,0.4,0.8,4,1.4,2.5,1.25,5
Fagiano Okayama,6,2,2,2,5,3,2,8,Japan - J1 League,0.33,0.67,2,0.83,3.03,1.49,5
Shimizu S-Pulse,6,2,2,2,6,5,1,8,Japan - J1 League,0.33,0.67,1,1.0,3.03,1.49,5
Kyoto Sanga,6,2,2,2,5,6,-1,8,Japan - J1 League,0.33,0.67,-1,0.83,3.03,1.49,5
FC Tokyo,6,2,1,3,4,5,-1,7,Japan - J1 League,0.33,0.5,-1,0.67,3.03,2.0,6
Yokohama FC,6,2,1,3,3,4,-1,7,Japan - J1 League,0.33,0.5,-1,0.5,3.03,2.0,6
Tokyo Verdy,6,2,1,3,5,9,-4,7,Japan - J1 League,0.33,0.5,-4,0.83,3.03,2.0,6
Yokohama M.,5,1,3,1,4,3,1,6,Japan - J1 League,0.2,0.8,1,0.8,5.0,1.25,7
Vissel Kobe,5,1,3,1,5,5,0,6,Japan - J1 League,0.2,0.8,0,1.0,5.0,1.25,7
Urawa RD,6,1,3,2,4,6,-2,6,Japan - J1 League,0.17,0.67,-2,0.67,5.88,1.49,7
Cerezo Osaka,6,1,2,3,10,11,-1,5,Japan - J1 League,0.17,0.5,-1,1.67,5.88,2.0,8
Albirex Niigata,6,0,3,3,6,10,-4,3,Japan - J1 League,0.0,0.5,-4,1.0,0.0,2.0,9
Nagoya G.,6,0,2,4,6,14,-8,2,Japan - J1 League,0.0,0.33,-8,1.0,0.0,3.03,10
JEF Utd Chiba,5,5,0,0,15,4,11,15,Japan - J2 League,1.0,1.0,11,3.0,1.0,1.0,1
Omiya Ardija,5,4,0,1,9,3,6,12,Japan - J2 League,0.8,0.8,6,1.8,1.25,1.25,2
V-V. Nagasaki,5,3,2,0,8,5,3,11,Japan - J2 League,0.6,1.0,3,1.6,1.67,1.0,3
Kataller Toyama,5,3,1,1,6,3,3,10,Japan - J2 League,0.6,0.8,3,1.2,1.67,1.25,4
Jubilo Iwata,5,3,0,2,7,7,0,9,Japan - J2 League,0.6,0.6,0,1.4,1.67,1.67,5
FC Imabari,5,2,2,1,7,4,3,8,Japan - J2 League,0.4,0.8,3,1.4,2.5,1.25,6
Vegalta Sendai,5,2,2,1,6,4,2,8,Japan - J2 League,0.4,0.8,2,1.2,2.5,1.25,6
Tokushima V.,5,2,2,1,4,2,2,8,Japan - J2 League,0.4,0.8,2,0.8,2.5,1.25,6
Fujieda MYFC,5,2,2,1,7,6,1,8,Japan - J2 League,0.4,0.8,1,1.4,2.5,1.25,6
M. Yamagata,5,2,0,3,10,9,1,6,Japan - J2 League,0.4,0.4,1,2.0,2.5,2.5,7
Mito Hollyhock,5,1,3,1,6,6,0,6,Japan - J2 League,0.2,0.8,0,1.2,5.0,1.25,7
Oita Trinita,5,1,3,1,3,3,0,6,Japan - J2 League,0.2,0.8,0,0.6,5.0,1.25,7
Blaublitz Akita,5,2,0,3,7,10,-3,6,Japan - J2 League,0.4,0.4,-3,1.4,2.5,2.5,7
R. Yamaguchi,5,1,2,2,6,6,0,5,Japan - J2 League,0.2,0.6,0,1.2,5.0,1.67,8
Ventforet Kofu,5,1,1,3,5,8,-3,4,Japan - J2 League,0.2,0.4,-3,1.0,5.0,2.5,9
R. Kumamoto,5,1,1,3,6,10,-4,4,Japan - J2 League,0.2,0.4,-4,1.2,5.0,2.5,9
Sagan Tosu,5,1,1,3,3,7,-4,4,Japan - J2 League,0.2,0.4,-4,0.6,5.0,2.5,9
Iwaki,5,0,3,2,2,6,-4,3,Japan - J2 League,0.0,0.6,-4,0.4,0.0,1.67,10
C. Sapporo,5,1,0,4,4,11,-7,3,Japan - J2 League,0.2,0.2,-7,0.8,5.0,5.0,10
Ehime FC,5,0,1,4,5,12,-7,1,Japan - J2 League,0.0,0.2,-7,1.0,0.0,5.0,11
Osaka,5,3,1,1,5,3,2,10,Japan - J3 League,0.6,0.8,2,1.0,1.67,1.25,1
Tochigi City,5,3,1,1,7,6,1,10,Japan - J3 League,0.6,0.8,1,1.4,1.67,1.25,1
G. Kitakyushu,4,3,0,1,6,2,4,9,Japan - J3 League,0.75,0.75,4,1.5,1.33,1.33,2
Kagoshima Utd,5,2,2,1,11,7,4,8,Japan - J3 League,0.4,0.8,4,2.2,2.5,1.25,3
Kamatamare S.,5,2,2,1,5,4,1,8,Japan - J3 League,0.4,0.8,1,1.0,2.5,1.25,3
Nara Club,5,2,2,1,7,7,0,8,Japan - J3 League,0.4,0.8,0,1.4,2.5,1.25,3
T. Miyazaki,5,2,1,2,7,6,1,7,Japan - J3 League,0.4,0.6,1,1.4,2.5,1.67,4
Fukushima Utd,4,2,1,1,8,8,0,7,Japan - J3 League,0.5,0.75,0,2.0,2.0,1.33,4
Kusatsu,5,2,1,2,8,8,0,7,Japan - J3 League,0.4,0.6,0,1.6,2.5,1.67,4
Tochigi SC,5,2,1,2,3,3,0,7,Japan - J3 League,0.4,0.6,0,0.6,2.5,1.67,4
SC Sagamihara,5,2,1,2,5,6,-1,7,Japan - J3 League,0.4,0.6,-1,1.0,2.5,1.67,4
AC Numazu,4,1,3,0,4,1,3,6,Japan - J3 League,0.25,1.0,3,1.0,4.0,1.0,5
Nagano Parceiro,4,2,0,2,5,6,-1,6,Japan - J3 League,0.5,0.5,-1,1.25,2.0,2.0,5
Kochi United,5,1,2,2,5,6,-1,5,Japan - J3 League,0.2,0.6,-1,1.0,5.0,1.67,6
Z. Kanazawa,3,1,1,1,4,4,0,4,Japan - J3 League,0.33,0.67,0,1.33,3.03,1.49,7
Gifu,4,1,1,2,6,7,-1,4,Japan - J3 League,0.25,0.5,-1,1.5,4.0,2.0,7
V. Hachinohe,4,1,1,2,3,4,-1,4,Japan - J3 League,0.25,0.5,-1,0.75,4.0,2.0,7
Matsumoto Y.,3,0,2,1,2,3,-1,2,Japan - J3 League,0.0,0.67,-1,0.67,0.0,1.49,8
Gainare Tottori,5,0,2,3,1,7,-6,2,Japan - J3 League,0.0,0.4,-6,0.2,0.0,2.5,8
FC Ryukyu,5,0,1,4,1,5,-4,1,Japan - J3 League,0.0,0.2,-4,0.2,0.0,5.0,9
Al Hussein,8,8,0,0,24,6,18,24,Jordan - Premier League,1.0,1.0,18,3.0,1.0,1.0,1
Al Jazeera,8,6,1,1,17,9,8,19,Jordan - Premier League,0.75,0.88,8,2.12,1.33,1.14,2
Al Wihdat,8,6,0,2,17,7,10,18,Jordan - Premier League,0.75,0.75,10,2.12,1.33,1.33,3
Al Faysali,8,4,4,0,13,6,7,16,Jordan - Premier League,0.5,1.0,7,1.62,2.0,1.0,4
Al Salt,8,4,1,3,14,7,7,13,Jordan - Premier League,0.5,0.62,7,1.75,2.0,1.61,5
Aqaba,8,3,2,3,10,15,-5,11,Jordan - Premier League,0.38,0.62,-5,1.25,2.63,1.61,6
Al Ramtha,8,3,2,3,6,11,-5,11,Jordan - Premier League,0.38,0.62,-5,0.75,2.63,1.61,6
Shabab Al Ordon,8,2,2,4,9,12,-3,8,Jordan - Premier League,0.25,0.5,-3,1.12,4.0,2.0,7
Maan,8,2,0,6,7,19,-12,6,Jordan - Premier League,0.25,0.25,-12,0.88,4.0,4.0,8
Moghayer Al S.,8,1,1,6,6,14,-8,4,Jordan - Premier League,0.12,0.25,-8,0.75,8.33,4.0,9
Al Sareeh,8,0,3,5,7,15,-8,3,Jordan - Premier League,0.0,0.38,-8,0.88,0.0,2.63,10
Al Ahli,8,0,2,6,3,11,-8,2,Jordan - Premier League,0.0,0.25,-8,0.38,0.0,4.0,11
Kairat Almaty,2,1,1,0,5,1,4,4,Kazakhstan - Premier League,0.5,1.0,4,2.5,2.0,1.0,1
FC Astana,2,1,1,0,3,1,2,4,Kazakhstan - Premier League,0.5,1.0,2,1.5,2.0,1.0,1
Tobol,2,1,1,0,2,0,2,4,Kazakhstan - Premier League,0.5,1.0,2,1.0,2.0,1.0,1
Aktobe,2,1,1,0,2,1,1,4,Kazakhstan - Premier League,0.5,1.0,1,1.0,2.0,1.0,1
Turan,2,1,0,1,3,2,1,3,Kazakhstan - Premier League,0.5,0.5,1,1.5,2.0,2.0,2
Yelimay Semey,2,1,0,1,3,2,1,3,Kazakhstan - Premier League,0.5,0.5,1,1.5,2.0,2.0,2
Atyrau,2,1,0,1,3,3,0,3,Kazakhstan - Premier League,0.5,0.5,0,1.5,2.0,2.0,2
Okzhetpes,2,1,0,1,2,3,-1,3,Kazakhstan - Premier League,0.5,0.5,-1,1.0,2.0,2.0,2
Zhetysu,2,0,2,0,1,1,0,2,Kazakhstan - Premier League,0.0,1.0,0,0.5,0.0,1.0,3
Zhenys,2,0,2,0,0,0,0,2,Kazakhstan - Premier League,0.0,1.0,0,0.0,0.0,1.0,3
Kyzylzhar,2,0,1,1,1,3,-2,1,Kazakhstan - Premier League,0.0,0.5,-2,0.5,0.0,2.0,4
Kaisar K.,2,0,1,1,0,2,-2,1,Kazakhstan - Premier League,0.0,0.5,-2,0.0,0.0,2.0,4
Ulytau,2,0,1,1,0,2,-2,1,Kazakhstan - Premier League,0.0,0.5,-2,0.0,0.0,2.0,4
Ordabasy,2,0,1,1,0,4,-4,1,Kazakhstan - Premier League,0.0,0.5,-4,0.0,0.0,2.0,4
Drita,8,5,1,2,13,6,7,16,Kosovo - Superliga,0.62,0.75,7,1.62,1.61,1.33,1
Gjilani,8,5,1,2,9,9,0,16,Kosovo - Superliga,0.62,0.75,0,1.12,1.61,1.33,1
Ferizaj,8,5,0,3,13,10,3,15,Kosovo - Superliga,0.62,0.62,3,1.62,1.61,1.61,2
Dukagjini,8,4,2,2,5,3,2,14,Kosovo - Superliga,0.5,0.75,2,0.62,2.0,1.33,3
Malisheva,8,3,2,3,11,9,2,11,Kosovo - Superliga,0.38,0.62,2,1.38,2.63,1.61,4
Ballkani,8,3,2,3,9,10,-1,11,Kosovo - Superliga,0.38,0.62,-1,1.12,2.63,1.61,4
Llapi,8,2,3,3,6,5,1,9,Kosovo - Superliga,0.25,0.62,1,0.75,4.0,1.61,5
Feronikeli,8,2,1,5,6,11,-5,7,Kosovo - Superliga,0.25,0.38,-5,0.75,4.0,2.63,6
Suhareka,8,2,1,5,9,15,-6,7,Kosovo - Superliga,0.25,0.38,-6,1.12,4.0,2.63,6
Prishtina,8,0,5,3,6,9,-3,5,Kosovo - Superliga,0.0,0.62,-3,0.75,0.0,1.61,7
Al Arabi SC,8,6,2,0,14,4,10,20,Kuwait - Premier League,0.75,1.0,10,1.75,1.33,1.0,1
Al Kuwait,8,5,2,1,22,5,17,17,Kuwait - Premier League,0.62,0.88,17,2.75,1.61,1.14,2
Al Qadsia,8,5,1,2,16,13,3,16,Kuwait - Premier League,0.62,0.75,3,2.0,1.61,1.33,3
Al Salmiyah,8,4,2,2,13,10,3,14,Kuwait - Premier League,0.5,0.75,3,1.62,2.0,1.33,4
Al Fahaheel,8,3,2,3,11,12,-1,11,Kuwait - Premier League,0.38,0.62,-1,1.38,2.63,1.61,5
Al Tadhamon,8,3,0,5,7,15,-8,9,Kuwait - Premier League,0.38,0.38,-8,0.88,2.63,2.63,6
Al Nasar,8,2,2,4,11,14,-3,8,Kuwait - Premier League,0.25,0.5,-3,1.38,4.0,2.0,7
Kazma,8,1,3,4,10,13,-3,6,Kuwait - Premier League,0.12,0.5,-3,1.25,8.33,2.0,8
Khaitan,8,1,3,4,4,7,-3,6,Kuwait - Premier League,0.12,0.5,-3,0.5,8.33,2.0,8
Yarmouk,8,0,3,5,6,21,-15,3,Kuwait - Premier League,0.0,0.38,-15,0.75,0.0,2.63,9
RFS,3,3,0,0,5,2,3,9,Latvia - Virsliga,1.0,1.0,3,1.67,1.0,1.0,1
Riga FC,3,1,2,0,5,3,2,5,Latvia - Virsliga,0.33,1.0,2,1.67,3.03,1.0,2
Liepaja,2,1,1,0,4,0,4,4,Latvia - Virsliga,0.5,1.0,4,2.0,2.0,1.0,3
Grobina,2,1,1,0,4,3,1,4,Latvia - Virsliga,0.5,1.0,1,2.0,2.0,1.0,3
Super Nova,2,1,0,1,4,2,2,3,Latvia - Virsliga,0.5,0.5,2,2.0,2.0,2.0,4
Daugavpils,3,1,0,2,6,5,1,3,Latvia - Virsliga,0.33,0.33,1,2.0,3.03,3.03,4
FS Jelgava,3,0,2,1,2,3,-1,2,Latvia - Virsliga,0.0,0.67,-1,0.67,0.0,1.49,5
Auda,2,0,1,1,3,4,-1,1,Latvia - Virsliga,0.0,0.5,-1,1.5,0.0,2.0,6
Tukums,2,0,1,1,0,3,-3,1,Latvia - Virsliga,0.0,0.5,-3,0.0,0.0,2.0,6
Metta,2,0,0,2,0,8,-8,0,Latvia - Virsliga,0.0,0.0,-8,0.0,0.0,0.0,7
Dziugas Telsiai,3,2,0,1,5,3,2,6,Lithuania - A Lyga,0.67,0.67,2,1.67,1.49,1.49,1
Suduva,2,2,0,0,5,3,2,6,Lithuania - A Lyga,1.0,1.0,2,2.5,1.0,1.0,1
Hegelmann L.,3,2,0,1,3,3,0,6,Lithuania - A Lyga,0.67,0.67,0,1.0,1.49,1.49,1
Zalgiris,3,1,2,0,6,5,1,5,Lithuania - A Lyga,0.33,1.0,1,2.0,3.03,1.0,2
Siauliai,3,1,1,1,5,4,1,4,Lithuania - A Lyga,0.33,0.67,1,1.67,3.03,1.49,3
Banga,3,1,1,1,3,2,1,4,Lithuania - A Lyga,0.33,0.67,1,1.0,3.03,1.49,3
Kauno Zalgiris,2,1,0,1,4,3,1,3,Lithuania - A Lyga,0.5,0.5,1,2.0,2.0,2.0,4
Riteriai,2,0,1,1,6,7,-1,1,Lithuania - A Lyga,0.0,0.5,-1,3.0,0.0,2.0,5
Dainava,3,0,1,2,3,7,-4,1,Lithuania - A Lyga,0.0,0.33,-4,1.0,0.0,3.03,5
Panevezys,2,0,0,2,2,5,-3,0,Lithuania - A Lyga,0.0,0.0,-3,1.0,0.0,0.0,6
Neptuna K.,2,2,0,0,9,1,8,6,Lithuania - 1st League,1.0,1.0,8,4.5,1.0,1.0,1
TransINVEST,2,2,0,0,5,0,5,6,Lithuania - 1st League,1.0,1.0,5,2.5,1.0,1.0,1
BFA Vilnius,2,2,0,0,3,0,3,6,Lithuania - 1st League,1.0,1.0,3,1.5,1.0,1.0,1
Nevezis,2,1,1,0,4,1,3,4,Lithuania - 1st League,0.5,1.0,3,2.0,2.0,1.0,2
Tauras,1,1,0,0,6,0,6,3,Lithuania - 1st League,1.0,1.0,6,6.0,1.0,1.0,3
Atmosfera,1,1,0,0,1,0,1,3,Lithuania - 1st League,1.0,1.0,1,1.0,1.0,1.0,3
Babrungas,1,1,0,0,1,0,1,3,Lithuania - 1st League,1.0,1.0,1,1.0,1.0,1.0,3
Kauno Z. B,2,1,0,1,1,1,0,3,Lithuania - 1st League,0.5,0.5,0,0.5,2.0,2.0,3
Hegelmann B,1,0,1,0,1,1,0,1,Lithuania - 1st League,0.0,1.0,0,1.0,0.0,1.0,4
Zalgiris B,1,0,1,0,1,1,0,1,Lithuania - 1st League,0.0,1.0,0,1.0,0.0,1.0,4
Be1 NFA,2,0,1,1,1,5,-4,1,Lithuania - 1st League,0.0,0.5,-4,0.5,0.0,2.0,4
Jonava,2,0,0,2,0,2,-2,0,Lithuania - 1st League,0.0,0.0,-2,0.0,0.0,0.0,5
Ekranas,2,0,0,2,0,3,-3,0,Lithuania - 1st League,0.0,0.0,-3,0.0,0.0,0.0,5
Siauliai B,1,0,0,1,1,5,-4,0,Lithuania - 1st League,0.0,0.0,-4,1.0,0.0,0.0,5
Minija,2,0,0,2,0,5,-5,0,Lithuania - 1st League,0.0,0.0,-5,0.0,0.0,0.0,5
Panevezys B,2,0,0,2,0,9,-9,0,Lithuania - 1st League,0.0,0.0,-9,0.0,0.0,0.0,5
Differdange,8,7,0,1,21,3,18,21,Luxembourg - National Division,0.88,0.88,18,2.62,1.14,1.14,1
UNA Strassen,8,6,2,0,24,5,19,20,Luxembourg - National Division,0.75,1.0,19,3.0,1.33,1.0,2
Dudelange,8,5,2,1,17,8,9,17,Luxembourg - National Division,0.62,0.88,9,2.12,1.61,1.14,3
Hostert,8,5,1,2,18,13,5,16,Luxembourg - National Division,0.62,0.75,5,2.25,1.61,1.33,4
Racing,8,4,1,3,8,4,4,13,Luxembourg - National Division,0.5,0.62,4,1.0,2.0,1.61,5
Hesperange,8,2,5,1,12,9,3,11,Luxembourg - National Division,0.25,0.88,3,1.5,4.0,1.14,6
Mondorf,8,3,2,3,8,10,-2,11,Luxembourg - National Division,0.38,0.62,-2,1.0,2.63,1.61,6
Niedercorn,8,2,4,2,7,9,-2,10,Luxembourg - National Division,0.25,0.75,-2,0.88,4.0,1.33,7
Wiltz,8,3,1,4,11,15,-4,10,Luxembourg - National Division,0.38,0.5,-4,1.38,2.63,2.0,7
Petange,8,2,3,3,5,6,-1,9,Luxembourg - National Division,0.25,0.62,-1,0.62,4.0,1.61,8
Jeunesse Esch,8,2,3,3,11,16,-5,9,Luxembourg - National Division,0.25,0.62,-5,1.38,4.0,1.61,8
Mondercange,8,2,1,5,6,11,-5,7,Luxembourg - National Division,0.25,0.38,-5,0.75,4.0,2.63,9
V. Rosport,8,1,4,3,6,13,-7,7,Luxembourg - National Division,0.12,0.62,-7,0.75,8.33,1.61,9
Rodange,8,1,3,4,15,20,-5,6,Luxembourg - National Division,0.12,0.5,-5,1.88,8.33,2.0,10
Bettembourg,8,2,0,6,6,13,-7,6,Luxembourg - National Division,0.25,0.25,-7,0.75,4.0,4.0,10
Fola Esch,8,1,0,7,5,25,-20,3,Luxembourg - National Division,0.12,0.12,-20,0.62,8.33,8.33,11
Johor Darul,8,8,0,0,26,1,25,24,Malaysia - Super League,1.0,1.0,25,3.25,1.0,1.0,1
Selangor,8,6,2,0,18,2,16,20,Malaysia - Super League,0.75,1.0,16,2.25,1.33,1.0,2
Kuching,8,4,3,1,15,6,9,15,Malaysia - Super League,0.5,0.88,9,1.88,2.0,1.14,3
Terengganu,8,4,2,2,15,9,6,14,Malaysia - Super League,0.5,0.75,6,1.88,2.0,1.33,4
Kuala Lumpur,8,4,2,2,11,11,0,14,Malaysia - Super League,0.5,0.75,0,1.38,2.0,1.33,4
Sabah,8,3,4,1,13,12,1,13,Malaysia - Super League,0.38,0.88,1,1.62,2.63,1.14,5
Pulau Pinang,8,2,3,3,13,12,1,9,Malaysia - Super League,0.25,0.62,1,1.62,4.0,1.61,6
Perak,8,1,4,3,13,14,-1,7,Malaysia - Super League,0.12,0.62,-1,1.62,8.33,1.61,7
PDRM,8,2,1,5,10,15,-5,7,Malaysia - Super League,0.25,0.38,-5,1.25,4.0,2.63,7
Negeri Sembilan,8,2,1,5,7,13,-6,7,Malaysia - Super League,0.25,0.38,-6,0.88,4.0,2.63,7
Kedah,8,2,1,5,7,15,-8,7,Malaysia - Super League,0.25,0.38,-8,0.88,4.0,2.63,7
Pahang,8,1,2,5,9,18,-9,5,Malaysia - Super League,0.12,0.38,-9,1.12,8.33,2.63,8
Kelantan United,8,0,0,8,3,35,-32,0,Malaysia - Super League,0.0,0.0,-32,0.38,0.0,0.0,9
Birkirkara,8,4,3,1,12,4,8,15,Malta - Premier League,0.5,0.88,8,1.5,2.0,1.14,1
Floriana,8,4,3,1,10,6,4,15,Malta - Premier League,0.5,0.88,4,1.25,2.0,1.14,1
Marsaxlokk,8,4,1,3,9,6,3,13,Malta - Premier League,0.5,0.62,3,1.12,2.0,1.61,2
Hibernians,8,4,1,3,12,12,0,13,Malta - Premier League,0.5,0.62,0,1.5,2.0,1.61,2
Mosta,8,4,1,3,9,9,0,13,Malta - Premier League,0.5,0.62,0,1.12,2.0,1.61,2
Sliema,8,4,0,4,12,11,1,12,Malta - Premier League,0.5,0.5,1,1.5,2.0,2.0,3
Zabbar,8,3,2,3,12,7,5,11,Malta - Premier League,0.38,0.62,5,1.5,2.63,1.61,4
Naxxar Lions,8,3,1,4,11,12,-1,10,Malta - Premier League,0.38,0.5,-1,1.38,2.63,2.0,5
Gzira Utd,8,3,1,4,6,13,-7,10,Malta - Premier League,0.38,0.5,-7,0.75,2.63,2.0,5
Hamrun Spartans,8,2,2,4,3,6,-3,8,Malta - Premier League,0.25,0.5,-3,0.38,4.0,2.0,6
Melita,8,1,4,3,11,16,-5,7,Malta - Premier League,0.12,0.62,-5,1.38,8.33,1.61,7
Balzan,8,1,3,4,6,11,-5,6,Malta - Premier League,0.12,0.5,-5,0.75,8.33,2.0,8
Cruz Azul,8,6,2,0,20,6,14,20,Mexico - Liga MX - Apertura,0.75,1.0,14,2.5,1.33,1.0,1
Toluca,8,5,2,1,21,7,14,17,Mexico - Liga MX - Apertura,0.62,0.88,14,2.62,1.61,1.14,2
A. San Luis,8,5,1,2,12,8,4,16,Mexico - Liga MX - Apertura,0.62,0.75,4,1.5,1.61,1.33,3
Pumas UNAM,8,4,3,1,8,3,5,15,Mexico - Liga MX - Apertura,0.5,0.88,5,1.0,2.0,1.14,4
Tijuana,8,4,3,1,10,9,1,15,Mexico - Liga MX - Apertura,0.5,0.88,1,1.25,2.0,1.14,4
CF America,8,4,2,2,15,10,5,14,Mexico - Liga MX - Apertura,0.5,0.75,5,1.88,2.0,1.33,5
Tigres,8,4,2,2,13,11,2,14,Mexico - Liga MX - Apertura,0.5,0.75,2,1.62,2.0,1.33,5
Juarez,8,4,1,3,13,15,-2,13,Mexico - Liga MX - Apertura,0.5,0.62,-2,1.62,2.0,1.61,6
Monterrey,8,3,3,2,12,7,5,12,Mexico - Liga MX - Apertura,0.38,0.75,5,1.5,2.63,1.33,7
Club Leon,8,2,5,1,13,9,4,11,Mexico - Liga MX - Apertura,0.25,0.88,4,1.62,4.0,1.14,8
Guadalajara,8,3,2,3,10,8,2,11,Mexico - Liga MX - Apertura,0.38,0.62,2,1.25,2.63,1.61,8
Queretaro,8,2,2,4,7,13,-6,8,Mexico - Liga MX - Apertura,0.25,0.5,-6,0.88,4.0,2.0,9
Atlas,8,1,5,2,6,12,-6,8,Mexico - Liga MX - Apertura,0.12,0.75,-6,0.75,8.33,1.33,9
Mazatlan,8,1,4,3,4,9,-5,7,Mexico - Liga MX - Apertura,0.12,0.62,-5,0.5,8.33,1.61,10
Pachuca,8,1,1,6,12,16,-4,4,Mexico - Liga MX - Apertura,0.12,0.25,-4,1.5,8.33,4.0,11
Necaxa,8,0,3,5,7,18,-11,3,Mexico - Liga MX - Apertura,0.0,0.38,-11,0.88,0.0,2.63,12
Puebla,8,1,0,7,7,18,-11,3,Mexico - Liga MX - Apertura,0.12,0.12,-11,0.88,8.33,8.33,12
Santos Laguna,8,0,2,6,4,16,-12,2,Mexico - Liga MX - Apertura,0.0,0.25,-12,0.5,0.0,4.0,13
Toluca,8,6,1,1,23,9,14,19,Mexico - Liga MX - Clausura,0.75,0.88,14,2.88,1.33,1.14,1
CF America,8,5,2,1,17,6,11,17,Mexico - Liga MX - Clausura,0.62,0.88,11,2.12,1.61,1.14,2
Cruz Azul,8,5,2,1,13,8,5,17,Mexico - Liga MX - Clausura,0.62,0.88,5,1.62,1.61,1.14,2
Necaxa,8,5,0,3,18,14,4,15,Mexico - Liga MX - Clausura,0.62,0.62,4,2.25,1.61,1.61,3
Tigres,8,5,0,3,10,6,4,15,Mexico - Liga MX - Clausura,0.62,0.62,4,1.25,1.61,1.61,3
Monterrey,8,4,2,2,17,12,5,14,Mexico - Liga MX - Clausura,0.5,0.75,5,2.12,2.0,1.33,4
Club Leon,8,4,2,2,13,11,2,14,Mexico - Liga MX - Clausura,0.5,0.75,2,1.62,2.0,1.33,4
Guadalajara,8,3,3,2,9,9,0,12,Mexico - Liga MX - Clausura,0.38,0.75,0,1.12,2.63,1.33,5
Juarez,8,3,2,3,8,14,-6,11,Mexico - Liga MX - Clausura,0.38,0.62,-6,1.0,2.63,1.61,6
Pumas UNAM,8,3,1,4,11,13,-2,10,Mexico - Liga MX - Clausura,0.38,0.5,-2,1.38,2.63,2.0,7
Atlas,8,3,1,4,12,17,-5,10,Mexico - Liga MX - Clausura,0.38,0.5,-5,1.5,2.63,2.0,7
Queretaro,8,3,1,4,7,12,-5,10,Mexico - Liga MX - Clausura,0.38,0.5,-5,0.88,2.63,2.0,7
Pachuca,8,2,3,3,10,11,-1,9,Mexico - Liga MX - Clausura,0.25,0.62,-1,1.25,4.0,1.61,8
Santos Laguna,8,2,1,5,9,15,-6,7,Mexico - Liga MX - Clausura,0.25,0.38,-6,1.12,4.0,2.63,9
Mazatlan,8,1,3,4,6,10,-4,6,Mexico - Liga MX - Clausura,0.12,0.5,-4,0.75,8.33,2.0,10
Puebla,8,2,0,6,9,15,-6,6,Mexico - Liga MX - Clausura,0.25,0.25,-6,1.12,4.0,4.0,10
A. San Luis,8,2,0,6,9,16,-7,6,Mexico - Liga MX - Clausura,0.25,0.25,-7,1.12,4.0,4.0,10
Tijuana,8,1,0,7,12,21,-9,3,Mexico - Liga MX - Clausura,0.12,0.12,-9,1.5,8.33,8.33,11
Buducnost,8,8,0,0,27,7,20,24,Montenegro - First League,1.0,1.0,20,3.38,1.0,1.0,1
Petrovac,8,5,1,2,15,12,3,16,Montenegro - First League,0.62,0.75,3,1.88,1.61,1.33,2
Sutjeska,8,4,2,2,10,8,2,14,Montenegro - First League,0.5,0.75,2,1.25,2.0,1.33,3
Decic,8,3,2,3,10,8,2,11,Montenegro - First League,0.38,0.62,2,1.25,2.63,1.61,4
Bokelj,8,3,1,4,7,9,-2,10,Montenegro - First League,0.38,0.5,-2,0.88,2.63,2.0,5
Jezero,8,3,0,5,9,11,-2,9,Montenegro - First League,0.38,0.38,-2,1.12,2.63,2.63,6
Mornar Bar,8,2,3,3,9,12,-3,9,Montenegro - First League,0.25,0.62,-3,1.12,4.0,1.61,6
Arsenal Tivat,8,2,2,4,6,11,-5,8,Montenegro - First League,0.25,0.5,-5,0.75,4.0,2.0,7
Jedinstvo,8,1,3,4,6,11,-5,6,Montenegro - First League,0.12,0.5,-5,0.75,8.33,2.0,8
Otrant,8,2,0,6,5,13,-8,6,Montenegro - First League,0.25,0.25,-8,0.62,4.0,4.0,8
Berkane,8,6,2,0,14,2,12,20,morocco,0.75,1.0,12,1.75,1.33,1.0,1
Wydad,8,4,4,0,14,5,9,16,morocco,0.5,1.0,9,1.75,2.0,1.0,2
FUS Rabat,8,4,2,2,13,8,5,14,morocco,0.5,0.75,5,1.62,2.0,1.33,3
FAR Rabat,8,4,2,2,11,9,2,14,morocco,0.5,0.75,2,1.38,2.0,1.33,3
Meknes,8,3,4,1,9,6,3,13,morocco,0.38,0.88,3,1.12,2.63,1.14,4
Raja Casablanca,8,3,4,1,9,6,3,13,morocco,0.38,0.88,3,1.12,2.63,1.14,4
Union Touarga,8,3,3,2,10,8,2,12,morocco,0.38,0.75,2,1.25,2.63,1.33,5
Olympic Safi,8,2,5,1,9,8,1,11,morocco,0.25,0.88,1,1.12,4.0,1.14,6
Maghreb de Fes,8,2,4,2,9,11,-2,10,morocco,0.25,0.75,-2,1.12,4.0,1.33,7
Ittihad Tanger,8,2,3,3,11,13,-2,9,morocco,0.25,0.62,-2,1.38,4.0,1.61,8
R. Zemamra,8,3,0,5,7,10,-3,9,morocco,0.38,0.38,-3,0.88,2.63,2.63,8
Difaa El Jadida,8,2,3,3,6,9,-3,9,morocco,0.25,0.62,-3,0.75,4.0,1.61,8
Hassania Agadir,8,1,3,4,8,12,-4,6,morocco,0.12,0.5,-4,1.0,8.33,2.0,9
Moghreb Tetouan,8,1,2,5,7,12,-5,5,morocco,0.12,0.38,-5,0.88,8.33,2.63,10
JS Sousalem,8,0,2,6,5,17,-12,2,morocco,0.0,0.25,-12,0.62,0.0,4.0,11
C. Mohammedia,8,0,1,7,4,16,-12,1,morocco,0.0,0.12,-12,0.5,0.0,8.33,12
Shan Utd,8,7,1,0,24,2,22,22,myanmar,0.88,1.0,22,3.0,1.14,1.0,1
Yangon Utd,8,5,2,1,21,6,15,17,myanmar,0.62,0.88,15,2.62,1.61,1.14,2
Sagaing Utd,8,4,2,2,16,13,3,14,myanmar,0.5,0.75,3,2.0,2.0,1.33,3
Thitsar Arman,8,4,1,3,15,12,3,13,myanmar,0.5,0.62,3,1.88,2.0,1.61,4
Yadanarbon,8,3,3,2,18,15,3,12,myanmar,0.38,0.75,3,2.25,2.63,1.33,5
Dagon,8,3,2,3,10,11,-1,11,myanmar,0.38,0.62,-1,1.25,2.63,1.61,6
Hantharwady,8,3,2,3,7,11,-4,11,myanmar,0.38,0.62,-4,0.88,2.63,1.61,6
Rakhine Utd,8,3,2,3,10,16,-6,11,myanmar,0.38,0.62,-6,1.25,2.63,1.61,6
Ayeyawady,8,2,0,6,9,16,-7,6,myanmar,0.25,0.25,-7,1.12,4.0,4.0,7
Ispe FC,8,1,3,4,4,14,-10,6,myanmar,0.12,0.5,-10,0.5,8.33,2.0,7
Dagon Port,8,1,2,5,12,21,-9,5,myanmar,0.12,0.38,-9,1.5,8.33,2.63,8
Myawady,8,1,2,5,11,20,-9,5,myanmar,0.12,0.38,-9,1.38,8.33,2.63,8
Ajax Amsterdam,8,8,0,0,16,2,14,24,netherlands,1.0,1.0,14,2.0,1.0,1.0,1
Go Ahead Eagles,8,5,1,2,16,13,3,16,netherlands,0.62,0.75,3,2.0,1.61,1.33,2
FC Twente,8,4,3,1,18,10,8,15,netherlands,0.5,0.88,8,2.25,2.0,1.14,3
AZ Alkmaar,8,4,2,2,10,7,3,14,netherlands,0.5,0.75,3,1.25,2.0,1.33,4
PSV Eindhoven,8,3,3,2,17,15,2,12,netherlands,0.38,0.75,2,2.12,2.63,1.33,5
Sparta,8,3,3,2,10,8,2,12,netherlands,0.38,0.75,2,1.25,2.63,1.33,5
FC Groningen,8,3,3,2,9,7,2,12,netherlands,0.38,0.75,2,1.12,2.63,1.33,5
Heracles Almelo,8,3,3,2,13,12,1,12,netherlands,0.38,0.75,1,1.62,2.63,1.33,5
RKC Waalwijk,8,3,1,4,14,11,3,10,netherlands,0.38,0.5,3,1.75,2.63,2.0,6
FC Utrecht,8,2,4,2,10,10,0,10,netherlands,0.25,0.75,0,1.25,4.0,1.33,6
Heerenveen,8,2,3,3,14,14,0,9,netherlands,0.25,0.62,0,1.75,4.0,1.61,7
PEC Zwolle,8,2,3,3,14,14,0,9,netherlands,0.25,0.62,0,1.75,4.0,1.61,7
NEC Nijmegen,8,2,3,3,13,13,0,9,netherlands,0.25,0.62,0,1.62,4.0,1.61,7
Feyenoord,8,2,3,3,8,9,-1,9,netherlands,0.25,0.62,-1,1.0,4.0,1.61,7
NAC Breda,8,1,4,3,7,13,-6,7,netherlands,0.12,0.62,-6,0.88,8.33,1.61,8
Fortuna Sittard,8,2,1,5,7,17,-10,7,netherlands,0.25,0.38,-10,0.88,4.0,2.63,8
Almere City,8,1,2,5,6,13,-7,5,netherlands,0.12,0.38,-7,0.75,8.33,2.63,9
Willem II,8,0,2,6,7,22,-15,2,netherlands,0.0,0.25,-15,0.88,0.0,4.0,10
ADO Den Haag,8,7,0,1,13,7,6,21,netherlands2,0.88,0.88,6,1.62,1.14,1.14,1
FC Volendam,8,6,0,2,18,9,9,18,netherlands2,0.75,0.75,9,2.25,1.33,1.33,2
Cambuur,8,5,2,1,17,8,9,17,netherlands2,0.62,0.88,9,2.12,1.61,1.14,3
De Graafschap,8,5,1,2,16,8,8,16,netherlands2,0.62,0.75,8,2.0,1.61,1.33,4
Vitesse Arnhem,8,5,1,2,13,8,5,16,netherlands2,0.62,0.75,5,1.62,1.61,1.33,4
FC Dordrecht,8,5,1,2,13,9,4,16,netherlands2,0.62,0.75,4,1.62,1.61,1.33,4
Telstar,8,5,0,3,19,10,9,15,netherlands2,0.62,0.62,9,2.38,1.61,1.61,5
Jong AZ,8,4,1,3,18,13,5,13,netherlands2,0.5,0.62,5,2.25,2.0,1.61,6
FC Emmen,8,4,0,4,11,9,2,12,netherlands2,0.5,0.5,2,1.38,2.0,2.0,7
Excelsior,8,3,2,3,14,13,1,11,netherlands2,0.38,0.62,1,1.75,2.63,1.61,8
FC Eindhoven,8,3,1,4,15,13,2,10,netherlands2,0.38,0.5,2,1.88,2.63,2.0,9
VVV,8,3,1,4,5,16,-11,10,netherlands2,0.38,0.5,-11,0.62,2.63,2.0,9
Roda JC,8,2,3,3,13,15,-2,9,netherlands2,0.25,0.62,-2,1.62,4.0,1.61,10
Helmond Sport,8,2,2,4,13,11,2,8,netherlands2,0.25,0.5,2,1.62,4.0,2.0,11
FC Den Bosch,8,2,1,5,7,9,-2,7,netherlands2,0.25,0.38,-2,0.88,4.0,2.63,12
Jong Ajax,8,2,1,5,6,13,-7,7,netherlands2,0.25,0.38,-7,0.75,4.0,2.63,12
MVV Maastricht,8,2,1,5,7,15,-8,7,netherlands2,0.25,0.38,-8,0.88,4.0,2.63,12
TOP Oss,8,0,4,4,5,15,-10,4,netherlands2,0.0,0.5,-10,0.62,0.0,2.0,13
Jong Utrecht,8,1,1,6,5,21,-16,4,netherlands2,0.12,0.25,-16,0.62,8.33,4.0,13
Jong PSV,8,0,2,6,10,19,-9,2,netherlands2,0.0,0.25,-9,1.25,0.0,4.0,14
Diriangen,8,7,1,0,29,1,28,22,nicaragua,0.88,1.0,28,3.62,1.14,1.0,1
Matagalpa,8,6,1,1,16,6,10,19,nicaragua,0.75,0.88,10,2.0,1.33,1.14,2
Real Esteli,8,4,3,1,13,9,4,15,nicaragua,0.5,0.88,4,1.62,2.0,1.14,3
Walter Ferreti,8,3,3,2,7,6,1,12,nicaragua,0.38,0.75,1,0.88,2.63,1.33,4
Managua FC,8,3,1,4,11,10,1,10,nicaragua,0.38,0.5,1,1.38,2.63,2.0,5
UNAN Managua,8,3,1,4,9,15,-6,10,nicaragua,0.38,0.5,-6,1.12,2.63,2.0,5
Jalapa,8,2,3,3,6,13,-7,9,nicaragua,0.25,0.62,-7,0.75,4.0,1.61,6
Export Sebaco,8,2,2,4,9,10,-1,8,nicaragua,0.25,0.5,-1,1.12,4.0,2.0,7
Rancho Santana,8,1,1,6,6,20,-14,4,nicaragua,0.12,0.25,-14,0.75,8.33,4.0,8
D. Ocotal,8,1,1,6,6,21,-15,4,nicaragua,0.12,0.25,-15,0.75,8.33,4.0,8
Real Esteli,8,6,1,1,20,6,14,19,nicaragua2,0.75,0.88,14,2.5,1.33,1.14,1
Diriangen,8,6,1,1,17,5,12,19,nicaragua2,0.75,0.88,12,2.12,1.33,1.14,1
Managua FC,8,4,3,1,9,5,4,15,nicaragua2,0.5,0.88,4,1.12,2.0,1.14,2
Matagalpa,8,3,2,3,14,14,0,11,nicaragua2,0.38,0.62,0,1.75,2.63,1.61,3
UNAN Managua,8,3,2,3,10,13,-3,11,nicaragua2,0.38,0.62,-3,1.25,2.63,1.61,3
Jalapa,8,2,3,3,8,10,-2,9,nicaragua2,0.25,0.62,-2,1.0,4.0,1.61,4
CS Sebaco,8,2,3,3,7,9,-2,9,nicaragua2,0.25,0.62,-2,0.88,4.0,1.61,4
Walter Ferreti,8,2,2,4,6,8,-2,8,nicaragua2,0.25,0.5,-2,0.75,4.0,2.0,5
Rancho Santana,8,1,2,5,4,10,-6,5,nicaragua2,0.12,0.38,-6,0.5,8.33,2.63,6
D. Ocotal,8,1,2,5,7,18,-11,5,nicaragua2,0.12,0.38,-11,0.88,8.33,2.63,6
Linfield,8,6,1,1,12,6,6,19,northernireland,0.75,0.88,6,1.5,1.33,1.14,1
Crusaders,8,5,1,2,12,8,4,16,northernireland,0.62,0.75,4,1.5,1.61,1.33,2
Coleraine,8,4,3,1,9,4,5,15,northernireland,0.5,0.88,5,1.12,2.0,1.14,3
Glentoran,8,4,3,1,10,8,2,15,northernireland,0.5,0.88,2,1.25,2.0,1.14,3
Ballymena Utd,8,3,2,3,11,9,2,11,northernireland,0.38,0.62,2,1.38,2.63,1.61,4
Glenavon,8,3,2,3,11,10,1,11,northernireland,0.38,0.62,1,1.38,2.63,1.61,4
Larne,8,3,2,3,9,8,1,11,northernireland,0.38,0.62,1,1.12,2.63,1.61,4
Dungannon,8,3,2,3,10,10,0,11,northernireland,0.38,0.62,0,1.25,2.63,1.61,4
Portadown,8,2,3,3,9,11,-2,9,northernireland,0.25,0.62,-2,1.12,4.0,1.61,5
Cliftonville,8,2,2,4,9,10,-1,8,northernireland,0.25,0.5,-1,1.12,4.0,2.0,6
Carrick Rangers,8,1,2,5,3,10,-7,5,northernireland,0.12,0.38,-7,0.38,8.33,2.63,7
Loughgall,8,0,2,6,3,13,-10,2,northernireland,0.0,0.25,-10,0.38,0.0,4.0,8
Bangor,8,5,2,1,17,3,14,17,northernireland2,0.62,0.88,14,2.12,1.61,1.14,1
HW Welders,8,5,2,1,15,4,11,17,northernireland2,0.62,0.88,11,1.88,1.61,1.14,1
Limavady,8,4,3,1,13,6,7,15,northernireland2,0.5,0.88,7,1.62,2.0,1.14,2
Ards,8,4,3,1,11,7,4,15,northernireland2,0.5,0.88,4,1.38,2.0,1.14,2
Annagh Utd,8,4,1,3,17,9,8,13,northernireland2,0.5,0.62,8,2.12,2.0,1.61,3
Institute,8,3,3,2,12,10,2,12,northernireland2,0.38,0.75,2,1.5,2.63,1.33,4
Ballinamallard,8,3,1,4,9,11,-2,10,northernireland2,0.38,0.5,-2,1.12,2.63,2.0,5
Newry City,8,2,3,3,8,13,-5,9,northernireland2,0.25,0.62,-5,1.0,4.0,1.61,6
Dundela,8,2,2,4,13,19,-6,8,northernireland2,0.25,0.5,-6,1.62,4.0,2.0,7
Newington,8,2,1,5,11,17,-6,7,northernireland2,0.25,0.38,-6,1.38,4.0,2.63,8
Armagh City,8,2,1,5,12,22,-10,7,northernireland2,0.25,0.38,-10,1.5,4.0,2.63,8
Ballyclare,8,1,2,5,6,18,-12,5,northernireland2,0.12,0.38,-12,0.75,8.33,2.63,9
Shkendija,8,5,2,1,10,7,3,17,northmacedonia,0.62,0.88,3,1.25,1.61,1.14,1
Sileks,8,4,3,1,15,7,8,15,northmacedonia,0.5,0.88,8,1.88,2.0,1.14,2
Shkupi,8,5,0,3,13,8,5,15,northmacedonia,0.62,0.62,5,1.62,1.61,1.61,2
Rabotnicki,8,4,2,2,9,6,3,14,northmacedonia,0.5,0.75,3,1.12,2.0,1.33,3
Pelister,8,4,1,3,6,8,-2,13,northmacedonia,0.5,0.62,-2,0.75,2.0,1.61,4
Tikves,8,3,2,3,8,7,1,11,northmacedonia,0.38,0.62,1,1.0,2.63,1.61,5
Gostivar,8,2,5,1,5,4,1,11,northmacedonia,0.25,0.88,1,0.62,4.0,1.14,5
Vardar,8,2,4,2,8,6,2,10,northmacedonia,0.25,0.75,2,1.0,4.0,1.33,6
Struga,8,3,0,5,10,13,-3,9,northmacedonia,0.38,0.38,-3,1.25,2.63,2.63,7
Besa,8,2,2,4,6,13,-7,8,northmacedonia,0.25,0.5,-7,0.75,4.0,2.0,8
Voska Sport,8,2,1,5,7,8,-1,7,northmacedonia,0.25,0.38,-1,0.88,4.0,2.63,9
Brera Strumica,8,0,2,6,5,15,-10,2,northmacedonia,0.0,0.25,-10,0.62,0.0,4.0,10
Bodo.Glimt,0,0,0,0,0,0,0,0,norway,0.0,0.0,0,0.0,0.0,0.0,1
Brann,0,0,0,0,0,0,0,0,norway,0.0,0.0,0,0.0,0.0,0.0,1
Bryne,0,0,0,0,0,0,0,0,norway,0.0,0.0,0,0.0,0.0,0.0,1
Fredrikstad,0,0,0,0,0,0,0,0,norway,0.0,0.0,0,0.0,0.0,0.0,1
HamKam,0,0,0,0,0,0,0,0,norway,0.0,0.0,0,0.0,0.0,0.0,1
Haugesund,0,0,0,0,0,0,0,0,norway,0.0,0.0,0,0.0,0.0,0.0,1
KFUM Oslo,0,0,0,0,0,0,0,0,norway,0.0,0.0,0,0.0,0.0,0.0,1
Kristiansund,0,0,0,0,0,0,0,0,norway,0.0,0.0,0,0.0,0.0,0.0,1
Molde,0,0,0,0,0,0,0,0,norway,0.0,0.0,0,0.0,0.0,0.0,1
Rosenborg,0,0,0,0,0,0,0,0,norway,0.0,0.0,0,0.0,0.0,0.0,1
Sandefjord,0,0,0,0,0,0,0,0,norway,0.0,0.0,0,0.0,0.0,0.0,1
Sarpsborg 08,0,0,0,0,0,0,0,0,norway,0.0,0.0,0,0.0,0.0,0.0,1
Stromsgodset,0,0,0,0,0,0,0,0,norway,0.0,0.0,0,0.0,0.0,0.0,1
Tromso,0,0,0,0,0,0,0,0,norway,0.0,0.0,0,0.0,0.0,0.0,1
Valerenga,0,0,0,0,0,0,0,0,norway,0.0,0.0,0,0.0,0.0,0.0,1
Viking,0,0,0,0,0,0,0,0,norway,0.0,0.0,0,0.0,0.0,0.0,1
Aalesund,0,0,0,0,0,0,0,0,norway2,0.0,0.0,0,0.0,0.0,0.0,1
Asane,0,0,0,0,0,0,0,0,norway2,0.0,0.0,0,0.0,0.0,0.0,1
Egersund,0,0,0,0,0,0,0,0,norway2,0.0,0.0,0,0.0,0.0,0.0,1
Hodd,0,0,0,0,0,0,0,0,norway2,0.0,0.0,0,0.0,0.0,0.0,1
Kongsvinger,0,0,0,0,0,0,0,0,norway2,0.0,0.0,0,0.0,0.0,0.0,1
Lillestrom,0,0,0,0,0,0,0,0,norway2,0.0,0.0,0,0.0,0.0,0.0,1
Lyn,0,0,0,0,0,0,0,0,norway2,0.0,0.0,0,0.0,0.0,0.0,1
Mjondalen,0,0,0,0,0,0,0,0,norway2,0.0,0.0,0,0.0,0.0,0.0,1
Moss,0,0,0,0,0,0,0,0,norway2,0.0,0.0,0,0.0,0.0,0.0,1
Odd,0,0,0,0,0,0,0,0,norway2,0.0,0.0,0,0.0,0.0,0.0,1
Ranheim,0,0,0,0,0,0,0,0,norway2,0.0,0.0,0,0.0,0.0,0.0,1
Raufoss,0,0,0,0,0,0,0,0,norway2,0.0,0.0,0,0.0,0.0,0.0,1
Skeid,0,0,0,0,0,0,0,0,norway2,0.0,0.0,0,0.0,0.0,0.0,1
Sogndal,0,0,0,0,0,0,0,0,norway2,0.0,0.0,0,0.0,0.0,0.0,1
Stabaek,0,0,0,0,0,0,0,0,norway2,0.0,0.0,0,0.0,0.0,0.0,1
Start,0,0,0,0,0,0,0,0,norway2,0.0,0.0,0,0.0,0.0,0.0,1
Arendal,0,0,0,0,0,0,0,0,norway3,0.0,0.0,0,0.0,0.0,0.0,1
Brann B,0,0,0,0,0,0,0,0,norway3,0.0,0.0,0,0.0,0.0,0.0,1
Brattvag,0,0,0,0,0,0,0,0,norway3,0.0,0.0,0,0.0,0.0,0.0,1
Eik Tonsberg,0,0,0,0,0,0,0,0,norway3,0.0,0.0,0,0.0,0.0,0.0,1
Flekkeroy,0,0,0,0,0,0,0,0,norway3,0.0,0.0,0,0.0,0.0,0.0,1
Jerv,0,0,0,0,0,0,0,0,norway3,0.0,0.0,0,0.0,0.0,0.0,1
Lysekloster,0,0,0,0,0,0,0,0,norway3,0.0,0.0,0,0.0,0.0,0.0,1
Notodden,0,0,0,0,0,0,0,0,norway3,0.0,0.0,0,0.0,0.0,0.0,1
Pors Grenland,0,0,0,0,0,0,0,0,norway3,0.0,0.0,0,0.0,0.0,0.0,1
Sandnes Ulf,0,0,0,0,0,0,0,0,norway3,0.0,0.0,0,0.0,0.0,0.0,1
Sandviken,0,0,0,0,0,0,0,0,norway3,0.0,0.0,0,0.0,0.0,0.0,1
Sotra,0,0,0,0,0,0,0,0,norway3,0.0,0.0,0,0.0,0.0,0.0,1
Traef,0,0,0,0,0,0,0,0,norway3,0.0,0.0,0,0.0,0.0,0.0,1
V. Haugesund,0,0,0,0,0,0,0,0,norway3,0.0,0.0,0,0.0,0.0,0.0,1
Alta,0,0,0,0,0,0,0,0,norway4,0.0,0.0,0,0.0,0.0,0.0,1
Asker,0,0,0,0,0,0,0,0,norway4,0.0,0.0,0,0.0,0.0,0.0,1
Eidsvold,0,0,0,0,0,0,0,0,norway4,0.0,0.0,0,0.0,0.0,0.0,1
Follo,0,0,0,0,0,0,0,0,norway4,0.0,0.0,0,0.0,0.0,0.0,1
Grorud,0,0,0,0,0,0,0,0,norway4,0.0,0.0,0,0.0,0.0,0.0,1
Honefoss,0,0,0,0,0,0,0,0,norway4,0.0,0.0,0,0.0,0.0,0.0,1
Kjelsas,0,0,0,0,0,0,0,0,norway4,0.0,0.0,0,0.0,0.0,0.0,1
Levanger,0,0,0,0,0,0,0,0,norway4,0.0,0.0,0,0.0,0.0,0.0,1
Rana,0,0,0,0,0,0,0,0,norway4,0.0,0.0,0,0.0,0.0,0.0,1
Stjordals-Blink,0,0,0,0,0,0,0,0,norway4,0.0,0.0,0,0.0,0.0,0.0,1
Strindheim,0,0,0,0,0,0,0,0,norway4,0.0,0.0,0,0.0,0.0,0.0,1
Strommen,0,0,0,0,0,0,0,0,norway4,0.0,0.0,0,0.0,0.0,0.0,1
Tromsdalen,0,0,0,0,0,0,0,0,norway4,0.0,0.0,0,0.0,0.0,0.0,1
Ull/Kisa,0,0,0,0,0,0,0,0,norway4,0.0,0.0,0,0.0,0.0,0.0,1
Alta B,0,0,0,0,0,0,0,0,norway5,0.0,0.0,0,0.0,0.0,0.0,1
Baerum,0,0,0,0,0,0,0,0,norway5,0.0,0.0,0,0.0,0.0,0.0,1
Floya,0,0,0,0,0,0,0,0,norway5,0.0,0.0,0,0.0,0.0,0.0,1
Frigg,0,0,0,0,0,0,0,0,norway5,0.0,0.0,0,0.0,0.0,0.0,1
Funnefoss/V.,0,0,0,0,0,0,0,0,norway5,0.0,0.0,0,0.0,0.0,0.0,1
Gamle Oslo,0,0,0,0,0,0,0,0,norway5,0.0,0.0,0,0.0,0.0,0.0,1
Harstad,0,0,0,0,0,0,0,0,norway5,0.0,0.0,0,0.0,0.0,0.0,1
Junkeren,0,0,0,0,0,0,0,0,norway5,0.0,0.0,0,0.0,0.0,0.0,1
KFUM B,0,0,0,0,0,0,0,0,norway5,0.0,0.0,0,0.0,0.0,0.0,1
Skjervoy,0,0,0,0,0,0,0,0,norway5,0.0,0.0,0,0.0,0.0,0.0,1
Sortland,0,0,0,0,0,0,0,0,norway5,0.0,0.0,0,0.0,0.0,0.0,1
Tromso B,0,0,0,0,0,0,0,0,norway5,0.0,0.0,0,0.0,0.0,0.0,1
Ulfstind,0,0,0,0,0,0,0,0,norway5,0.0,0.0,0,0.0,0.0,0.0,1
Ullern,0,0,0,0,0,0,0,0,norway5,0.0,0.0,0,0.0,0.0,0.0,1
Aalesund B,0,0,0,0,0,0,0,0,norway6,0.0,0.0,0,0.0,0.0,0.0,1
Byasen,0,0,0,0,0,0,0,0,norway6,0.0,0.0,0,0.0,0.0,0.0,1
Kristiansund B,0,0,0,0,0,0,0,0,norway6,0.0,0.0,0,0.0,0.0,0.0,1
Kvik Trondheim,0,0,0,0,0,0,0,0,norway6,0.0,0.0,0,0.0,0.0,0.0,1
Melhus,0,0,0,0,0,0,0,0,norway6,0.0,0.0,0,0.0,0.0,0.0,1
Molde B,0,0,0,0,0,0,0,0,norway6,0.0,0.0,0,0.0,0.0,0.0,1
Nardo,0,0,0,0,0,0,0,0,norway6,0.0,0.0,0,0.0,0.0,0.0,1
Ranheim B,0,0,0,0,0,0,0,0,norway6,0.0,0.0,0,0.0,0.0,0.0,1
Rosenborg B,0,0,0,0,0,0,0,0,norway6,0.0,0.0,0,0.0,0.0,0.0,1
Spjelkavik,0,0,0,0,0,0,0,0,norway6,0.0,0.0,0,0.0,0.0,0.0,1
Surnadal,0,0,0,0,0,0,0,0,norway6,0.0,0.0,0,0.0,0.0,0.0,1
Tiller,0,0,0,0,0,0,0,0,norway6,0.0,0.0,0,0.0,0.0,0.0,1
Trygg.Lade,0,0,0,0,0,0,0,0,norway6,0.0,0.0,0,0.0,0.0,0.0,1
Volda,0,0,0,0,0,0,0,0,norway6,0.0,0.0,0,0.0,0.0,0.0,1
Assiden IF,0,0,0,0,0,0,0,0,norway7,0.0,0.0,0,0.0,0.0,0.0,1
Bjorkelangen,0,0,0,0,0,0,0,0,norway7,0.0,0.0,0,0.0,0.0,0.0,1
Elverum,0,0,0,0,0,0,0,0,norway7,0.0,0.0,0,0.0,0.0,0.0,1
Gjovik-Lyn,0,0,0,0,0,0,0,0,norway7,0.0,0.0,0,0.0,0.0,0.0,1
HamKam B,0,0,0,0,0,0,0,0,norway7,0.0,0.0,0,0.0,0.0,0.0,1
Kongsvinger B,0,0,0,0,0,0,0,0,norway7,0.0,0.0,0,0.0,0.0,0.0,1
Lillehammer,0,0,0,0,0,0,0,0,norway7,0.0,0.0,0,0.0,0.0,0.0,1
Lillestrom B,0,0,0,0,0,0,0,0,norway7,0.0,0.0,0,0.0,0.0,0.0,1
Lorenskog,0,0,0,0,0,0,0,0,norway7,0.0,0.0,0,0.0,0.0,0.0,1
Nordstrand,0,0,0,0,0,0,0,0,norway7,0.0,0.0,0,0.0,0.0,0.0,1
Skedsmo,0,0,0,0,0,0,0,0,norway7,0.0,0.0,0,0.0,0.0,0.0,1
Skjetten,0,0,0,0,0,0,0,0,norway7,0.0,0.0,0,0.0,0.0,0.0,1
Stromsgodset B,0,0,0,0,0,0,0,0,norway7,0.0,0.0,0,0.0,0.0,0.0,1
Ull/Kisa B,0,0,0,0,0,0,0,0,norway7,0.0,0.0,0,0.0,0.0,0.0,1
Asane B,0,0,0,0,0,0,0,0,norway8,0.0,0.0,0,0.0,0.0,0.0,1
Askoy,0,0,0,0,0,0,0,0,norway8,0.0,0.0,0,0.0,0.0,0.0,1
Bjarg,0,0,0,0,0,0,0,0,norway8,0.0,0.0,0,0.0,0.0,0.0,1
Fana,0,0,0,0,0,0,0,0,norway8,0.0,0.0,0,0.0,0.0,0.0,1
Fjora,0,0,0,0,0,0,0,0,norway8,0.0,0.0,0,0.0,0.0,0.0,1
Forde,0,0,0,0,0,0,0,0,norway8,0.0,0.0,0,0.0,0.0,0.0,1
Fyllingsdalen,0,0,0,0,0,0,0,0,norway8,0.0,0.0,0,0.0,0.0,0.0,1
Gneist,0,0,0,0,0,0,0,0,norway8,0.0,0.0,0,0.0,0.0,0.0,1
Loddefjord,0,0,0,0,0,0,0,0,norway8,0.0,0.0,0,0.0,0.0,0.0,1
Lyn B,0,0,0,0,0,0,0,0,norway8,0.0,0.0,0,0.0,0.0,0.0,1
Lyngbo,0,0,0,0,0,0,0,0,norway8,0.0,0.0,0,0.0,0.0,0.0,1
OS,0,0,0,0,0,0,0,0,norway8,0.0,0.0,0,0.0,0.0,0.0,1
Sandefjord B,0,0,0,0,0,0,0,0,norway8,0.0,0.0,0,0.0,0.0,0.0,1
Valerenga B,0,0,0,0,0,0,0,0,norway8,0.0,0.0,0,0.0,0.0,0.0,1
Brodd,0,0,0,0,0,0,0,0,norway9,0.0,0.0,0,0.0,0.0,0.0,1
Djerv,0,0,0,0,0,0,0,0,norway9,0.0,0.0,0,0.0,0.0,0.0,1
Haugesund B,0,0,0,0,0,0,0,0,norway9,0.0,0.0,0,0.0,0.0,0.0,1
Hinna,0,0,0,0,0,0,0,0,norway9,0.0,0.0,0,0.0,0.0,0.0,1
Madla,0,0,0,0,0,0,0,0,norway9,0.0,0.0,0,0.0,0.0,0.0,1
Sandnes Ulf B,0,0,0,0,0,0,0,0,norway9,0.0,0.0,0,0.0,0.0,0.0,1
Sola,0,0,0,0,0,0,0,0,norway9,0.0,0.0,0,0.0,0.0,0.0,1
Staal Jorpeland,0,0,0,0,0,0,0,0,norway9,0.0,0.0,0,0.0,0.0,0.0,1
Stord,0,0,0,0,0,0,0,0,norway9,0.0,0.0,0,0.0,0.0,0.0,1
Torvastad,0,0,0,0,0,0,0,0,norway9,0.0,0.0,0,0.0,0.0,0.0,1
Vag,0,0,0,0,0,0,0,0,norway9,0.0,0.0,0,0.0,0.0,0.0,1
Vidar,0,0,0,0,0,0,0,0,norway9,0.0,0.0,0,0.0,0.0,0.0,1
Viking B,0,0,0,0,0,0,0,0,norway9,0.0,0.0,0,0.0,0.0,0.0,1
Vindbjart,0,0,0,0,0,0,0,0,norway9,0.0,0.0,0,0.0,0.0,0.0,1
Drobak-Frogn,0,0,0,0,0,0,0,0,norway10,0.0,0.0,0,0.0,0.0,0.0,1
Flint,0,0,0,0,0,0,0,0,norway10,0.0,0.0,0,0.0,0.0,0.0,1
Fram,0,0,0,0,0,0,0,0,norway10,0.0,0.0,0,0.0,0.0,0.0,1
Fredrikstad B,0,0,0,0,0,0,0,0,norway10,0.0,0.0,0,0.0,0.0,0.0,1
Grei,0,0,0,0,0,0,0,0,norway10,0.0,0.0,0,0.0,0.0,0.0,1
IF Ready,0,0,0,0,0,0,0,0,norway10,0.0,0.0,0,0.0,0.0,0.0,1
Kvik Halden,0,0,0,0,0,0,0,0,norway10,0.0,0.0,0,0.0,0.0,0.0,1
Lokomotiv Oslo,0,0,0,0,0,0,0,0,norway10,0.0,0.0,0,0.0,0.0,0.0,1
Odd B,0,0,0,0,0,0,0,0,norway10,0.0,0.0,0,0.0,0.0,0.0,1
Oppsal,0,0,0,0,0,0,0,0,norway10,0.0,0.0,0,0.0,0.0,0.0,1
Orn Horten,0,0,0,0,0,0,0,0,norway10,0.0,0.0,0,0.0,0.0,0.0,1
Pors Grenland B,0,0,0,0,0,0,0,0,norway10,0.0,0.0,0,0.0,0.0,0.0,1
Sarpsborg 08 B,0,0,0,0,0,0,0,0,norway10,0.0,0.0,0,0.0,0.0,0.0,1
Stabaek B,0,0,0,0,0,0,0,0,norway10,0.0,0.0,0,0.0,0.0,0.0,1
Plaza Amador,8,5,2,1,14,10,4,17,panama,0.62,0.88,4,1.75,1.61,1.14,1
UMECIT,8,3,4,1,9,6,3,13,panama,0.38,0.88,3,1.12,2.63,1.14,2
Arabe Unido,8,3,4,1,8,6,2,13,panama,0.38,0.88,2,1.0,2.63,1.14,2
Independiente,8,3,3,2,11,7,4,12,panama,0.38,0.75,4,1.38,2.63,1.33,3
Universitario,8,2,5,1,10,7,3,11,panama,0.25,0.88,3,1.25,4.0,1.14,4
San Francisco,8,3,2,3,4,5,-1,11,panama,0.38,0.62,-1,0.5,2.63,1.61,4
San Miguelito,8,3,2,3,8,10,-2,11,panama,0.38,0.62,-2,1.0,2.63,1.61,4
Veraguas,8,2,3,3,7,11,-4,9,panama,0.25,0.62,-4,0.88,4.0,1.61,5
Costa del Este,8,1,5,2,9,10,-1,8,panama,0.12,0.75,-1,1.12,8.33,1.33,6
Alianza,8,1,4,3,7,11,-4,7,panama,0.12,0.62,-4,0.88,8.33,1.61,7
Tauro,8,1,3,4,8,8,0,6,panama,0.12,0.5,0,1.0,8.33,2.0,8
Herrera,8,1,3,4,5,9,-4,6,panama,0.12,0.5,-4,0.62,8.33,2.0,8
San Miguelito,8,5,2,1,8,4,4,17,panama2,0.62,0.88,4,1.0,1.61,1.14,1
Independiente,8,5,1,2,14,11,3,16,panama2,0.62,0.75,3,1.75,1.61,1.33,2
Plaza Amador,8,4,3,1,9,6,3,15,panama2,0.5,0.88,3,1.12,2.0,1.14,3
Tauro,8,4,3,1,9,6,3,15,panama2,0.5,0.88,3,1.12,2.0,1.14,3
Veraguas,8,3,3,2,11,7,4,12,panama2,0.38,0.75,4,1.38,2.63,1.33,4
Arabe Unido,8,2,5,1,7,6,1,11,panama2,0.25,0.88,1,0.88,4.0,1.14,5
Universitario,8,3,2,3,6,5,1,11,panama2,0.38,0.62,1,0.75,2.63,1.61,5
UMECIT,8,3,1,4,8,8,0,10,panama2,0.38,0.5,0,1.0,2.63,2.0,6
Costa del Este,8,2,3,3,10,15,-5,9,panama2,0.25,0.62,-5,1.25,4.0,1.61,7
Alianza,8,2,0,6,8,12,-4,6,panama2,0.25,0.25,-4,1.0,4.0,4.0,8
San Francisco,8,1,2,5,4,10,-6,5,panama2,0.12,0.38,-6,0.5,8.33,2.63,9
Herrera,8,1,1,6,4,8,-4,4,panama2,0.12,0.25,-4,0.5,8.33,4.0,10
Libertad,8,7,1,0,19,5,14,22,paraguay,0.88,1.0,14,2.38,1.14,1.0,1
Olimpia,8,5,2,1,16,9,7,17,paraguay,0.62,0.88,7,2.0,1.61,1.14,2
Guarani,8,4,1,3,8,8,0,13,paraguay,0.5,0.62,0,1.0,2.0,1.61,3
S. Ameliano,8,3,3,2,10,9,1,12,paraguay,0.38,0.75,1,1.25,2.63,1.33,4
G. Caballero,8,3,2,3,7,5,2,11,paraguay,0.38,0.62,2,0.88,2.63,1.61,5
Cerro Porteno,8,3,2,3,10,9,1,11,paraguay,0.38,0.62,1,1.25,2.63,1.61,5
D. Recoleta,8,3,2,3,13,15,-2,11,paraguay,0.38,0.62,-2,1.62,2.63,1.61,5
S. Trinidense,8,2,4,2,9,10,-1,10,paraguay,0.25,0.75,-1,1.12,4.0,1.33,6
2 de Mayo,8,1,4,3,6,8,-2,7,paraguay,0.12,0.62,-2,0.75,8.33,1.61,7
A. Tembetary,8,1,3,4,7,12,-5,6,paraguay,0.12,0.5,-5,0.88,8.33,2.0,8
S. Luqueno,8,1,3,4,4,11,-7,6,paraguay,0.12,0.5,-7,0.5,8.33,2.0,8
Nacional,8,1,1,6,5,13,-8,4,paraguay,0.12,0.25,-8,0.62,8.33,4.0,9
Olimpia,8,4,3,1,10,4,6,15,paraguay2,0.5,0.88,6,1.25,2.0,1.14,1
Guarani,8,3,5,0,10,7,3,14,paraguay2,0.38,1.0,3,1.25,2.63,1.0,2
S. Ameliano,8,4,1,3,7,6,1,13,paraguay2,0.5,0.62,1,0.88,2.0,1.61,3
Sol de America,8,3,3,2,12,9,3,12,paraguay2,0.38,0.75,3,1.5,2.63,1.33,4
S. Luqueno,8,3,3,2,10,8,2,12,paraguay2,0.38,0.75,2,1.25,2.63,1.33,4
S. Trinidense,8,3,3,2,10,9,1,12,paraguay2,0.38,0.75,1,1.25,2.63,1.33,4
2 de Mayo,8,2,4,2,7,5,2,10,paraguay2,0.25,0.75,2,0.88,4.0,1.33,5
G. Caballero,8,2,3,3,7,7,0,9,paraguay2,0.25,0.62,0,0.88,4.0,1.61,6
Nacional,8,1,5,2,8,9,-1,8,paraguay2,0.12,0.75,-1,1.0,8.33,1.33,7
Cerro Porteno,8,2,2,4,11,15,-4,8,paraguay2,0.25,0.5,-4,1.38,4.0,2.0,7
Libertad,8,2,1,5,8,12,-4,7,paraguay2,0.25,0.38,-4,1.0,4.0,2.63,8
Tacuary,8,1,3,4,5,14,-9,6,paraguay2,0.12,0.5,-9,0.62,8.33,2.0,9
FBC Melgar,4,4,0,0,7,1,6,12,peru,1.0,1.0,6,1.75,1.0,1.0,1
Alianza Lima,5,4,0,1,9,4,5,12,peru,0.8,0.8,5,1.8,1.25,1.25,1
D. Garcilaso,5,3,2,0,9,5,4,11,peru,0.6,1.0,4,1.8,1.67,1.0,2
Universitario,4,3,1,0,10,3,7,10,peru,0.75,1.0,7,2.5,1.33,1.0,3
Sport Huancayo,5,3,1,1,6,4,2,10,peru,0.6,0.8,2,1.2,1.67,1.25,3
ADT,5,2,2,1,12,11,1,8,peru,0.4,0.8,1,2.4,2.5,1.25,4
Alianza A.,5,2,1,2,9,6,3,7,peru,0.4,0.6,3,1.8,2.5,1.67,5
S. Cristal,5,2,1,2,6,6,0,7,peru,0.4,0.6,0,1.2,2.5,1.67,5
Sport Boys,5,2,1,2,6,7,-1,7,peru,0.4,0.6,-1,1.2,2.5,1.67,5
Binacional,4,2,0,2,8,6,2,6,peru,0.5,0.5,2,2.0,2.0,2.0,6
Atletico Grau,4,2,0,2,6,7,-1,6,peru,0.5,0.5,-1,1.5,2.0,2.0,6
Cienciano,4,1,1,2,9,10,-1,4,peru,0.25,0.5,-1,2.25,4.0,2.0,7
Ayacucho,5,1,1,3,5,8,-3,4,peru,0.2,0.4,-3,1.0,5.0,2.5,7
Cusco,4,1,1,2,3,6,-3,4,peru,0.25,0.5,-3,0.75,4.0,2.0,7
Los Chankas,3,0,2,1,4,5,-1,2,peru,0.0,0.67,-1,1.33,0.0,1.49,8
Comerciantes U.,4,0,2,2,5,7,-2,2,peru,0.0,0.5,-2,1.25,0.0,2.0,8
A. Huanuco,5,0,2,3,6,12,-6,2,peru,0.0,0.4,-6,1.2,0.0,2.5,8
Cajamarca,4,0,2,2,1,8,-7,2,peru,0.0,0.5,-7,0.25,0.0,2.0,8
Juan Pablo II C,4,0,0,4,0,5,-5,0,peru,0.0,0.0,-5,0.0,0.0,0.0,9
Manila Digger,8,6,0,2,30,5,25,18,philippines,0.75,0.75,25,3.75,1.33,1.33,1
Kaya FC,8,6,0,2,19,8,11,18,philippines,0.75,0.75,11,2.38,1.33,1.33,1
Stallion,8,4,2,2,20,9,11,14,philippines,0.5,0.75,11,2.5,2.0,1.33,2
One Taguig,8,4,2,2,15,6,9,14,philippines,0.5,0.75,9,1.88,2.0,1.33,2
Davao Aguilas,8,4,1,3,12,7,5,13,philippines,0.5,0.62,5,1.5,2.0,1.61,3
Loyola,8,4,1,3,10,10,0,13,philippines,0.5,0.62,0,1.25,2.0,1.61,3
DH Cebu,8,3,2,3,13,10,3,11,philippines,0.38,0.62,3,1.62,2.63,1.61,4
Maharlika,8,2,2,4,7,15,-8,8,philippines,0.25,0.5,-8,0.88,4.0,2.0,5
Mendiola,8,1,1,6,7,38,-31,4,philippines,0.12,0.25,-31,0.88,8.33,4.0,6
PFF Development,8,0,2,6,8,32,-24,2,philippines,0.0,0.25,-24,1.0,0.0,4.0,7
Pogon Szczecin,8,5,2,1,16,7,9,17,poland,0.62,0.88,9,2.0,1.61,1.14,1
Rakow C.,8,5,2,1,14,7,7,17,poland,0.62,0.88,7,1.75,1.61,1.14,1
Jagiellonia,8,4,3,1,15,6,9,15,poland,0.5,0.88,9,1.88,2.0,1.14,2
Korona Kielce,8,4,3,1,10,7,3,15,poland,0.5,0.88,3,1.25,2.0,1.14,2
Radomiak Radom,8,4,2,2,13,14,-1,14,poland,0.5,0.75,-1,1.62,2.0,1.33,3
Lech Poznan,8,4,1,3,14,7,7,13,poland,0.5,0.62,7,1.75,2.0,1.61,4
Gornik Zabrze,8,4,1,3,12,10,2,13,poland,0.5,0.62,2,1.5,2.0,1.61,4
Piast Gliwice,8,3,4,1,7,6,1,13,poland,0.38,0.88,1,0.88,2.63,1.14,4
Legia Warsaw,8,3,3,2,15,11,4,12,poland,0.38,0.75,4,1.88,2.63,1.33,5
Katowice,8,3,2,3,7,7,0,11,poland,0.38,0.62,0,0.88,2.63,1.61,6
Lechia Gdansk,8,3,1,4,9,11,-2,10,poland,0.38,0.5,-2,1.12,2.63,2.0,7
Motor Lublin,8,2,3,3,10,16,-6,9,poland,0.25,0.62,-6,1.25,4.0,1.61,8
Slask Wroclaw,8,2,2,4,12,13,-1,8,poland,0.25,0.5,-1,1.5,4.0,2.0,9
Puszcza Niepolo,8,2,2,4,7,9,-2,8,poland,0.25,0.5,-2,0.88,4.0,2.0,9
Cracovia Krakow,8,1,5,2,8,11,-3,8,poland,0.12,0.75,-3,1.0,8.33,1.33,9
Widzew Lodz,8,2,2,4,6,15,-9,8,poland,0.25,0.5,-9,0.75,4.0,2.0,9
Stal Mielec,8,1,1,6,8,16,-8,4,poland,0.12,0.25,-8,1.0,8.33,4.0,10
Zaglebie Lubin,8,1,1,6,5,14,-9,4,poland,0.12,0.25,-9,0.62,8.33,4.0,10
Tychy,8,6,1,1,23,8,15,19,poland2,0.75,0.88,15,2.88,1.33,1.14,1
Arka Gdynia,8,5,3,0,14,5,9,18,poland2,0.62,1.0,9,1.75,1.61,1.0,2
Polonia Warszaw,8,5,2,1,13,8,5,17,poland2,0.62,0.88,5,1.62,1.61,1.14,3
Wisla Plock,8,4,3,1,14,6,8,15,poland2,0.5,0.88,8,1.75,2.0,1.14,4
T. Nieciecza,8,4,3,1,16,11,5,15,poland2,0.5,0.88,5,2.0,2.0,1.14,4
Znicz Pruszkow,8,4,1,3,12,11,1,13,poland2,0.5,0.62,1,1.5,2.0,1.61,5
Stal Rzeszow,8,3,3,2,9,10,-1,12,poland2,0.38,0.75,-1,1.12,2.63,1.33,6
Wisla Krakow,8,3,2,3,12,9,3,11,poland2,0.38,0.62,3,1.5,2.63,1.61,7
Miedz Legnica,8,3,2,3,13,13,0,11,poland2,0.38,0.62,0,1.62,2.63,1.61,7
Gornik Leczna,8,2,3,3,13,11,2,9,poland2,0.25,0.62,2,1.62,4.0,1.61,8
Ruch Chorzow,8,2,3,3,12,12,0,9,poland2,0.25,0.62,0,1.5,4.0,1.61,8
LKS Lodz,8,2,3,3,10,11,-1,9,poland2,0.25,0.62,-1,1.25,4.0,1.61,8
Chrobry Glogow,8,2,3,3,8,9,-1,9,poland2,0.25,0.62,-1,1.0,4.0,1.61,8
Odra Opole,8,1,4,3,6,16,-10,7,poland2,0.12,0.62,-10,0.75,8.33,1.61,9
K. Kolobrzeg,8,1,3,4,6,15,-9,6,poland2,0.12,0.5,-9,0.75,8.33,2.0,10
Pogon Siedlce,8,1,2,5,6,12,-6,5,poland2,0.12,0.38,-6,0.75,8.33,2.63,11
Warta Poznan,8,1,1,6,5,15,-10,4,poland2,0.12,0.25,-10,0.62,8.33,4.0,12
Stalowa Wola,8,0,3,5,3,17,-14,3,poland2,0.0,0.38,-14,0.38,0.0,2.63,13
Pogon Grodzisk,8,6,1,1,14,6,8,19,poland3,0.75,0.88,8,1.75,1.33,1.14,1
Wieczysta K.,8,5,2,1,17,5,12,17,poland3,0.62,0.88,12,2.12,1.61,1.14,2
LKS Lodz B,8,5,1,2,12,7,5,16,poland3,0.62,0.75,5,1.5,1.61,1.33,3
Chojniczanka,8,5,1,2,8,5,3,16,poland3,0.62,0.75,3,1.0,1.61,1.33,3
Hutnik Krakow,8,4,2,2,9,8,1,14,poland3,0.5,0.75,1,1.12,2.0,1.33,4
Kalisz,8,4,1,3,10,7,3,13,poland3,0.5,0.62,3,1.25,2.0,1.61,5
Z. Sosnowiec,8,3,3,2,13,13,0,12,poland3,0.38,0.75,0,1.62,2.63,1.33,6
Jastrzebie,8,3,2,3,8,6,2,11,poland3,0.38,0.62,2,1.0,2.63,1.61,7
Podbeskidzie,8,3,2,3,7,6,1,11,poland3,0.38,0.62,1,0.88,2.63,1.61,7
Swit Skolwin,8,3,2,3,14,14,0,11,poland3,0.38,0.62,0,1.75,2.63,1.61,7
Zaglebie L. B,8,3,1,4,16,16,0,10,poland3,0.38,0.5,0,2.0,2.63,2.0,8
Rekord Bielsko,8,2,4,2,10,10,0,10,poland3,0.25,0.75,0,1.25,4.0,1.33,8
Polonia Bytom,8,2,3,3,7,7,0,9,poland3,0.25,0.62,0,0.88,4.0,1.61,9
SKRA Czestochow,8,2,2,4,6,12,-6,8,poland3,0.25,0.5,-6,0.75,4.0,2.0,10
Resovia Rzeszow,8,2,1,5,10,12,-2,7,poland3,0.25,0.38,-2,1.25,4.0,2.63,11
Wisla Pulawy,8,2,1,5,8,20,-12,7,poland3,0.25,0.38,-12,1.0,4.0,2.63,11
O. Grudziadz,8,0,3,5,6,14,-8,3,poland3,0.0,0.38,-8,0.75,0.0,2.63,12
Olimpia Elblag,8,0,1,7,5,16,-11,1,poland3,0.0,0.12,-11,0.62,0.0,8.33,13
Sporting Braga,8,6,1,1,11,3,8,19,portugal,0.75,0.88,8,1.38,1.33,1.14,1
Benfica,8,6,0,2,19,9,10,18,portugal,0.75,0.75,10,2.38,1.33,1.33,2
Sporting CP,8,5,3,0,19,9,10,18,portugal,0.62,1.0,10,2.38,1.61,1.0,2
Estoril,8,5,2,1,15,12,3,17,portugal,0.62,0.88,3,1.88,1.61,1.14,3
Famalicao,8,4,2,2,9,5,4,14,portugal,0.5,0.75,4,1.12,2.0,1.33,4
FC Porto,8,3,4,1,10,6,4,13,portugal,0.38,0.88,4,1.25,2.63,1.14,5
Guimaraes,8,3,4,1,8,5,3,13,portugal,0.38,0.88,3,1.0,2.63,1.14,5
Arouca,8,3,4,1,11,10,1,13,portugal,0.38,0.88,1,1.38,2.63,1.14,5
Santa Clara,8,3,3,2,7,6,1,12,portugal,0.38,0.75,1,0.88,2.63,1.33,6
Casa Pia,8,4,0,4,12,12,0,12,portugal,0.5,0.5,0,1.5,2.0,2.0,6
Nacional,8,3,1,4,10,12,-2,10,portugal,0.38,0.5,-2,1.25,2.63,2.0,7
Rio Ave,8,2,3,3,9,12,-3,9,portugal,0.25,0.62,-3,1.12,4.0,1.61,8
AVS,8,2,2,4,6,10,-4,8,portugal,0.25,0.5,-4,0.75,4.0,2.0,9
Estrela Amadora,8,1,4,3,5,7,-2,7,portugal,0.12,0.62,-2,0.62,8.33,1.61,10
Moreirense,8,1,3,4,8,12,-4,6,portugal,0.12,0.5,-4,1.0,8.33,2.0,11
Gil Vicente,8,1,1,6,5,11,-6,4,portugal,0.12,0.25,-6,0.62,8.33,4.0,12
Boavista,8,1,0,7,5,16,-11,3,portugal,0.12,0.12,-11,0.62,8.33,8.33,13
Farense,8,0,2,6,6,14,-8,2,portugal,0.0,0.25,-8,0.75,0.0,4.0,14
Vizela,8,6,2,0,17,4,13,20,portugal2,0.75,1.0,13,2.12,1.33,1.0,1
Alverca,8,4,3,1,17,9,8,15,portugal2,0.5,0.88,8,2.12,2.0,1.14,2
Chaves,8,4,3,1,10,4,6,15,portugal2,0.5,0.88,6,1.25,2.0,1.14,2
Feirense,8,5,0,3,12,13,-1,15,portugal2,0.62,0.62,-1,1.5,1.61,1.61,2
Tondela,8,3,4,1,9,6,3,13,portugal2,0.38,0.88,3,1.12,2.63,1.14,3
Uniao de Leiria,8,3,3,2,8,7,1,12,portugal2,0.38,0.75,1,1.0,2.63,1.33,4
Oliveirense,8,3,3,2,9,9,0,12,portugal2,0.38,0.75,0,1.12,2.63,1.33,4
Academico Viseu,8,2,5,1,10,9,1,11,portugal2,0.25,0.88,1,1.25,4.0,1.14,5
Torreense,8,2,4,2,13,12,1,10,portugal2,0.25,0.75,1,1.62,4.0,1.33,6
Maritimo,8,2,4,2,8,11,-3,10,portugal2,0.25,0.75,-3,1.0,4.0,1.33,6
Benfica B,8,2,3,3,9,7,2,9,portugal2,0.25,0.62,2,1.12,4.0,1.61,7
FC Porto B,8,2,3,3,8,10,-2,9,portugal2,0.25,0.62,-2,1.0,4.0,1.61,7
Pacos Ferreira,8,2,3,3,7,10,-3,9,portugal2,0.25,0.62,-3,0.88,4.0,1.61,7
Felgueiras,8,2,2,4,8,11,-3,8,portugal2,0.25,0.5,-3,1.0,4.0,2.0,8
Penafiel,8,2,1,5,10,12,-2,7,portugal2,0.25,0.38,-2,1.25,4.0,2.63,9
Portimonense,8,2,1,5,6,11,-5,7,portugal2,0.25,0.38,-5,0.75,4.0,2.63,9
Leixoes,8,0,4,4,3,10,-7,4,portugal2,0.0,0.5,-7,0.38,0.0,2.0,10
Mafra,8,0,3,5,2,11,-9,3,portugal2,0.0,0.38,-9,0.25,0.0,2.63,11
Al Sadd,8,6,1,1,18,4,14,19,qatar,0.75,0.88,14,2.25,1.33,1.14,1
Al Gharafa,8,6,1,1,18,12,6,19,qatar,0.75,0.88,6,2.25,1.33,1.14,1
Al Rayyan,8,5,2,1,22,9,13,17,qatar,0.62,0.88,13,2.75,1.61,1.14,2
Al Duhail,8,5,1,2,15,9,6,16,qatar,0.62,0.75,6,1.88,1.61,1.33,3
Al Arabi,8,4,0,4,17,18,-1,12,qatar,0.5,0.5,-1,2.12,2.0,2.0,4
Al Shahaniya,8,4,0,4,12,18,-6,12,qatar,0.5,0.5,-6,1.5,2.0,2.0,4
Qatar SC,8,3,2,3,13,14,-1,11,qatar,0.38,0.62,-1,1.62,2.63,1.61,5
Al Shamal,8,3,1,4,12,7,5,10,qatar,0.38,0.5,5,1.5,2.63,2.0,6
Al Ahli Doha,8,2,2,4,14,19,-5,8,qatar,0.25,0.5,-5,1.75,4.0,2.0,7
Al Wakrah,8,2,1,5,11,21,-10,7,qatar,0.25,0.38,-10,1.38,4.0,2.63,8
Umm Salal,8,1,1,6,10,19,-9,4,qatar,0.12,0.25,-9,1.25,8.33,4.0,9
Al Khor,8,1,0,7,9,21,-12,3,qatar,0.12,0.12,-12,1.12,8.33,8.33,10
CFR Cluj,8,5,3,0,19,5,14,18,romania,0.62,1.0,14,2.38,1.61,1.0,1
FCSB,8,5,3,0,10,2,8,18,romania,0.62,1.0,8,1.25,1.61,1.0,1
Univ. Craiova,8,5,1,2,11,6,5,16,romania,0.62,0.75,5,1.38,1.61,1.33,2
Din. Bucharest,8,4,2,2,10,6,4,14,romania,0.5,0.75,4,1.25,2.0,1.33,3
Rapid Bucharest,8,4,2,2,9,6,3,14,romania,0.5,0.75,3,1.12,2.0,1.33,3
Hermannstadt,8,4,2,2,9,7,2,14,romania,0.5,0.75,2,1.12,2.0,1.33,3
U. Cluj,8,3,3,2,9,8,1,12,romania,0.38,0.75,1,1.12,2.63,1.33,4
Botosani,8,3,3,2,8,7,1,12,romania,0.38,0.75,1,1.0,2.63,1.33,4
Sepsi OSK,8,3,2,3,8,9,-1,11,romania,0.38,0.62,-1,1.0,2.63,1.61,5
Farul Constanta,8,3,1,4,8,10,-2,10,romania,0.38,0.5,-2,1.0,2.63,2.0,6
P. Iasi,8,2,3,3,8,12,-4,9,romania,0.25,0.62,-4,1.0,4.0,1.61,7
Petrolul,8,2,2,4,6,8,-2,8,romania,0.25,0.5,-2,0.75,4.0,2.0,8
UTA Arad,8,2,2,4,5,10,-5,8,romania,0.25,0.5,-5,0.62,4.0,2.0,8
Otelul,8,2,1,5,7,11,-4,7,romania,0.25,0.38,-4,0.88,4.0,2.63,9
FC Buzau,8,1,1,6,6,16,-10,4,romania,0.12,0.25,-10,0.75,8.33,4.0,10
Unirea Slobozia,8,0,1,7,4,14,-10,1,romania,0.0,0.12,-10,0.5,0.0,8.33,11
Spartak Moscow,8,7,0,1,22,4,18,21,russia,0.88,0.88,18,2.75,1.14,1.14,1
Rostov,8,5,2,1,18,9,9,17,russia,0.62,0.88,9,2.25,1.61,1.14,2
Rubin Kazan,8,4,2,2,14,10,4,14,russia,0.5,0.75,4,1.75,2.0,1.33,3
Zenit,8,4,2,2,11,8,3,14,russia,0.5,0.75,3,1.38,2.0,1.33,3
Dinamo Moscow,8,3,4,1,16,8,8,13,russia,0.38,0.88,8,2.0,2.63,1.14,4
FC Krasnodar,8,3,4,1,13,8,5,13,russia,0.38,0.88,5,1.62,2.63,1.14,4
Akron,8,4,1,3,9,11,-2,13,russia,0.5,0.62,-2,1.12,2.0,1.61,4
CSKA Moscow,8,3,3,2,7,7,0,12,russia,0.38,0.75,0,0.88,2.63,1.33,5
Lokomotiv M.,8,3,3,2,10,12,-2,12,russia,0.38,0.75,-2,1.25,2.63,1.33,5
Makhachkala,8,2,3,3,10,11,-1,9,russia,0.25,0.62,-1,1.25,4.0,1.61,6
Akhmat Grozny,8,2,3,3,8,10,-2,9,russia,0.25,0.62,-2,1.0,4.0,1.61,6
Khimki,8,2,3,3,10,13,-3,9,russia,0.25,0.62,-3,1.25,4.0,1.61,6
Krylya Sovetov,8,2,1,5,8,17,-9,7,russia,0.25,0.38,-9,1.0,4.0,2.63,7
Nizhny Novgorod,8,2,1,5,5,16,-11,7,russia,0.25,0.38,-11,0.62,4.0,2.63,7
Fakel Voronezh,8,0,3,5,3,9,-6,3,russia,0.0,0.38,-6,0.38,0.0,2.63,8
Orenburg,8,1,0,7,3,13,-10,3,russia,0.12,0.12,-10,0.38,8.33,8.33,8
PFC Sochi,8,6,2,0,14,5,9,20,russia2,0.75,1.0,9,1.75,1.33,1.0,1
Baltika,8,6,2,0,12,3,9,20,russia2,0.75,1.0,9,1.5,1.33,1.0,1
Torpedo Moscow,8,5,2,1,11,5,6,17,russia2,0.62,0.88,6,1.38,1.61,1.14,2
Chernomorets,8,5,1,2,12,10,2,16,russia2,0.62,0.75,2,1.5,1.61,1.33,3
Yenisey,8,4,2,2,9,6,3,14,russia2,0.5,0.75,3,1.12,2.0,1.33,4
SKA Khabarovsk,8,4,2,2,6,5,1,14,russia2,0.5,0.75,1,0.75,2.0,1.33,4
Ural,8,3,3,2,9,7,2,12,russia2,0.38,0.75,2,1.12,2.63,1.33,5
Chayka,8,2,4,2,9,9,0,10,russia2,0.25,0.75,0,1.12,4.0,1.33,6
Rotor Volgograd,8,2,4,2,6,7,-1,10,russia2,0.25,0.75,-1,0.75,4.0,1.33,6
Shinnik,8,2,4,2,3,4,-1,10,russia2,0.25,0.75,-1,0.38,4.0,1.33,6
Tyumen,8,3,1,4,8,11,-3,10,russia2,0.38,0.5,-3,1.0,2.63,2.0,6
Kamaz,8,3,0,5,10,11,-1,9,russia2,0.38,0.38,-1,1.25,2.63,2.63,7
Ufa,8,2,2,4,8,11,-3,8,russia2,0.25,0.5,-3,1.0,4.0,2.0,8
Neftekhimik,8,2,1,5,11,11,0,7,russia2,0.25,0.38,0,1.38,4.0,2.63,9
Rodina Moskva,8,1,3,4,4,8,-4,6,russia2,0.12,0.5,-4,0.5,8.33,2.0,10
Sokol Saratov,8,1,2,5,4,11,-7,5,russia2,0.12,0.38,-7,0.5,8.33,2.63,11
Arsenal Tula,8,0,4,4,5,10,-5,4,russia2,0.0,0.5,-5,0.62,0.0,2.0,12
A. Vladikavkaz,8,0,2,6,3,14,-11,2,russia2,0.0,0.25,-11,0.38,0.0,4.0,13
Al Ittihad,8,5,3,0,19,10,9,18,saudiarabia,0.62,1.0,9,2.38,1.61,1.0,1
Al Ahli Jeddah,8,5,1,2,18,10,8,16,saudiarabia,0.62,0.75,8,2.25,1.61,1.33,2
Al Nassr,8,5,1,2,18,11,7,16,saudiarabia,0.62,0.75,7,2.25,1.61,1.33,2
Al Ittifaq,8,5,1,2,13,9,4,16,saudiarabia,0.62,0.75,4,1.62,1.61,1.33,2
Al Shabab,8,4,2,2,22,12,10,14,saudiarabia,0.5,0.75,10,2.75,2.0,1.33,3
Al Hilal,8,4,2,2,19,11,8,14,saudiarabia,0.5,0.75,8,2.38,2.0,1.33,3
Al Quadisiya,8,4,2,2,11,9,2,14,saudiarabia,0.5,0.75,2,1.38,2.0,1.33,3
Al Fateh,8,4,1,3,12,10,2,13,saudiarabia,0.5,0.62,2,1.5,2.0,1.61,4
Al Orubah,8,4,0,4,11,15,-4,12,saudiarabia,0.5,0.5,-4,1.38,2.0,2.0,5
Al Kholood,8,4,0,4,13,18,-5,12,saudiarabia,0.5,0.5,-5,1.62,2.0,2.0,5
Al Taawon,8,3,2,3,9,8,1,11,saudiarabia,0.38,0.62,1,1.12,2.63,1.61,6
Al Feiha,8,2,4,2,4,5,-1,10,saudiarabia,0.25,0.75,-1,0.5,4.0,1.33,7
Al Riyadh,8,2,2,4,7,10,-3,8,saudiarabia,0.25,0.5,-3,0.88,4.0,2.0,8
Al Wahda,8,2,1,5,8,13,-5,7,saudiarabia,0.25,0.38,-5,1.0,4.0,2.63,9
Damak,8,1,3,4,5,12,-7,6,saudiarabia,0.12,0.5,-7,0.62,8.33,2.0,10
Al Akhdoud,8,1,2,5,4,14,-10,5,saudiarabia,0.12,0.38,-10,0.5,8.33,2.63,11
Al Raed,8,1,1,6,8,16,-8,4,saudiarabia,0.12,0.25,-8,1.0,8.33,4.0,12
Al Khaleej,8,0,4,4,6,14,-8,4,saudiarabia,0.0,0.5,-8,0.75,0.0,2.0,12
Neom SC,8,6,2,0,16,5,11,20,saudiarabia2,0.75,1.0,11,2.0,1.33,1.0,1
Al Adalha,8,4,4,0,15,10,5,16,saudiarabia2,0.5,1.0,5,1.88,2.0,1.0,2
Al Bukayriyah,8,4,3,1,13,4,9,15,saudiarabia2,0.5,0.88,9,1.62,2.0,1.14,3
Al Najma,8,4,3,1,13,8,5,15,saudiarabia2,0.5,0.88,5,1.62,2.0,1.14,3
Al Tai,8,4,3,1,11,6,5,15,saudiarabia2,0.5,0.88,5,1.38,2.0,1.14,3
Al Hazm,8,4,2,2,12,9,3,14,saudiarabia2,0.5,0.75,3,1.5,2.0,1.33,4
Jeddah,8,4,1,3,7,5,2,13,saudiarabia2,0.5,0.62,2,0.88,2.0,1.61,5
Al Jandal,8,3,3,2,10,7,3,12,saudiarabia2,0.38,0.75,3,1.25,2.63,1.33,6
Al Jabalain,8,3,3,2,10,10,0,12,saudiarabia2,0.38,0.75,0,1.25,2.63,1.33,6
Al Jubail,8,2,5,1,11,11,0,11,saudiarabia2,0.25,0.88,0,1.38,4.0,1.14,7
Abha,8,2,5,1,10,10,0,11,saudiarabia2,0.25,0.88,0,1.25,4.0,1.14,7
Al Zulfi,8,2,4,2,8,7,1,10,saudiarabia2,0.25,0.75,1,1.0,4.0,1.33,8
Al Ain,8,2,2,4,9,15,-6,8,saudiarabia2,0.25,0.5,-6,1.12,4.0,2.0,9
Al Faisaly,8,1,4,3,8,13,-5,7,saudiarabia2,0.12,0.62,-5,1.0,8.33,1.61,10
Al Batin,8,1,3,4,7,11,-4,6,saudiarabia2,0.12,0.5,-4,0.88,8.33,2.0,11
Al Arabi,8,1,1,6,11,17,-6,4,saudiarabia2,0.12,0.25,-6,1.38,8.33,4.0,12
Ohod,8,1,1,6,7,13,-6,4,saudiarabia2,0.12,0.25,-6,0.88,8.33,4.0,12
Al Safa,8,0,1,7,3,19,-16,1,saudiarabia2,0.0,0.12,-16,0.38,0.0,8.33,13
Celtic,8,6,1,1,30,10,20,19,scotland,0.75,0.88,20,3.75,1.33,1.14,1
Rangers,8,6,0,2,21,9,12,18,scotland,0.75,0.75,12,2.62,1.33,1.33,2
Hibernian,8,5,3,0,14,6,8,18,scotland,0.62,1.0,8,1.75,1.61,1.0,2
Hearts,8,5,1,2,18,9,9,16,scotland,0.62,0.75,9,2.25,1.61,1.33,3
St. Johnstone,8,3,2,3,8,10,-2,11,scotland,0.38,0.62,-2,1.0,2.63,1.61,4
Ross County,8,3,1,4,9,13,-4,10,scotland,0.38,0.5,-4,1.12,2.63,2.0,5
St. Mirren,8,2,2,4,10,12,-2,8,scotland,0.25,0.5,-2,1.25,4.0,2.0,6
Kilmarnock,8,2,2,4,9,11,-2,8,scotland,0.25,0.5,-2,1.12,4.0,2.0,6
Aberdeen,8,2,2,4,6,16,-10,8,scotland,0.25,0.5,-10,0.75,4.0,2.0,6
Motherwell,8,2,1,5,9,16,-7,7,scotland,0.25,0.38,-7,1.12,4.0,2.63,7
Dundee Utd,8,2,1,5,6,14,-8,7,scotland,0.25,0.38,-8,0.75,4.0,2.63,7
Dundee FC,8,0,3,5,8,24,-16,3,scotland,0.0,0.38,-16,1.0,0.0,2.63,8
Falkirk,8,5,2,1,20,8,12,17,scotland2,0.62,0.88,12,2.5,1.61,1.14,1
Livingston,8,4,4,0,14,8,6,16,scotland2,0.5,1.0,6,1.75,2.0,1.0,2
Ayr Utd,8,4,1,3,15,12,3,13,scotland2,0.5,0.62,3,1.88,2.0,1.61,3
Raith Rovers,8,4,1,3,11,8,3,13,scotland2,0.5,0.62,3,1.38,2.0,1.61,3
Airdrieonians,8,3,3,2,12,15,-3,12,scotland2,0.38,0.75,-3,1.5,2.63,1.33,4
Greenock Morton,8,3,2,3,13,12,1,11,scotland2,0.38,0.62,1,1.62,2.63,1.61,5
Partick Thistle,8,2,3,3,11,14,-3,9,scotland2,0.25,0.62,-3,1.38,4.0,1.61,6
Dunfermline,8,2,2,4,5,9,-4,8,scotland2,0.25,0.5,-4,0.62,4.0,2.0,7
Hamilton,8,2,1,5,6,13,-7,7,scotland2,0.25,0.38,-7,0.75,4.0,2.63,8
Queens Park,8,1,1,6,9,15,-6,4,scotland2,0.12,0.25,-6,1.12,8.33,4.0,9
Arbroath,8,6,1,1,17,7,10,19,scotland3,0.75,0.88,10,2.12,1.33,1.14,1
Cove Rangers,8,5,2,1,18,9,9,17,scotland3,0.62,0.88,9,2.25,1.61,1.14,2
Stenhousemuir,8,5,1,2,13,10,3,16,scotland3,0.62,0.75,3,1.62,1.61,1.33,3
Inverness,8,5,1,2,10,7,3,16,scotland3,0.62,0.75,3,1.25,1.61,1.33,3
Alloa Athletic,8,3,2,3,16,15,1,11,scotland3,0.38,0.62,1,2.0,2.63,1.61,4
Annan Athletic,8,3,1,4,12,16,-4,10,scotland3,0.38,0.5,-4,1.5,2.63,2.0,5
Queen of South,8,3,0,5,11,13,-2,9,scotland3,0.38,0.38,-2,1.38,2.63,2.63,6
Montrose,8,1,5,2,9,14,-5,8,scotland3,0.12,0.75,-5,1.12,8.33,1.33,7
Kelty Hearts,8,1,2,5,3,12,-9,5,scotland3,0.12,0.38,-9,0.38,8.33,2.63,8
Dumbarton,8,0,2,6,8,15,-7,2,scotland3,0.0,0.25,-7,1.0,0.0,4.0,9
Stranraer,8,5,1,2,11,4,7,16,scotland4,0.62,0.75,7,1.38,1.61,1.33,1
Edinburgh City,8,5,0,3,14,11,3,15,scotland4,0.62,0.62,3,1.75,1.61,1.61,2
Spartans,8,4,2,2,10,8,2,14,scotland4,0.5,0.75,2,1.25,2.0,1.33,3
Peterhead,8,3,4,1,12,8,4,13,scotland4,0.38,0.88,4,1.5,2.63,1.14,4
East Fife,8,3,2,3,8,8,0,11,scotland4,0.38,0.62,0,1.0,2.63,1.61,5
Stirling Albion,8,3,2,3,12,13,-1,11,scotland4,0.38,0.62,-1,1.5,2.63,1.61,5
Forfar Athletic,8,3,1,4,7,9,-2,10,scotland4,0.38,0.5,-2,0.88,2.63,2.0,6
Clyde,8,2,2,4,7,10,-3,8,scotland4,0.25,0.5,-3,0.88,4.0,2.0,7
Elgin City,8,2,0,6,7,11,-4,6,scotland4,0.25,0.25,-4,0.88,4.0,4.0,8
Bonnyrigg Rose,8,1,2,5,8,16,-8,5,scotland4,0.12,0.38,-8,1.0,8.33,2.63,9
Red Star,8,7,1,0,30,7,23,22,serbia,0.88,1.0,23,3.75,1.14,1.0,1
Partizan,8,5,3,0,19,9,10,18,serbia,0.62,1.0,10,2.38,1.61,1.0,2
Radnicki 1923,8,4,2,2,10,12,-2,14,serbia,0.5,0.75,-2,1.25,2.0,1.33,3
Novi Pazar,8,4,1,3,13,11,2,13,serbia,0.5,0.62,2,1.62,2.0,1.61,4
IMT N. Beograd,8,4,1,3,10,11,-1,13,serbia,0.5,0.62,-1,1.25,2.0,1.61,4
Vojvodina,8,3,3,2,11,9,2,12,serbia,0.38,0.75,2,1.38,2.63,1.33,5
S. Subotica,8,3,3,2,9,8,1,12,serbia,0.38,0.75,1,1.12,2.63,1.33,5
Z. Pancevo,8,2,5,1,9,7,2,11,serbia,0.25,0.88,2,1.12,4.0,1.14,6
Napredak,8,3,2,3,8,10,-2,11,serbia,0.38,0.62,-2,1.0,2.63,1.61,6
Cukaricki,8,2,3,3,8,11,-3,9,serbia,0.25,0.62,-3,1.0,4.0,1.61,7
Backa Topola,8,3,0,5,12,16,-4,9,serbia,0.38,0.38,-4,1.5,2.63,2.63,7
Mladost Lucani,8,2,2,4,7,11,-4,8,serbia,0.25,0.5,-4,0.88,4.0,2.0,8
OFK Beograd,8,2,2,4,8,13,-5,8,serbia,0.25,0.5,-5,1.0,4.0,2.0,8
Jedinstvo U.,8,2,1,5,10,10,0,7,serbia,0.25,0.38,0,1.25,4.0,2.63,9
Tekstilac Odzac,8,2,1,5,8,15,-7,7,serbia,0.25,0.38,-7,1.0,4.0,2.63,9
Radnicki Nis,8,1,2,5,6,15,-9,5,serbia,0.12,0.38,-9,0.75,8.33,2.63,10
R. Surdulica,8,6,1,1,14,3,11,19,serbia2,0.75,0.88,11,1.75,1.33,1.14,1
Javor Ivanjica,8,5,3,0,11,4,7,18,serbia2,0.62,1.0,7,1.38,1.61,1.0,2
Zemun,8,4,4,0,16,6,10,16,serbia2,0.5,1.0,10,2.0,2.0,1.0,3
Mladost,8,4,2,2,6,6,0,14,serbia2,0.5,0.75,0,0.75,2.0,1.33,4
Vozdovac,8,3,4,1,6,3,3,13,serbia2,0.38,0.88,3,0.75,2.63,1.14,5
Trajal Krusevac,8,3,2,3,8,10,-2,11,serbia2,0.38,0.62,-2,1.0,2.63,1.61,6
Macva Sabac,8,2,4,2,7,6,1,10,serbia2,0.25,0.75,1,0.88,4.0,1.33,7
Borac Cacak,8,3,1,4,8,9,-1,10,serbia2,0.38,0.5,-1,1.0,2.63,2.0,7
Graficar,8,2,4,2,8,10,-2,10,serbia2,0.25,0.75,-2,1.0,4.0,1.33,7
Smederevo,8,1,6,1,6,9,-3,9,serbia2,0.12,0.88,-3,0.75,8.33,1.14,8
Sloven Ruma,8,1,5,2,7,7,0,8,serbia2,0.12,0.75,0,0.88,8.33,1.33,9
Vrsac,8,2,2,4,4,6,-2,8,serbia2,0.25,0.5,-2,0.5,4.0,2.0,9
Dubocica,8,2,2,4,9,13,-4,8,serbia2,0.25,0.5,-4,1.12,4.0,2.0,9
S. Mitrovica,8,2,2,4,6,11,-5,8,serbia2,0.25,0.5,-5,0.75,4.0,2.0,9
Indija,8,1,3,4,6,10,-4,6,serbia2,0.12,0.5,-4,0.75,8.33,2.0,10
Sloboda Uzice,8,0,4,4,4,8,-4,4,serbia2,0.0,0.5,-4,0.5,0.0,2.0,11
Lion City,8,7,1,0,26,7,19,22,singapore,0.88,1.0,19,3.25,1.14,1.0,1
Tampines Rovers,8,6,0,2,23,7,16,18,singapore,0.75,0.75,16,2.88,1.33,1.33,2
Geylang,8,4,1,3,19,12,7,13,singapore,0.5,0.62,7,2.38,2.0,1.61,3
A. Niigata (S),8,4,1,3,12,16,-4,13,singapore,0.5,0.62,-4,1.5,2.0,1.61,3
Hougang,8,3,2,3,21,14,7,11,singapore,0.38,0.62,7,2.62,2.63,1.61,4
Young Lions,8,2,3,3,12,17,-5,9,singapore,0.25,0.62,-5,1.5,4.0,1.61,5
Khalsa,8,3,0,5,17,23,-6,9,singapore,0.38,0.38,-6,2.12,2.63,2.63,5
DPMM FC,8,2,1,5,10,17,-7,7,singapore,0.25,0.38,-7,1.25,4.0,2.63,6
Tanjong Pagar,8,1,1,6,6,28,-22,4,singapore,0.12,0.25,-22,0.75,8.33,4.0,7
Spartak Trnava,8,5,3,0,13,4,9,18,slovakia,0.62,1.0,9,1.62,1.61,1.0,1
S. Bratislava,8,4,2,2,19,9,10,14,slovakia,0.5,0.75,10,2.38,2.0,1.33,2
Podbrezova,8,3,5,0,11,6,5,14,slovakia,0.38,1.0,5,1.38,2.63,1.0,2
DAC Streda,8,3,4,1,16,10,6,13,slovakia,0.38,0.88,6,2.0,2.63,1.14,3
Skalica,8,3,4,1,6,4,2,13,slovakia,0.38,0.88,2,0.75,2.63,1.14,3
Komarno,8,3,3,2,7,9,-2,12,slovakia,0.38,0.75,-2,0.88,2.63,1.33,4
FC Kosice,8,3,2,3,14,10,4,11,slovakia,0.38,0.62,4,1.75,2.63,1.61,5
Z. Michalovce,8,2,4,2,10,10,0,10,slovakia,0.25,0.75,0,1.25,4.0,1.33,6
Trencin,8,2,4,2,9,9,0,10,slovakia,0.25,0.75,0,1.12,4.0,1.33,6
Zilina,8,2,3,3,6,9,-3,9,slovakia,0.25,0.62,-3,0.75,4.0,1.61,7
Ruzomberok,8,1,0,7,4,17,-13,3,slovakia,0.12,0.12,-13,0.5,8.33,8.33,8
Banska Bystrica,8,0,0,8,3,21,-18,0,slovakia,0.0,0.0,-18,0.38,0.0,0.0,9
Presov,8,7,1,0,17,5,12,22,slovakia2,0.88,1.0,12,2.12,1.14,1.0,1
Zlate Moravce,8,5,2,1,11,3,8,17,slovakia2,0.62,0.88,8,1.38,1.61,1.14,2
L. Mikulas,8,5,2,1,16,10,6,17,slovakia2,0.62,0.88,6,2.0,1.61,1.14,2
Malzenice,8,4,1,3,12,9,3,13,slovakia2,0.5,0.62,3,1.5,2.0,1.61,3
P. Bystrica,8,4,1,3,13,12,1,13,slovakia2,0.5,0.62,1,1.62,2.0,1.61,3
S. Bratislava B,8,4,0,4,9,9,0,12,slovakia2,0.5,0.5,0,1.12,2.0,2.0,4
Puchov,8,3,2,3,13,13,0,11,slovakia2,0.38,0.62,0,1.62,2.63,1.61,5
Zvolen,8,3,1,4,5,12,-7,10,slovakia2,0.38,0.5,-7,0.62,2.63,2.0,6
Petrzalka,8,3,0,5,9,8,1,9,slovakia2,0.38,0.38,1,1.12,2.63,2.63,7
Pohronie,8,3,0,5,10,15,-5,9,slovakia2,0.38,0.38,-5,1.25,2.63,2.63,7
Humenne,8,3,0,5,6,15,-9,9,slovakia2,0.38,0.38,-9,0.75,2.63,2.63,7
S. Lubovna,8,2,2,4,11,9,2,8,slovakia2,0.25,0.5,2,1.38,4.0,2.0,8
Zilina B,8,2,1,5,12,13,-1,7,slovakia2,0.25,0.38,-1,1.5,4.0,2.63,9
Samorin,8,1,0,7,10,21,-11,3,slovakia2,0.12,0.12,-11,1.25,8.33,8.33,10
NK Olimpija,8,6,0,2,18,6,12,18,slovenia,0.75,0.75,12,2.25,1.33,1.33,1
Maribor,8,6,0,2,18,7,11,18,slovenia,0.75,0.75,11,2.25,1.33,1.33,1
Bravo,8,4,3,1,14,11,3,15,slovenia,0.5,0.88,3,1.75,2.0,1.14,2
Koper,8,3,3,2,12,10,2,12,slovenia,0.38,0.75,2,1.5,2.63,1.33,3
Mura,8,3,3,2,8,6,2,12,slovenia,0.38,0.75,2,1.0,2.63,1.33,3
Nafta,8,2,4,2,8,13,-5,10,slovenia,0.25,0.75,-5,1.0,4.0,1.33,4
NK Celje,8,1,4,3,16,12,4,7,slovenia,0.12,0.62,4,2.0,8.33,1.61,5
Domzale,8,2,1,5,11,13,-2,7,slovenia,0.25,0.38,-2,1.38,4.0,2.63,5
Primorje,8,1,3,4,9,18,-9,6,slovenia,0.12,0.5,-9,1.12,8.33,2.0,6
Radomlje,8,2,0,6,6,22,-16,6,slovenia,0.25,0.25,-16,0.75,4.0,4.0,6
Mamelodi S.,8,6,1,1,19,7,12,19,southafrica,0.75,0.88,12,2.38,1.33,1.14,1
TS Galaxy,8,5,1,2,13,10,3,16,southafrica,0.62,0.75,3,1.62,1.61,1.33,2
Magesi,8,5,0,3,7,6,1,15,southafrica,0.62,0.62,1,0.88,1.61,1.61,3
Stellenbosch,8,3,4,1,9,7,2,13,southafrica,0.38,0.88,2,1.12,2.63,1.14,4
Orlando Pirates,8,4,1,3,7,9,-2,13,southafrica,0.5,0.62,-2,0.88,2.0,1.61,4
Richards Bay,8,3,3,2,8,6,2,12,southafrica,0.38,0.75,2,1.0,2.63,1.33,5
AmaZulu,8,3,2,3,12,10,2,11,southafrica,0.38,0.62,2,1.5,2.63,1.61,6
Sekhukhune,8,3,2,3,13,13,0,11,southafrica,0.38,0.62,0,1.62,2.63,1.61,6
Kaizer Chiefs,8,3,2,3,6,8,-2,11,southafrica,0.38,0.62,-2,0.75,2.63,1.61,6
Chippa Utd,8,3,1,4,8,5,3,10,southafrica,0.38,0.5,3,1.0,2.63,2.0,7
Golden Arrows,8,2,3,3,5,10,-5,9,southafrica,0.25,0.62,-5,0.62,4.0,1.61,8
Marumo G.,8,2,1,5,6,10,-4,7,southafrica,0.25,0.38,-4,0.75,4.0,2.63,9
Polokwane,8,1,3,4,2,7,-5,6,southafrica,0.12,0.5,-5,0.25,8.33,2.0,10
Royal AM,8,1,2,5,9,13,-4,5,southafrica,0.12,0.38,-4,1.12,8.33,2.63,11
SuperSport Utd,8,1,2,5,7,12,-5,5,southafrica,0.12,0.38,-5,0.88,8.33,2.63,11
Cape Town City,8,0,3,5,3,11,-8,3,southafrica,0.0,0.38,-8,0.38,0.0,2.63,12
Kruger United,8,5,1,2,11,7,4,16,southafrica2,0.62,0.75,4,1.38,1.61,1.33,1
Venda FC,8,4,2,2,12,4,8,14,southafrica2,0.5,0.75,8,1.5,2.0,1.33,2
Casric Stars,8,4,2,2,12,6,6,14,southafrica2,0.5,0.75,6,1.5,2.0,1.33,2
Durban City,8,4,2,2,9,6,3,14,southafrica2,0.5,0.75,3,1.12,2.0,1.33,2
Cape Town Spurs,8,3,3,2,10,10,0,12,southafrica2,0.38,0.75,0,1.25,2.63,1.33,3
Black Leopards,8,3,2,3,10,9,1,11,southafrica2,0.38,0.62,1,1.25,2.63,1.61,4
Orbit College,8,2,5,1,6,5,1,11,southafrica2,0.25,0.88,1,0.75,4.0,1.14,4
Pretoria C.,8,3,2,3,8,9,-1,11,southafrica2,0.38,0.62,-1,1.0,2.63,1.61,4
JDR Stars,8,2,4,2,9,12,-3,10,southafrica2,0.25,0.75,-3,1.12,4.0,1.33,5
Highbury,8,2,3,3,10,8,2,9,southafrica2,0.25,0.62,2,1.25,4.0,1.61,6
Pretoria U.,8,2,3,3,6,8,-2,9,southafrica2,0.25,0.62,-2,0.75,4.0,1.61,6
Upington City,8,2,3,3,6,8,-2,9,southafrica2,0.25,0.62,-2,0.75,4.0,1.61,6
Leruma United,8,2,3,3,4,6,-2,9,southafrica2,0.25,0.62,-2,0.5,4.0,1.61,6
Hungry Lions,8,2,2,4,11,12,-1,8,southafrica2,0.25,0.5,-1,1.38,4.0,2.0,7
Milford,8,2,2,4,8,14,-6,8,southafrica2,0.25,0.5,-6,1.0,4.0,2.0,7
Baroka,8,1,4,3,8,15,-7,7,southafrica2,0.12,0.62,-7,1.0,8.33,1.61,8
Daejeon Citizen,5,4,0,1,9,4,5,12,southkorea,0.8,0.8,5,1.8,1.25,1.25,1
Ulsan,5,3,1,1,6,2,4,10,southkorea,0.6,0.8,4,1.2,1.67,1.25,2
Seoul,5,2,2,1,3,3,0,8,southkorea,0.4,0.8,0,0.6,2.5,1.25,3
Gimcheon Sangmu,4,2,1,1,7,5,2,7,southkorea,0.5,0.75,2,1.75,2.0,1.33,4
Daegu,5,2,1,2,6,5,1,7,southkorea,0.4,0.6,1,1.2,2.5,1.67,4
Gangwon,5,2,1,2,4,4,0,7,southkorea,0.4,0.6,0,0.8,2.5,1.67,4
Anyang,5,2,0,3,5,7,-2,6,southkorea,0.4,0.4,-2,1.0,2.5,2.5,5
Gwangju,3,1,2,0,4,3,1,5,southkorea,0.33,1.0,1,1.33,3.03,1.0,6
Jeonbuk Motors,4,1,1,2,4,5,-1,4,southkorea,0.25,0.5,-1,1.0,4.0,2.0,7
Jeju Utd,5,1,1,3,5,8,-3,4,southkorea,0.2,0.4,-3,1.0,5.0,2.5,7
Suwon City,5,0,3,2,2,5,-3,3,southkorea,0.0,0.6,-3,0.4,0.0,1.67,8
Pohang Steelers,3,0,1,2,1,5,-4,1,southkorea,0.0,0.33,-4,0.33,0.0,3.03,9
Incheon Utd,4,3,0,1,6,2,4,9,southkorea2,0.75,0.75,4,1.5,1.33,1.33,1
Jeonnam,4,2,2,0,6,3,3,8,southkorea2,0.5,1.0,3,1.5,2.0,1.0,2
Seongnam,4,2,2,0,5,2,3,8,southkorea2,0.5,1.0,3,1.25,2.0,1.0,2
Seoul E-Land,4,2,1,1,7,5,2,7,southkorea2,0.5,0.75,2,1.75,2.0,1.33,3
Busan IPark,4,2,1,1,4,2,2,7,southkorea2,0.5,0.75,2,1.0,2.0,1.33,3
Bucheon FC,3,2,0,1,5,4,1,6,southkorea2,0.67,0.67,1,1.67,1.49,1.49,4
Gimpo,4,1,2,1,4,3,1,5,southkorea2,0.25,0.75,1,1.0,4.0,1.33,5
Gyeongnam,4,1,2,1,4,5,-1,5,southkorea2,0.25,0.75,-1,1.0,4.0,1.33,5
Hwaseong,4,1,2,1,4,5,-1,5,southkorea2,0.25,0.75,-1,1.0,4.0,1.33,5
Cheongju,4,1,1,2,6,8,-2,4,southkorea2,0.25,0.5,-2,1.5,4.0,2.0,6
Suwon Bluewings,4,1,1,2,3,6,-3,4,southkorea2,0.25,0.5,-3,0.75,4.0,2.0,6
Cheonan City,4,1,0,3,3,6,-3,3,southkorea2,0.25,0.25,-3,0.75,4.0,4.0,7
Asan,4,0,2,2,2,4,-2,2,southkorea2,0.0,0.5,-2,0.5,0.0,2.0,8
Ansan Greeners,3,0,0,3,0,4,-4,0,southkorea2,0.0,0.0,-4,0.0,0.0,0.0,9
FC Barcelona,8,6,1,1,21,5,16,19,spain,0.75,0.88,16,2.62,1.33,1.14,1
Real Betis,8,5,1,2,14,10,4,16,spain,0.62,0.75,4,1.75,1.61,1.33,2
Celta Vigo,8,4,3,1,12,9,3,15,spain,0.5,0.88,3,1.5,2.0,1.14,3
Villarreal,8,4,2,2,15,7,8,14,spain,0.5,0.75,8,1.88,2.0,1.33,4
Real Madrid,8,4,2,2,12,7,5,14,spain,0.5,0.75,5,1.5,2.0,1.33,4
Getafe,8,4,2,2,10,6,4,14,spain,0.5,0.75,4,1.25,2.0,1.33,4
Athletic Bilbao,8,3,4,1,16,7,9,13,spain,0.38,0.88,9,2.0,2.63,1.14,5
Sevilla FC,8,3,4,1,11,8,3,13,spain,0.38,0.88,3,1.38,2.63,1.14,5
Atletico Madrid,8,3,3,2,10,6,4,12,spain,0.38,0.75,4,1.25,2.63,1.33,6
Espanyol,8,3,3,2,9,8,1,12,spain,0.38,0.75,1,1.12,2.63,1.33,6
Valencia,8,3,3,2,12,17,-5,12,spain,0.38,0.75,-5,1.5,2.63,1.33,6
Rayo Vallecano,8,3,2,3,7,7,0,11,spain,0.38,0.62,0,0.88,2.63,1.61,7
Mallorca,8,2,4,2,9,9,0,10,spain,0.25,0.75,0,1.12,4.0,1.33,8
Osasuna,8,1,5,2,9,10,-1,8,spain,0.12,0.75,-1,1.12,8.33,1.33,9
Leganes,8,2,2,4,6,11,-5,8,spain,0.25,0.5,-5,0.75,4.0,2.0,9
Alaves,8,1,4,3,8,10,-2,7,spain,0.12,0.62,-2,1.0,8.33,1.61,10
Girona,8,1,3,4,8,14,-6,6,spain,0.12,0.5,-6,1.0,8.33,2.0,11
Real Sociedad,8,2,0,6,6,15,-9,6,spain,0.25,0.25,-9,0.75,4.0,4.0,11
Las Palmas,8,0,3,5,7,14,-7,3,spain,0.0,0.38,-7,0.88,0.0,2.63,12
Valladolid,8,0,1,7,4,24,-20,1,spain,0.0,0.12,-20,0.5,0.0,8.33,13
Cadiz,8,5,2,1,17,9,8,17,spain2,0.62,0.88,8,2.12,1.61,1.14,1
Levante,8,5,2,1,12,5,7,17,spain2,0.62,0.88,7,1.5,1.61,1.14,1
Mirandes,8,5,1,2,14,7,7,16,spain2,0.62,0.75,7,1.75,1.61,1.33,2
Huesca,8,4,3,1,11,5,6,15,spain2,0.5,0.88,6,1.38,2.0,1.14,3
Burgos,8,5,0,3,8,7,1,15,spain2,0.62,0.62,1,1.0,1.61,1.61,3
Racing,8,4,2,2,18,10,8,14,spain2,0.5,0.75,8,2.25,2.0,1.33,4
Cordoba,8,4,2,2,14,8,6,14,spain2,0.5,0.75,6,1.75,2.0,1.33,4
Elche,8,4,2,2,11,9,2,14,spain2,0.5,0.75,2,1.38,2.0,1.33,4
Eldense,8,4,1,3,10,11,-1,13,spain2,0.5,0.62,-1,1.25,2.0,1.61,5
Albacete,8,4,0,4,10,8,2,12,spain2,0.5,0.5,2,1.25,2.0,2.0,6
Granada,8,3,3,2,13,12,1,12,spain2,0.38,0.75,1,1.62,2.63,1.33,6
Deportivo,8,3,3,2,8,7,1,12,spain2,0.38,0.75,1,1.0,2.63,1.33,6
Real Oviedo,8,3,3,2,7,6,1,12,spain2,0.38,0.75,1,0.88,2.63,1.33,6
Castellon,8,3,1,4,9,9,0,10,spain2,0.38,0.5,0,1.12,2.63,2.0,7
Sporting Gijon,8,1,6,1,7,7,0,9,spain2,0.12,0.88,0,0.88,8.33,1.14,8
Eibar,8,2,3,3,5,7,-2,9,spain2,0.25,0.62,-2,0.62,4.0,1.61,8
Malaga,8,2,2,4,7,11,-4,8,spain2,0.25,0.5,-4,0.88,4.0,2.0,9
Almeria,8,1,4,3,11,12,-1,7,spain2,0.12,0.62,-1,1.38,8.33,1.61,10
Tenerife,8,2,1,5,7,10,-3,7,spain2,0.25,0.38,-3,0.88,4.0,2.63,10
Real Zaragoza,8,1,3,4,9,15,-6,6,spain2,0.12,0.5,-6,1.12,8.33,2.0,11
Racing Ferrol,8,1,1,6,4,15,-11,4,spain2,0.12,0.25,-11,0.5,8.33,4.0,12
Cartagena,8,0,0,8,3,19,-16,0,spain2,0.0,0.0,-16,0.38,0.0,0.0,13
Athletic B. B,8,5,2,1,13,6,7,17,spain3,0.62,0.88,7,1.62,1.61,1.14,1
Leonesa,8,4,4,0,17,10,7,16,spain3,0.5,1.0,7,2.12,2.0,1.0,2
Real Union,8,5,0,3,13,6,7,15,spain3,0.62,0.62,7,1.62,1.61,1.61,3
Ponferradina,8,4,2,2,11,6,5,14,spain3,0.5,0.75,5,1.38,2.0,1.33,4
FC Andorra,8,4,1,3,10,9,1,13,spain3,0.5,0.62,1,1.25,2.0,1.61,5
Real Sociedad B,8,3,3,2,9,6,3,12,spain3,0.38,0.75,3,1.12,2.63,1.33,6
Ourense CF,8,3,3,2,8,7,1,12,spain3,0.38,0.75,1,1.0,2.63,1.33,6
Tarazona,8,3,3,2,7,6,1,12,spain3,0.38,0.75,1,0.88,2.63,1.33,6
Gimnastic T.,8,3,3,2,8,8,0,12,spain3,0.38,0.75,0,1.0,2.63,1.33,6
Amorebieta,8,3,2,3,11,8,3,11,spain3,0.38,0.62,3,1.38,2.63,1.61,7
Osasuna B,8,2,5,1,12,10,2,11,spain3,0.25,0.88,2,1.5,4.0,1.14,7
Zamora,8,3,2,3,7,8,-1,11,spain3,0.38,0.62,-1,0.88,2.63,1.61,7
Unionistas,8,3,1,4,14,15,-1,10,spain3,0.38,0.5,-1,1.75,2.63,2.0,8
Barakaldo,8,3,1,4,11,12,-1,10,spain3,0.38,0.5,-1,1.38,2.63,2.0,8
Lugo,8,3,1,4,13,16,-3,10,spain3,0.38,0.5,-3,1.62,2.63,2.0,8
Sestao River,8,1,5,2,7,9,-2,8,spain3,0.12,0.75,-2,0.88,8.33,1.33,9
Arenteiro,8,2,2,4,8,12,-4,8,spain3,0.25,0.5,-4,1.0,4.0,2.0,9
Celta Vigo B,8,1,2,5,5,11,-6,5,spain3,0.12,0.38,-6,0.62,8.33,2.63,10
Gimnastica,8,1,1,6,7,21,-14,4,spain3,0.12,0.25,-14,0.88,8.33,4.0,11
FC Barcelona B,8,0,3,5,8,16,-8,3,spain3,0.0,0.38,-8,1.0,0.0,2.63,12
UD Ibiza,8,7,0,1,21,9,12,21,spain4,0.88,0.88,12,2.62,1.14,1.14,1
Sevilla FC B,8,6,1,1,9,2,7,19,spain4,0.75,0.88,7,1.12,1.33,1.14,2
Ceuta,8,5,3,0,14,5,9,18,spain4,0.62,1.0,9,1.75,1.61,1.0,3
Real Madrid B,8,3,5,0,13,7,6,14,spain4,0.38,1.0,6,1.62,2.63,1.0,4
Atletico M. B,8,4,2,2,10,8,2,14,spain4,0.5,0.75,2,1.25,2.0,1.33,4
Real Murcia,8,4,0,4,11,9,2,12,spain4,0.5,0.5,2,1.38,2.0,2.0,5
Villarreal B,8,3,2,3,14,9,5,11,spain4,0.38,0.62,5,1.75,2.63,1.61,6
Fuenlabrada,8,3,2,3,14,12,2,11,spain4,0.38,0.62,2,1.75,2.63,1.61,6
Hercules,8,3,2,3,9,9,0,11,spain4,0.38,0.62,0,1.12,2.63,1.61,6
Antequera,8,2,4,2,12,13,-1,10,spain4,0.25,0.75,-1,1.5,4.0,1.33,7
Recreativo H.,8,2,4,2,8,9,-1,10,spain4,0.25,0.75,-1,1.0,4.0,1.33,7
Merida,8,3,1,4,12,17,-5,10,spain4,0.38,0.5,-5,1.5,2.63,2.0,7
Intercity,8,2,3,3,8,10,-2,9,spain4,0.25,0.62,-2,1.0,4.0,1.61,8
Real Betis B,8,2,3,3,8,15,-7,9,spain4,0.25,0.62,-7,1.0,4.0,1.61,8
Alcorcon,8,2,2,4,7,7,0,8,spain4,0.25,0.5,0,0.88,4.0,2.0,9
Sanluqueno,8,2,2,4,9,13,-4,8,spain4,0.25,0.5,-4,1.12,4.0,2.0,9
Yeclano,8,1,4,3,8,9,-1,7,spain4,0.12,0.62,-1,1.0,8.33,1.61,10
Marbella,8,1,3,4,8,13,-5,6,spain4,0.12,0.5,-5,1.0,8.33,2.0,11
Alcoyano,8,1,3,4,2,9,-7,6,spain4,0.12,0.5,-7,0.25,8.33,2.0,11
Algeciras,8,1,2,5,4,14,-10,5,spain4,0.12,0.38,-10,0.5,8.33,2.63,12
Llanera,8,4,3,1,11,6,5,15,spain5,0.5,0.88,5,1.38,2.0,1.14,1
Numancia,8,4,3,1,9,4,5,15,spain5,0.5,0.88,5,1.12,2.0,1.14,1
Real Aviles,8,3,5,0,13,7,6,14,spain5,0.38,1.0,6,1.62,2.63,1.0,2
Real Avila,8,4,2,2,8,3,5,14,spain5,0.5,0.75,5,1.0,2.0,1.33,2
Pontevedra,8,4,2,2,10,7,3,14,spain5,0.5,0.75,3,1.25,2.0,1.33,2
Rayo Cantabria,8,4,1,3,9,11,-2,13,spain5,0.5,0.62,-2,1.12,2.0,1.61,3
Bergantinos,8,4,0,4,6,7,-1,12,spain5,0.5,0.5,-1,0.75,2.0,2.0,4
D. Fabril,8,3,2,3,7,4,3,11,spain5,0.38,0.62,3,0.88,2.63,1.61,5
Langreo,8,3,2,3,5,7,-2,11,spain5,0.38,0.62,-2,0.62,2.63,1.61,5
Salamanca CF,8,3,1,4,11,11,0,10,spain5,0.38,0.5,0,1.38,2.63,2.0,6
Valladolid B,8,2,4,2,9,9,0,10,spain5,0.25,0.75,0,1.12,4.0,1.33,6
Marino de L.,8,2,3,3,7,6,1,9,spain5,0.25,0.62,1,0.88,4.0,1.61,7
Escobedo,8,2,3,3,2,4,-2,9,spain5,0.25,0.62,-2,0.25,4.0,1.61,7
Coruxo,8,2,2,4,3,8,-5,8,spain5,0.25,0.5,-5,0.38,4.0,2.0,8
Laredo,8,1,4,3,7,11,-4,7,spain5,0.12,0.62,-4,0.88,8.33,1.61,9
Torrelavega,8,1,4,3,3,7,-4,7,spain5,0.12,0.62,-4,0.38,8.33,1.61,9
Guijuelo,8,1,4,3,5,10,-5,7,spain5,0.12,0.62,-5,0.62,8.33,1.61,9
Compostela,8,1,3,4,10,14,-4,6,spain5,0.12,0.5,-4,1.25,8.33,2.0,10
Teruel,8,6,2,0,14,3,11,20,spain6,0.75,1.0,11,1.75,1.33,1.0,1
Eibar B,8,6,0,2,13,2,11,18,spain6,0.75,0.75,11,1.62,1.33,1.33,2
SD Logrones,8,6,0,2,17,9,8,18,spain6,0.75,0.75,8,2.12,1.33,1.33,2
Ejea,8,5,3,0,10,3,7,18,spain6,0.62,1.0,7,1.25,1.61,1.0,2
Utebo,8,4,3,1,11,4,7,15,spain6,0.5,0.88,7,1.38,2.0,1.14,3
Alaves B,8,3,2,3,7,7,0,11,spain6,0.38,0.62,0,0.88,2.63,1.61,4
Gernika,8,3,2,3,9,12,-3,11,spain6,0.38,0.62,-3,1.12,2.63,1.61,4
Arenas Club,8,3,1,4,8,8,0,10,spain6,0.38,0.5,0,1.0,2.63,2.0,5
Alfaro,8,2,4,2,7,8,-1,10,spain6,0.25,0.75,-1,0.88,4.0,1.33,5
Subiza,8,3,1,4,10,13,-3,10,spain6,0.38,0.5,-3,1.25,2.63,2.0,5
Anguiano,8,3,1,4,9,14,-5,10,spain6,0.38,0.5,-5,1.12,2.63,2.0,5
Real Zaragoza B,8,3,0,5,7,10,-3,9,spain6,0.38,0.38,-3,0.88,2.63,2.63,6
UD Logrones,8,1,5,2,8,8,0,8,spain6,0.12,0.75,0,1.0,8.33,1.33,7
Tudelano,8,2,2,4,9,12,-3,8,spain6,0.25,0.5,-3,1.12,4.0,2.0,7
Barbastro,8,2,2,4,8,11,-3,8,spain6,0.25,0.5,-3,1.0,4.0,2.0,7
Real Sociedad C,8,2,1,5,8,11,-3,7,spain6,0.25,0.38,-3,1.0,4.0,2.63,8
Calahorra,8,1,4,3,5,10,-5,7,spain6,0.12,0.62,-5,0.62,8.33,1.61,8
Izarra,8,0,1,7,2,16,-14,1,spain6,0.0,0.12,-14,0.25,0.0,8.33,9
Europa,8,5,2,1,11,6,5,17,spain7,0.62,0.88,5,1.38,1.61,1.14,1
Sant Andreu,8,4,4,0,16,4,12,16,spain7,0.5,1.0,12,2.0,2.0,1.0,2
Torrent,8,4,4,0,10,5,5,16,spain7,0.5,1.0,5,1.25,2.0,1.0,2
Elche B,8,4,2,2,12,6,6,14,spain7,0.5,0.75,6,1.5,2.0,1.33,3
A. Baleares,8,3,5,0,8,4,4,14,spain7,0.38,1.0,4,1.0,2.63,1.0,3
Valencia B,8,4,2,2,8,4,4,14,spain7,0.5,0.75,4,1.0,2.0,1.33,3
Andratx,8,4,2,2,10,11,-1,14,spain7,0.5,0.75,-1,1.25,2.0,1.33,3
Espanyol B,8,3,4,1,13,8,5,13,spain7,0.38,0.88,5,1.62,2.63,1.14,4
SD Ibiza,8,3,3,2,9,8,1,12,spain7,0.38,0.75,1,1.12,2.63,1.33,5
Terrassa,8,3,2,3,6,5,1,11,spain7,0.38,0.62,1,0.75,2.63,1.61,6
Lleida,8,1,7,0,10,7,3,10,spain7,0.12,1.0,3,1.25,8.33,1.0,7
Olot,8,2,3,3,6,9,-3,9,spain7,0.25,0.62,-3,0.75,4.0,1.61,8
Sabadell,8,2,3,3,7,11,-4,9,spain7,0.25,0.62,-4,0.88,4.0,1.61,8
Cornella,8,1,4,3,9,14,-5,7,spain7,0.12,0.62,-5,1.12,8.33,1.61,9
Pena Deportiva,8,1,3,4,7,11,-4,6,spain7,0.12,0.5,-4,0.88,8.33,2.0,10
Badalona,8,1,1,6,4,14,-10,4,spain7,0.12,0.25,-10,0.5,8.33,4.0,11
Alzira,8,0,2,6,9,20,-11,2,spain7,0.0,0.25,-11,1.12,0.0,4.0,12
Mallorca B,8,0,1,7,5,14,-9,1,spain7,0.0,0.12,-9,0.62,0.0,8.33,13
La Union,8,6,1,1,10,2,8,19,spain8,0.75,0.88,8,1.25,1.33,1.14,1
Torremolinos,8,5,3,0,10,4,6,18,spain8,0.62,1.0,6,1.25,1.61,1.0,2
Linares,8,4,3,1,12,6,6,15,spain8,0.5,0.88,6,1.5,2.0,1.14,3
Aguilas CF,8,4,3,1,11,8,3,15,spain8,0.5,0.88,3,1.38,2.0,1.14,3
Antoniano,8,4,2,2,11,10,1,14,spain8,0.5,0.75,1,1.38,2.0,1.33,4
CD Estepona,8,3,4,1,12,6,6,13,spain8,0.38,0.88,6,1.5,2.63,1.14,5
UCAM Murcia,8,3,4,1,9,4,5,13,spain8,0.38,0.88,5,1.12,2.63,1.14,5
Almeria B,8,4,1,3,8,7,1,13,spain8,0.5,0.62,1,1.0,2.0,1.61,5
San Fernando,8,2,6,0,12,8,4,12,spain8,0.25,1.0,4,1.5,4.0,1.0,6
Orihuela,8,3,3,2,5,4,1,12,spain8,0.38,0.75,1,0.62,2.63,1.33,6
Xerez CD,8,2,3,3,6,6,0,9,spain8,0.25,0.62,0,0.75,4.0,1.61,7
Cadiz B,8,2,3,3,7,12,-5,9,spain8,0.25,0.62,-5,0.88,4.0,1.61,7
D. Minera,8,2,2,4,7,11,-4,8,spain8,0.25,0.5,-4,0.88,4.0,2.0,8
Xerez D. FC,8,2,1,5,5,11,-6,7,spain8,0.25,0.38,-6,0.62,4.0,2.63,9
Villanovense,8,1,3,4,6,10,-4,6,spain8,0.12,0.5,-4,0.75,8.33,2.0,10
Granada B,8,1,2,5,7,12,-5,5,spain8,0.12,0.38,-5,0.88,8.33,2.63,11
Linense,8,1,2,5,6,11,-5,5,spain8,0.12,0.38,-5,0.75,8.33,2.63,11
Don Benito,8,0,3,5,4,11,-7,3,spain8,0.0,0.38,-7,0.5,0.0,2.63,12
CD Coria,8,6,1,1,16,10,6,19,spain9,0.75,0.88,6,2.0,1.33,1.14,1
Guadalajara,8,5,3,0,10,3,7,18,spain9,0.62,1.0,7,1.25,1.61,1.0,2
Talavera CF,8,4,4,0,17,7,10,16,spain9,0.5,1.0,10,2.12,2.0,1.0,3
Cacereno,8,5,1,2,10,6,4,16,spain9,0.62,0.75,4,1.25,1.61,1.33,3
Navalcarnero,8,5,1,2,9,6,3,16,spain9,0.62,0.75,3,1.12,1.61,1.33,3
R. Majadahonda,8,3,4,1,12,6,6,13,spain9,0.38,0.88,6,1.5,2.63,1.14,4
Conquense,8,4,0,4,8,7,1,12,spain9,0.5,0.5,1,1.0,2.0,2.0,5
CD Mostoles,8,4,0,4,10,10,0,12,spain9,0.5,0.5,0,1.25,2.0,2.0,5
Getafe B,8,3,2,3,9,10,-1,11,spain9,0.38,0.62,-1,1.12,2.63,1.61,6
S. Sebastian R.,8,3,2,3,9,12,-3,11,spain9,0.38,0.62,-3,1.12,2.63,1.61,6
Real Madrid C,8,2,4,2,8,9,-1,10,spain9,0.25,0.75,-1,1.0,4.0,1.33,7
Colonia M.,8,2,3,3,7,10,-3,9,spain9,0.25,0.62,-3,0.88,4.0,1.61,8
Atletico Paso,8,2,3,3,8,12,-4,9,spain9,0.25,0.62,-4,1.0,4.0,1.61,8
Tenerife B,8,2,1,5,11,16,-5,7,spain9,0.25,0.38,-5,1.38,4.0,2.63,9
Union Adarve,8,1,3,4,7,10,-3,6,spain9,0.12,0.5,-3,0.88,8.33,2.0,10
Melilla,8,1,3,4,6,9,-3,6,spain9,0.12,0.5,-3,0.75,8.33,2.0,10
Yaiza,8,1,2,5,6,10,-4,5,spain9,0.12,0.38,-4,0.75,8.33,2.63,11
Illescas,8,0,1,7,5,15,-10,1,spain9,0.0,0.12,-10,0.62,0.0,8.33,12
AIK,0,0,0,0,0,0,0,0,sweden,0.0,0.0,0,0.0,0.0,0.0,1
Brommapojkarna,0,0,0,0,0,0,0,0,sweden,0.0,0.0,0,0.0,0.0,0.0,1
Degerfors,0,0,0,0,0,0,0,0,sweden,0.0,0.0,0,0.0,0.0,0.0,1
Djurgarden,0,0,0,0,0,0,0,0,sweden,0.0,0.0,0,0.0,0.0,0.0,1
Elfsborg,0,0,0,0,0,0,0,0,sweden,0.0,0.0,0,0.0,0.0,0.0,1
GAIS,0,0,0,0,0,0,0,0,sweden,0.0,0.0,0,0.0,0.0,0.0,1
Hacken,0,0,0,0,0,0,0,0,sweden,0.0,0.0,0,0.0,0.0,0.0,1
Halmstad,0,0,0,0,0,0,0,0,sweden,0.0,0.0,0,0.0,0.0,0.0,1
Hammarby,0,0,0,0,0,0,0,0,sweden,0.0,0.0,0,0.0,0.0,0.0,1
IFK Goteborg,0,0,0,0,0,0,0,0,sweden,0.0,0.0,0,0.0,0.0,0.0,1
Malmo FF,0,0,0,0,0,0,0,0,sweden,0.0,0.0,0,0.0,0.0,0.0,1
Mjallby,0,0,0,0,0,0,0,0,sweden,0.0,0.0,0,0.0,0.0,0.0,1
Norrkoping,0,0,0,0,0,0,0,0,sweden,0.0,0.0,0,0.0,0.0,0.0,1
Oster,0,0,0,0,0,0,0,0,sweden,0.0,0.0,0,0.0,0.0,0.0,1
Sirius,0,0,0,0,0,0,0,0,sweden,0.0,0.0,0,0.0,0.0,0.0,1
Varnamo,0,0,0,0,0,0,0,0,sweden,0.0,0.0,0,0.0,0.0,0.0,1
Brage,0,0,0,0,0,0,0,0,sweden2,0.0,0.0,0,0.0,0.0,0.0,1
Falkenberg,0,0,0,0,0,0,0,0,sweden2,0.0,0.0,0,0.0,0.0,0.0,1
GIF Sundsvall,0,0,0,0,0,0,0,0,sweden2,0.0,0.0,0,0.0,0.0,0.0,1
Helsingborg,0,0,0,0,0,0,0,0,sweden2,0.0,0.0,0,0.0,0.0,0.0,1
Kalmar,0,0,0,0,0,0,0,0,sweden2,0.0,0.0,0,0.0,0.0,0.0,1
Landskrona,0,0,0,0,0,0,0,0,sweden2,0.0,0.0,0,0.0,0.0,0.0,1
Oddevold,0,0,0,0,0,0,0,0,sweden2,0.0,0.0,0,0.0,0.0,0.0,1
Orebro,0,0,0,0,0,0,0,0,sweden2,0.0,0.0,0,0.0,0.0,0.0,1
Orgryte,0,0,0,0,0,0,0,0,sweden2,0.0,0.0,0,0.0,0.0,0.0,1
Ostersunds,0,0,0,0,0,0,0,0,sweden2,0.0,0.0,0,0.0,0.0,0.0,1
Sandviken,0,0,0,0,0,0,0,0,sweden2,0.0,0.0,0,0.0,0.0,0.0,1
Trelleborg,0,0,0,0,0,0,0,0,sweden2,0.0,0.0,0,0.0,0.0,0.0,1
Umea,0,0,0,0,0,0,0,0,sweden2,0.0,0.0,0,0.0,0.0,0.0,1
Utsikten,0,0,0,0,0,0,0,0,sweden2,0.0,0.0,0,0.0,0.0,0.0,1
Varberg BoIS,0,0,0,0,0,0,0,0,sweden2,0.0,0.0,0,0.0,0.0,0.0,1
Vasteras,0,0,0,0,0,0,0,0,sweden2,0.0,0.0,0,0.0,0.0,0.0,1
Servette,8,5,2,1,17,11,6,17,switzerland,0.62,0.88,6,2.12,1.61,1.14,1
BSC Young Boys,8,5,1,2,17,5,12,16,switzerland,0.62,0.75,12,2.12,1.61,1.33,2
FC Basel,8,4,3,1,14,8,6,15,switzerland,0.5,0.88,6,1.75,2.0,1.14,3
Yverdon,8,4,1,3,14,17,-3,13,switzerland,0.5,0.62,-3,1.75,2.0,1.61,4
FC Zurich,8,4,0,4,13,11,2,12,switzerland,0.5,0.5,2,1.62,2.0,2.0,5
Luzern,8,3,2,3,13,13,0,11,switzerland,0.38,0.62,0,1.62,2.63,1.61,6
Lugano,8,3,1,4,11,13,-2,10,switzerland,0.38,0.5,-2,1.38,2.63,2.0,7
St. Gallen,8,3,1,4,9,14,-5,10,switzerland,0.38,0.5,-5,1.12,2.63,2.0,7
Lausanne Sport,8,2,3,3,12,12,0,9,switzerland,0.25,0.62,0,1.5,4.0,1.61,8
Grasshopper,8,1,5,2,9,11,-2,8,switzerland,0.12,0.75,-2,1.12,8.33,1.33,9
Sion,8,2,1,5,12,21,-9,7,switzerland,0.25,0.38,-9,1.5,4.0,2.63,10
Winterthur,8,2,0,6,11,16,-5,6,switzerland,0.25,0.25,-5,1.38,4.0,4.0,11
Bangkok Utd,8,6,2,0,15,7,8,20,thailand,0.75,1.0,8,1.88,1.33,1.0,1
Pathum Utd,8,6,1,1,14,4,10,19,thailand,0.75,0.88,10,1.75,1.33,1.14,2
Buriram Utd,8,5,1,2,27,7,20,16,thailand,0.62,0.75,20,3.38,1.61,1.33,3
Ratchaburi,8,4,3,1,16,8,8,15,thailand,0.5,0.88,8,2.0,2.0,1.14,4
Uthai Thani,8,4,2,2,12,5,7,14,thailand,0.5,0.75,7,1.5,2.0,1.33,5
Muang Thong Utd,8,4,0,4,13,11,2,12,thailand,0.5,0.5,2,1.62,2.0,2.0,6
Lamphun Warrior,8,3,3,2,6,5,1,12,thailand,0.38,0.75,1,0.75,2.63,1.33,6
Prachuap,8,3,1,4,12,11,1,10,thailand,0.38,0.5,1,1.5,2.63,2.0,7
N. Ratchasima,8,2,4,2,16,16,0,10,thailand,0.25,0.75,0,2.0,4.0,1.33,7
Port FC,8,3,1,4,13,13,0,10,thailand,0.38,0.5,0,1.62,2.63,2.0,7
Chiangrai Utd,8,3,0,5,8,9,-1,9,thailand,0.38,0.38,-1,1.0,2.63,2.63,8
Rayong,8,2,3,3,16,19,-3,9,thailand,0.25,0.62,-3,2.0,4.0,1.61,8
Nakhon Pathom,8,2,2,4,6,13,-7,8,thailand,0.25,0.5,-7,0.75,4.0,2.0,9
N. Bua Pitchaya,8,1,3,4,5,13,-8,6,thailand,0.12,0.5,-8,0.62,8.33,2.0,10
Sukhothai,8,1,2,5,7,15,-8,5,thailand,0.12,0.38,-8,0.88,8.33,2.63,11
Khon Kaen Utd,8,0,2,6,4,23,-19,2,thailand,0.0,0.25,-19,0.5,0.0,4.0,12
Kanchanaburi,8,5,3,0,16,7,9,18,thailand2,0.62,1.0,9,2.0,1.61,1.0,1
Chonburi,8,4,3,1,15,7,8,15,thailand2,0.5,0.88,8,1.88,2.0,1.14,2
Ayutthaya Utd,8,4,3,1,15,8,7,15,thailand2,0.5,0.88,7,1.88,2.0,1.14,2
Nakhon Si,8,4,2,2,15,15,0,14,thailand2,0.5,0.75,0,1.88,2.0,1.33,3
Kasetsart,8,3,3,2,9,7,2,12,thailand2,0.38,0.75,2,1.12,2.63,1.33,4
Police Tero,8,4,0,4,11,11,0,12,thailand2,0.5,0.5,0,1.38,2.0,2.0,4
Phrae Utd,8,3,2,3,16,12,4,11,thailand2,0.38,0.62,4,2.0,2.63,1.61,5
Lampang,8,3,2,3,12,11,1,11,thailand2,0.38,0.62,1,1.5,2.63,1.61,5
Pattaya United,8,3,2,3,7,10,-3,11,thailand2,0.38,0.62,-3,0.88,2.63,1.61,5
Mahasarakham,8,2,4,2,9,10,-1,10,thailand2,0.25,0.75,-1,1.12,4.0,1.33,6
Suphanburi,8,2,4,2,18,22,-4,10,thailand2,0.25,0.75,-4,2.25,4.0,1.33,6
Sisaket Utd,8,2,3,3,6,11,-5,9,thailand2,0.25,0.62,-5,0.75,4.0,1.61,7
Chanthaburi,8,2,2,4,10,13,-3,8,thailand2,0.25,0.5,-3,1.25,4.0,2.0,8
Bangkok FC,8,2,2,4,9,12,-3,8,thailand2,0.25,0.5,-3,1.12,4.0,2.0,8
Chiangmai Utd,8,2,2,4,10,16,-6,8,thailand2,0.25,0.5,-6,1.25,4.0,2.0,8
Trat FC,8,2,1,5,12,14,-2,7,thailand2,0.25,0.38,-2,1.5,4.0,2.63,9
Chainat,8,1,2,5,5,10,-5,5,thailand2,0.12,0.38,-5,0.62,8.33,2.63,10
Samut Prakan,0,0,0,0,0,0,0,0,thailand2,0.0,0.0,0,0.0,0.0,0.0,11
Fenerbahce,8,7,1,0,21,7,14,22,turkey,0.88,1.0,14,2.62,1.14,1.0,1
Galatasaray,8,6,2,0,16,5,11,20,turkey,0.75,1.0,11,2.0,1.33,1.0,2
Besiktas,8,4,2,2,11,6,5,14,turkey,0.5,0.75,5,1.38,2.0,1.33,3
Samsunspor,8,4,2,2,12,12,0,14,turkey,0.5,0.75,0,1.5,2.0,1.33,3
Trabzonspor,8,4,1,3,13,7,6,13,turkey,0.5,0.62,6,1.62,2.0,1.61,4
Gaziantep,8,4,1,3,11,9,2,13,turkey,0.5,0.62,2,1.38,2.0,1.61,4
Kasimpasa,8,4,1,3,20,19,1,13,turkey,0.5,0.62,1,2.5,2.0,1.61,4
Eyupspor,8,4,1,3,10,9,1,13,turkey,0.5,0.62,1,1.25,2.0,1.61,4
Bodrumspor,8,3,3,2,4,4,0,12,turkey,0.38,0.75,0,0.5,2.63,1.33,5
Antalyaspor,8,3,3,2,9,13,-4,12,turkey,0.38,0.75,-4,1.12,2.63,1.33,5
Kayserispor,8,3,2,3,10,12,-2,11,turkey,0.38,0.62,-2,1.25,2.63,1.61,6
Basaksehir,8,3,1,4,12,12,0,10,turkey,0.38,0.5,0,1.5,2.63,2.0,7
Konyaspor,8,3,1,4,9,9,0,10,turkey,0.38,0.5,0,1.12,2.63,2.0,7
Rizespor,8,3,0,5,15,17,-2,9,turkey,0.38,0.38,-2,1.88,2.63,2.63,8
Alanyaspor,8,3,0,5,12,16,-4,9,turkey,0.38,0.38,-4,1.5,2.63,2.63,8
Goztepe,8,2,2,4,11,10,1,8,turkey,0.25,0.5,1,1.38,4.0,2.0,9
Hatayspor,8,2,1,5,11,15,-4,7,turkey,0.25,0.38,-4,1.38,4.0,2.63,10
Sivasspor,8,2,1,5,10,14,-4,7,turkey,0.25,0.38,-4,1.25,4.0,2.63,10
Adana Demirspor,8,0,2,6,10,22,-12,2,turkey,0.0,0.25,-12,1.25,0.0,4.0,11
Igdir,8,5,2,1,13,5,8,17,turkey2,0.62,0.88,8,1.62,1.61,1.14,1
Bandirmaspor,8,5,1,2,12,11,1,16,turkey2,0.62,0.75,1,1.5,1.61,1.33,2
Genclerbirligi,8,4,3,1,16,8,8,15,turkey2,0.5,0.88,8,2.0,2.0,1.14,3
Kocaelispor,8,3,5,0,9,4,5,14,turkey2,0.38,1.0,5,1.12,2.63,1.0,4
F. Karagumruk,8,4,2,2,11,9,2,14,turkey2,0.5,0.75,2,1.38,2.0,1.33,4
Amed SK,8,3,4,1,11,6,5,13,turkey2,0.38,0.88,5,1.38,2.63,1.14,5
Keciorengucu,8,3,3,2,19,12,7,12,turkey2,0.38,0.75,7,2.38,2.63,1.33,6
Erzurum BB,8,3,3,2,16,9,7,12,turkey2,0.38,0.75,7,2.0,2.63,1.33,6
Umraniyespor,8,3,3,2,10,6,4,12,turkey2,0.38,0.75,4,1.25,2.63,1.33,6
Boluspor,8,3,3,2,6,3,3,12,turkey2,0.38,0.75,3,0.75,2.63,1.33,6
Sakaryaspor,8,3,3,2,13,11,2,12,turkey2,0.38,0.75,2,1.62,2.63,1.33,6
Erokspor,8,2,5,1,13,10,3,11,turkey2,0.25,0.88,3,1.62,4.0,1.14,7
Adanaspor,8,3,2,3,9,10,-1,11,turkey2,0.38,0.62,-1,1.12,2.63,1.61,7
Istanbulspor,8,3,1,4,8,6,2,10,turkey2,0.38,0.5,2,1.0,2.63,2.0,8
Corum,8,3,1,4,10,9,1,10,turkey2,0.38,0.5,1,1.25,2.63,2.0,8
Ankaragucu,8,2,2,4,10,11,-1,8,turkey2,0.25,0.5,-1,1.25,4.0,2.0,9
Manisa BB,8,2,1,5,10,11,-1,7,turkey2,0.25,0.38,-1,1.25,4.0,2.63,10
Pendikspor,8,2,1,5,7,13,-6,7,turkey2,0.25,0.38,-6,0.88,4.0,2.63,10
Sanliurfaspor,8,1,3,4,10,12,-2,6,turkey2,0.12,0.5,-2,1.25,8.33,2.0,11
Y. Malatyaspor,8,0,0,8,1,36,-35,0,turkey2,0.0,0.0,-35,0.12,0.0,0.0,12
Sariyer,8,6,1,1,25,8,17,19,turkey3,0.75,0.88,17,3.12,1.33,1.14,1
B. Petrolspor,8,6,1,1,12,6,6,19,turkey3,0.75,0.88,6,1.5,1.33,1.14,1
Adana,8,5,2,1,11,3,8,17,turkey3,0.62,0.88,8,1.38,1.61,1.14,2
Trabzon FK,8,5,2,1,12,6,6,17,turkey3,0.62,0.88,6,1.5,1.61,1.14,2
Kastamonuspor,8,4,4,0,13,4,9,16,turkey3,0.5,1.0,9,1.62,2.0,1.0,3
Altinordu,8,3,4,1,13,8,5,13,turkey3,0.38,0.88,5,1.62,2.63,1.14,4
Iskenderun,8,4,1,3,11,9,2,13,turkey3,0.5,0.62,2,1.38,2.0,1.61,4
Kirklarelispor,8,3,2,3,12,9,3,11,turkey3,0.38,0.62,3,1.5,2.63,1.61,5
Inegolspor,8,3,2,3,11,17,-6,11,turkey3,0.38,0.62,-6,1.38,2.63,1.61,5
Ankaraspor,8,3,1,4,16,8,8,10,turkey3,0.38,0.5,8,2.0,2.63,2.0,6
Altay,8,3,1,4,7,12,-5,10,turkey3,0.38,0.5,-5,0.88,2.63,2.0,6
B. Anadolu,8,2,3,3,5,11,-6,9,turkey3,0.25,0.62,-6,0.62,4.0,1.61,7
Karakopru,8,2,2,4,7,8,-1,8,turkey3,0.25,0.5,-1,0.88,4.0,2.0,8
Isparta Davrazs,8,2,2,4,8,12,-4,8,turkey3,0.25,0.5,-4,1.0,4.0,2.0,8
Fethiyespor,8,1,4,3,3,5,-2,7,turkey3,0.12,0.62,-2,0.38,8.33,1.61,9
Kepez Belediyes,8,1,3,4,7,12,-5,6,turkey3,0.12,0.5,-5,0.88,8.33,2.0,10
24 Erzincanspor,8,1,2,5,9,20,-11,5,turkey3,0.12,0.38,-11,1.12,8.33,2.63,11
Afyonspor,8,0,0,8,0,24,-24,0,turkey3,0.0,0.0,-24,0.0,0.0,0.0,12
Elazigspor,8,6,1,1,22,6,16,19,turkey4,0.75,0.88,16,2.75,1.33,1.14,1
Menemen B.,8,5,2,1,23,12,11,17,turkey4,0.62,0.88,11,2.88,1.61,1.14,2
Aksaray B.,8,4,3,1,16,6,10,15,turkey4,0.5,0.88,10,2.0,2.0,1.14,3
Van Spor,8,4,3,1,18,9,9,15,turkey4,0.5,0.88,9,2.25,2.0,1.14,3
Beyoglu Yeni C.,8,4,2,2,7,5,2,14,turkey4,0.5,0.75,2,0.88,2.0,1.33,4
Serik Belediyes,8,3,4,1,11,6,5,13,turkey4,0.38,0.88,5,1.38,2.63,1.14,5
Karacabey,8,4,1,3,13,12,1,13,turkey4,0.5,0.62,1,1.62,2.0,1.61,5
Erbaaspor,8,4,1,3,16,16,0,13,turkey4,0.5,0.62,0,2.0,2.0,1.61,5
Arnavutkoy B.,8,3,3,2,14,14,0,12,turkey4,0.38,0.75,0,1.75,2.63,1.33,6
Bucaspor,8,3,3,2,6,6,0,12,turkey4,0.38,0.75,0,0.75,2.63,1.33,6
A. Demirspor,8,2,5,1,10,8,2,11,turkey4,0.25,0.88,2,1.25,4.0,1.14,7
Derince,8,3,1,4,8,12,-4,10,turkey4,0.38,0.5,-4,1.0,2.63,2.0,8
Diyarbekirspor,8,2,3,3,5,6,-1,9,turkey4,0.25,0.62,-1,0.62,4.0,1.61,9
Karaman,8,1,4,3,10,11,-1,7,turkey4,0.12,0.62,-1,1.25,8.33,1.61,10
Somaspor,8,1,3,4,5,5,0,6,turkey4,0.12,0.5,0,0.62,8.33,2.0,11
Yeni Mersin,8,1,2,5,3,15,-12,5,turkey4,0.12,0.38,-12,0.38,8.33,2.63,12
Nazillispor,8,1,1,6,11,25,-14,4,turkey4,0.12,0.25,-14,1.38,8.33,4.0,13
Giresunspor,8,0,1,7,4,23,-19,1,turkey4,0.0,0.12,-19,0.5,0.0,8.33,14
Kutahyaspor,8,6,2,0,19,7,12,20,turkey5,0.75,1.0,12,2.38,1.33,1.0,1
Karsiyaka,8,5,2,1,14,5,9,17,turkey5,0.62,0.88,9,1.75,1.61,1.14,2
K. Bulvarspor,8,5,1,2,14,9,5,16,turkey5,0.62,0.75,5,1.75,1.61,1.33,3
Duzcespor,8,4,3,1,10,8,2,15,turkey5,0.5,0.88,2,1.25,2.0,1.14,4
Anadolu U.,8,4,2,2,14,11,3,14,turkey5,0.5,0.75,3,1.75,2.0,1.33,5
Artvin Hopaspor,8,4,2,2,7,4,3,14,turkey5,0.5,0.75,3,0.88,2.0,1.33,5
Bursaspor,8,3,4,1,11,7,4,13,turkey5,0.38,0.88,4,1.38,2.63,1.14,6
Musspor,8,3,3,2,12,9,3,12,turkey5,0.38,0.75,3,1.5,2.63,1.33,7
Silifke,8,3,2,3,14,12,2,11,turkey5,0.38,0.62,2,1.75,2.63,1.61,8
Elaziz K.,8,2,2,4,4,7,-3,8,turkey5,0.25,0.5,-3,0.5,4.0,2.0,9
Viven Bornova,8,1,4,3,6,13,-7,7,turkey5,0.12,0.62,-7,0.75,8.33,1.61,10
Kirsehir B.,8,2,1,5,7,17,-10,7,turkey5,0.25,0.38,-10,0.88,4.0,2.63,10
Tokat,8,1,3,4,7,10,-3,6,turkey5,0.12,0.5,-3,0.88,8.33,2.0,11
Kahramanmar.,8,2,0,6,10,16,-6,6,turkey5,0.25,0.25,-6,1.25,4.0,4.0,11
Kusadasispor,8,2,0,6,6,12,-6,6,turkey5,0.25,0.25,-6,0.75,4.0,4.0,11
Ergene Velimese,8,1,2,5,6,13,-7,5,turkey5,0.12,0.38,-7,0.75,8.33,2.63,12
Muglaspor,8,5,3,0,10,2,8,18,turkey6,0.62,1.0,8,1.25,1.61,1.0,1
Balikesirspor,8,5,1,2,13,5,8,16,turkey6,0.62,0.75,8,1.62,1.61,1.33,2
Silivrispor,8,5,1,2,11,8,3,16,turkey6,0.62,0.75,3,1.38,1.61,1.33,2
Amasyaspor,8,4,2,2,12,8,4,14,turkey6,0.5,0.75,4,1.5,2.0,1.33,3
Usakspor,8,3,4,1,14,7,7,13,turkey6,0.38,0.88,7,1.75,2.63,1.14,4
Inegol Kafkas,8,4,1,3,7,7,0,13,turkey6,0.5,0.62,0,0.88,2.0,1.61,4
Fatsa B.,8,4,1,3,6,7,-1,13,turkey6,0.5,0.62,-1,0.75,2.0,1.61,4
Etimesgut,8,3,3,2,7,6,1,12,turkey6,0.38,0.75,1,0.88,2.63,1.33,5
Beykoz Ishaklis,8,2,3,3,8,9,-1,9,turkey6,0.25,0.62,-1,1.0,4.0,1.61,6
Turk Metal 1963,8,2,3,3,9,11,-2,9,turkey6,0.25,0.62,-2,1.12,4.0,1.61,6
Tire 2021 FK,8,2,3,3,8,10,-2,9,turkey6,0.25,0.62,-2,1.0,4.0,1.61,6
Mazidagi,8,1,5,2,6,6,0,8,turkey6,0.12,0.75,0,0.75,8.33,1.33,7
Nevsehirspor,8,1,3,4,9,12,-3,6,turkey6,0.12,0.5,-3,1.12,8.33,2.0,8
Cayelispor,8,1,3,4,3,9,-6,6,turkey6,0.12,0.5,-6,0.38,8.33,2.0,8
Kelkit,8,0,4,4,6,10,-4,4,turkey6,0.0,0.5,-4,0.75,0.0,2.0,9
Adiyaman,8,0,1,7,6,22,-16,1,turkey6,0.0,0.12,-16,0.75,0.0,8.33,10
Orduspor,8,7,1,0,16,4,12,22,turkey7,0.88,1.0,12,2.0,1.14,1.0,1
Aliaga FAS,8,5,3,0,14,4,10,18,turkey7,0.62,1.0,10,1.75,1.61,1.0,2
Ayvalikgucu,8,5,2,1,12,8,4,17,turkey7,0.62,0.88,4,1.5,1.61,1.14,3
Kucukcekmece,8,4,3,1,15,8,7,15,turkey7,0.5,0.88,7,1.88,2.0,1.14,4
Corluspor,8,5,0,3,14,11,3,15,turkey7,0.62,0.62,3,1.75,1.61,1.61,4
Yozgat Bld Bozo,8,3,2,3,14,12,2,11,turkey7,0.38,0.62,2,1.75,2.63,1.61,5
Viransehir,8,3,2,3,7,10,-3,11,turkey7,0.38,0.62,-3,0.88,2.63,1.61,5
Osmaniyespor,8,2,4,2,12,15,-3,10,turkey7,0.25,0.75,-3,1.5,4.0,1.33,6
Pazarspor,8,2,3,3,8,9,-1,9,turkey7,0.25,0.62,-1,1.0,4.0,1.61,7
Cankaya FK,8,2,3,3,11,13,-2,9,turkey7,0.25,0.62,-2,1.38,4.0,1.61,7
Alanya 1221,8,2,1,5,5,8,-3,7,turkey7,0.25,0.38,-3,0.62,4.0,2.63,8
1922 Konyaspor,8,1,4,3,5,9,-4,7,turkey7,0.12,0.62,-4,0.62,8.33,1.61,8
Efeler 09,8,2,1,5,5,13,-8,7,turkey7,0.25,0.38,-8,0.62,4.0,2.63,8
Bursa,8,2,1,5,8,17,-9,7,turkey7,0.25,0.38,-9,1.0,4.0,2.63,8
K. Idmanyurdu,8,1,2,5,6,11,-5,5,turkey7,0.12,0.38,-5,0.75,8.33,2.63,9
Bayburt,8,1,0,7,6,15,-9,3,turkey7,0.12,0.12,-9,0.75,8.33,8.33,10
Sebat G.,8,6,1,1,19,5,14,19,turkey8,0.75,0.88,14,2.38,1.33,1.14,1
Mardin BB,8,6,0,2,15,7,8,18,turkey8,0.75,0.75,8,1.88,1.33,1.33,2
Orduspor 1967,8,5,2,1,19,5,14,17,turkey8,0.62,0.88,14,2.38,1.61,1.14,3
K. Istiklalspor,8,4,3,1,16,6,10,15,turkey8,0.5,0.88,10,2.0,2.0,1.14,4
Agri 1970,8,4,3,1,9,7,2,15,turkey8,0.5,0.88,2,1.12,2.0,1.14,4
Kirikkale B.,8,4,2,2,12,9,3,14,turkey8,0.5,0.75,3,1.5,2.0,1.33,5
Nilufer B.,8,4,1,3,12,7,5,13,turkey8,0.5,0.62,5,1.5,2.0,1.61,6
Denizlispor,8,3,2,3,10,11,-1,11,turkey8,0.38,0.62,-1,1.25,2.63,1.61,7
Z. Komurspor,8,3,2,3,10,15,-5,11,turkey8,0.38,0.62,-5,1.25,2.63,1.61,7
Polatli B.,8,2,3,3,10,15,-5,9,turkey8,0.25,0.62,-5,1.25,4.0,1.61,8
Tepecik,8,2,2,4,9,12,-3,8,turkey8,0.25,0.5,-3,1.12,4.0,2.0,9
Coruhlu,8,1,4,3,11,17,-6,7,turkey8,0.12,0.62,-6,1.38,8.33,1.61,10
Nigde Belediyes,8,1,3,4,7,13,-6,6,turkey8,0.12,0.5,-6,0.88,8.33,2.0,11
Turgutluspor,8,1,2,5,11,16,-5,5,turkey8,0.12,0.38,-5,1.38,8.33,2.63,12
Erciyes,8,1,2,5,5,11,-6,5,turkey8,0.12,0.38,-6,0.62,8.33,2.63,12
Edirnespor,8,0,3,5,5,21,-16,3,turkey8,0.0,0.38,-16,0.62,0.0,2.63,13
Shabab Al Ahli,8,8,0,0,18,3,15,24,uae,1.0,1.0,15,2.25,1.0,1.0,1
Al Sharjah,8,5,1,2,7,3,4,16,uae,0.62,0.75,4,0.88,1.61,1.33,2
Ajman,8,5,0,3,18,15,3,15,uae,0.62,0.62,3,2.25,1.61,1.61,3
Al Wasl,8,4,2,2,13,6,7,14,uae,0.5,0.75,7,1.62,2.0,1.33,4
Al Wahda,8,4,1,3,15,11,4,13,uae,0.5,0.62,4,1.88,2.0,1.61,5
Khorfakkan,8,4,1,3,14,11,3,13,uae,0.5,0.62,3,1.75,2.0,1.61,5
Al Jazira,8,4,1,3,14,12,2,13,uae,0.5,0.62,2,1.75,2.0,1.61,5
Al Bataeh,8,3,2,3,8,10,-2,11,uae,0.38,0.62,-2,1.0,2.63,1.61,6
Bani Yas,8,3,2,3,7,12,-5,11,uae,0.38,0.62,-5,0.88,2.63,1.61,6
Al Ain,8,3,1,4,14,13,1,10,uae,0.38,0.5,1,1.75,2.63,2.0,7
Ittihad Kalba,8,2,2,4,9,12,-3,8,uae,0.25,0.5,-3,1.12,4.0,2.0,8
Al Nasr,8,2,1,5,9,15,-6,7,uae,0.25,0.38,-6,1.12,4.0,2.63,9
Dibba Al Hisn,8,1,1,6,7,16,-9,4,uae,0.12,0.25,-9,0.88,8.33,4.0,10
Al Urooba,8,0,0,8,6,22,-16,0,uae,0.0,0.0,-16,0.75,0.0,0.0,11
Dynamo Kyiv,8,4,4,0,12,5,7,16,ukraine,0.5,1.0,7,1.5,2.0,1.0,1
Shakhtar,8,4,3,1,15,4,11,15,ukraine,0.5,0.88,11,1.88,2.0,1.14,2
Livyi Bereh,8,4,2,2,8,4,4,14,ukraine,0.5,0.75,4,1.0,2.0,1.33,3
Oleksandria,8,4,2,2,11,8,3,14,ukraine,0.5,0.75,3,1.38,2.0,1.33,3
Zorya Luhansk,8,4,2,2,13,11,2,14,ukraine,0.5,0.75,2,1.62,2.0,1.33,3
Kryvbas KR,8,4,2,2,11,9,2,14,ukraine,0.5,0.75,2,1.38,2.0,1.33,3
Veres,8,4,1,3,13,12,1,13,ukraine,0.5,0.62,1,1.62,2.0,1.61,4
Karpaty Lviv,8,3,2,3,8,6,2,11,ukraine,0.38,0.62,2,1.0,2.63,1.61,5
Polessya,8,3,2,3,8,11,-3,11,ukraine,0.38,0.62,-3,1.0,2.63,1.61,5
Obolon,8,2,3,3,6,9,-3,9,ukraine,0.25,0.62,-3,0.75,4.0,1.61,6
Rukh Lviv,8,2,2,4,5,9,-4,8,ukraine,0.25,0.5,-4,0.62,4.0,2.0,7
Vorskla Poltava,8,2,2,4,5,9,-4,8,ukraine,0.25,0.5,-4,0.62,4.0,2.0,7
Inhulets,8,2,1,5,7,15,-8,7,ukraine,0.25,0.38,-8,0.88,4.0,2.63,8
Kolos Kovalivka,8,1,3,4,6,8,-2,6,ukraine,0.12,0.5,-2,0.75,8.33,2.0,9
LNZ Cherkasy,8,1,1,6,5,12,-7,4,ukraine,0.12,0.25,-7,0.62,8.33,4.0,10
Chornomorets,8,1,0,7,6,17,-11,3,ukraine,0.12,0.12,-11,0.75,8.33,8.33,11
Dnipro-1,0,0,0,0,0,0,0,0,ukraine,0.0,0.0,0,0.0,0.0,0.0,12
Liverpool M.,6,4,2,0,11,5,6,14,uruguay,0.67,1.0,6,1.83,1.49,1.0,1
Plaza Colonia,6,4,1,1,7,3,4,13,uruguay,0.67,0.83,4,1.17,1.49,1.2,2
Defensor S.,5,4,0,1,7,2,5,12,uruguay,0.8,0.8,5,1.4,1.25,1.25,3
Nacional,5,2,2,1,12,8,4,8,uruguay,0.4,0.8,4,2.4,2.5,1.25,4
Cerro Largo,5,2,2,1,8,7,1,8,uruguay,0.4,0.8,1,1.6,2.5,1.25,4
Juventud,5,2,2,1,7,6,1,8,uruguay,0.4,0.8,1,1.4,2.5,1.25,4
Montevideo City,6,2,2,2,6,9,-3,8,uruguay,0.33,0.67,-3,1.0,3.03,1.49,4
Racing CM,5,2,1,2,5,4,1,7,uruguay,0.4,0.6,1,1.0,2.5,1.67,5
Cerro,5,2,1,2,5,5,0,7,uruguay,0.4,0.6,0,1.0,2.5,1.67,5
Penarol,6,1,3,2,6,7,-1,6,uruguay,0.17,0.67,-1,1.0,5.88,1.49,6
Wanderers,5,1,2,2,4,4,0,5,uruguay,0.2,0.6,0,0.8,5.0,1.67,7
Danubio,5,0,4,1,4,5,-1,4,uruguay,0.0,0.8,-1,0.8,0.0,1.25,8
Miramar Misione,6,1,1,4,6,9,-3,4,uruguay,0.17,0.33,-3,1.0,5.88,3.03,8
River Plate,5,0,3,2,6,8,-2,3,uruguay,0.0,0.6,-2,1.2,0.0,1.67,9
Boston River,5,0,3,2,5,8,-3,3,uruguay,0.0,0.6,-3,1.0,0.0,1.67,9
Progreso,6,0,3,3,7,16,-9,3,uruguay,0.0,0.5,-9,1.17,0.0,2.0,9
Nacional,7,5,1,1,18,5,13,16,uruguay2,0.71,0.86,13,2.57,1.41,1.16,1
Penarol,7,4,2,1,10,5,5,14,uruguay2,0.57,0.86,5,1.43,1.75,1.16,2
Danubio,7,4,2,1,11,11,0,14,uruguay2,0.57,0.86,0,1.57,1.75,1.16,2
Wanderers,7,4,1,2,11,9,2,13,uruguay2,0.57,0.71,2,1.57,1.75,1.41,3
Defensor S.,7,3,2,2,7,5,2,11,uruguay2,0.43,0.71,2,1.0,2.33,1.41,4
Cerro Largo,7,3,2,2,6,7,-1,11,uruguay2,0.43,0.71,-1,0.86,2.33,1.41,4
Cerro,7,3,1,3,8,5,3,10,uruguay2,0.43,0.57,3,1.14,2.33,1.75,5
Fenix,7,3,1,3,10,9,1,10,uruguay2,0.43,0.57,1,1.43,2.33,1.75,5
Miramar Misione,7,3,1,3,7,10,-3,10,uruguay2,0.43,0.57,-3,1.0,2.33,1.75,5
River Plate,7,2,2,3,8,9,-1,8,uruguay2,0.29,0.57,-1,1.14,3.45,1.75,6
Progreso,7,2,2,3,8,11,-3,8,uruguay2,0.29,0.57,-3,1.14,3.45,1.75,6
Rampla Juniors,7,2,2,3,8,12,-4,8,uruguay2,0.29,0.57,-4,1.14,3.45,1.75,6
Boston River,7,2,1,4,6,8,-2,7,uruguay2,0.29,0.43,-2,0.86,3.45,2.33,7
Racing CM,7,1,3,3,8,10,-2,6,uruguay2,0.14,0.57,-2,1.14,7.14,1.75,8
D. Maldonado,7,1,3,3,5,9,-4,6,uruguay2,0.14,0.57,-4,0.71,7.14,1.75,8
Liverpool M.,7,1,0,6,4,10,-6,3,uruguay2,0.14,0.14,-6,0.57,7.14,7.14,9
Vancouver,4,4,0,0,9,2,7,12,usa,1.0,1.0,7,2.25,1.0,1.0,1
Philadelphia,3,3,0,0,10,3,7,9,usa,1.0,1.0,7,3.33,1.0,1.0,2
San Diego,4,2,2,0,6,2,4,8,usa,0.5,1.0,4,1.5,2.0,1.0,3
St. Louis City,4,2,2,0,4,0,4,8,usa,0.5,1.0,4,1.0,2.0,1.0,3
Columbus Crew,4,2,2,0,6,3,3,8,usa,0.5,1.0,3,1.5,2.0,1.0,3
Colorado Rapids,4,2,2,0,6,4,2,8,usa,0.5,1.0,2,1.5,2.0,1.0,3
Inter Miami,3,2,1,0,7,3,4,7,usa,0.67,1.0,4,2.33,1.49,1.0,4
Charlotte,4,2,1,1,6,3,3,7,usa,0.5,0.75,3,1.5,2.0,1.33,4
Chicago Fire,4,2,1,1,9,8,1,7,usa,0.5,0.75,1,2.25,2.0,1.33,4
New York City,4,2,1,1,6,5,1,7,usa,0.5,0.75,1,1.5,2.0,1.33,4
Minnesota Utd,4,2,1,1,5,4,1,7,usa,0.5,0.75,1,1.25,2.0,1.33,4
SJ Earthquakes,4,2,0,2,7,4,3,6,usa,0.5,0.5,3,1.75,2.0,2.0,5
DC United,4,1,3,0,6,5,1,6,usa,0.25,1.0,1,1.5,4.0,1.0,5
Austin,4,2,0,2,2,2,0,6,usa,0.5,0.5,0,0.5,2.0,2.0,5
Cincinnati,4,2,0,2,4,6,-2,6,usa,0.5,0.5,-2,1.0,2.0,2.0,5
Los Angeles FC,4,2,0,2,4,6,-2,6,usa,0.5,0.5,-2,1.0,2.0,2.0,5
Real Salt Lake,4,2,0,2,5,8,-3,6,usa,0.5,0.5,-3,1.25,2.0,2.0,5
New York RB,4,1,2,1,4,3,1,5,usa,0.25,0.75,1,1.0,4.0,1.33,6
Seattle,4,1,1,2,7,7,0,4,usa,0.25,0.5,0,1.75,4.0,2.0,7
Nashville SC,3,1,1,1,2,2,0,4,usa,0.33,0.67,0,0.67,3.03,1.49,7
Orlando City,4,1,1,2,9,10,-1,4,usa,0.25,0.5,-1,2.25,4.0,2.0,7
Atlanta Utd,3,1,1,1,3,4,-1,4,usa,0.33,0.67,-1,1.0,3.03,1.49,7
Dallas,4,1,1,2,6,8,-2,4,usa,0.25,0.5,-2,1.5,4.0,2.0,7
Portland,3,1,0,2,2,6,-4,3,usa,0.33,0.33,-4,0.67,3.03,3.03,8
Sporting KC,4,0,1,3,5,8,-3,1,usa,0.0,0.25,-3,1.25,0.0,4.0,9
CF Montreal,4,0,1,3,2,6,-4,1,usa,0.0,0.25,-4,0.5,0.0,4.0,9
New England,4,0,1,3,1,5,-4,1,usa,0.0,0.25,-4,0.25,0.0,4.0,9
Toronto,4,0,1,3,5,10,-5,1,usa,0.0,0.25,-5,1.25,0.0,4.0,9
Houston Dynamo,4,0,1,3,3,8,-5,1,usa,0.0,0.25,-5,0.75,0.0,4.0,9
Loudoun Utd,2,2,0,0,5,2,3,6,usa2,1.0,1.0,3,2.5,1.0,1.0,1
Detroit City,2,2,0,0,4,1,3,6,usa2,1.0,1.0,3,2.0,1.0,1.0,1
San Antonio,2,2,0,0,3,0,3,6,usa2,1.0,1.0,3,1.5,1.0,1.0,1
FC Tulsa,2,2,0,0,2,0,2,6,usa2,1.0,1.0,2,1.0,1.0,1.0,1
Orange County,2,1,1,0,6,4,2,4,usa2,0.5,1.0,2,3.0,2.0,1.0,2
Lexington,2,1,1,0,4,2,2,4,usa2,0.5,1.0,2,2.0,2.0,1.0,2
Indy Eleven,1,1,0,0,3,1,2,3,usa2,1.0,1.0,2,3.0,1.0,1.0,3
Charleston,2,1,0,1,3,2,1,3,usa2,0.5,0.5,1,1.5,2.0,2.0,3
Louisville City,1,1,0,0,2,1,1,3,usa2,1.0,1.0,1,2.0,1.0,1.0,3
Sacramento R.,1,1,0,0,2,1,1,3,usa2,1.0,1.0,1,2.0,1.0,1.0,3
New Mexico,2,1,0,1,4,4,0,3,usa2,0.5,0.5,0,2.0,2.0,2.0,3
Las Vegas L.,2,1,0,1,3,3,0,3,usa2,0.5,0.5,0,1.5,2.0,2.0,3
Monterey Bay,2,1,0,1,3,3,0,3,usa2,0.5,0.5,0,1.5,2.0,2.0,3
El Paso,2,0,2,0,6,6,0,2,usa2,0.0,1.0,0,3.0,0.0,1.0,4
Phoenix Rising,2,0,1,1,4,5,-1,1,usa2,0.0,0.5,-1,2.0,0.0,2.0,5
Colorado S.,2,0,1,1,3,4,-1,1,usa2,0.0,0.5,-1,1.5,0.0,2.0,5
North Carolina,2,0,1,1,2,3,-1,1,usa2,0.0,0.5,-1,1.0,0.0,2.0,5
Pittsburgh,2,0,1,1,1,3,-2,1,usa2,0.0,0.5,-2,0.5,0.0,2.0,5
Birmingham L.,1,0,0,1,1,3,-2,0,usa2,0.0,0.0,-2,1.0,0.0,0.0,6
Hartford A.,1,0,0,1,0,2,-2,0,usa2,0.0,0.0,-2,0.0,0.0,0.0,6
Rhode Island,1,0,0,1,0,2,-2,0,usa2,0.0,0.0,-2,0.0,0.0,0.0,6
Tampa Bay,2,0,0,2,0,2,-2,0,usa2,0.0,0.0,-2,0.0,0.0,0.0,6
Oakland Roots,2,0,0,2,4,7,-3,0,usa2,0.0,0.0,-3,2.0,0.0,0.0,6
Miami FC,2,0,0,2,1,5,-4,0,usa2,0.0,0.0,-4,0.5,0.0,0.0,6
Greenville,2,1,1,0,4,1,3,4,usa3,0.5,1.0,3,2.0,2.0,1.0,1
Naples,2,1,1,0,3,1,2,4,usa3,0.5,1.0,2,1.5,2.0,1.0,1
Richmond K.,2,1,0,1,4,3,1,3,usa3,0.5,0.5,1,2.0,2.0,2.0,2
Charlotte I.,1,1,0,0,1,0,1,3,usa3,1.0,1.0,1,1.0,1.0,1.0,2
Chattanooga RW,1,0,1,0,1,1,0,1,usa3,0.0,1.0,0,1.0,0.0,1.0,3
Westchester SC,1,0,1,0,1,1,0,1,usa3,0.0,1.0,0,1.0,0.0,1.0,3
Alta,0,0,0,0,0,0,0,0,usa3,0.0,0.0,0,0.0,0.0,0.0,4
One Knoxville,0,0,0,0,0,0,0,0,usa3,0.0,0.0,0,0.0,0.0,0.0,4
Portland Hearts,0,0,0,0,0,0,0,0,usa3,0.0,0.0,0,0.0,0.0,0.0,4
Spokane V.,0,0,0,0,0,0,0,0,usa3,0.0,0.0,0,0.0,0.0,0.0,4
Texoma,0,0,0,0,0,0,0,0,usa3,0.0,0.0,0,0.0,0.0,0.0,4
Tormenta,1,0,0,1,2,4,-2,0,usa3,0.0,0.0,-2,2.0,0.0,0.0,4
Forward Madison,1,0,0,1,0,2,-2,0,usa3,0.0,0.0,-2,0.0,0.0,0.0,4
Union Omaha,1,0,0,1,0,3,-3,0,usa3,0.0,0.0,-3,0.0,0.0,0.0,4
UCV,8,4,3,1,10,6,4,15,venezuela,0.5,0.88,4,1.25,2.0,1.14,1
Carabobo,8,4,3,1,10,7,3,15,venezuela,0.5,0.88,3,1.25,2.0,1.14,1
D. Tachira,7,4,2,1,8,3,5,14,venezuela,0.57,0.86,5,1.14,1.75,1.16,2
Puerto Cabello,8,4,1,3,9,6,3,13,venezuela,0.5,0.62,3,1.12,2.0,1.61,3
D. La Guaira,7,3,3,1,11,7,4,12,venezuela,0.43,0.86,4,1.57,2.33,1.16,4
A. Anzoategui,8,3,3,2,11,8,3,12,venezuela,0.38,0.75,3,1.38,2.63,1.33,4
Caracas,8,3,3,2,5,3,2,12,venezuela,0.38,0.75,2,0.62,2.63,1.33,4
Rayo Zuliano,8,3,2,3,7,7,0,11,venezuela,0.38,0.62,0,0.88,2.63,1.61,5
Portuguesa,8,3,2,3,5,5,0,11,venezuela,0.38,0.62,0,0.62,2.63,1.61,5
Metropolitanos,7,2,2,3,7,9,-2,8,venezuela,0.29,0.57,-2,1.0,3.45,1.75,6
E. Merida,7,2,1,4,8,10,-2,7,venezuela,0.29,0.43,-2,1.14,3.45,2.33,7
Monagas,8,2,1,5,6,13,-7,7,venezuela,0.25,0.38,-7,0.75,4.0,2.63,7
Zamora,8,1,3,4,6,10,-4,6,venezuela,0.12,0.5,-4,0.75,8.33,2.0,8
Yaracuyanos,8,0,3,5,5,14,-9,3,venezuela,0.0,0.38,-9,0.62,0.0,2.63,9
Bunyodkor,2,1,1,0,4,2,2,4,uzbekistan,0.5,1.0,2,2.0,2.0,1.0,1
Nasaf Qarshi,2,1,1,0,2,1,1,4,uzbekistan,0.5,1.0,1,1.0,2.0,1.0,1
D. Samarqand,2,1,1,0,1,0,1,4,uzbekistan,0.5,1.0,1,0.5,2.0,1.0,1
Xorazm,1,1,0,0,2,0,2,3,uzbekistan,1.0,1.0,2,2.0,1.0,1.0,2
Buxoro,2,1,0,1,3,2,1,3,uzbekistan,0.5,0.5,1,1.5,2.0,2.0,2
AGMK,1,1,0,0,2,1,1,3,uzbekistan,1.0,1.0,1,2.0,1.0,1.0,2
Qizilqum,2,1,0,1,2,2,0,3,uzbekistan,0.5,0.5,0,1.0,2.0,2.0,2
Andijan,2,0,2,0,2,2,0,2,uzbekistan,0.0,1.0,0,1.0,0.0,1.0,3
Neftchi,2,0,2,0,2,2,0,2,uzbekistan,0.0,1.0,0,1.0,0.0,1.0,3
Kokand-1912,2,0,2,0,1,1,0,2,uzbekistan,0.0,1.0,0,0.5,0.0,1.0,3
Navbahor,1,0,1,0,0,0,0,1,uzbekistan,0.0,1.0,0,0.0,0.0,1.0,4
Pakhtakor,0,0,0,0,0,0,0,0,uzbekistan,0.0,0.0,0,0.0,0.0,0.0,5
Mashal,1,0,0,1,0,1,-1,0,uzbekistan,0.0,0.0,-1,0.0,0.0,0.0,5
Sogdiana,1,0,0,1,0,1,-1,0,uzbekistan,0.0,0.0,-1,0.0,0.0,0.0,5
Termez Surkhon,1,0,0,1,0,2,-2,0,uzbekistan,0.0,0.0,-2,0.0,0.0,0.0,5
Shurtan,2,0,0,2,0,4,-4,0,uzbekistan,0.0,0.0,-4,0.0,0.0,0.0,5
Viettel,8,5,1,2,14,8,6,16,vietnam,0.62,0.75,6,1.75,1.61,1.33,1
Hai Phong,8,5,1,2,9,4,5,16,vietnam,0.62,0.75,5,1.12,1.61,1.33,1
Nam Dinh,8,4,3,1,13,6,7,15,vietnam,0.5,0.88,7,1.62,2.0,1.14,2
Ha Noi,8,4,2,2,14,7,7,14,vietnam,0.5,0.75,7,1.75,2.0,1.33,3
Binh Duong,8,4,1,3,11,12,-1,13,vietnam,0.5,0.62,-1,1.38,2.0,1.61,4
Quang Nam,8,3,3,2,13,11,2,12,vietnam,0.38,0.75,2,1.62,2.63,1.33,5
Cong An Nhan,8,2,5,1,13,10,3,11,vietnam,0.25,0.88,3,1.62,4.0,1.14,6
Song Lam Nghe,8,3,2,3,6,12,-6,11,vietnam,0.38,0.62,-6,0.75,2.63,1.61,6
Ho Chi Minh,8,2,4,2,9,11,-2,10,vietnam,0.25,0.75,-2,1.12,4.0,1.33,7
Thanh Hoa,8,1,6,1,8,8,0,9,vietnam,0.12,0.88,0,1.0,8.33,1.14,8
Hong Linh Ha T.,8,0,7,1,6,7,-1,7,vietnam,0.0,0.88,-1,0.75,0.0,1.14,9
Gia Lai,8,1,3,4,7,13,-6,6,vietnam,0.12,0.5,-6,0.88,8.33,2.0,10
Da Nang,8,1,2,5,6,11,-5,5,vietnam,0.12,0.38,-5,0.75,8.33,2.63,11
Binh Dinh,8,0,2,6,4,13,-9,2,vietnam,0.0,0.25,-9,0.5,0.0,4.0,12
Phu Dong,8,8,0,0,15,1,14,24,vietnam2,1.0,1.0,14,1.88,1.0,1.0,1
Binh Phuoc,8,5,2,1,13,7,6,17,vietnam2,0.62,0.88,6,1.62,1.61,1.14,2
PVF-CAND,8,4,2,2,8,8,0,14,vietnam2,0.5,0.75,0,1.0,2.0,1.33,3
Ba Ria Vung Tau,8,4,1,3,9,9,0,13,vietnam2,0.5,0.62,0,1.12,2.0,1.61,4
S. Khanh Hoa,8,2,4,2,8,8,0,10,vietnam2,0.25,0.75,0,1.0,4.0,1.33,5
Long An,8,2,4,2,5,5,0,10,vietnam2,0.25,0.75,0,0.62,4.0,1.33,5
Ho Chi Minh B,8,2,3,3,7,10,-3,9,vietnam2,0.25,0.62,-3,0.88,4.0,1.61,6
Hoa Binh,8,1,5,2,2,4,-2,8,vietnam2,0.12,0.75,-2,0.25,8.33,1.33,7
Dong Nai,8,0,6,2,1,3,-2,6,vietnam2,0.0,0.75,-2,0.12,0.0,1.33,8
Dong Thap,8,1,3,4,1,4,-3,6,vietnam2,0.12,0.5,-3,0.12,8.33,2.0,8
Hue,8,1,1,6,7,14,-7,4,vietnam2,0.12,0.25,-7,0.88,8.33,4.0,9
The New Saints,8,8,0,0,21,3,18,24,wales,1.0,1.0,18,2.62,1.0,1.0,1
Barry,8,4,3,1,13,10,3,15,wales,0.5,0.88,3,1.62,2.0,1.14,2
Caernarfon,8,4,1,3,14,11,3,13,wales,0.5,0.62,3,1.75,2.0,1.61,3
Haverfordwest,8,3,4,1,12,10,2,13,wales,0.38,0.88,2,1.5,2.63,1.14,3
Flint,8,4,1,3,12,14,-2,13,wales,0.5,0.62,-2,1.5,2.0,1.61,3
Connahs Quay,8,4,0,4,11,6,5,12,wales,0.5,0.5,5,1.38,2.0,2.0,4
Cardiff MU,8,3,2,3,11,12,-1,11,wales,0.38,0.62,-1,1.38,2.63,1.61,5
Penybont,8,3,2,3,9,12,-3,11,wales,0.38,0.62,-3,1.12,2.63,1.61,5
Briton Ferry,8,2,2,4,17,19,-2,8,wales,0.25,0.5,-2,2.12,4.0,2.0,6
Newtown,8,1,4,3,9,11,-2,7,wales,0.12,0.62,-2,1.12,8.33,1.61,7
Bala Town,8,1,1,6,8,15,-7,4,wales,0.12,0.25,-7,1.0,8.33,4.0,8
Aberystwyth,8,1,0,7,6,19,-13,3,wales,0.12,0.12,-13,0.75,8.33,8.33,9
