Equipe,GP,W,D,L,GF,GA,GD,Pts_Overall,Liga,PIO,PIO_HA,GD_Overall,GF_AVG_Overall,PPG_Overall,Odd_Justa_MO,Odd_Justa_HA,Rank_Overall
AF Elbasani,8,3,5,0,8,4,4,14,Albania - Abissnet Superiore,0.38,1.0,4,1.0,1.75,2.63,1.0,1
Dinamo Tirana,8,4,2,2,13,10,3,14,Albania - Abissnet Superiore,0.5,0.75,3,1.62,1.75,2.0,1.33,1
Egnatia R.,8,3,4,1,11,6,5,13,Albania - Abissnet Superiore,0.38,0.88,5,1.38,1.62,2.63,1.14,2
Teuta Durres,8,2,5,1,5,4,1,11,Albania - Abissnet Superiore,0.25,0.88,1,0.62,1.38,4.0,1.14,3
Bylis,8,3,2,3,8,12,-4,11,Albania - Abissnet Superiore,0.38,0.62,-4,1.0,1.38,2.63,1.61,3
KF Tirana,8,2,3,3,11,12,-1,9,Albania - Abissnet Superiore,0.25,0.62,-1,1.38,1.12,4.0,1.61,4
Vllaznia S.,8,1,5,2,8,8,0,8,Albania - Abissnet Superiore,0.12,0.75,0,1.0,1.0,8.33,1.33,5
Partizani T.,8,2,1,5,5,11,-6,7,Albania - Abissnet Superiore,0.25,0.38,-6,0.62,0.88,4.0,2.63,6
Laci,8,0,3,5,5,13,-8,3,Albania - Abissnet Superiore,0.0,0.38,-8,0.62,0.38,0.0,2.63,7
MC Alger,8,6,2,0,17,7,10,20,Algeria - Ligue 1,0.75,1.0,10,2.12,2.5,1.33,1.0,1
JS Saoura,8,5,0,3,11,5,6,15,Algeria - Ligue 1,0.62,0.62,6,1.38,1.88,1.61,1.61,2
El Bayadh,8,4,3,1,6,3,3,15,Algeria - Ligue 1,0.5,0.88,3,0.75,1.88,2.0,1.14,2
CR Belouizdad,8,4,2,2,12,5,7,14,Algeria - Ligue 1,0.5,0.75,7,1.5,1.75,2.0,1.33,3
USM Alger,8,3,4,1,9,4,5,13,Algeria - Ligue 1,0.38,0.88,5,1.12,1.62,2.63,1.14,4
ASO Chlef,8,3,4,1,9,6,3,13,Algeria - Ligue 1,0.38,0.88,3,1.12,1.62,2.63,1.14,4
JS Kabylie,8,3,3,2,9,8,1,12,Algeria - Ligue 1,0.38,0.75,1,1.12,1.5,2.63,1.33,5
ES Setif,8,2,3,3,4,5,-1,9,Algeria - Ligue 1,0.25,0.62,-1,0.5,1.12,4.0,1.61,6
Mostaganem,8,2,3,3,4,5,-1,9,Algeria - Ligue 1,0.25,0.62,-1,0.5,1.12,4.0,1.61,6
Biskra,8,1,4,3,2,6,-4,7,Algeria - Ligue 1,0.12,0.62,-4,0.25,0.88,8.33,1.61,7
Paradou AC,8,2,1,5,8,13,-5,7,Algeria - Ligue 1,0.25,0.38,-5,1.0,0.88,4.0,2.63,7
Khenchela,8,2,1,5,8,17,-9,7,Algeria - Ligue 1,0.25,0.38,-9,1.0,0.88,4.0,2.63,7
CS Constantine,8,1,3,4,6,10,-4,6,Algeria - Ligue 1,0.12,0.5,-4,0.75,0.75,8.33,2.0,8
MC Oran,8,2,0,6,5,12,-7,6,Algeria - Ligue 1,0.25,0.25,-7,0.62,0.75,4.0,4.0,8
O. Akbou,8,0,4,4,3,7,-4,4,Algeria - Ligue 1,0.0,0.5,-4,0.38,0.5,0.0,2.0,9
NC Magra,8,0,4,4,2,10,-8,4,Algeria - Ligue 1,0.0,0.5,-8,0.25,0.5,0.0,2.0,9
Boca Juniors,8,7,0,1,14,3,11,21,Argentina - Liga Profesional,0.88,0.88,11,1.75,2.62,1.14,1.14,1
Huracan,8,5,3,0,12,4,8,18,Argentina - Liga Profesional,0.62,1.0,8,1.5,2.25,1.61,1.0,2
Tigre,8,6,0,2,13,7,6,18,Argentina - Liga Profesional,0.75,0.75,6,1.62,2.25,1.33,1.33,2
Independiente,8,4,4,0,14,4,10,16,Argentina - Liga Profesional,0.5,1.0,10,1.75,2.0,2.0,1.0,3
Argentinos Jrs,8,4,3,1,13,8,5,15,Argentina - Liga Profesional,0.5,0.88,5,1.62,1.88,2.0,1.14,4
Rosario Central,8,4,3,1,9,6,3,15,Argentina - Liga Profesional,0.5,0.88,3,1.12,1.88,2.0,1.14,4
San Lorenzo,8,4,2,2,9,8,1,14,Argentina - Liga Profesional,0.5,0.75,1,1.12,1.75,2.0,1.33,5
River Plate,8,3,4,1,7,5,2,13,Argentina - Liga Profesional,0.38,0.88,2,0.88,1.62,2.63,1.14,6
Platense,8,3,3,2,8,6,2,12,Argentina - Liga Profesional,0.38,0.75,2,1.0,1.5,2.63,1.33,7
Belgrano,8,3,3,2,8,9,-1,12,Argentina - Liga Profesional,0.38,0.75,-1,1.0,1.5,2.63,1.33,7
Estudiantes,8,3,2,3,10,9,1,11,Argentina - Liga Profesional,0.38,0.62,1,1.25,1.38,2.63,1.61,8
Godoy Cruz,8,2,5,1,7,8,-1,11,Argentina - Liga Profesional,0.25,0.88,-1,0.88,1.38,4.0,1.14,8
Barracas C.,8,2,4,2,11,10,1,10,Argentina - Liga Profesional,0.25,0.75,1,1.38,1.25,4.0,1.33,9
Union Santa Fe,8,3,1,4,6,7,-1,10,Argentina - Liga Profesional,0.38,0.5,-1,0.75,1.25,2.63,2.0,9
Defensa y J.,8,3,1,4,6,13,-7,10,Argentina - Liga Profesional,0.38,0.5,-7,0.75,1.25,2.63,2.0,9
Lanus,8,1,6,1,7,5,2,9,Argentina - Liga Profesional,0.12,0.88,2,0.88,1.12,8.33,1.14,10
T. de Cordoba,8,1,6,1,5,4,1,9,Argentina - Liga Profesional,0.12,0.88,1,0.62,1.12,8.33,1.14,10
Central Cordoba,8,2,3,3,12,12,0,9,Argentina - Liga Profesional,0.25,0.62,0,1.5,1.12,4.0,1.61,10
D. Riestra,8,1,6,1,4,4,0,9,Argentina - Liga Profesional,0.12,0.88,0,0.5,1.12,8.33,1.14,10
Aldosivi,8,2,3,3,12,14,-2,9,Argentina - Liga Profesional,0.25,0.62,-2,1.5,1.12,4.0,1.61,10
Gimnasia,8,2,3,3,4,6,-2,9,Argentina - Liga Profesional,0.25,0.62,-2,0.5,1.12,4.0,1.61,10
I. Rivadavia,8,2,3,3,7,11,-4,9,Argentina - Liga Profesional,0.25,0.62,-4,0.88,1.12,4.0,1.61,10
Newells,8,2,2,4,6,9,-3,8,Argentina - Liga Profesional,0.25,0.5,-3,0.75,1.0,4.0,2.0,11
Sarmiento,8,1,5,2,6,11,-5,8,Argentina - Liga Profesional,0.12,0.75,-5,0.75,1.0,8.33,1.33,11
Racing Club,8,2,1,5,11,12,-1,7,Argentina - Liga Profesional,0.25,0.38,-1,1.38,0.88,4.0,2.63,12
Velez Sarsfield,8,2,1,5,4,11,-7,7,Argentina - Liga Profesional,0.25,0.38,-7,0.5,0.88,4.0,2.63,12
Instituto,8,1,2,5,3,11,-8,5,Argentina - Liga Profesional,0.12,0.38,-8,0.38,0.62,8.33,2.63,13
A. Tucuman,8,1,1,6,10,12,-2,4,Argentina - Liga Profesional,0.12,0.25,-2,1.25,0.5,8.33,4.0,14
SM San Juan,8,1,0,7,3,10,-7,3,Argentina - Liga Profesional,0.12,0.12,-7,0.38,0.38,8.33,8.33,15
G. Mendoza,8,5,3,0,10,2,8,18,Argentina - Primera Nacional,0.62,1.0,8,1.25,2.25,1.61,1.0,1
E. Rio Cuarto,8,5,2,1,11,5,6,17,Argentina - Primera Nacional,0.62,0.88,6,1.38,2.12,1.61,1.14,2
SM Tucuman,8,4,4,0,6,2,4,16,Argentina - Primera Nacional,0.5,1.0,4,0.75,2.0,2.0,1.0,3
Gimnasia Jujuy,8,4,3,1,8,2,6,15,Argentina - Primera Nacional,0.5,0.88,6,1.0,1.88,2.0,1.14,4
Atlanta,8,3,5,0,7,3,4,14,Argentina - Primera Nacional,0.38,1.0,4,0.88,1.75,2.63,1.0,5
Colon Santa Fe,8,4,2,2,8,6,2,14,Argentina - Primera Nacional,0.5,0.75,2,1.0,1.75,2.0,1.33,5
Racing Cordoba,8,4,2,2,10,9,1,14,Argentina - Primera Nacional,0.5,0.75,1,1.25,1.75,2.0,1.33,5
Los Andes,8,3,4,1,9,5,4,13,Argentina - Primera Nacional,0.38,0.88,4,1.12,1.62,2.63,1.14,6
D. de Belgrano,8,3,4,1,8,4,4,13,Argentina - Primera Nacional,0.38,0.88,4,1.0,1.62,2.63,1.14,6
Chaco For Ever,8,4,1,3,8,6,2,13,Argentina - Primera Nacional,0.5,0.62,2,1.0,1.62,2.0,1.61,6
Tristan Suarez,8,3,4,1,7,5,2,13,Argentina - Primera Nacional,0.38,0.88,2,0.88,1.62,2.63,1.14,6
Chacarita J.,8,3,3,2,9,6,3,12,Argentina - Primera Nacional,0.38,0.75,3,1.12,1.5,2.63,1.33,7
Ferro Carril,8,3,3,2,5,3,2,12,Argentina - Primera Nacional,0.38,0.75,2,0.62,1.5,2.63,1.33,7
D. Madryn,8,3,3,2,6,5,1,12,Argentina - Primera Nacional,0.38,0.75,1,0.75,1.5,2.63,1.33,7
Gimnasia y Tiro,8,3,3,2,5,4,1,12,Argentina - Primera Nacional,0.38,0.75,1,0.62,1.5,2.63,1.33,7
Temperley,8,4,0,4,8,8,0,12,Argentina - Primera Nacional,0.5,0.5,0,1.0,1.5,2.0,2.0,7
Quilmes,8,3,3,2,7,7,0,12,Argentina - Primera Nacional,0.38,0.75,0,0.88,1.5,2.63,1.33,7
CA Estudiantes,8,3,2,3,10,9,1,11,Argentina - Primera Nacional,0.38,0.62,1,1.25,1.38,2.63,1.61,8
Atletico Mitre,8,3,2,3,5,5,0,11,Argentina - Primera Nacional,0.38,0.62,0,0.62,1.38,2.63,1.61,8
Agropecuario,8,3,1,4,8,8,0,10,Argentina - Primera Nacional,0.38,0.5,0,1.0,1.25,2.63,2.0,9
All Boys,8,2,3,3,7,6,1,9,Argentina - Primera Nacional,0.25,0.62,1,0.88,1.12,4.0,1.61,10
San Miguel,8,2,3,3,7,6,1,9,Argentina - Primera Nacional,0.25,0.62,1,0.88,1.12,4.0,1.61,10
Deportivo Moron,8,2,3,3,5,5,0,9,Argentina - Primera Nacional,0.25,0.62,0,0.62,1.12,4.0,1.61,10
Deportivo Maipu,8,2,3,3,8,9,-1,9,Argentina - Primera Nacional,0.25,0.62,-1,1.0,1.12,4.0,1.61,10
Almagro,8,2,3,3,7,9,-2,9,Argentina - Primera Nacional,0.25,0.62,-2,0.88,1.12,4.0,1.61,10
San Telmo,8,2,3,3,6,11,-5,9,Argentina - Primera Nacional,0.25,0.62,-5,0.75,1.12,4.0,1.61,10
Alvarado,8,1,5,2,6,7,-1,8,Argentina - Primera Nacional,0.12,0.75,-1,0.75,1.0,8.33,1.33,11
Nueva Chicago,8,2,2,4,7,9,-2,8,Argentina - Primera Nacional,0.25,0.5,-2,0.88,1.0,4.0,2.0,11
Central Norte,8,2,2,4,6,10,-4,8,Argentina - Primera Nacional,0.25,0.5,-4,0.75,1.0,4.0,2.0,11
Argentino Merlo,8,6,1,1,15,6,9,19,Argentina - Primera B,0.75,0.88,9,1.88,2.38,1.33,1.14,1
A. Quilmes,8,5,2,1,12,4,8,17,Argentina - Primera B,0.62,0.88,8,1.5,2.12,1.61,1.14,2
Comunicaciones,8,5,2,1,12,6,6,17,Argentina - Primera B,0.62,0.88,6,1.5,2.12,1.61,1.14,2
Villa Dalmine,8,5,2,1,7,2,5,17,Argentina - Primera B,0.62,0.88,5,0.88,2.12,1.61,1.14,2
Deportivo Merlo,8,4,3,1,8,4,4,15,Argentina - Primera B,0.5,0.88,4,1.0,1.88,2.0,1.14,3
Excursionistas,8,4,2,2,16,9,7,14,Argentina - Primera B,0.5,0.75,7,2.0,1.75,2.0,1.33,4
D. Armenio,8,4,1,3,13,8,5,13,Argentina - Primera B,0.5,0.62,5,1.62,1.62,2.0,1.61,5
Colegiales,8,4,1,3,9,7,2,13,Argentina - Primera B,0.5,0.62,2,1.12,1.62,2.0,1.61,5
Midland,8,3,3,2,10,7,3,12,Argentina - Primera B,0.38,0.75,3,1.25,1.5,2.63,1.33,6
Sacachispas,8,3,2,3,4,6,-2,11,Argentina - Primera B,0.38,0.62,-2,0.5,1.38,2.63,1.61,7
Liniers,8,2,4,2,5,5,0,10,Argentina - Primera B,0.25,0.75,0,0.62,1.25,4.0,1.33,8
S. Italiano,8,2,3,3,9,9,0,9,Argentina - Primera B,0.25,0.62,0,1.12,1.12,4.0,1.61,9
Flandria,8,2,3,3,7,9,-2,9,Argentina - Primera B,0.25,0.62,-2,0.88,1.12,4.0,1.61,9
SM Burzaco,8,3,0,5,5,9,-4,9,Argentina - Primera B,0.38,0.38,-4,0.62,1.12,2.63,2.63,9
Dock Sud,8,2,2,4,5,8,-3,8,Argentina - Primera B,0.25,0.5,-3,0.62,1.0,4.0,2.0,10
Los Andes,8,2,2,4,5,9,-4,8,Argentina - Primera B,0.25,0.5,-4,0.62,1.0,4.0,2.0,10
Acassuso,8,2,2,4,5,12,-7,8,Argentina - Primera B,0.25,0.5,-7,0.62,1.0,4.0,2.0,10
UAI Urquiza,8,2,2,4,10,18,-8,8,Argentina - Primera B,0.25,0.5,-8,1.25,1.0,4.0,2.0,10
V. San Carlos,8,2,1,5,5,9,-4,7,Argentina - Primera B,0.25,0.38,-4,0.62,0.88,4.0,2.63,11
D. Laferrere,8,1,4,3,4,9,-5,7,Argentina - Primera B,0.12,0.62,-5,0.5,0.88,8.33,1.61,11
Canuelas,8,2,0,6,6,11,-5,6,Argentina - Primera B,0.25,0.25,-5,0.75,0.75,4.0,4.0,12
Fenix,8,1,1,6,5,12,-7,4,Argentina - Primera B,0.12,0.25,-7,0.62,0.5,8.33,4.0,13
Sarmiento DLB,4,3,0,1,8,3,5,9,Argentina - Torneo Federal,0.75,0.75,5,2.0,2.25,1.33,1.33,1
D. Rincon,4,3,0,1,4,1,3,9,Argentina - Torneo Federal,0.75,0.75,3,1.0,2.25,1.33,1.33,1
Douglas Haig,4,2,2,0,5,2,3,8,Argentina - Torneo Federal,0.5,1.0,3,1.25,2.0,2.0,1.0,2
G. Chivilcoy,4,2,2,0,3,1,2,8,Argentina - Torneo Federal,0.5,1.0,2,0.75,2.0,2.0,1.0,2
Sol de America,3,2,1,0,9,3,6,7,Argentina - Torneo Federal,0.67,1.0,6,3.0,2.33,1.49,1.0,3
Ciudad Bolivar,3,2,1,0,5,1,4,7,Argentina - Torneo Federal,0.67,1.0,4,1.67,2.33,1.49,1.0,3
Circulo D.,4,2,1,1,8,5,3,7,Argentina - Torneo Federal,0.5,0.75,3,2.0,1.75,2.0,1.33,3
S. Las Parejas,4,2,1,1,6,3,3,7,Argentina - Torneo Federal,0.5,0.75,3,1.5,1.75,2.0,1.33,3
Bartolomé Mitre,4,2,1,1,5,3,2,7,Argentina - Torneo Federal,0.5,0.75,2,1.25,1.75,2.0,1.33,3
Olimpo Bahia B.,3,2,1,0,2,0,2,7,Argentina - Torneo Federal,0.67,1.0,2,0.67,2.33,1.49,1.0,3
Argentino MM,4,2,1,1,4,3,1,7,Argentina - Torneo Federal,0.5,0.75,1,1.0,1.75,2.0,1.33,3
Huracan Las H.,4,2,1,1,5,5,0,7,Argentina - Torneo Federal,0.5,0.75,0,1.25,1.75,2.0,1.33,3
Cipolletti,4,2,0,2,8,4,4,6,Argentina - Torneo Federal,0.5,0.5,4,2.0,1.5,2.0,2.0,4
Costa Brava,4,1,3,0,5,2,3,6,Argentina - Torneo Federal,0.25,1.0,3,1.25,1.5,4.0,1.0,4
SM Formosa,3,2,0,1,4,1,3,6,Argentina - Torneo Federal,0.67,0.67,3,1.33,2.0,1.49,1.49,4
A. Rafaela,4,2,0,2,6,7,-1,6,Argentina - Torneo Federal,0.5,0.5,-1,1.5,1.5,2.0,2.0,4
Guillermo Brown,4,2,0,2,5,7,-2,6,Argentina - Torneo Federal,0.5,0.5,-2,1.25,1.5,2.0,2.0,4
S. Belgrano,3,1,2,0,4,1,3,5,Argentina - Torneo Federal,0.33,1.0,3,1.33,1.67,3.03,1.0,5
I. Chivilcoy,4,1,2,1,5,3,2,5,Argentina - Torneo Federal,0.25,0.75,2,1.25,1.25,4.0,1.33,5
Juventud U. U.,3,1,2,0,3,2,1,5,Argentina - Torneo Federal,0.33,1.0,1,1.0,1.67,3.03,1.0,5
SM Mendoza,4,1,2,1,6,6,0,5,Argentina - Torneo Federal,0.25,0.75,0,1.5,1.25,4.0,1.33,5
Santamarina,4,1,2,1,4,4,0,5,Argentina - Torneo Federal,0.25,0.75,0,1.0,1.25,4.0,1.33,5
Villa Mitre,4,1,2,1,3,3,0,5,Argentina - Torneo Federal,0.25,0.75,0,0.75,1.25,4.0,1.33,5
J. Antoniana,3,1,1,1,3,3,0,4,Argentina - Torneo Federal,0.33,0.67,0,1.0,1.33,3.03,1.49,6
9 Julio Rafaela,3,1,1,1,3,4,-1,4,Argentina - Torneo Federal,0.33,0.67,-1,1.0,1.33,3.03,1.49,6
Ben Hur,4,1,1,2,4,6,-2,4,Argentina - Torneo Federal,0.25,0.5,-2,1.0,1.0,4.0,2.0,6
Gimnasia E.,4,1,1,2,1,5,-4,4,Argentina - Torneo Federal,0.25,0.5,-4,0.25,1.0,4.0,2.0,6
Gutierrez,3,1,0,2,5,6,-1,3,Argentina - Torneo Federal,0.33,0.33,-1,1.67,1.0,3.03,3.03,7
Kimberley,3,1,0,2,1,2,-1,3,Argentina - Torneo Federal,0.33,0.33,-1,0.33,1.0,3.03,3.03,7
Noah,8,8,0,0,34,4,30,24,Armenia - Premier League,1.0,1.0,30,4.25,3.0,1.0,1.0,1
Van,8,4,3,1,13,7,6,15,Armenia - Premier League,0.5,0.88,6,1.62,1.88,2.0,1.14,2
Urartu,8,5,0,3,14,10,4,15,Armenia - Premier League,0.62,0.62,4,1.75,1.88,1.61,1.61,2
Ararat-Armenia,8,4,2,2,16,10,6,14,Armenia - Premier League,0.5,0.75,6,2.0,1.75,2.0,1.33,3
BKMA,8,3,3,2,12,10,2,12,Armenia - Premier League,0.38,0.75,2,1.5,1.5,2.63,1.33,4
Pyunik,8,3,1,4,13,11,2,10,Armenia - Premier League,0.38,0.5,2,1.62,1.25,2.63,2.0,5
Shirak,8,3,1,4,7,15,-8,10,Armenia - Premier League,0.38,0.5,-8,0.88,1.25,2.63,2.0,5
Ararat Yerevan,8,1,4,3,7,12,-5,7,Armenia - Premier League,0.12,0.62,-5,0.88,0.88,8.33,1.61,6
West Armenia,8,2,0,6,6,25,-19,6,Armenia - Premier League,0.25,0.25,-19,0.75,0.75,4.0,4.0,7
Alashkert,8,0,4,4,6,13,-7,4,Armenia - Premier League,0.0,0.5,-7,0.75,0.5,0.0,2.0,8
Gandzasar,8,0,1,7,3,22,-19,1,Armenia - Premier League,0.0,0.12,-19,0.38,0.12,0.0,8.33,9
WS Wanderers,8,5,3,0,21,10,11,18,Australia - A-League,0.62,1.0,11,2.62,2.25,1.61,1.0,1
Western United,8,5,2,1,23,11,12,17,Australia - A-League,0.62,0.88,12,2.88,2.12,1.61,1.14,2
Auckland,8,4,4,0,20,10,10,16,Australia - A-League,0.5,1.0,10,2.5,2.0,2.0,1.0,3
Melbourne City,8,5,1,2,10,6,4,16,Australia - A-League,0.62,0.75,4,1.25,2.0,1.61,1.33,3
Melbourne V.,8,4,2,2,16,13,3,14,Australia - A-League,0.5,0.75,3,2.0,1.75,2.0,1.33,4
Newcastle Jets,8,4,2,2,16,14,2,14,Australia - A-League,0.5,0.75,2,2.0,1.75,2.0,1.33,4
Sydney FC,8,3,3,2,15,12,3,12,Australia - A-League,0.38,0.75,3,1.88,1.5,2.63,1.33,5
Macarthur FC,8,2,2,4,17,18,-1,8,Australia - A-League,0.25,0.5,-1,2.12,1.0,4.0,2.0,6
Brisbane Roar,8,1,3,4,8,15,-7,6,Australia - A-League,0.12,0.5,-7,1.0,0.75,8.33,2.0,7
Central Coast,8,1,3,4,9,17,-8,6,Australia - A-League,0.12,0.5,-8,1.12,0.75,8.33,2.0,7
Wellington,8,1,3,4,8,17,-9,6,Australia - A-League,0.12,0.5,-9,1.0,0.75,8.33,2.0,7
Adelaide Utd,8,1,2,5,16,23,-7,5,Australia - A-League,0.12,0.38,-7,2.0,0.62,8.33,2.63,8
Perth Glory,8,0,2,6,5,17,-12,2,Australia - A-League,0.0,0.25,-12,0.62,0.25,0.0,4.0,9
Avondale,8,7,0,1,24,7,17,21,Australia - NPL Victoria,0.88,0.88,17,3.0,2.62,1.14,1.14,1
Oakleigh C.,8,6,1,1,19,6,13,19,Australia - NPL Victoria,0.75,0.88,13,2.38,2.38,1.33,1.14,2
Heidelberg Utd,8,6,1,1,20,8,12,19,Australia - NPL Victoria,0.75,0.88,12,2.5,2.38,1.33,1.14,2
Dandenong T.,8,5,1,2,16,11,5,16,Australia - NPL Victoria,0.62,0.75,5,2.0,2.0,1.61,1.33,3
Preston Lions,8,3,2,3,12,12,0,11,Australia - NPL Victoria,0.38,0.62,0,1.5,1.38,2.63,1.61,4
Hume City,8,3,2,3,10,14,-4,11,Australia - NPL Victoria,0.38,0.62,-4,1.25,1.38,2.63,1.61,4
M. Victory B,8,3,1,4,13,16,-3,10,Australia - NPL Victoria,0.38,0.5,-3,1.62,1.25,2.63,2.0,5
Dandenong City,8,2,3,3,13,13,0,9,Australia - NPL Victoria,0.25,0.62,0,1.62,1.12,4.0,1.61,6
St. Albans,8,3,0,5,14,15,-1,9,Australia - NPL Victoria,0.38,0.38,-1,1.75,1.12,2.63,2.63,6
Green Gully,8,2,3,3,8,13,-5,9,Australia - NPL Victoria,0.25,0.62,-5,1.0,1.12,4.0,1.61,6
Altona Magic,8,1,3,4,3,8,-5,6,Australia - NPL Victoria,0.12,0.5,-5,0.38,0.75,8.33,2.0,7
South Melbourne,8,1,3,4,8,14,-6,6,Australia - NPL Victoria,0.12,0.5,-6,1.0,0.75,8.33,2.0,7
Melbourne K.,8,2,0,6,9,16,-7,6,Australia - NPL Victoria,0.25,0.25,-7,1.12,0.75,4.0,4.0,7
Port Melbourne,8,2,0,6,6,22,-16,6,Australia - NPL Victoria,0.25,0.25,-16,0.75,0.75,4.0,4.0,7
Moreton City E.,4,4,0,0,10,4,6,12,Australia - NPL Queensland,1.0,1.0,6,2.5,3.0,1.0,1.0,1
Gold C. Knights,3,3,0,0,6,1,5,9,Australia - NPL Queensland,1.0,1.0,5,2.0,3.0,1.0,1.0,2
Peninsula,3,2,1,0,8,2,6,7,Australia - NPL Queensland,0.67,1.0,6,2.67,2.33,1.49,1.0,3
Olympic FC,3,2,0,1,6,2,4,6,Australia - NPL Queensland,0.67,0.67,4,2.0,2.0,1.49,1.49,4
Gold C. Utd,3,2,0,1,5,4,1,6,Australia - NPL Queensland,0.67,0.67,1,1.67,2.0,1.49,1.49,4
Eastern Suburbs,3,1,2,0,6,4,2,5,Australia - NPL Queensland,0.33,1.0,2,2.0,1.67,3.03,1.0,5
Q. Lions,4,1,1,2,6,7,-1,4,Australia - NPL Queensland,0.25,0.5,-1,1.5,1.0,4.0,2.0,6
Brisbane City,4,1,0,3,5,9,-4,3,Australia - NPL Queensland,0.25,0.25,-4,1.25,0.75,4.0,4.0,7
St George W.,4,0,2,2,4,7,-3,2,Australia - NPL Queensland,0.0,0.5,-3,1.0,0.5,0.0,2.0,8
Wynnum Wolves,3,0,1,2,3,7,-4,1,Australia - NPL Queensland,0.0,0.33,-4,1.0,0.33,0.0,3.03,9
SC Wanderers,3,0,1,2,2,6,-4,1,Australia - NPL Queensland,0.0,0.33,-4,0.67,0.33,0.0,3.03,9
Brisbane Roar B,3,0,0,3,1,9,-8,0,Australia - NPL Queensland,0.0,0.0,-8,0.33,0.0,0.0,0.0,10
Austria Wien,8,6,1,1,16,6,10,19,Austria - Bundesliga,0.75,0.88,10,2.0,2.38,1.33,1.14,1
Wolfsberger AC,8,5,1,2,19,11,8,16,Austria - Bundesliga,0.62,0.75,8,2.38,2.0,1.61,1.33,2
Salzburg,8,4,4,0,12,5,7,16,Austria - Bundesliga,0.5,1.0,7,1.5,2.0,2.0,1.0,2
BW Linz,8,5,1,2,13,9,4,16,Austria - Bundesliga,0.62,0.75,4,1.62,2.0,1.61,1.33,2
Sturm Graz,8,4,2,2,15,13,2,14,Austria - Bundesliga,0.5,0.75,2,1.88,1.75,2.0,1.33,3
LASK Linz,8,3,2,3,10,12,-2,11,Austria - Bundesliga,0.38,0.62,-2,1.25,1.38,2.63,1.61,4
Hartberg,8,2,3,3,7,13,-6,9,Austria - Bundesliga,0.25,0.62,-6,0.88,1.12,4.0,1.61,5
Rapid Wien,8,2,1,5,14,12,2,7,Austria - Bundesliga,0.25,0.38,2,1.75,0.88,4.0,2.63,6
Altach,8,1,4,3,8,15,-7,7,Austria - Bundesliga,0.12,0.62,-7,1.0,0.88,8.33,1.61,6
Tirol,8,1,3,4,9,13,-4,6,Austria - Bundesliga,0.12,0.5,-4,1.12,0.75,8.33,2.0,7
A. Klagenfurt,8,1,3,4,9,14,-5,6,Austria - Bundesliga,0.12,0.5,-5,1.12,0.75,8.33,2.0,7
Grazer AK,8,1,1,6,9,19,-10,4,Austria - Bundesliga,0.12,0.25,-10,1.12,0.5,8.33,4.0,8
Ried,8,6,1,1,13,5,8,19,Austria - 2. Liga,0.75,0.88,8,1.62,2.38,1.33,1.14,1
St. Polten,8,5,3,0,17,7,10,18,Austria - 2. Liga,0.62,1.0,10,2.12,2.25,1.61,1.0,2
Admira Wacker,8,5,3,0,17,9,8,18,Austria - 2. Liga,0.62,1.0,8,2.12,2.25,1.61,1.0,2
Bregenz,8,5,0,3,19,12,7,15,Austria - 2. Liga,0.62,0.62,7,2.38,1.88,1.61,1.61,3
Rapid Wien B,8,4,1,3,13,12,1,13,Austria - 2. Liga,0.5,0.62,1,1.62,1.62,2.0,1.61,4
Liefering,8,4,0,4,13,11,2,12,Austria - 2. Liga,0.5,0.5,2,1.62,1.5,2.0,2.0,5
Voitsberg,8,4,0,4,10,10,0,12,Austria - 2. Liga,0.5,0.5,0,1.25,1.5,2.0,2.0,5
Stripfing,8,3,2,3,13,12,1,11,Austria - 2. Liga,0.38,0.62,1,1.62,1.38,2.63,1.61,6
Sturm Graz B,8,3,2,3,8,8,0,11,Austria - 2. Liga,0.38,0.62,0,1.0,1.38,2.63,1.61,6
Kapfenberger,8,3,2,3,17,18,-1,11,Austria - 2. Liga,0.38,0.62,-1,2.12,1.38,2.63,1.61,6
First Vienna,8,3,1,4,12,12,0,10,Austria - 2. Liga,0.38,0.5,0,1.5,1.25,2.63,2.0,7
A. Lustenau,8,2,2,4,5,8,-3,8,Austria - 2. Liga,0.25,0.5,-3,0.62,1.0,4.0,2.0,8
Amstetten,8,1,3,4,8,13,-5,6,Austria - 2. Liga,0.12,0.5,-5,1.0,0.75,8.33,2.0,9
Floridsdorfer,8,1,3,4,6,12,-6,6,Austria - 2. Liga,0.12,0.5,-6,0.75,0.75,8.33,2.0,9
SV Horn,8,1,2,5,4,11,-7,5,Austria - 2. Liga,0.12,0.38,-7,0.5,0.62,8.33,2.63,10
Lafnitz,8,0,3,5,10,25,-15,3,Austria - 2. Liga,0.0,0.38,-15,1.25,0.38,0.0,2.63,11
Qarabag,8,6,2,0,17,3,14,20,Azerbaijan - Premier League,0.75,1.0,14,2.12,2.5,1.33,1.0,1
Zira,8,5,1,2,13,4,9,16,Azerbaijan - Premier League,0.62,0.75,9,1.62,2.0,1.61,1.33,2
Neftci,8,4,2,2,9,6,3,14,Azerbaijan - Premier League,0.5,0.75,3,1.12,1.75,2.0,1.33,3
Shamakhi,8,3,2,3,6,8,-2,11,Azerbaijan - Premier League,0.38,0.62,-2,0.75,1.38,2.63,1.61,4
Kapaz,8,2,4,2,4,7,-3,10,Azerbaijan - Premier League,0.25,0.75,-3,0.5,1.25,4.0,1.33,5
Sabah,8,1,5,2,9,10,-1,8,Azerbaijan - Premier League,0.12,0.75,-1,1.12,1.0,8.33,1.33,6
Sumqayit,8,2,2,4,8,11,-3,8,Azerbaijan - Premier League,0.25,0.5,-3,1.0,1.0,4.0,2.0,6
Turan,8,2,2,4,6,11,-5,8,Azerbaijan - Premier League,0.25,0.5,-5,0.75,1.0,4.0,2.0,6
Araz,8,0,6,2,5,8,-3,6,Azerbaijan - Premier League,0.0,0.75,-3,0.62,0.75,0.0,1.33,7
Sebail,8,0,4,4,2,11,-9,4,Azerbaijan - Premier League,0.0,0.5,-9,0.25,0.5,0.0,2.0,8
Al-Muharraq,8,7,0,1,20,5,15,21,Bahrain - Premier League,0.88,0.88,15,2.5,2.62,1.14,1.14,1
Khalidiya,8,5,2,1,17,9,8,17,Bahrain - Premier League,0.62,0.88,8,2.12,2.12,1.61,1.14,2
Malkiya,8,3,3,2,7,10,-3,12,Bahrain - Premier League,0.38,0.75,-3,0.88,1.5,2.63,1.33,3
Al Ahli M.,8,3,2,3,14,13,1,11,Bahrain - Premier League,0.38,0.62,1,1.75,1.38,2.63,1.61,4
Al Shabbab,8,3,2,3,11,11,0,11,Bahrain - Premier League,0.38,0.62,0,1.38,1.38,2.63,1.61,4
Al Riffa,8,3,2,3,10,10,0,11,Bahrain - Premier League,0.38,0.62,0,1.25,1.38,2.63,1.61,4
Sitra,8,2,4,2,10,8,2,10,Bahrain - Premier League,0.25,0.75,2,1.25,1.25,4.0,1.33,5
Al-Najma,8,3,1,4,13,12,1,10,Bahrain - Premier League,0.38,0.5,1,1.62,1.25,2.63,2.0,5
Bahrain SC,8,2,2,4,9,14,-5,8,Bahrain - Premier League,0.25,0.5,-5,1.12,1.0,4.0,2.0,6
Manama,8,2,2,4,6,13,-7,8,Bahrain - Premier League,0.25,0.5,-7,0.75,1.0,4.0,2.0,6
East Riffa,8,1,4,3,7,10,-3,7,Bahrain - Premier League,0.12,0.62,-3,0.88,0.88,8.33,1.61,7
AAli FC,8,1,2,5,7,16,-9,5,Bahrain - Premier League,0.12,0.38,-9,0.88,0.62,8.33,2.63,8
Mohammedan,8,7,0,1,17,4,13,21,Bangladesh - Premier League,0.88,0.88,13,2.12,2.62,1.14,1.14,1
Bashundhara K.,8,5,2,1,22,5,17,17,Bangladesh - Premier League,0.62,0.88,17,2.75,2.12,1.61,1.14,2
Abahani,8,5,2,1,14,2,12,17,Bangladesh - Premier League,0.62,0.88,12,1.75,2.12,1.61,1.14,2
Fortis,8,3,4,1,10,5,5,13,Bangladesh - Premier League,0.38,0.88,5,1.25,1.62,2.63,1.14,3
Brothers Union,8,3,2,3,11,7,4,11,Bangladesh - Premier League,0.38,0.62,4,1.38,1.38,2.63,1.61,4
B. Police,8,3,1,4,9,13,-4,10,Bangladesh - Premier League,0.38,0.5,-4,1.12,1.25,2.63,2.0,5
Rahmatgonj,8,3,0,5,19,16,3,9,Bangladesh - Premier League,0.38,0.38,3,2.38,1.12,2.63,2.63,6
Fakirerpool,8,3,0,5,10,23,-13,9,Bangladesh - Premier League,0.38,0.38,-13,1.25,1.12,2.63,2.63,6
Dhaka Wanderers,8,1,1,6,5,27,-22,4,Bangladesh - Premier League,0.12,0.25,-22,0.62,0.5,8.33,4.0,7
Chittagong,8,1,0,7,2,17,-15,3,Bangladesh - Premier League,0.12,0.12,-15,0.25,0.38,8.33,8.33,8
Slavia Mozyr,3,2,1,0,7,3,4,7,Belarus - Vysshaya Liga,0.67,1.0,4,2.33,2.33,1.49,1.0,1
Maxline,3,2,1,0,5,2,3,7,Belarus - Vysshaya Liga,0.67,1.0,3,1.67,2.33,1.49,1.0,1
BATE Borisov,3,2,0,1,2,1,1,6,Belarus - Vysshaya Liga,0.67,0.67,1,0.67,2.0,1.49,1.49,2
Isloch,3,1,2,0,4,3,1,5,Belarus - Vysshaya Liga,0.33,1.0,1,1.33,1.67,3.03,1.0,3
Slutsk,3,1,1,1,2,1,1,4,Belarus - Vysshaya Liga,0.33,0.67,1,0.67,1.33,3.03,1.49,4
Dinamo Minsk,2,1,1,0,1,0,1,4,Belarus - Vysshaya Liga,0.5,1.0,1,0.5,2.0,2.0,1.0,4
FC Minsk,3,1,1,1,4,4,0,4,Belarus - Vysshaya Liga,0.33,0.67,0,1.33,1.33,3.03,1.49,4
Gomel,3,1,1,1,2,2,0,4,Belarus - Vysshaya Liga,0.33,0.67,0,0.67,1.33,3.03,1.49,4
Naftan,3,1,1,1,4,5,-1,4,Belarus - Vysshaya Liga,0.33,0.67,-1,1.33,1.33,3.03,1.49,4
Neman Grodno,2,1,0,1,3,1,2,3,Belarus - Vysshaya Liga,0.5,0.5,2,1.5,1.5,2.0,2.0,5
Arsenal D.,3,0,3,0,4,4,0,3,Belarus - Vysshaya Liga,0.0,1.0,0,1.33,1.0,0.0,1.0,5
Vitebsk,3,1,0,2,3,3,0,3,Belarus - Vysshaya Liga,0.33,0.33,0,1.0,1.0,3.03,3.03,5
T. Zhodino,3,0,3,0,1,1,0,3,Belarus - Vysshaya Liga,0.0,1.0,0,0.33,1.0,0.0,1.0,5
Dinamo Brest,3,0,2,1,3,5,-2,2,Belarus - Vysshaya Liga,0.0,0.67,-2,1.0,0.67,0.0,1.49,6
Smorgon,3,0,1,2,1,4,-3,1,Belarus - Vysshaya Liga,0.0,0.33,-3,0.33,0.33,0.0,3.03,7
Molodechno,3,0,0,3,1,8,-7,0,Belarus - Vysshaya Liga,0.0,0.0,-7,0.33,0.0,0.0,0.0,8
Slonim,2,2,0,0,3,1,2,6,Belarus - First League,1.0,1.0,2,1.5,3.0,1.0,1.0,1
BATE B,2,1,1,0,8,3,5,4,Belarus - First League,0.5,1.0,5,4.0,2.0,2.0,1.0,2
Dinamo Minsk B,2,1,1,0,3,1,2,4,Belarus - First League,0.5,1.0,2,1.5,2.0,2.0,1.0,2
ABFF U19,2,1,1,0,2,0,2,4,Belarus - First League,0.5,1.0,2,1.0,2.0,2.0,1.0,2
Volna Pinsk,2,1,1,0,6,5,1,4,Belarus - First League,0.5,1.0,1,3.0,2.0,2.0,1.0,2
Dnepr Mogilev,2,1,1,0,5,4,1,4,Belarus - First League,0.5,1.0,1,2.5,2.0,2.0,1.0,2
Lida,2,1,0,1,6,4,2,3,Belarus - First League,0.5,0.5,2,3.0,1.5,2.0,2.0,3
Ostrovets,2,1,0,1,5,5,0,3,Belarus - First League,0.5,0.5,0,2.5,1.5,2.0,2.0,3
Orsha,2,1,0,1,3,7,-4,3,Belarus - First League,0.5,0.5,-4,1.5,1.5,2.0,2.0,3
Lokomotiv Gomel,2,0,2,0,5,5,0,2,Belarus - First League,0.0,1.0,0,2.5,1.0,0.0,1.0,4
Niva,2,0,2,0,3,3,0,2,Belarus - First League,0.0,1.0,0,1.5,1.0,0.0,1.0,4
Bumprom,2,0,2,0,2,2,0,2,Belarus - First League,0.0,1.0,0,1.0,1.0,0.0,1.0,4
Osipovichy,2,0,1,1,3,4,-1,1,Belarus - First League,0.0,0.5,-1,1.5,0.5,0.0,2.0,5
Gomel B,2,0,1,1,2,3,-1,1,Belarus - First League,0.0,0.5,-1,1.0,0.5,0.0,2.0,5
Uni X L. Minsk,2,0,1,1,2,4,-2,1,Belarus - First League,0.0,0.5,-2,1.0,0.5,0.0,2.0,5
Baranovichi,1,0,0,1,1,2,-1,0,Belarus - First League,0.0,0.0,-1,1.0,0.0,0.0,0.0,6
Belshina,1,0,0,1,0,2,-2,0,Belarus - First League,0.0,0.0,-2,0.0,0.0,0.0,0.0,6
Minsk B,2,0,0,2,1,5,-4,0,Belarus - First League,0.0,0.0,-4,0.5,0.0,0.0,0.0,6
KRC Genk,8,6,2,0,11,5,6,20,Belgium - Pro League,0.75,1.0,6,1.38,2.5,1.33,1.0,1
Royale Union SG,8,6,0,2,18,6,12,18,Belgium - Pro League,0.75,0.75,12,2.25,2.25,1.33,1.33,2
Anderlecht,8,5,0,3,12,6,6,15,Belgium - Pro League,0.62,0.62,6,1.5,1.88,1.61,1.61,3
Westerlo,8,4,2,2,13,10,3,14,Belgium - Pro League,0.5,0.75,3,1.62,1.75,2.0,1.33,4
Gent,8,3,4,1,10,8,2,13,Belgium - Pro League,0.38,0.88,2,1.25,1.62,2.63,1.14,5
Club Brugge,8,3,3,2,14,11,3,12,Belgium - Pro League,0.38,0.75,3,1.75,1.5,2.63,1.33,6
OH Leuven,8,3,3,2,9,9,0,12,Belgium - Pro League,0.38,0.75,0,1.12,1.5,2.63,1.33,6
KV Mechelen,8,3,2,3,9,11,-2,11,Belgium - Pro League,0.38,0.62,-2,1.12,1.38,2.63,1.61,7
Antwerp,8,2,4,2,7,8,-1,10,Belgium - Pro League,0.25,0.75,-1,0.88,1.25,4.0,1.33,8
Charleroi,8,2,3,3,13,10,3,9,Belgium - Pro League,0.25,0.62,3,1.62,1.12,4.0,1.61,9
Sint-Truiden,8,2,3,3,14,13,1,9,Belgium - Pro League,0.25,0.62,1,1.75,1.12,4.0,1.61,9
Kortrijk,8,2,2,4,11,13,-2,8,Belgium - Pro League,0.25,0.5,-2,1.38,1.0,4.0,2.0,10
Standard Liege,8,2,2,4,7,13,-6,8,Belgium - Pro League,0.25,0.5,-6,0.88,1.0,4.0,2.0,10
Cercle Brugge,8,0,5,3,6,12,-6,5,Belgium - Pro League,0.0,0.62,-6,0.75,0.62,0.0,1.61,11
Beerschot,8,1,2,5,5,13,-8,5,Belgium - Pro League,0.12,0.38,-8,0.62,0.62,8.33,2.63,11
Dender,8,1,1,6,6,17,-11,4,Belgium - Pro League,0.12,0.25,-11,0.75,0.5,8.33,4.0,12
Beveren,8,7,0,1,16,7,9,21,Belgium - Challenger Pro League,0.88,0.88,9,2.0,2.62,1.14,1.14,1
La Louviere,8,6,2,0,18,5,13,20,Belgium - Challenger Pro League,0.75,1.0,13,2.25,2.5,1.33,1.0,2
RWDM,8,6,2,0,10,1,9,20,Belgium - Challenger Pro League,0.75,1.0,9,1.25,2.5,1.33,1.0,2
Lokeren-Temse,8,6,0,2,11,10,1,18,Belgium - Challenger Pro League,0.75,0.75,1,1.38,2.25,1.33,1.33,3
Patro Eisden,8,4,3,1,11,7,4,15,Belgium - Challenger Pro League,0.5,0.88,4,1.38,1.88,2.0,1.14,4
Zulte-Waregem,8,3,3,2,11,7,4,12,Belgium - Challenger Pro League,0.38,0.75,4,1.38,1.5,2.63,1.33,5
Club Brugge B,8,4,0,4,11,8,3,12,Belgium - Challenger Pro League,0.5,0.5,3,1.38,1.5,2.0,2.0,5
Eupen,8,3,2,3,10,13,-3,11,Belgium - Challenger Pro League,0.38,0.62,-3,1.25,1.38,2.63,1.61,6
Lierse K.,8,2,2,4,8,8,0,8,Belgium - Challenger Pro League,0.25,0.5,0,1.0,1.0,4.0,2.0,7
RFC Liege,8,2,2,4,12,14,-2,8,Belgium - Challenger Pro League,0.25,0.5,-2,1.5,1.0,4.0,2.0,7
Lommel SK,8,2,1,5,6,13,-7,7,Belgium - Challenger Pro League,0.25,0.38,-7,0.75,0.88,4.0,2.63,8
Francs Borains,8,2,0,6,7,14,-7,6,Belgium - Challenger Pro League,0.25,0.25,-7,0.88,0.75,4.0,4.0,9
Anderlecht B,8,1,2,5,12,16,-4,5,Belgium - Challenger Pro League,0.12,0.38,-4,1.5,0.62,8.33,2.63,10
Seraing,8,0,3,5,7,17,-10,3,Belgium - Challenger Pro League,0.0,0.38,-10,0.88,0.38,0.0,2.63,11
KRC Genk B,8,0,2,6,5,15,-10,2,Belgium - Challenger Pro League,0.0,0.25,-10,0.62,0.25,0.0,4.0,12
Deinze,0,0,0,0,0,0,0,0,Belgium - Challenger Pro League,0.0,0.0,0,0.0,0.0,0.0,0.0,13
Gualberto V. SJ,2,2,0,0,5,1,4,6,Bolivia - Primera Div. - Apertura,1.0,1.0,4,2.5,3.0,1.0,1.0,1
ABB,2,2,0,0,3,0,3,6,Bolivia - Primera Div. - Apertura,1.0,1.0,3,1.5,3.0,1.0,1.0,1
Always Ready,2,2,0,0,3,1,2,6,Bolivia - Primera Div. - Apertura,1.0,1.0,2,1.5,3.0,1.0,1.0,1
U. de Vinto,2,1,1,0,4,2,2,4,Bolivia - Primera Div. - Apertura,0.5,1.0,2,2.0,2.0,2.0,1.0,2
Aurora,2,1,0,1,7,6,1,3,Bolivia - Primera Div. - Apertura,0.5,0.5,1,3.5,1.5,2.0,2.0,3
Guabira,2,1,0,1,7,6,1,3,Bolivia - Primera Div. - Apertura,0.5,0.5,1,3.5,1.5,2.0,2.0,3
Blooming,2,1,0,1,4,3,1,3,Bolivia - Primera Div. - Apertura,0.5,0.5,1,2.0,1.5,2.0,2.0,3
Bolivar,2,1,0,1,4,3,1,3,Bolivia - Primera Div. - Apertura,0.5,0.5,1,2.0,1.5,2.0,2.0,3
The Strongest,2,1,0,1,3,3,0,3,Bolivia - Primera Div. - Apertura,0.5,0.5,0,1.5,1.5,2.0,2.0,3
SA Bulo Bulo,2,1,0,1,2,2,0,3,Bolivia - Primera Div. - Apertura,0.5,0.5,0,1.0,1.5,2.0,2.0,3
Real Tomayapo,2,1,0,1,3,4,-1,3,Bolivia - Primera Div. - Apertura,0.5,0.5,-1,1.5,1.5,2.0,2.0,3
I. Petrolero,2,1,0,1,1,2,-1,3,Bolivia - Primera Div. - Apertura,0.5,0.5,-1,0.5,1.5,2.0,2.0,3
Oriente P.,2,0,1,1,1,5,-4,1,Bolivia - Primera Div. - Apertura,0.0,0.5,-4,0.5,0.5,0.0,2.0,4
Real Oruro,2,0,0,2,1,4,-3,0,Bolivia - Primera Div. - Apertura,0.0,0.0,-3,0.5,0.0,0.0,0.0,5
Nacional Potosi,2,0,0,2,0,3,-3,0,Bolivia - Primera Div. - Apertura,0.0,0.0,-3,0.0,0.0,0.0,0.0,5
Wilstermann,2,0,0,2,0,3,-3,0,Bolivia - Primera Div. - Apertura,0.0,0.0,-3,0.0,0.0,0.0,0.0,5
Bolivar,8,6,1,1,28,11,17,19,Bolivia - Primera Div. - Clausura,0.75,0.88,17,3.5,2.38,1.33,1.14,1
The Strongest,8,6,0,2,26,11,15,18,Bolivia - Primera Div. - Clausura,0.75,0.75,15,3.25,2.25,1.33,1.33,2
Always Ready,8,4,1,3,20,13,7,13,Bolivia - Primera Div. - Clausura,0.5,0.62,7,2.5,1.62,2.0,1.61,3
Gualberto V. SJ,8,4,1,3,18,12,6,13,Bolivia - Primera Div. - Clausura,0.5,0.62,6,2.25,1.62,2.0,1.61,3
Nacional Potosi,8,4,1,3,16,12,4,13,Bolivia - Primera Div. - Clausura,0.5,0.62,4,2.0,1.62,2.0,1.61,3
Royal Pari,8,4,1,3,11,10,1,13,Bolivia - Primera Div. - Clausura,0.5,0.62,1,1.38,1.62,2.0,1.61,3
Aurora,8,3,3,2,19,14,5,12,Bolivia - Primera Div. - Clausura,0.38,0.75,5,2.38,1.5,2.63,1.33,4
Real Tomayapo,8,4,0,4,14,12,2,12,Bolivia - Primera Div. - Clausura,0.5,0.5,2,1.75,1.5,2.0,2.0,4
Blooming,8,3,3,2,10,13,-3,12,Bolivia - Primera Div. - Clausura,0.38,0.75,-3,1.25,1.5,2.63,1.33,4
Guabira,8,3,2,3,10,10,0,11,Bolivia - Primera Div. - Clausura,0.38,0.62,0,1.25,1.38,2.63,1.61,5
Wilstermann,8,2,4,2,11,13,-2,10,Bolivia - Primera Div. - Clausura,0.25,0.75,-2,1.38,1.25,4.0,1.33,6
I. Petrolero,8,3,0,5,13,20,-7,9,Bolivia - Primera Div. - Clausura,0.38,0.38,-7,1.62,1.12,2.63,2.63,7
SA Bulo Bulo,8,2,2,4,14,22,-8,8,Bolivia - Primera Div. - Clausura,0.25,0.5,-8,1.75,1.0,4.0,2.0,8
Oriente P.,8,2,1,5,14,23,-9,7,Bolivia - Primera Div. - Clausura,0.25,0.38,-9,1.75,0.88,4.0,2.63,9
U. de Vinto,8,2,1,5,8,17,-9,7,Bolivia - Primera Div. - Clausura,0.25,0.38,-9,1.0,0.88,4.0,2.63,9
Santa Cruz,8,1,0,7,7,27,-20,3,Bolivia - Primera Div. - Clausura,0.12,0.12,-20,0.88,0.38,8.33,8.33,10
Corinthians,2,1,1,0,4,1,3,4,Brazil - Serie A,0.5,1.0,3,2.0,2.0,2.0,1.0,1
Internacional,2,1,1,0,4,1,3,4,Brazil - Serie A,0.5,1.0,3,2.0,2.0,2.0,1.0,1
Ceara,2,1,1,0,4,2,2,4,Brazil - Serie A,0.5,1.0,2,2.0,2.0,2.0,1.0,1
Fortaleza,2,1,1,0,3,1,2,4,Brazil - Serie A,0.5,1.0,2,1.5,2.0,2.0,1.0,1
Botafogo,2,1,1,0,2,0,2,4,Brazil - Serie A,0.5,1.0,2,1.0,2.0,2.0,1.0,1
Flamengo,2,1,1,0,3,2,1,4,Brazil - Serie A,0.5,1.0,1,1.5,2.0,2.0,1.0,1
Palmeiras,2,1,1,0,2,1,1,4,Brazil - Serie A,0.5,1.0,1,1.0,2.0,2.0,1.0,1
Juventude,2,1,0,1,2,2,0,3,Brazil - Serie A,0.5,0.5,0,1.0,1.5,2.0,2.0,2
Fluminense,2,1,0,1,2,3,-1,3,Brazil - Serie A,0.5,0.5,-1,1.0,1.5,2.0,2.0,2
Gremio,2,1,0,1,2,3,-1,3,Brazil - Serie A,0.5,0.5,-1,1.0,1.5,2.0,2.0,2
Cruzeiro,2,1,0,1,2,4,-2,3,Brazil - Serie A,0.5,0.5,-2,1.0,1.5,2.0,2.0,2
Vasco da Gama,2,1,0,1,2,4,-2,3,Brazil - Serie A,0.5,0.5,-2,1.0,1.5,2.0,2.0,2
Bahia,2,0,2,0,3,3,0,2,Brazil - Serie A,0.0,1.0,0,1.5,1.0,0.0,1.0,3
Sao Paulo,2,0,2,0,0,0,0,2,Brazil - Serie A,0.0,1.0,0,0.0,1.0,0.0,1.0,3
Bragantino,2,0,1,1,3,4,-1,1,Brazil - Serie A,0.0,0.5,-1,1.5,0.5,0.0,2.0,4
Santos,2,0,1,1,3,4,-1,1,Brazil - Serie A,0.0,0.5,-1,1.5,0.5,0.0,2.0,4
Mirassol,2,0,1,1,2,3,-1,1,Brazil - Serie A,0.0,0.5,-1,1.0,0.5,0.0,2.0,4
Atletico MG,2,0,1,1,1,2,-1,1,Brazil - Serie A,0.0,0.5,-1,0.5,0.5,0.0,2.0,4
Sport Recife,2,0,1,1,1,2,-1,1,Brazil - Serie A,0.0,0.5,-1,0.5,0.5,0.0,2.0,4
Vitoria,2,0,0,2,1,4,-3,0,Brazil - Serie A,0.0,0.0,-3,0.5,0.0,0.0,0.0,5
Athletico PR,1,1,0,0,2,1,1,3,Brazil - Serie B,1.0,1.0,1,2.0,3.0,1.0,1.0,1
Operario PR,1,1,0,0,2,1,1,3,Brazil - Serie B,1.0,1.0,1,2.0,3.0,1.0,1.0,1
America MG,1,1,0,0,1,0,1,3,Brazil - Serie B,1.0,1.0,1,1.0,3.0,1.0,1.0,1
Coritiba,1,1,0,0,1,0,1,3,Brazil - Serie B,1.0,1.0,1,1.0,3.0,1.0,1.0,1
CRB,1,1,0,0,1,0,1,3,Brazil - Serie B,1.0,1.0,1,1.0,3.0,1.0,1.0,1
Cuiaba,1,1,0,0,1,0,1,3,Brazil - Serie B,1.0,1.0,1,1.0,3.0,1.0,1.0,1
Goias,1,1,0,0,1,0,1,3,Brazil - Serie B,1.0,1.0,1,1.0,3.0,1.0,1.0,1
Avai,1,0,1,0,1,1,0,1,Brazil - Serie B,0.0,1.0,0,1.0,1.0,0.0,1.0,2
Ferroviaria,1,0,1,0,1,1,0,1,Brazil - Serie B,0.0,1.0,0,1.0,1.0,0.0,1.0,2
Novorizontino,1,0,1,0,1,1,0,1,Brazil - Serie B,0.0,1.0,0,1.0,1.0,0.0,1.0,2
Remo,1,0,1,0,1,1,0,1,Brazil - Serie B,0.0,1.0,0,1.0,1.0,0.0,1.0,2
Athletic Club,0,0,0,0,0,0,0,0,Brazil - Serie B,0.0,0.0,0,0.0,0.0,0.0,0.0,3
Atletico GO,0,0,0,0,0,0,0,0,Brazil - Serie B,0.0,0.0,0,0.0,0.0,0.0,0.0,3
Criciuma,1,0,0,1,1,2,-1,0,Brazil - Serie B,0.0,0.0,-1,1.0,0.0,0.0,0.0,3
Paysandu,1,0,0,1,1,2,-1,0,Brazil - Serie B,0.0,0.0,-1,1.0,0.0,0.0,0.0,3
Amazonas,1,0,0,1,0,1,-1,0,Brazil - Serie B,0.0,0.0,-1,0.0,0.0,0.0,0.0,3
Botafogo SP,1,0,0,1,0,1,-1,0,Brazil - Serie B,0.0,0.0,-1,0.0,0.0,0.0,0.0,3
Chapecoense,1,0,0,1,0,1,-1,0,Brazil - Serie B,0.0,0.0,-1,0.0,0.0,0.0,0.0,3
Vila Nova,1,0,0,1,0,1,-1,0,Brazil - Serie B,0.0,0.0,-1,0.0,0.0,0.0,0.0,3
Volta Redonda,1,0,0,1,0,1,-1,0,Brazil - Serie B,0.0,0.0,-1,0.0,0.0,0.0,0.0,3
ABC,0,0,0,0,0,0,0,0,Brazil - Serie C,0.0,0.0,0,0.0,0.0,0.0,0.0,1
Anapolis,0,0,0,0,0,0,0,0,Brazil - Serie C,0.0,0.0,0,0.0,0.0,0.0,0.0,1
Botafogo PB,0,0,0,0,0,0,0,0,Brazil - Serie C,0.0,0.0,0,0.0,0.0,0.0,0.0,1
Brusque,0,0,0,0,0,0,0,0,Brazil - Serie C,0.0,0.0,0,0.0,0.0,0.0,0.0,1
Caxias,0,0,0,0,0,0,0,0,Brazil - Serie C,0.0,0.0,0,0.0,0.0,0.0,0.0,1
Confianca,0,0,0,0,0,0,0,0,Brazil - Serie C,0.0,0.0,0,0.0,0.0,0.0,0.0,1
CSA,0,0,0,0,0,0,0,0,Brazil - Serie C,0.0,0.0,0,0.0,0.0,0.0,0.0,1
Figueirense,0,0,0,0,0,0,0,0,Brazil - Serie C,0.0,0.0,0,0.0,0.0,0.0,0.0,1
Floresta,0,0,0,0,0,0,0,0,Brazil - Serie C,0.0,0.0,0,0.0,0.0,0.0,0.0,1
Guarani,0,0,0,0,0,0,0,0,Brazil - Serie C,0.0,0.0,0,0.0,0.0,0.0,0.0,1
Itabaiana,0,0,0,0,0,0,0,0,Brazil - Serie C,0.0,0.0,0,0.0,0.0,0.0,0.0,1
Ituano,0,0,0,0,0,0,0,0,Brazil - Serie C,0.0,0.0,0,0.0,0.0,0.0,0.0,1
Londrina,0,0,0,0,0,0,0,0,Brazil - Serie C,0.0,0.0,0,0.0,0.0,0.0,0.0,1
Maringa,0,0,0,0,0,0,0,0,Brazil - Serie C,0.0,0.0,0,0.0,0.0,0.0,0.0,1
Nautico,0,0,0,0,0,0,0,0,Brazil - Serie C,0.0,0.0,0,0.0,0.0,0.0,0.0,1
Ponte Preta,0,0,0,0,0,0,0,0,Brazil - Serie C,0.0,0.0,0,0.0,0.0,0.0,0.0,1
Retro,0,0,0,0,0,0,0,0,Brazil - Serie C,0.0,0.0,0,0.0,0.0,0.0,0.0,1
Sao Bernardo,0,0,0,0,0,0,0,0,Brazil - Serie C,0.0,0.0,0,0.0,0.0,0.0,0.0,1
Tombense,0,0,0,0,0,0,0,0,Brazil - Serie C,0.0,0.0,0,0.0,0.0,0.0,0.0,1
Ypiranga,0,0,0,0,0,0,0,0,Brazil - Serie C,0.0,0.0,0,0.0,0.0,0.0,0.0,1
Agua Santa,0,0,0,0,0,0,0,0,Brazil - Serie D,0.0,0.0,0,0.0,0.0,0.0,0.0,1
Aguia de Maraba,0,0,0,0,0,0,0,0,Brazil - Serie D,0.0,0.0,0,0.0,0.0,0.0,0.0,1
Altos,0,0,0,0,0,0,0,0,Brazil - Serie D,0.0,0.0,0,0.0,0.0,0.0,0.0,1
America RN,0,0,0,0,0,0,0,0,Brazil - Serie D,0.0,0.0,0,0.0,0.0,0.0,0.0,1
Aparecidense,0,0,0,0,0,0,0,0,Brazil - Serie D,0.0,0.0,0,0.0,0.0,0.0,0.0,1
ASA,0,0,0,0,0,0,0,0,Brazil - Serie D,0.0,0.0,0,0.0,0.0,0.0,0.0,1
Azuriz,0,0,0,0,0,0,0,0,Brazil - Serie D,0.0,0.0,0,0.0,0.0,0.0,0.0,1
Barcelona BA,0,0,0,0,0,0,0,0,Brazil - Serie D,0.0,0.0,0,0.0,0.0,0.0,0.0,1
Barra FC,0,0,0,0,0,0,0,0,Brazil - Serie D,0.0,0.0,0,0.0,0.0,0.0,0.0,1
Boavista,0,0,0,0,0,0,0,0,Brazil - Serie D,0.0,0.0,0,0.0,0.0,0.0,0.0,1
Brasil de P.,0,0,0,0,0,0,0,0,Brazil - Serie D,0.0,0.0,0,0.0,0.0,0.0,0.0,1
Capital,0,0,0,0,0,0,0,0,Brazil - Serie D,0.0,0.0,0,0.0,0.0,0.0,0.0,1
Cascavel,0,0,0,0,0,0,0,0,Brazil - Serie D,0.0,0.0,0,0.0,0.0,0.0,0.0,1
Ceilandia,0,0,0,0,0,0,0,0,Brazil - Serie D,0.0,0.0,0,0.0,0.0,0.0,0.0,1
Central,0,0,0,0,0,0,0,0,Brazil - Serie D,0.0,0.0,0,0.0,0.0,0.0,0.0,1
CFRJ . Marica,0,0,0,0,0,0,0,0,Brazil - Serie D,0.0,0.0,0,0.0,0.0,0.0,0.0,1
Cianorte,0,0,0,0,0,0,0,0,Brazil - Serie D,0.0,0.0,0,0.0,0.0,0.0,0.0,1
EC Sao Jose,0,0,0,0,0,0,0,0,Brazil - Serie D,0.0,0.0,0,0.0,0.0,0.0,0.0,1
Ferroviario,0,0,0,0,0,0,0,0,Brazil - Serie D,0.0,0.0,0,0.0,0.0,0.0,0.0,1
GAS,0,0,0,0,0,0,0,0,Brazil - Serie D,0.0,0.0,0,0.0,0.0,0.0,0.0,1
Goianesia,0,0,0,0,0,0,0,0,Brazil - Serie D,0.0,0.0,0,0.0,0.0,0.0,0.0,1
Goiania,0,0,0,0,0,0,0,0,Brazil - Serie D,0.0,0.0,0,0.0,0.0,0.0,0.0,1
Goiatuba EC,0,0,0,0,0,0,0,0,Brazil - Serie D,0.0,0.0,0,0.0,0.0,0.0,0.0,1
Guarany de Bage,0,0,0,0,0,0,0,0,Brazil - Serie D,0.0,0.0,0,0.0,0.0,0.0,0.0,1
Horizonte,0,0,0,0,0,0,0,0,Brazil - Serie D,0.0,0.0,0,0.0,0.0,0.0,0.0,1
Humaita,0,0,0,0,0,0,0,0,Brazil - Serie D,0.0,0.0,0,0.0,0.0,0.0,0.0,1
Iguatu,0,0,0,0,0,0,0,0,Brazil - Serie D,0.0,0.0,0,0.0,0.0,0.0,0.0,1
Imperatriz,0,0,0,0,0,0,0,0,Brazil - Serie D,0.0,0.0,0,0.0,0.0,0.0,0.0,1
Independencia,0,0,0,0,0,0,0,0,Brazil - Serie D,0.0,0.0,0,0.0,0.0,0.0,0.0,1
Flamengo,8,7,1,0,22,0,22,22,Brazil - Carioca,0.88,1.0,22,2.75,2.75,1.14,1.0,1
Fluminense,8,4,3,1,12,7,5,15,Brazil - Carioca,0.5,0.88,5,1.5,1.88,2.0,1.14,2
Vasco da Gama,8,4,2,2,11,7,4,14,Brazil - Carioca,0.5,0.75,4,1.38,1.75,2.0,1.33,3
Volta Redonda,8,4,2,2,11,10,1,14,Brazil - Carioca,0.5,0.75,1,1.38,1.75,2.0,1.33,3
Sampaio Correa,8,3,3,2,11,9,2,12,Brazil - Carioca,0.38,0.75,2,1.38,1.5,2.63,1.33,4
Madureira,8,3,2,3,7,5,2,11,Brazil - Carioca,0.38,0.62,2,0.88,1.38,2.63,1.61,5
Boavista,8,1,7,0,7,5,2,10,Brazil - Carioca,0.12,1.0,2,0.88,1.25,8.33,1.0,6
Botafogo,8,3,1,4,7,8,-1,10,Brazil - Carioca,0.38,0.5,-1,0.88,1.25,2.63,2.0,6
Nova Iguacu,8,2,3,3,4,7,-3,9,Brazil - Carioca,0.25,0.62,-3,0.5,1.12,4.0,1.61,7
CFRJ . Marica,8,1,2,5,7,15,-8,5,Brazil - Carioca,0.12,0.38,-8,0.88,0.62,8.33,2.63,8
Portuguesa RJ,8,1,1,6,9,21,-12,4,Brazil - Carioca,0.12,0.25,-12,1.12,0.5,8.33,4.0,9
Bangu,8,0,3,5,4,18,-14,3,Brazil - Carioca,0.0,0.38,-14,0.5,0.38,0.0,2.63,10
Atletico MG,8,4,4,0,9,2,7,16,Brazil - Mineiro,0.5,1.0,7,1.12,2.0,2.0,1.0,1
Tombense,8,5,1,2,8,5,3,16,Brazil - Mineiro,0.62,0.75,3,1.0,2.0,1.61,1.33,1
Betim,8,4,3,1,12,5,7,15,Brazil - Mineiro,0.5,0.88,7,1.5,1.88,2.0,1.14,2
America MG,8,3,4,1,14,5,9,13,Brazil - Mineiro,0.38,0.88,9,1.75,1.62,2.63,1.14,3
Athletic Club,8,4,0,4,12,12,0,12,Brazil - Mineiro,0.5,0.5,0,1.5,1.5,2.0,2.0,4
Cruzeiro,8,3,2,3,11,9,2,11,Brazil - Mineiro,0.38,0.62,2,1.38,1.38,2.63,1.61,5
Democrata GV,8,3,2,3,8,9,-1,11,Brazil - Mineiro,0.38,0.62,-1,1.0,1.38,2.63,1.61,5
Uberlandia,8,2,3,3,10,10,0,9,Brazil - Mineiro,0.25,0.62,0,1.25,1.12,4.0,1.61,6
Itabirito,8,2,2,4,7,11,-4,8,Brazil - Mineiro,0.25,0.5,-4,0.88,1.0,4.0,2.0,7
Pouso Alegre,8,2,2,4,7,15,-8,8,Brazil - Mineiro,0.25,0.5,-8,0.88,1.0,4.0,2.0,7
Aymores,8,1,4,3,3,5,-2,7,Brazil - Mineiro,0.12,0.62,-2,0.38,0.88,8.33,1.61,8
Villa Nova,8,1,1,6,4,17,-13,4,Brazil - Mineiro,0.12,0.25,-13,0.5,0.5,8.33,4.0,9
Anapolis,8,6,0,2,13,6,7,18,Brazil - Goiano,0.75,0.75,7,1.62,2.25,1.33,1.33,1
Vila Nova,8,4,3,1,8,5,3,15,Brazil - Goiano,0.5,0.88,3,1.0,1.88,2.0,1.14,2
Atletico GO,8,4,2,2,10,6,4,14,Brazil - Goiano,0.5,0.75,4,1.25,1.75,2.0,1.33,3
CRAC,8,4,2,2,7,4,3,14,Brazil - Goiano,0.5,0.75,3,0.88,1.75,2.0,1.33,3
Goias,8,4,2,2,7,5,2,14,Brazil - Goiano,0.5,0.75,2,0.88,1.75,2.0,1.33,3
Goianesia,8,2,4,2,11,9,2,10,Brazil - Goiano,0.25,0.75,2,1.38,1.25,4.0,1.33,4
ABECAT Ouvidore,8,3,1,4,8,10,-2,10,Brazil - Goiano,0.38,0.5,-2,1.0,1.25,2.63,2.0,4
Goiatuba EC,8,2,4,2,4,6,-2,10,Brazil - Goiano,0.25,0.75,-2,0.5,1.25,4.0,1.33,4
Jataiense,8,3,0,5,10,10,0,9,Brazil - Goiano,0.38,0.38,0,1.25,1.12,2.63,2.63,5
Goiania,8,2,1,5,8,14,-6,7,Brazil - Goiano,0.25,0.38,-6,1.0,0.88,4.0,2.63,6
Aparecidense,8,1,3,4,4,7,-3,6,Brazil - Goiano,0.12,0.5,-3,0.5,0.75,8.33,2.0,7
Inhumas,8,1,2,5,5,13,-8,5,Brazil - Goiano,0.12,0.38,-8,0.62,0.62,8.33,2.63,8
Santa Cruz,8,6,1,1,13,3,10,19,Brazil - Pernambucano,0.75,0.88,10,1.62,2.38,1.33,1.14,1
Nautico,8,5,0,3,14,8,6,15,Brazil - Pernambucano,0.62,0.62,6,1.75,1.88,1.61,1.61,2
Sport Recife,8,4,2,2,16,7,9,14,Brazil - Pernambucano,0.5,0.75,9,2.0,1.75,2.0,1.33,3
Maguary PE,8,4,2,2,10,9,1,14,Brazil - Pernambucano,0.5,0.75,1,1.25,1.75,2.0,1.33,3
Retro,8,3,3,2,7,7,0,12,Brazil - Pernambucano,0.38,0.75,0,0.88,1.5,2.63,1.33,4
Decisao,8,3,3,2,10,11,-1,12,Brazil - Pernambucano,0.38,0.75,-1,1.25,1.5,2.63,1.33,4
Jaguar,8,3,1,4,10,16,-6,10,Brazil - Pernambucano,0.38,0.5,-6,1.25,1.25,2.63,2.0,5
Central,8,2,2,4,8,9,-1,8,Brazil - Pernambucano,0.25,0.5,-1,1.0,1.0,4.0,2.0,6
Afogados,8,0,4,4,4,12,-8,4,Brazil - Pernambucano,0.0,0.5,-8,0.5,0.5,0.0,2.0,7
Petrolina,8,0,2,6,3,13,-10,2,Brazil - Pernambucano,0.0,0.25,-10,0.38,0.25,0.0,4.0,8
Corinthians,8,5,3,0,13,7,6,18,Brazil - Paulista,0.62,1.0,6,1.62,2.25,1.61,1.0,1
Palmeiras,8,4,4,0,15,6,9,16,Brazil - Paulista,0.5,1.0,9,1.88,2.0,2.0,1.0,2
Ponte Preta,8,5,1,2,9,6,3,16,Brazil - Paulista,0.62,0.75,3,1.12,2.0,1.61,1.33,2
Santos,8,4,2,2,15,8,7,14,Brazil - Paulista,0.5,0.75,7,1.88,1.75,2.0,1.33,3
Bragantino,8,4,2,2,10,5,5,14,Brazil - Paulista,0.5,0.75,5,1.25,1.75,2.0,1.33,3
Sao Bernardo,8,4,2,2,12,11,1,14,Brazil - Paulista,0.5,0.75,1,1.5,1.75,2.0,1.33,3
Novorizontino,8,3,4,1,8,6,2,13,Brazil - Paulista,0.38,0.88,2,1.0,1.62,2.63,1.14,4
Portuguesa,8,2,5,1,12,10,2,11,Brazil - Paulista,0.25,0.88,2,1.5,1.38,4.0,1.14,5
Velo Clube,8,2,4,2,10,10,0,10,Brazil - Paulista,0.25,0.75,0,1.25,1.25,4.0,1.33,6
Sao Paulo,8,2,3,3,12,11,1,9,Brazil - Paulista,0.25,0.62,1,1.5,1.12,4.0,1.61,7
Botafogo SP,8,2,3,3,8,10,-2,9,Brazil - Paulista,0.25,0.62,-2,1.0,1.12,4.0,1.61,7
Mirassol,8,2,1,5,10,17,-7,7,Brazil - Paulista,0.25,0.38,-7,1.25,0.88,4.0,2.63,8
Guarani,8,1,3,4,10,13,-3,6,Brazil - Paulista,0.12,0.5,-3,1.25,0.75,8.33,2.0,9
Agua Santa,8,0,4,4,5,13,-8,4,Brazil - Paulista,0.0,0.5,-8,0.62,0.5,0.0,2.0,10
Noroeste,8,0,3,5,9,16,-7,3,Brazil - Paulista,0.0,0.38,-7,1.12,0.38,0.0,2.63,11
Inter Limeira,8,0,3,5,5,15,-10,3,Brazil - Paulista,0.0,0.38,-10,0.62,0.38,0.0,2.63,11
Treze,8,5,2,1,17,7,10,17,Brazil - Paraibano,0.62,0.88,10,2.12,2.12,1.61,1.14,1
Sousa,8,5,2,1,12,3,9,17,Brazil - Paraibano,0.62,0.88,9,1.5,2.12,1.61,1.14,1
Botafogo PB,8,5,1,2,15,6,9,16,Brazil - Paraibano,0.62,0.75,9,1.88,2.0,1.61,1.33,2
Serra Branca,8,4,2,2,20,8,12,14,Brazil - Paraibano,0.5,0.75,12,2.5,1.75,2.0,1.33,3
Campinense,8,4,2,2,14,9,5,14,Brazil - Paraibano,0.5,0.75,5,1.75,1.75,2.0,1.33,3
Pombal,8,2,3,3,7,8,-1,9,Brazil - Paraibano,0.25,0.62,-1,0.88,1.12,4.0,1.61,4
Nacional Patos,8,2,3,3,13,17,-4,9,Brazil - Paraibano,0.25,0.62,-4,1.62,1.12,4.0,1.61,4
EC de Patos,8,2,1,5,11,16,-5,7,Brazil - Paraibano,0.25,0.38,-5,1.38,0.88,4.0,2.63,5
Auto Esporte,8,1,3,4,8,15,-7,6,Brazil - Paraibano,0.12,0.5,-7,1.0,0.75,8.33,2.0,6
Picuiense,8,0,1,7,5,33,-28,1,Brazil - Paraibano,0.0,0.12,-28,0.62,0.12,0.0,8.33,7
Santa Catarina,8,4,3,1,14,9,5,15,Brazil - Catarinense,0.5,0.88,5,1.75,1.88,2.0,1.14,1
Brusque,8,4,2,2,12,6,6,14,Brazil - Catarinense,0.5,0.75,6,1.5,1.75,2.0,1.33,2
Avai,8,4,1,3,12,6,6,13,Brazil - Catarinense,0.5,0.62,6,1.5,1.62,2.0,1.61,3
Criciuma,8,3,4,1,10,4,6,13,Brazil - Catarinense,0.38,0.88,6,1.25,1.62,2.63,1.14,3
Figueirense,8,4,1,3,16,11,5,13,Brazil - Catarinense,0.5,0.62,5,2.0,1.62,2.0,1.61,3
Barra FC,8,3,3,2,6,7,-1,12,Brazil - Catarinense,0.38,0.75,-1,0.75,1.5,2.63,1.33,4
Marcilio Dias,8,2,4,2,7,8,-1,10,Brazil - Catarinense,0.25,0.75,-1,0.88,1.25,4.0,1.33,5
Concordia,8,3,1,4,8,15,-7,10,Brazil - Catarinense,0.38,0.5,-7,1.0,1.25,2.63,2.0,5
Chapecoense,8,1,6,1,10,9,1,9,Brazil - Catarinense,0.12,0.88,1,1.25,1.12,8.33,1.14,6
Joinville,8,2,3,3,9,14,-5,9,Brazil - Catarinense,0.25,0.62,-5,1.12,1.12,4.0,1.61,6
Caravaggio,8,2,1,5,5,12,-7,7,Brazil - Catarinense,0.25,0.38,-7,0.62,0.88,4.0,2.63,7
Hercilio Luz,8,1,2,5,6,13,-7,5,Brazil - Catarinense,0.12,0.38,-7,0.75,0.62,8.33,2.63,8
Internacional,8,6,2,0,16,4,12,20,Brazil - Gaucho,0.75,1.0,12,2.0,2.5,1.33,1.0,1
Juventude,8,6,1,1,14,6,8,19,Brazil - Gaucho,0.75,0.88,8,1.75,2.38,1.33,1.14,2
Gremio,8,5,2,1,19,3,16,17,Brazil - Gaucho,0.62,0.88,16,2.38,2.12,1.61,1.14,3
Caxias,8,4,2,2,8,9,-1,14,Brazil - Gaucho,0.5,0.75,-1,1.0,1.75,2.0,1.33,4
Ypiranga,8,3,3,2,6,6,0,12,Brazil - Gaucho,0.38,0.75,0,0.75,1.5,2.63,1.33,5
Guarany de Bage,8,2,3,3,6,6,0,9,Brazil - Gaucho,0.25,0.62,0,0.75,1.12,4.0,1.61,6
Sao Luiz,8,2,3,3,7,13,-6,9,Brazil - Gaucho,0.25,0.62,-6,0.88,1.12,4.0,1.61,6
Brasil de P.,8,1,4,3,5,10,-5,7,Brazil - Gaucho,0.12,0.62,-5,0.62,0.88,8.33,1.61,7
Monsoon,8,2,1,5,7,14,-7,7,Brazil - Gaucho,0.25,0.38,-7,0.88,0.88,4.0,2.63,7
Pelotas,8,1,3,4,6,13,-7,6,Brazil - Gaucho,0.12,0.5,-7,0.75,0.75,8.33,2.0,8
EC Sao Jose,8,0,5,3,5,10,-5,5,Brazil - Gaucho,0.0,0.62,-5,0.62,0.62,0.0,1.61,9
Avenida,8,0,3,5,4,9,-5,3,Brazil - Gaucho,0.0,0.38,-5,0.5,0.38,0.0,2.63,10
CSKA Sofia,8,5,3,0,13,4,9,18,Bulgaria - Parva Liga,0.62,1.0,9,1.62,2.25,1.61,1.0,1
Levski Sofia,8,4,4,0,16,8,8,16,Bulgaria - Parva Liga,0.5,1.0,8,2.0,2.0,2.0,1.0,2
Arda,8,4,3,1,16,6,10,15,Bulgaria - Parva Liga,0.5,0.88,10,2.0,1.88,2.0,1.14,3
Ludogorets,8,4,2,2,12,6,6,14,Bulgaria - Parva Liga,0.5,0.75,6,1.5,1.75,2.0,1.33,4
Lok. Plovdiv,8,4,2,2,6,4,2,14,Bulgaria - Parva Liga,0.5,0.75,2,0.75,1.75,2.0,1.33,4
CSKA 1948 Sofia,8,4,1,3,14,10,4,13,Bulgaria - Parva Liga,0.5,0.62,4,1.75,1.62,2.0,1.61,5
Septemvri Sofia,8,4,1,3,13,12,1,13,Bulgaria - Parva Liga,0.5,0.62,1,1.62,1.62,2.0,1.61,5
Lokomotiv Sofia,8,4,0,4,12,9,3,12,Bulgaria - Parva Liga,0.5,0.5,3,1.5,1.5,2.0,2.0,6
Spartak Varna,8,3,2,3,10,12,-2,11,Bulgaria - Parva Liga,0.38,0.62,-2,1.25,1.38,2.63,1.61,7
Slavia Sofia,8,2,4,2,15,15,0,10,Bulgaria - Parva Liga,0.25,0.75,0,1.88,1.25,4.0,1.33,8
Cherno More,8,1,6,1,7,10,-3,9,Bulgaria - Parva Liga,0.12,0.88,-3,0.88,1.12,8.33,1.14,9
Beroe,8,2,1,5,8,12,-4,7,Bulgaria - Parva Liga,0.25,0.38,-4,1.0,0.88,4.0,2.63,10
L. Krumovgrad,8,1,3,4,3,11,-8,6,Bulgaria - Parva Liga,0.12,0.5,-8,0.38,0.75,8.33,2.0,11
Botev Vratsa,8,1,2,5,2,10,-8,5,Bulgaria - Parva Liga,0.12,0.38,-8,0.25,0.62,8.33,2.63,12
Botev Plovdiv,8,0,4,4,5,15,-10,4,Bulgaria - Parva Liga,0.0,0.5,-10,0.62,0.5,0.0,2.0,13
Hebar,8,1,1,6,5,16,-11,4,Bulgaria - Parva Liga,0.12,0.25,-11,0.62,0.5,8.33,4.0,13
Pacific,1,1,0,0,2,0,2,3,Canada - Premier League,1.0,1.0,2,2.0,3.0,1.0,1.0,1
York Utd,1,1,0,0,2,0,2,3,Canada - Premier League,1.0,1.0,2,2.0,3.0,1.0,1.0,1
Forge,1,1,0,0,1,0,1,3,Canada - Premier League,1.0,1.0,1,1.0,3.0,1.0,1.0,1
A. Ottawa,1,0,1,0,2,2,0,1,Canada - Premier League,0.0,1.0,0,2.0,1.0,0.0,1.0,2
HFX Wanderers,1,0,1,0,2,2,0,1,Canada - Premier League,0.0,1.0,0,2.0,1.0,0.0,1.0,2
Cavalry,1,0,0,1,0,1,-1,0,Canada - Premier League,0.0,0.0,-1,0.0,0.0,0.0,0.0,3
Valour,1,0,0,1,0,2,-2,0,Canada - Premier League,0.0,0.0,-2,0.0,0.0,0.0,0.0,3
Vancouver FC,1,0,0,1,0,2,-2,0,Canada - Premier League,0.0,0.0,-2,0.0,0.0,0.0,0.0,3
Coquimbo Unido,6,4,2,0,9,3,6,14,Chile - Primera Division,0.67,1.0,6,1.5,2.33,1.49,1.0,1
Huachipato,6,4,1,1,12,5,7,13,Chile - Primera Division,0.67,0.83,7,2.0,2.17,1.49,1.2,2
Palestino,6,4,1,1,11,5,6,13,Chile - Primera Division,0.67,0.83,6,1.83,2.17,1.49,1.2,2
Union La Calera,6,3,1,2,9,5,4,10,Chile - Primera Division,0.5,0.67,4,1.5,1.67,2.0,1.49,3
Audax Italiano,6,3,1,2,12,9,3,10,Chile - Primera Division,0.5,0.67,3,2.0,1.67,2.0,1.49,3
OHiggins,6,2,4,0,7,4,3,10,Chile - Primera Division,0.33,1.0,3,1.17,1.67,3.03,1.0,3
U. Catolica,5,3,1,1,7,4,3,10,Chile - Primera Division,0.6,0.8,3,1.4,2.0,1.67,1.25,3
Cobresal,6,2,2,2,8,7,1,8,Chile - Primera Division,0.33,0.67,1,1.33,1.33,3.03,1.49,4
U. de Chile,5,2,1,2,8,5,3,7,Chile - Primera Division,0.4,0.6,3,1.6,1.4,2.5,1.67,5
Colo-Colo,5,2,1,2,7,5,2,7,Chile - Primera Division,0.4,0.6,2,1.4,1.4,2.5,1.67,5
La Serena,6,2,1,3,6,10,-4,7,Chile - Primera Division,0.33,0.5,-4,1.0,1.17,3.03,2.0,5
Nublense,6,1,3,2,5,11,-6,6,Chile - Primera Division,0.17,0.67,-6,0.83,1.0,5.88,1.49,6
Everton,6,1,2,3,4,9,-5,5,Chile - Primera Division,0.17,0.5,-5,0.67,0.83,5.88,2.0,7
Union Espanola,5,1,0,4,5,10,-5,3,Chile - Primera Division,0.2,0.2,-5,1.0,0.6,5.0,5.0,8
D. Limache,6,0,2,4,7,13,-6,2,Chile - Primera Division,0.0,0.33,-6,1.17,0.33,0.0,3.03,9
D. Iquique,6,0,1,5,4,16,-12,1,Chile - Primera Division,0.0,0.17,-12,0.67,0.17,0.0,5.88,10
Copiapo,5,3,2,0,10,3,7,11,Chile - Primera B,0.6,1.0,7,2.0,2.2,1.67,1.0,1
S. Wanderers,5,3,1,1,7,4,3,10,Chile - Primera B,0.6,0.8,3,1.4,2.0,1.67,1.25,2
U. Concepcion,5,3,1,1,6,3,3,10,Chile - Primera B,0.6,0.8,3,1.2,2.0,1.67,1.25,2
Recoleta,5,3,1,1,5,5,0,10,Chile - Primera B,0.6,0.8,0,1.0,2.0,1.67,1.25,2
Rangers,5,2,2,1,7,6,1,8,Chile - Primera B,0.4,0.8,1,1.4,1.6,2.5,1.25,3
Magallanes,5,2,1,2,6,4,2,7,Chile - Primera B,0.4,0.6,2,1.2,1.4,2.5,1.67,4
San Marcos,5,2,1,2,7,6,1,7,Chile - Primera B,0.4,0.6,1,1.4,1.4,2.5,1.67,4
Cobreloa,5,1,3,1,7,7,0,6,Chile - Primera B,0.2,0.8,0,1.4,1.2,5.0,1.25,5
Curico Unido,5,1,3,1,6,6,0,6,Chile - Primera B,0.2,0.8,0,1.2,1.2,5.0,1.25,5
San Luis,5,1,3,1,5,5,0,6,Chile - Primera B,0.2,0.8,0,1.0,1.2,5.0,1.25,5
S. Morning,5,1,2,2,4,5,-1,5,Chile - Primera B,0.2,0.6,-1,0.8,1.0,5.0,1.67,6
Deportes Temuco,5,1,2,2,6,8,-2,5,Chile - Primera B,0.2,0.6,-2,1.2,1.0,5.0,1.67,6
Antofagasta,5,1,2,2,5,9,-4,5,Chile - Primera B,0.2,0.6,-4,1.0,1.0,5.0,1.67,6
CD Santa Cruz,5,1,1,3,5,8,-3,4,Chile - Primera B,0.2,0.4,-3,1.0,0.8,5.0,2.5,7
Concepcion,5,1,1,3,6,10,-4,4,Chile - Primera B,0.2,0.4,-4,1.2,0.8,5.0,2.5,7
U. San Felipe,5,0,2,3,2,5,-3,2,Chile - Primera B,0.0,0.4,-3,0.4,0.4,0.0,2.5,8
S. Shenhua,5,3,2,0,11,6,5,11,China - Super League,0.6,1.0,5,2.2,2.2,1.67,1.0,1
Shanghai Port,5,3,2,0,11,6,5,11,China - Super League,0.6,1.0,5,2.2,2.2,1.67,1.0,1
Chengdu,5,3,1,1,8,3,5,10,China - Super League,0.6,0.8,5,1.6,2.0,1.67,1.25,2
Shandong T.,5,3,1,1,10,8,2,10,China - Super League,0.6,0.8,2,2.0,2.0,1.67,1.25,2
Beijing Guoan,5,2,3,0,9,5,4,9,China - Super League,0.4,1.0,4,1.8,1.8,2.5,1.0,3
Qingdao West C.,5,2,3,0,12,9,3,9,China - Super League,0.4,1.0,3,2.4,1.8,2.5,1.0,3
Tianjin T.,5,2,3,0,9,7,2,9,China - Super League,0.4,1.0,2,1.8,1.8,2.5,1.0,3
Zhejiang,5,2,2,1,9,4,5,8,China - Super League,0.4,0.8,5,1.8,1.6,2.5,1.25,4
Meizhou Hakka,5,2,1,2,11,10,1,7,China - Super League,0.4,0.6,1,2.2,1.4,2.5,1.67,5
Yunnan Yukun,5,2,1,2,7,9,-2,7,China - Super League,0.4,0.6,-2,1.4,1.4,2.5,1.67,5
Dalian Yingbo,5,1,2,2,5,8,-3,5,China - Super League,0.2,0.6,-3,1.0,1.0,5.0,1.67,6
Henan SL,5,1,1,3,7,9,-2,4,China - Super League,0.2,0.4,-2,1.4,0.8,5.0,2.5,7
Sichuan Jiuniu,5,1,0,4,6,13,-7,3,China - Super League,0.2,0.2,-7,1.2,0.6,5.0,5.0,8
Qingdao Hainiu,5,0,2,3,3,6,-3,2,China - Super League,0.0,0.4,-3,0.6,0.4,0.0,2.5,9
Changchun Yatai,5,0,1,4,3,9,-6,1,China - Super League,0.0,0.2,-6,0.6,0.2,0.0,5.0,10
Wuhan Three T.,5,0,1,4,2,11,-9,1,China - Super League,0.0,0.2,-9,0.4,0.2,0.0,5.0,10
Guangdong GZP,3,2,1,0,7,1,6,7,China - League One,0.67,1.0,6,2.33,2.33,1.49,1.0,1
Chongqing T.,3,2,1,0,6,2,4,7,China - League One,0.67,1.0,4,2.0,2.33,1.49,1.0,1
S. Gongfu,3,2,1,0,6,2,4,7,China - League One,0.67,1.0,4,2.0,2.33,1.49,1.0,1
Liaoning Tieren,3,2,0,1,6,3,3,6,China - League One,0.67,0.67,3,2.0,2.0,1.49,1.49,2
Suzhou Dongwu,3,1,2,0,2,0,2,5,China - League One,0.33,1.0,2,0.67,1.67,3.03,1.0,3
Shaanxi Union,3,1,1,1,4,3,1,4,China - League One,0.33,0.67,1,1.33,1.33,3.03,1.49,4
Nanjing City,3,1,1,1,2,2,0,4,China - League One,0.33,0.67,0,0.67,1.33,3.03,1.49,4
Dalian Kuncheng,3,1,1,1,2,3,-1,4,China - League One,0.33,0.67,-1,0.67,1.33,3.03,1.49,4
Nantong Zhiyun,3,1,1,1,1,2,-1,4,China - League One,0.33,0.67,-1,0.33,1.33,3.03,1.49,4
Qingdao RL,3,0,3,0,2,2,0,3,China - League One,0.0,1.0,0,0.67,1.0,0.0,1.0,5
Foshan Nanshi,3,1,0,2,3,5,-2,3,China - League One,0.33,0.33,-2,1.0,1.0,3.03,3.03,5
Shanghai Jiadin,3,1,0,2,2,4,-2,3,China - League One,0.33,0.33,-2,0.67,1.0,3.03,3.03,5
Shenzhen J.,3,1,0,2,3,6,-3,3,China - League One,0.33,0.33,-3,1.0,1.0,3.03,3.03,5
Heilongjiang IC,3,0,2,1,4,6,-2,2,China - League One,0.0,0.67,-2,1.33,0.67,0.0,1.49,6
Guangxi Baoyun,3,0,1,2,0,4,-4,1,China - League One,0.0,0.33,-4,0.0,0.33,0.0,3.03,7
Yanbian Longdin,3,0,1,2,2,7,-5,1,China - League One,0.0,0.33,-5,0.67,0.33,0.0,3.03,7
Changchun Xidu,3,3,0,0,6,2,4,9,China - League Two,1.0,1.0,4,2.0,3.0,1.0,1.0,1
Wuxi Wugou,3,2,1,0,6,1,5,7,China - League Two,0.67,1.0,5,2.0,2.33,1.49,1.0,2
Guizhou Zhuchen,3,2,1,0,4,0,4,7,China - League Two,0.67,1.0,4,1.33,2.33,1.49,1.0,2
Chengdu Rongche,3,2,1,0,5,2,3,7,China - League Two,0.67,1.0,3,1.67,2.33,1.49,1.0,2
Shanghai Port B,3,2,0,1,7,2,5,6,China - League Two,0.67,0.67,5,2.33,2.0,1.49,1.49,3
Guangzhou Dande,3,2,0,1,6,2,4,6,China - League Two,0.67,0.67,4,2.0,2.0,1.49,1.49,3
Shandong T. B,3,1,2,0,4,2,2,5,China - League Two,0.33,1.0,2,1.33,1.67,3.03,1.0,4
Langfang Glory,3,1,2,0,4,3,1,5,China - League Two,0.33,1.0,1,1.33,1.67,3.03,1.0,4
Jiangxi DH,3,1,2,0,3,2,1,5,China - League Two,0.33,1.0,1,1.0,1.67,3.03,1.0,4
Jiangxi Lushan,3,1,2,0,3,2,1,5,China - League Two,0.33,1.0,1,1.0,1.67,3.03,1.0,4
Ganzhou Ruishi,3,1,2,0,2,1,1,5,China - League Two,0.33,1.0,1,0.67,1.67,3.03,1.0,4
Guangxi H.,3,1,1,1,3,3,0,4,China - League Two,0.33,0.67,0,1.0,1.33,3.03,1.49,5
Haikou M.,3,0,3,0,3,3,0,3,China - League Two,0.0,1.0,0,1.0,1.0,0.0,1.0,6
Wuhan Three Tow,3,0,3,0,2,2,0,3,China - League Two,0.0,1.0,0,0.67,1.0,0.0,1.0,6
Shenzhen 2028,3,1,0,2,1,3,-2,3,China - League Two,0.33,0.33,-2,0.33,1.0,3.03,3.03,6
Hubei Istar,3,0,2,1,1,3,-2,2,China - League Two,0.0,0.67,-2,0.33,0.67,0.0,1.49,7
Quanzhou Yassin,3,0,2,1,1,3,-2,2,China - League Two,0.0,0.67,-2,0.33,0.67,0.0,1.49,7
Rizhao Yuqi,3,0,2,1,1,3,-2,2,China - League Two,0.0,0.67,-2,0.33,0.67,0.0,1.49,7
Nantong Haimen,3,0,2,1,3,7,-4,2,China - League Two,0.0,0.67,-4,1.0,0.67,0.0,1.49,7
Xian Ronghai,3,0,2,1,1,6,-5,2,China - League Two,0.0,0.67,-5,0.33,0.67,0.0,1.49,7
Taian Tiankuang,3,0,1,2,2,4,-2,1,China - League Two,0.0,0.33,-2,0.67,0.33,0.0,3.03,8
Guangxi Lanhang,3,0,1,2,0,4,-4,1,China - League Two,0.0,0.33,-4,0.0,0.33,0.0,3.03,8
Beijing IT,3,0,0,3,1,4,-3,0,China - League Two,0.0,0.0,-3,0.33,0.0,0.0,0.0,9
Guangdong Mingt,3,0,0,3,1,6,-5,0,China - League Two,0.0,0.0,-5,0.33,0.0,0.0,0.0,9
Junior,8,6,1,1,11,5,6,19,Colombia - Primera A - Apertura,0.75,0.88,6,1.38,2.38,1.33,1.14,1
Santa Fe,8,5,2,1,16,7,9,17,Colombia - Primera A - Apertura,0.62,0.88,9,2.0,2.12,1.61,1.14,2
Millonarios,8,5,0,3,13,8,5,15,Colombia - Primera A - Apertura,0.62,0.62,5,1.62,1.88,1.61,1.61,3
Deportivo Pasto,8,4,3,1,8,5,3,15,Colombia - Primera A - Apertura,0.5,0.88,3,1.0,1.88,2.0,1.14,3
Deportivo Cali,8,3,5,0,11,6,5,14,Colombia - Primera A - Apertura,0.38,1.0,5,1.38,1.75,2.63,1.0,4
America de Cali,8,4,2,2,10,5,5,14,Colombia - Primera A - Apertura,0.5,0.75,5,1.25,1.75,2.0,1.33,4
A. Nacional,8,4,2,2,14,10,4,14,Colombia - Primera A - Apertura,0.5,0.75,4,1.75,1.75,2.0,1.33,4
Deportes Tolima,8,4,2,2,13,9,4,14,Colombia - Primera A - Apertura,0.5,0.75,4,1.62,1.75,2.0,1.33,4
I. Medelin,8,3,4,1,6,2,4,13,Colombia - Primera A - Apertura,0.38,0.88,4,0.75,1.62,2.63,1.14,5
Once Caldas,8,4,1,3,10,7,3,13,Colombia - Primera A - Apertura,0.5,0.62,3,1.25,1.62,2.0,1.61,5
A. Bucaramanga,8,3,3,2,8,6,2,12,Colombia - Primera A - Apertura,0.38,0.75,2,1.0,1.5,2.63,1.33,6
D. Pereira,8,3,2,3,9,9,0,11,Colombia - Primera A - Apertura,0.38,0.62,0,1.12,1.38,2.63,1.61,7
A. Petrolera,8,3,1,4,8,12,-4,10,Colombia - Primera A - Apertura,0.38,0.5,-4,1.0,1.25,2.63,2.0,8
Envigado,8,3,1,4,8,15,-7,10,Colombia - Primera A - Apertura,0.38,0.5,-7,1.0,1.25,2.63,2.0,8
Llaneros,8,3,0,5,5,9,-4,9,Colombia - Primera A - Apertura,0.38,0.38,-4,0.62,1.12,2.63,2.63,9
Boyaca Chico,8,1,5,2,5,10,-5,8,Colombia - Primera A - Apertura,0.12,0.75,-5,0.62,1.0,8.33,1.33,10
R. Aguilas,8,1,2,5,4,8,-4,5,Colombia - Primera A - Apertura,0.12,0.38,-4,0.5,0.62,8.33,2.63,11
La Equidad,8,0,3,5,3,9,-6,3,Colombia - Primera A - Apertura,0.0,0.38,-6,0.38,0.38,0.0,2.63,12
Fortaleza CEIF,8,0,3,5,3,14,-11,3,Colombia - Primera A - Apertura,0.0,0.38,-11,0.38,0.38,0.0,2.63,12
Union Magdalena,8,0,2,6,6,13,-7,2,Colombia - Primera A - Apertura,0.0,0.25,-7,0.75,0.25,0.0,4.0,13
I. Medelin,8,5,2,1,15,6,9,17,Colombia - Primera A - Clausura,0.62,0.88,9,1.88,2.12,1.61,1.14,1
Millonarios,8,5,2,1,11,4,7,17,Colombia - Primera A - Clausura,0.62,0.88,7,1.38,2.12,1.61,1.14,1
Junior,8,4,3,1,11,4,7,15,Colombia - Primera A - Clausura,0.5,0.88,7,1.38,1.88,2.0,1.14,2
Santa Fe,8,4,3,1,12,6,6,15,Colombia - Primera A - Clausura,0.5,0.88,6,1.5,1.88,2.0,1.14,2
D. Pereira,8,4,3,1,12,9,3,15,Colombia - Primera A - Clausura,0.5,0.88,3,1.5,1.88,2.0,1.14,2
Deportes Tolima,8,4,2,2,9,4,5,14,Colombia - Primera A - Clausura,0.5,0.75,5,1.12,1.75,2.0,1.33,3
Deportivo Pasto,8,4,1,3,14,11,3,13,Colombia - Primera A - Clausura,0.5,0.62,3,1.75,1.62,2.0,1.61,4
A. Nacional,8,3,4,1,9,7,2,13,Colombia - Primera A - Clausura,0.38,0.88,2,1.12,1.62,2.63,1.14,4
A. Bucaramanga,8,3,3,2,12,7,5,12,Colombia - Primera A - Clausura,0.38,0.75,5,1.5,1.5,2.63,1.33,5
America de Cali,8,3,2,3,10,10,0,11,Colombia - Primera A - Clausura,0.38,0.62,0,1.25,1.38,2.63,1.61,6
Fortaleza CEIF,8,3,1,4,9,8,1,10,Colombia - Primera A - Clausura,0.38,0.5,1,1.12,1.25,2.63,2.0,7
La Equidad,8,2,3,3,12,13,-1,9,Colombia - Primera A - Clausura,0.25,0.62,-1,1.5,1.12,4.0,1.61,8
Patriotas,8,2,2,4,12,14,-2,8,Colombia - Primera A - Clausura,0.25,0.5,-2,1.5,1.0,4.0,2.0,9
Deportivo Cali,8,2,2,4,5,9,-4,8,Colombia - Primera A - Clausura,0.25,0.5,-4,0.62,1.0,4.0,2.0,9
A. Petrolera,8,2,2,4,7,12,-5,8,Colombia - Primera A - Clausura,0.25,0.5,-5,0.88,1.0,4.0,2.0,9
Jaguares de C.,8,2,2,4,7,14,-7,8,Colombia - Primera A - Clausura,0.25,0.5,-7,0.88,1.0,4.0,2.0,9
Envigado,8,2,1,5,5,9,-4,7,Colombia - Primera A - Clausura,0.25,0.38,-4,0.62,0.88,4.0,2.63,10
Boyaca Chico,8,2,1,5,5,15,-10,7,Colombia - Primera A - Clausura,0.25,0.38,-10,0.62,0.88,4.0,2.63,10
Once Caldas,8,1,2,5,4,12,-8,5,Colombia - Primera A - Clausura,0.12,0.38,-8,0.5,0.62,8.33,2.63,11
R. Aguilas,8,1,1,6,4,15,-11,4,Colombia - Primera A - Clausura,0.12,0.25,-11,0.5,0.5,8.33,4.0,12
Saprissa,8,5,2,1,13,7,6,17,Costa Rica - Primera Div. - Apertura,0.62,0.88,6,1.62,2.12,1.61,1.14,1
Alajuelense,8,5,1,2,13,6,7,16,Costa Rica - Primera Div. - Apertura,0.62,0.75,7,1.62,2.0,1.61,1.33,2
Santos Guapiles,8,5,1,2,14,8,6,16,Costa Rica - Primera Div. - Apertura,0.62,0.75,6,1.75,2.0,1.61,1.33,2
Guanacasteca,8,4,1,3,11,11,0,13,Costa Rica - Primera Div. - Apertura,0.5,0.62,0,1.38,1.62,2.0,1.61,3
Herediano,8,3,3,2,11,9,2,12,Costa Rica - Primera Div. - Apertura,0.38,0.75,2,1.38,1.5,2.63,1.33,4
San Carlos,8,2,5,1,11,11,0,11,Costa Rica - Primera Div. - Apertura,0.25,0.88,0,1.38,1.38,4.0,1.14,5
Cartagines,8,3,1,4,15,18,-3,10,Costa Rica - Primera Div. - Apertura,0.38,0.5,-3,1.88,1.25,2.63,2.0,6
Zeledon,8,3,1,4,9,12,-3,10,Costa Rica - Primera Div. - Apertura,0.38,0.5,-3,1.12,1.25,2.63,2.0,6
M. Liberia,8,2,2,4,9,11,-2,8,Costa Rica - Primera Div. - Apertura,0.25,0.5,-2,1.12,1.0,4.0,2.0,7
Sporting SJ,8,2,1,5,10,11,-1,7,Costa Rica - Primera Div. - Apertura,0.25,0.38,-1,1.25,0.88,4.0,2.63,8
Santa Ana,8,2,1,5,7,11,-4,7,Costa Rica - Primera Div. - Apertura,0.25,0.38,-4,0.88,0.88,4.0,2.63,8
Puntarenas,8,2,1,5,8,16,-8,7,Costa Rica - Primera Div. - Apertura,0.25,0.38,-8,1.0,0.88,4.0,2.63,8
Banik Ostrava,8,6,1,1,16,5,11,19,CzechRepublic - 1. Liga,0.75,0.88,11,2.0,2.38,1.33,1.14,1
Slavia Prague,8,6,1,1,13,4,9,19,CzechRepublic - 1. Liga,0.75,0.88,9,1.62,2.38,1.33,1.14,1
Viktoria Plzen,8,5,1,2,14,8,6,16,CzechRepublic - 1. Liga,0.62,0.75,6,1.75,2.0,1.61,1.33,2
Sparta Prague,8,5,1,2,15,10,5,16,CzechRepublic - 1. Liga,0.62,0.75,5,1.88,2.0,1.61,1.33,2
Slovan Liberec,8,4,3,1,13,5,8,15,CzechRepublic - 1. Liga,0.5,0.88,8,1.62,1.88,2.0,1.14,3
Jablonec,8,4,3,1,14,8,6,15,CzechRepublic - 1. Liga,0.5,0.88,6,1.75,1.88,2.0,1.14,3
Karvina,8,4,2,2,13,13,0,14,CzechRepublic - 1. Liga,0.5,0.75,0,1.62,1.75,2.0,1.33,4
Hradec Kralove,8,3,3,2,11,10,1,12,CzechRepublic - 1. Liga,0.38,0.75,1,1.38,1.5,2.63,1.33,5
Dukla Praha,8,2,5,1,5,5,0,11,CzechRepublic - 1. Liga,0.25,0.88,0,0.62,1.38,4.0,1.14,6
Sigma Olomouc,8,3,1,4,11,8,3,10,CzechRepublic - 1. Liga,0.38,0.5,3,1.38,1.25,2.63,2.0,7
Bohemians,8,2,3,3,6,9,-3,9,CzechRepublic - 1. Liga,0.25,0.62,-3,0.75,1.12,4.0,1.61,8
Teplice,8,2,2,4,6,9,-3,8,CzechRepublic - 1. Liga,0.25,0.5,-3,0.75,1.0,4.0,2.0,9
Mlada Boleslav,8,2,0,6,9,14,-5,6,CzechRepublic - 1. Liga,0.25,0.25,-5,1.12,0.75,4.0,4.0,10
Slovacko,8,1,1,6,4,16,-12,4,CzechRepublic - 1. Liga,0.12,0.25,-12,0.5,0.5,8.33,4.0,11
Pardubice,8,1,1,6,4,17,-13,4,CzechRepublic - 1. Liga,0.12,0.25,-13,0.5,0.5,8.33,4.0,11
C. Budejovice,8,0,0,8,6,18,-12,0,CzechRepublic - 1. Liga,0.0,0.0,-12,0.75,0.0,0.0,0.0,12
FC Kobenhavn,8,5,2,1,11,6,5,17,Denmark - Superligaen,0.62,0.88,5,1.38,2.12,1.61,1.14,1
FC Midtjylland,8,5,0,3,15,9,6,15,Denmark - Superligaen,0.62,0.62,6,1.88,1.88,1.61,1.61,2
Brondby IF,8,3,4,1,16,12,4,13,Denmark - Superligaen,0.38,0.88,4,2.0,1.62,2.63,1.14,3
Viborg,8,4,1,3,16,15,1,13,Denmark - Superligaen,0.5,0.62,1,2.0,1.62,2.0,1.61,3
AGF Aarhus,8,3,3,2,15,8,7,12,Denmark - Superligaen,0.38,0.75,7,1.88,1.5,2.63,1.33,4
Silkeborg,8,3,2,3,13,10,3,11,Denmark - Superligaen,0.38,0.62,3,1.62,1.38,2.63,1.61,5
Randers FC,8,3,2,3,12,12,0,11,Denmark - Superligaen,0.38,0.62,0,1.5,1.38,2.63,1.61,5
Vejle BK,8,3,2,3,11,15,-4,11,Denmark - Superligaen,0.38,0.62,-4,1.38,1.38,2.63,1.61,5
Nordsjaelland,8,3,0,5,10,13,-3,9,Denmark - Superligaen,0.38,0.38,-3,1.25,1.12,2.63,2.63,6
Lyngby,8,2,2,4,5,8,-3,8,Denmark - Superligaen,0.25,0.5,-3,0.62,1.0,4.0,2.0,7
SonderjyskE,8,2,1,5,10,17,-7,7,Denmark - Superligaen,0.25,0.38,-7,1.25,0.88,4.0,2.63,8
Aalborg BK,8,1,2,5,6,16,-10,5,Denmark - Superligaen,0.12,0.38,-10,0.75,0.62,8.33,2.63,9
AC Horsens,8,5,1,2,13,9,4,16,Denmark - 1st Division,0.62,0.75,4,1.62,2.0,1.61,1.33,1
Hillerod,8,4,3,1,14,6,8,15,Denmark - 1st Division,0.5,0.88,8,1.75,1.88,2.0,1.14,2
Fredericia,8,5,0,3,7,5,2,15,Denmark - 1st Division,0.62,0.62,2,0.88,1.88,1.61,1.61,2
Kolding IF,8,4,1,3,9,6,3,13,Denmark - 1st Division,0.5,0.62,3,1.12,1.62,2.0,1.61,3
Hvidovre,8,4,1,3,7,8,-1,13,Denmark - 1st Division,0.5,0.62,-1,0.88,1.62,2.0,1.61,3
B 93,8,2,4,2,15,16,-1,10,Denmark - 1st Division,0.25,0.75,-1,1.88,1.25,4.0,1.33,4
HB Koge,8,2,4,2,8,12,-4,10,Denmark - 1st Division,0.25,0.75,-4,1.0,1.25,4.0,1.33,4
Esbjerg,8,3,0,5,9,9,0,9,Denmark - 1st Division,0.38,0.38,0,1.12,1.12,2.63,2.63,5
Odense BK,8,1,6,1,8,8,0,9,Denmark - 1st Division,0.12,0.88,0,1.0,1.12,8.33,1.14,5
Hobro,8,2,2,4,6,10,-4,8,Denmark - 1st Division,0.25,0.5,-4,0.75,1.0,4.0,2.0,6
Roskilde,8,2,1,5,10,14,-4,7,Denmark - 1st Division,0.25,0.38,-4,1.25,0.88,4.0,2.63,7
Vendsyssel,8,1,3,4,7,10,-3,6,Denmark - 1st Division,0.12,0.5,-3,0.88,0.75,8.33,2.0,8
AB Copenhagen,8,5,1,2,19,9,10,16,Denmark - 2nd Division,0.62,0.75,10,2.38,2.0,1.61,1.33,1
Aarhus Fremad,8,5,1,2,11,3,8,16,Denmark - 2nd Division,0.62,0.75,8,1.38,2.0,1.61,1.33,1
Naestved,8,5,1,2,10,7,3,16,Denmark - 2nd Division,0.62,0.75,3,1.25,2.0,1.61,1.33,1
Middelfart,8,4,2,2,11,9,2,14,Denmark - 2nd Division,0.5,0.75,2,1.38,1.75,2.0,1.33,2
Skive,8,4,1,3,8,8,0,13,Denmark - 2nd Division,0.5,0.62,0,1.0,1.62,2.0,1.61,3
BK Frem,8,3,3,2,10,6,4,12,Denmark - 2nd Division,0.38,0.75,4,1.25,1.5,2.63,1.33,4
Ishoj,8,3,2,3,7,9,-2,11,Denmark - 2nd Division,0.38,0.62,-2,0.88,1.38,2.63,1.61,5
Hellerup IK,8,3,1,4,6,15,-9,10,Denmark - 2nd Division,0.38,0.5,-9,0.75,1.25,2.63,2.0,6
Thisted,8,2,2,4,11,13,-2,8,Denmark - 2nd Division,0.25,0.5,-2,1.38,1.0,4.0,2.0,7
Fremad Amager,8,2,1,5,7,12,-5,7,Denmark - 2nd Division,0.25,0.38,-5,0.88,0.88,4.0,2.63,8
Helsingor,8,0,6,2,8,11,-3,6,Denmark - 2nd Division,0.0,0.75,-3,1.0,0.75,0.0,1.33,9
Nykobing,8,1,1,6,8,14,-6,4,Denmark - 2nd Division,0.12,0.25,-6,1.0,0.5,8.33,4.0,10
Barcelona SC,6,5,0,1,11,7,4,15,Ecuador - Liga Pro 1st Stage,0.83,0.83,4,1.83,2.5,1.2,1.2,1
I. del Valle,7,3,3,1,13,6,7,12,Ecuador - Liga Pro 1st Stage,0.43,0.86,7,1.86,1.71,2.33,1.16,2
U. Catolica,7,3,3,1,13,6,7,12,Ecuador - Liga Pro 1st Stage,0.43,0.86,7,1.86,1.71,2.33,1.16,2
Cuniburo,7,3,3,1,10,8,2,12,Ecuador - Liga Pro 1st Stage,0.43,0.86,2,1.43,1.71,2.33,1.16,2
LDU Quito,6,3,2,1,10,3,7,11,Ecuador - Liga Pro 1st Stage,0.5,0.83,7,1.67,1.83,2.0,1.2,3
Libertad,7,3,2,2,12,11,1,11,Ecuador - Liga Pro 1st Stage,0.43,0.71,1,1.71,1.57,2.33,1.41,3
Orense,7,3,1,3,6,11,-5,10,Ecuador - Liga Pro 1st Stage,0.43,0.57,-5,0.86,1.43,2.33,1.75,4
Mushuc Runa,7,2,3,2,9,7,2,9,Ecuador - Liga Pro 1st Stage,0.29,0.71,2,1.29,1.29,3.45,1.41,5
Aucas,7,2,3,2,10,9,1,9,Ecuador - Liga Pro 1st Stage,0.29,0.71,1,1.43,1.29,3.45,1.41,5
Macara,7,2,3,2,5,5,0,9,Ecuador - Liga Pro 1st Stage,0.29,0.71,0,0.71,1.29,3.45,1.41,5
D. Cuenca,7,2,1,4,5,10,-5,7,Ecuador - Liga Pro 1st Stage,0.29,0.43,-5,0.71,1.0,3.45,2.33,6
Manta,7,1,3,3,11,15,-4,6,Ecuador - Liga Pro 1st Stage,0.14,0.57,-4,1.57,0.86,7.14,1.75,7
Tecnico U.,7,1,3,3,6,10,-4,6,Ecuador - Liga Pro 1st Stage,0.14,0.57,-4,0.86,0.86,7.14,1.75,7
Delfin,7,1,3,3,5,10,-5,6,Ecuador - Liga Pro 1st Stage,0.14,0.57,-5,0.71,0.86,7.14,1.75,7
Emelec,7,1,3,3,4,10,-6,6,Ecuador - Liga Pro 1st Stage,0.14,0.57,-6,0.57,0.86,7.14,1.75,7
El Nacional,7,1,2,4,7,9,-2,5,Ecuador - Liga Pro 1st Stage,0.14,0.43,-2,1.0,0.71,7.14,2.33,8
Cumbaya,3,3,0,0,7,0,7,9,Ecuador - Serie B,1.0,1.0,7,2.33,3.0,1.0,1.0,1
San Antonio,3,2,0,1,4,4,0,6,Ecuador - Serie B,0.67,0.67,0,1.33,2.0,1.49,1.49,2
Leones Norte,3,1,2,0,5,3,2,5,Ecuador - Serie B,0.33,1.0,2,1.67,1.67,3.03,1.0,3
Gualaceo,3,1,2,0,6,5,1,5,Ecuador - Serie B,0.33,1.0,1,2.0,1.67,3.03,1.0,3
Nueve Octubre,3,1,2,0,3,2,1,5,Ecuador - Serie B,0.33,1.0,1,1.0,1.67,3.03,1.0,3
Guayaquil City,3,1,1,1,5,3,2,4,Ecuador - Serie B,0.33,0.67,2,1.67,1.33,3.03,1.49,4
Vargas Torres,3,1,1,1,2,2,0,4,Ecuador - Serie B,0.33,0.67,0,0.67,1.33,3.03,1.49,4
Vinotinto,3,1,0,2,2,3,-1,3,Ecuador - Serie B,0.33,0.33,-1,0.67,1.0,3.03,3.03,5
Chacaritas,3,0,2,1,3,4,-1,2,Ecuador - Serie B,0.0,0.67,-1,1.0,0.67,0.0,1.49,6
22 de Julio,3,0,2,1,1,5,-4,2,Ecuador - Serie B,0.0,0.67,-4,0.33,0.67,0.0,1.49,6
Imbabura,3,0,1,2,2,5,-3,1,Ecuador - Serie B,0.0,0.33,-3,0.67,0.33,0.0,3.03,7
I. Juniors,3,0,1,2,1,5,-4,1,Ecuador - Serie B,0.0,0.33,-4,0.33,0.33,0.0,3.03,7
Pyramids FC,8,7,1,0,15,3,12,22,Egypt - Premier League,0.88,1.0,12,1.88,2.75,1.14,1.0,1
Al Ahly,8,6,1,1,14,6,8,19,Egypt - Premier League,0.75,0.88,8,1.75,2.38,1.33,1.14,2
Zamalek,8,4,3,1,12,6,6,15,Egypt - Premier League,0.5,0.88,6,1.5,1.88,2.0,1.14,3
National Bank,8,4,3,1,14,9,5,15,Egypt - Premier League,0.5,0.88,5,1.75,1.88,2.0,1.14,3
El Gouna,8,4,2,2,9,4,5,14,Egypt - Premier League,0.5,0.75,5,1.12,1.75,2.0,1.33,4
Pharco,8,4,2,2,9,7,2,14,Egypt - Premier League,0.5,0.75,2,1.12,1.75,2.0,1.33,4
Al Masry,8,3,4,1,10,5,5,13,Egypt - Premier League,0.38,0.88,5,1.25,1.62,2.63,1.14,5
ZED FC,8,2,5,1,11,7,4,11,Egypt - Premier League,0.25,0.88,4,1.38,1.38,4.0,1.14,6
Haras El Hodood,8,3,1,4,8,10,-2,10,Egypt - Premier League,0.38,0.5,-2,1.0,1.25,2.63,2.0,7
El Geish,8,2,3,3,6,8,-2,9,Egypt - Premier League,0.25,0.62,-2,0.75,1.12,4.0,1.61,8
Ghazl El M.,8,3,0,5,9,12,-3,9,Egypt - Premier League,0.38,0.38,-3,1.12,1.12,2.63,2.63,8
Petrojet,8,2,3,3,9,12,-3,9,Egypt - Premier League,0.25,0.62,-3,1.12,1.12,4.0,1.61,8
Smouha,8,3,0,5,4,11,-7,9,Egypt - Premier League,0.38,0.38,-7,0.5,1.12,2.63,2.63,8
Ceramica C.,8,2,2,4,10,11,-1,8,Egypt - Premier League,0.25,0.5,-1,1.25,1.0,4.0,2.0,9
Modern Sport,8,1,2,5,8,13,-5,5,Egypt - Premier League,0.12,0.38,-5,1.0,0.62,8.33,2.63,10
Al Ittihad,8,1,2,5,6,12,-6,5,Egypt - Premier League,0.12,0.38,-6,0.75,0.62,8.33,2.63,10
ENPPI,8,1,2,5,5,13,-8,5,Egypt - Premier League,0.12,0.38,-8,0.62,0.62,8.33,2.63,10
Ismaily,8,1,2,5,4,14,-10,5,Egypt - Premier League,0.12,0.38,-10,0.5,0.62,8.33,2.63,10
Liverpool,8,5,2,1,16,9,7,17,Premier League,0.62,0.88,7,2.0,2.12,1.61,1.14,2
Crystal Palace,8,5,1,2,14,7,7,16,Premier League,0.62,0.75,7,1.75,2.0,1.61,1.33,3
Wolverhampton,8,5,1,2,11,7,4,16,Premier League,0.62,0.75,4,1.38,2.0,1.61,1.33,3
Arsenal,8,4,3,1,12,5,7,15,Premier League,0.5,0.88,7,1.5,1.88,2.0,1.14,4
Fulham,8,5,0,3,13,11,2,15,Premier League,0.62,0.62,2,1.62,1.88,1.61,1.61,4
Aston Villa,8,4,2,2,12,11,1,14,Premier League,0.5,0.75,1,1.5,1.75,2.0,1.33,5
Nottm Forest,8,4,1,3,18,10,8,13,Premier League,0.5,0.62,8,2.25,1.62,2.0,1.61,6
Tottenham,8,4,1,3,12,8,4,13,Premier League,0.5,0.62,4,1.5,1.62,2.0,1.61,6
Chelsea,8,4,1,3,9,7,2,13,Premier League,0.5,0.62,2,1.12,1.62,2.0,1.61,6
Brighton,8,4,1,3,14,16,-2,13,Premier League,0.5,0.62,-2,1.75,1.62,2.0,1.61,6
Newcastle Utd,8,4,0,4,12,17,-5,12,Premier League,0.5,0.5,-5,1.5,1.5,2.0,2.0,7
Brentford,8,3,2,3,9,7,2,11,Premier League,0.38,0.62,2,1.12,1.38,2.63,1.61,8
Manchester City,8,3,2,3,10,10,0,11,Premier League,0.38,0.62,0,1.25,1.38,2.63,1.61,8
Everton,8,1,6,1,10,10,0,9,Premier League,0.12,0.88,0,1.25,1.12,8.33,1.14,10
Manchester Utd,8,2,3,3,9,9,0,9,Premier League,0.25,0.62,0,1.12,1.12,4.0,1.61,10
West Ham Utd,8,2,2,4,7,8,-1,8,Premier League,0.25,0.5,-1,0.88,1.0,4.0,2.0,11
Bournemouth,8,1,2,5,10,14,-4,5,Premier League,0.12,0.38,-4,1.25,0.62,8.33,2.63,13
Ipswich Town,8,1,1,6,10,18,-8,4,Premier League,0.12,0.25,-8,1.25,0.5,8.33,4.0,14
Southampton,8,1,1,6,7,21,-14,4,Premier League,0.12,0.25,-14,0.88,0.5,8.33,4.0,14
Leicester City,8,1,0,7,2,19,-17,3,Premier League,0.12,0.12,-17,0.25,0.38,8.33,8.33,15
Burnley,8,6,2,0,16,3,13,20,Premier League,0.75,1.0,13,2.0,2.5,1.33,1.0,1
Middlesbrough,8,5,1,2,11,6,5,16,Premier League,0.62,0.75,5,1.38,2.0,1.61,1.33,3
Sheffield Utd,8,5,1,2,10,7,3,16,Premier League,0.62,0.75,3,1.25,2.0,1.61,1.33,3
Bristol City,8,4,3,1,11,7,4,15,Premier League,0.5,0.88,4,1.38,1.88,2.0,1.14,4
Coventry City,8,5,0,3,15,13,2,15,Premier League,0.62,0.62,2,1.88,1.88,1.61,1.61,4
Hull City,8,4,2,2,8,5,3,14,Premier League,0.5,0.75,3,1.0,1.75,2.0,1.33,5
Leeds Utd,8,3,4,1,13,9,4,13,Premier League,0.38,0.88,4,1.62,1.62,2.63,1.14,6
Sunderland,8,4,1,3,8,9,-1,13,Premier League,0.5,0.62,-1,1.0,1.62,2.0,1.61,6
Millwall,8,4,1,3,7,8,-1,13,Premier League,0.5,0.62,-1,0.88,1.62,2.0,1.61,6
Portsmouth,8,4,0,4,9,8,1,12,Premier League,0.5,0.5,1,1.12,1.5,2.0,2.0,7
Derby County,8,4,0,4,9,10,-1,12,Premier League,0.5,0.5,-1,1.12,1.5,2.0,2.0,7
Luton Town,8,3,3,2,6,9,-3,12,Premier League,0.38,0.75,-3,0.75,1.5,2.63,1.33,7
Watford,8,3,2,3,6,5,1,11,Premier League,0.38,0.62,1,0.75,1.38,2.63,1.61,8
Swansea City,8,3,2,3,8,8,0,11,Premier League,0.38,0.62,0,1.0,1.38,2.63,1.61,8
West Brom,8,2,4,2,7,6,1,10,Premier League,0.25,0.75,1,0.88,1.25,4.0,1.33,9
Norwich City,8,2,3,3,12,12,0,9,Premier League,0.25,0.62,0,1.5,1.12,4.0,1.61,10
Cardiff City,8,2,3,3,8,9,-1,9,Premier League,0.25,0.62,-1,1.0,1.12,4.0,1.61,10
Plymouth,8,2,3,3,8,12,-4,9,Premier League,0.25,0.62,-4,1.0,1.12,4.0,1.61,10
Stoke City,8,2,2,4,10,13,-3,8,Premier League,0.25,0.5,-3,1.25,1.0,4.0,2.0,11
Preston,8,1,4,3,6,9,-3,7,Premier League,0.12,0.62,-3,0.75,0.88,8.33,1.61,12
Sheffield Wed,8,2,1,5,9,13,-4,7,Premier League,0.25,0.38,-4,1.12,0.88,4.0,2.63,12
Oxford Utd,8,2,1,5,7,12,-5,7,Premier League,0.25,0.38,-5,0.88,0.88,4.0,2.63,12
QP Rangers,8,1,2,5,10,12,-2,5,Premier League,0.12,0.38,-2,1.25,0.62,8.33,2.63,13
Blackburn,8,1,1,6,5,12,-7,4,Premier League,0.12,0.25,-7,0.62,0.5,8.33,4.0,14
Birmingham City,8,6,1,1,18,9,9,19,League One,0.75,0.88,9,2.25,2.38,1.33,1.14,1
Wrexham,8,6,1,1,11,4,7,19,League One,0.75,0.88,7,1.38,2.38,1.33,1.14,1
Stockport,8,5,2,1,11,4,7,17,League One,0.62,0.88,7,1.38,2.12,1.61,1.14,2
Charlton,8,5,2,1,12,7,5,17,League One,0.62,0.88,5,1.5,2.12,1.61,1.14,2
Blackpool,8,5,1,2,14,6,8,16,League One,0.62,0.75,8,1.75,2.0,1.61,1.33,3
Reading,8,4,3,1,10,7,3,15,League One,0.5,0.88,3,1.25,1.88,2.0,1.14,4
Peterborough,8,4,2,2,13,12,1,14,League One,0.5,0.75,1,1.62,1.75,2.0,1.33,5
Bolton,8,4,1,3,10,8,2,13,League One,0.5,0.62,2,1.25,1.62,2.0,1.61,6
Rotherham,8,4,1,3,11,12,-1,13,League One,0.5,0.62,-1,1.38,1.62,2.0,1.61,6
Exeter City,8,3,3,2,7,6,1,12,League One,0.38,0.75,1,0.88,1.5,2.63,1.33,7
Lincoln City,8,3,2,3,15,9,6,11,League One,0.38,0.62,6,1.88,1.38,2.63,1.61,8
Wycombe,8,3,2,3,7,6,1,11,League One,0.38,0.62,1,0.88,1.38,2.63,1.61,8
Northampton,8,2,4,2,10,9,1,10,League One,0.25,0.75,1,1.25,1.25,4.0,1.33,9
Burton Albion,8,3,1,4,8,11,-3,10,League One,0.38,0.5,-3,1.0,1.25,2.63,2.0,9
Wigan Athletic,8,2,3,3,6,7,-1,9,League One,0.25,0.62,-1,0.75,1.12,4.0,1.61,10
Huddersfield,8,3,0,5,10,12,-2,9,League One,0.38,0.38,-2,1.25,1.12,2.63,2.63,10
Mansfield,8,2,3,3,8,10,-2,9,League One,0.25,0.62,-2,1.0,1.12,4.0,1.61,10
Stevenage,8,2,2,4,8,11,-3,8,League One,0.25,0.5,-3,1.0,1.0,4.0,2.0,11
Leyton Orient,8,2,1,5,6,10,-4,7,League One,0.25,0.38,-4,0.75,0.88,4.0,2.63,12
Crawley Town,8,2,1,5,12,18,-6,7,League One,0.25,0.38,-6,1.5,0.88,4.0,2.63,12
Bristol Rovers,8,2,1,5,6,13,-7,7,League One,0.25,0.38,-7,0.75,0.88,4.0,2.63,12
Cambridge Utd,8,1,3,4,6,9,-3,6,League One,0.12,0.5,-3,0.75,0.75,8.33,2.0,13
Barnsley,8,1,2,5,10,19,-9,5,League One,0.12,0.38,-9,1.25,0.62,8.33,2.63,14
Shrewsbury,8,0,2,6,2,13,-11,2,League One,0.0,0.25,-11,0.25,0.25,0.0,4.0,15
Port Vale,8,5,1,2,12,6,6,16,League Two,0.62,0.75,6,1.5,2.0,1.61,1.33,1
Chesterfield,8,5,1,2,11,8,3,16,League Two,0.62,0.75,3,1.38,2.0,1.61,1.33,1
Colchester Utd,8,5,1,2,11,8,3,16,League Two,0.62,0.75,3,1.38,2.0,1.61,1.33,1
Doncaster,8,4,3,1,15,7,8,15,League Two,0.5,0.88,8,1.88,1.88,2.0,1.14,2
Tranmere,8,4,3,1,13,6,7,15,League Two,0.5,0.88,7,1.62,1.88,2.0,1.14,2
Barrow,8,4,3,1,13,7,6,15,League Two,0.5,0.88,6,1.62,1.88,2.0,1.14,2
Swindon Town,8,3,4,1,14,9,5,13,League Two,0.38,0.88,5,1.75,1.62,2.63,1.14,3
Bradford,8,4,1,3,11,6,5,13,League Two,0.5,0.62,5,1.38,1.62,2.0,1.61,3
Grimsby,8,4,1,3,10,9,1,13,League Two,0.5,0.62,1,1.25,1.62,2.0,1.61,3
Fleetwood,8,3,3,2,15,14,1,12,League Two,0.38,0.75,1,1.88,1.5,2.63,1.33,4
Harrogate,8,3,3,2,7,8,-1,12,League Two,0.38,0.75,-1,0.88,1.5,2.63,1.33,4
Bromley,8,3,2,3,13,10,3,11,League Two,0.38,0.62,3,1.62,1.38,2.63,1.61,5
AFC Wimbledon,8,3,2,3,10,9,1,11,League Two,0.38,0.62,1,1.25,1.38,2.63,1.61,5
Gillingham,8,2,5,1,8,8,0,11,League Two,0.25,0.88,0,1.0,1.38,4.0,1.14,5
Notts County,8,3,1,4,9,7,2,10,League Two,0.38,0.5,2,1.12,1.25,2.63,2.0,6
Morecambe,8,3,1,4,8,9,-1,10,League Two,0.38,0.5,-1,1.0,1.25,2.63,2.0,6
Salford City,8,2,4,2,11,14,-3,10,League Two,0.25,0.75,-3,1.38,1.25,4.0,1.33,6
Accrington,8,2,3,3,9,11,-2,9,League Two,0.25,0.62,-2,1.12,1.12,4.0,1.61,7
Crewe Alexandra,8,2,3,3,8,10,-2,9,League Two,0.25,0.62,-2,1.0,1.12,4.0,1.61,7
Carlisle Utd,8,2,2,4,10,14,-4,8,League Two,0.25,0.5,-4,1.25,1.0,4.0,2.0,8
Newport,8,2,1,5,10,15,-5,7,League Two,0.25,0.38,-5,1.25,0.88,4.0,2.63,9
Milton Keynes,8,2,1,5,7,18,-11,7,League Two,0.25,0.38,-11,0.88,0.88,4.0,2.63,9
Walsall,8,0,5,3,9,13,-4,5,League Two,0.0,0.62,-4,1.12,0.62,0.0,1.61,10
Cheltenham,8,1,1,6,5,15,-10,4,League Two,0.12,0.25,-10,0.62,0.5,8.33,4.0,11
Barnet,8,7,0,1,19,3,16,21,England - National League,0.88,0.88,16,2.38,2.62,1.14,1.14,1
Tamworth,8,5,2,1,17,9,8,17,England - National League,0.62,0.88,8,2.12,2.12,1.61,1.14,2
Aldershot Town,8,5,2,1,14,10,4,17,England - National League,0.62,0.88,4,1.75,2.12,1.61,1.14,2
York City,8,5,1,2,15,6,9,16,England - National League,0.62,0.75,9,1.88,2.0,1.61,1.33,3
Boston Utd,8,5,1,2,15,10,5,16,England - National League,0.62,0.75,5,1.88,2.0,1.61,1.33,3
Braintree Town,8,5,1,2,14,9,5,16,England - National League,0.62,0.75,5,1.75,2.0,1.61,1.33,3
Southend Utd,8,3,4,1,12,12,0,13,England - National League,0.38,0.88,0,1.5,1.62,2.63,1.14,4
Wealdstone,8,4,1,3,10,14,-4,13,England - National League,0.5,0.62,-4,1.25,1.62,2.0,1.61,4
Rochdale,8,3,3,2,16,11,5,12,England - National League,0.38,0.75,5,2.0,1.5,2.63,1.33,5
Hartlepool,8,3,2,3,13,11,2,11,England - National League,0.38,0.62,2,1.62,1.38,2.63,1.61,6
Halifax Town,8,3,2,3,7,6,1,11,England - National League,0.38,0.62,1,0.88,1.38,2.63,1.61,6
Forest Green,8,3,2,3,10,11,-1,11,England - National League,0.38,0.62,-1,1.25,1.38,2.63,1.61,6
Oldham,8,2,4,2,8,8,0,10,England - National League,0.25,0.75,0,1.0,1.25,4.0,1.33,7
Sutton Utd,8,2,3,3,8,11,-3,9,England - National League,0.25,0.62,-3,1.0,1.12,4.0,1.61,8
Maidenhead Utd,8,2,2,4,9,10,-1,8,England - National League,0.25,0.5,-1,1.12,1.0,4.0,2.0,9
Woking,8,1,5,2,8,9,-1,8,England - National League,0.12,0.75,-1,1.0,1.0,8.33,1.33,9
Dagenham & R.,8,2,2,4,6,10,-4,8,England - National League,0.25,0.5,-4,0.75,1.0,4.0,2.0,9
Yeovil Town,8,2,1,5,7,14,-7,7,England - National League,0.25,0.38,-7,0.88,0.88,4.0,2.63,10
Eastleigh,8,1,3,4,8,12,-4,6,England - National League,0.12,0.5,-4,1.0,0.75,8.33,2.0,11
AFC Fylde,8,2,0,6,7,12,-5,6,England - National League,0.25,0.25,-5,0.88,0.75,4.0,4.0,11
Solihull Moors,8,1,3,4,7,14,-7,6,England - National League,0.12,0.5,-7,0.88,0.75,8.33,2.0,11
Ebbsfleet Utd,8,1,2,5,13,19,-6,5,England - National League,0.12,0.38,-6,1.62,0.62,8.33,2.63,12
Altrincham,8,1,2,5,7,13,-6,5,England - National League,0.12,0.38,-6,0.88,0.62,8.33,2.63,12
Gateshead FC,8,1,1,6,6,16,-10,4,England - National League,0.12,0.25,-10,0.75,0.5,8.33,4.0,13
Kidderminster,8,6,2,0,19,3,16,20,England - National L. North,0.75,1.0,16,2.38,2.5,1.33,1.0,1
Marine,8,5,2,1,9,7,2,17,England - National L. North,0.62,0.88,2,1.12,2.12,1.61,1.14,2
Scunthorpe,8,5,1,2,11,4,7,16,England - National L. North,0.62,0.75,7,1.38,2.0,1.61,1.33,3
Spennymoor,8,5,1,2,14,8,6,16,England - National L. North,0.62,0.75,6,1.75,2.0,1.61,1.33,3
Brackley Town,8,5,1,2,11,5,6,16,England - National L. North,0.62,0.75,6,1.38,2.0,1.61,1.33,3
Darlington,8,4,3,1,16,13,3,15,England - National L. North,0.5,0.88,3,2.0,1.88,2.0,1.14,4
Oxford City,8,4,3,1,13,12,1,15,England - National L. North,0.5,0.88,1,1.62,1.88,2.0,1.14,4
Buxton,8,4,2,2,14,6,8,14,England - National L. North,0.5,0.75,8,1.75,1.75,2.0,1.33,5
Curzon,8,4,2,2,12,9,3,14,England - National L. North,0.5,0.75,3,1.5,1.75,2.0,1.33,5
Kings Lynn,8,4,2,2,7,6,1,14,England - National L. North,0.5,0.75,1,0.88,1.75,2.0,1.33,5
Scarborough,8,4,1,3,12,8,4,13,England - National L. North,0.5,0.62,4,1.5,1.62,2.0,1.61,6
Hereford Utd,8,3,2,3,13,10,3,11,England - National L. North,0.38,0.62,3,1.62,1.38,2.63,1.61,7
Chorley,8,3,2,3,13,11,2,11,England - National L. North,0.38,0.62,2,1.62,1.38,2.63,1.61,7
Peterborough S.,8,3,2,3,12,11,1,11,England - National L. North,0.38,0.62,1,1.5,1.38,2.63,1.61,7
Chester,8,2,4,2,11,11,0,10,England - National L. North,0.25,0.75,0,1.38,1.25,4.0,1.33,8
Rushall,8,2,3,3,8,15,-7,9,England - National L. North,0.25,0.62,-7,1.0,1.12,4.0,1.61,9
Leamington,8,2,1,5,5,7,-2,7,England - National L. North,0.25,0.38,-2,0.62,0.88,4.0,2.63,10
Radcliffe,8,2,1,5,8,11,-3,7,England - National L. North,0.25,0.38,-3,1.0,0.88,4.0,2.63,10
Alfreton Town,8,1,4,3,4,9,-5,7,England - National L. North,0.12,0.62,-5,0.5,0.88,8.33,1.61,10
South Shields,8,2,0,6,8,17,-9,6,England - National L. North,0.25,0.25,-9,1.0,0.75,4.0,4.0,11
Southport,8,1,2,5,5,11,-6,5,England - National L. North,0.12,0.38,-6,0.62,0.62,8.33,2.63,12
Warrington,8,1,1,6,7,16,-9,4,England - National L. North,0.12,0.25,-9,0.88,0.5,8.33,4.0,13
Needham Market,8,1,1,6,7,18,-11,4,England - National L. North,0.12,0.25,-11,0.88,0.5,8.33,4.0,13
Farsley Celtic,8,0,0,8,4,30,-26,0,England - National L. North,0.0,0.0,-26,0.5,0.0,0.0,0.0,14
Truro City,8,6,1,1,17,8,9,19,England - National L. South,0.75,0.88,9,2.12,2.38,1.33,1.14,1
Eastbourne,8,5,2,1,19,8,11,17,England - National L. South,0.62,0.88,11,2.38,2.12,1.61,1.14,2
Torquay Utd,8,5,2,1,12,7,5,17,England - National L. South,0.62,0.88,5,1.5,2.12,1.61,1.14,2
Weston-s.-Mare,8,4,3,1,13,6,7,15,England - National L. South,0.5,0.88,7,1.62,1.88,2.0,1.14,3
Worthing,8,5,0,3,13,7,6,15,England - National L. South,0.62,0.62,6,1.62,1.88,1.61,1.61,3
Hemel Hempstead,8,4,3,1,11,8,3,15,England - National L. South,0.5,0.88,3,1.38,1.88,2.0,1.14,3
Maidstone Utd,8,4,2,2,14,7,7,14,England - National L. South,0.5,0.75,7,1.75,1.75,2.0,1.33,4
Dorking,8,3,4,1,12,8,4,13,England - National L. South,0.38,0.88,4,1.5,1.62,2.63,1.14,5
Chesham Utd,8,4,1,3,10,11,-1,13,England - National L. South,0.5,0.62,-1,1.25,1.62,2.0,1.61,5
Bath City,8,3,3,2,10,3,7,12,England - National L. South,0.38,0.75,7,1.25,1.5,2.63,1.33,6
Enfield Town,8,3,3,2,9,10,-1,12,England - National L. South,0.38,0.75,-1,1.12,1.5,2.63,1.33,6
St Albans,8,2,4,2,8,8,0,10,England - National L. South,0.25,0.75,0,1.0,1.25,4.0,1.33,7
Boreham Wood,8,3,1,4,10,11,-1,10,England - National L. South,0.38,0.5,-1,1.25,1.25,2.63,2.0,7
Farnborough,8,3,1,4,9,12,-3,10,England - National L. South,0.38,0.5,-3,1.12,1.25,2.63,2.0,7
Weymouth,8,2,3,3,12,13,-1,9,England - National L. South,0.25,0.62,-1,1.5,1.12,4.0,1.61,8
Slough Town,8,2,3,3,11,14,-3,9,England - National L. South,0.25,0.62,-3,1.38,1.12,4.0,1.61,8
Hornchurch,8,2,3,3,8,11,-3,9,England - National L. South,0.25,0.62,-3,1.0,1.12,4.0,1.61,8
Tonbridge,8,3,0,5,6,12,-6,9,England - National L. South,0.38,0.38,-6,0.75,1.12,2.63,2.63,8
Chelmsford City,8,2,2,4,7,9,-2,8,England - National L. South,0.25,0.5,-2,0.88,1.0,4.0,2.0,9
Salisbury,8,2,2,4,11,14,-3,8,England - National L. South,0.25,0.5,-3,1.38,1.0,4.0,2.0,9
Welling Utd,8,1,2,5,9,15,-6,5,England - National L. South,0.12,0.38,-6,1.12,0.62,8.33,2.63,10
Chippenham,8,1,2,5,4,15,-11,5,England - National L. South,0.12,0.38,-11,0.5,0.62,8.33,2.63,10
Hampton & R.,8,1,0,7,5,18,-13,3,England - National L. South,0.12,0.12,-13,0.62,0.38,8.33,8.33,11
Aveley,8,0,2,6,5,14,-9,2,England - National L. South,0.0,0.25,-9,0.62,0.25,0.0,4.0,12
Chatham Town,8,7,1,0,17,3,14,22,England - Isthmian league,0.88,1.0,14,2.12,2.75,1.14,1.0,1
Wingate & F.,8,5,2,1,17,6,11,17,England - Isthmian league,0.62,0.88,11,2.12,2.12,1.61,1.14,2
Dartford,8,5,1,2,15,11,4,16,England - Isthmian league,0.62,0.75,4,1.88,2.0,1.61,1.33,3
Horsham,8,5,1,2,10,7,3,16,England - Isthmian league,0.62,0.75,3,1.25,2.0,1.61,1.33,3
Billericay Town,8,5,0,3,22,14,8,15,England - Isthmian league,0.62,0.62,8,2.75,1.88,1.61,1.61,4
Hashtag United,8,4,3,1,21,14,7,15,England - Isthmian league,0.5,0.88,7,2.62,1.88,2.0,1.14,4
Cray Wanderers,8,5,0,3,17,10,7,15,England - Isthmian league,0.62,0.62,7,2.12,1.88,1.61,1.61,4
Chichester City,8,5,0,3,15,9,6,15,England - Isthmian league,0.62,0.62,6,1.88,1.88,1.61,1.61,4
Cray Valley PM,8,4,2,2,13,10,3,14,England - Isthmian league,0.5,0.75,3,1.62,1.75,2.0,1.33,5
Carshalton,8,4,1,3,16,14,2,13,England - Isthmian league,0.5,0.62,2,2.0,1.62,2.0,1.61,6
Dover Athletic,8,4,1,3,8,7,1,13,England - Isthmian league,0.5,0.62,1,1.0,1.62,2.0,1.61,6
Lewes,8,4,1,3,13,14,-1,13,England - Isthmian league,0.5,0.62,-1,1.62,1.62,2.0,1.61,6
Whitehawk,8,4,0,4,13,8,5,12,England - Isthmian league,0.5,0.5,5,1.62,1.5,2.0,2.0,7
Bognor Regis,8,3,2,3,12,12,0,11,England - Isthmian league,0.38,0.62,0,1.5,1.38,2.63,1.61,8
Cheshunt,8,3,0,5,9,11,-2,9,England - Isthmian league,0.38,0.38,-2,1.12,1.12,2.63,2.63,9
Folkestone,8,2,2,4,10,14,-4,8,England - Isthmian league,0.25,0.5,-4,1.25,1.0,4.0,2.0,10
Potters Bar,8,2,1,5,5,12,-7,7,England - Isthmian league,0.25,0.38,-7,0.62,0.88,4.0,2.63,11
Hastings Utd,8,2,1,5,6,14,-8,7,England - Isthmian league,0.25,0.38,-8,0.75,0.88,4.0,2.63,11
Canvey Island,8,1,3,4,7,11,-4,6,England - Isthmian league,0.12,0.5,-4,0.88,0.75,8.33,2.0,12
Hendon,8,1,3,4,8,14,-6,6,England - Isthmian league,0.12,0.5,-6,1.0,0.75,8.33,2.0,12
Dulwich Hamlet,8,1,2,5,6,14,-8,5,England - Isthmian league,0.12,0.38,-8,0.75,0.62,8.33,2.63,13
Bowers & Pitsea,8,0,0,8,2,26,-24,0,England - Isthmian league,0.0,0.0,-24,0.25,0.0,0.0,0.0,14
Macclesfield,8,8,0,0,27,6,21,24,England - Northern league,1.0,1.0,21,3.38,3.0,1.0,1.0,1
Worksop Town,8,7,0,1,26,10,16,21,England - Northern league,0.88,0.88,16,3.25,2.62,1.14,1.14,2
Stockton Town,8,6,1,1,12,5,7,19,England - Northern league,0.75,0.88,7,1.5,2.38,1.33,1.14,3
Prescot Cables,8,6,1,1,11,7,4,19,England - Northern league,0.75,0.88,4,1.38,2.38,1.33,1.14,3
Morpeth Town,8,4,3,1,10,9,1,15,England - Northern league,0.5,0.88,1,1.25,1.88,2.0,1.14,4
Guiseley,8,3,5,0,10,5,5,14,England - Northern league,0.38,1.0,5,1.25,1.75,2.63,1.0,5
Leek Town,8,4,2,2,13,9,4,14,England - Northern league,0.5,0.75,4,1.62,1.75,2.0,1.33,5
Hyde Utd,8,4,2,2,12,10,2,14,England - Northern league,0.5,0.75,2,1.5,1.75,2.0,1.33,5
FC United,8,4,1,3,10,11,-1,13,England - Northern league,0.5,0.62,-1,1.25,1.62,2.0,1.61,6
Ilkeston Town,8,3,3,2,11,7,4,12,England - Northern league,0.38,0.75,4,1.38,1.5,2.63,1.33,7
Gainsborough,8,3,2,3,9,9,0,11,England - Northern league,0.38,0.62,0,1.12,1.38,2.63,1.61,8
Bamber Bridge,8,3,1,4,13,9,4,10,England - Northern league,0.38,0.5,4,1.62,1.25,2.63,2.0,9
Workington,8,3,1,4,14,12,2,10,England - Northern league,0.38,0.5,2,1.75,1.25,2.63,2.0,9
Ashton Utd,8,2,3,3,12,11,1,9,England - Northern league,0.25,0.62,1,1.5,1.12,4.0,1.61,10
Rylands,8,2,3,3,10,12,-2,9,England - Northern league,0.25,0.62,-2,1.25,1.12,4.0,1.61,10
Basford Utd,8,2,2,4,7,12,-5,8,England - Northern league,0.25,0.5,-5,0.88,1.0,4.0,2.0,11
Mickleover,8,2,2,4,6,17,-11,8,England - Northern league,0.25,0.5,-11,0.75,1.0,4.0,2.0,11
Whitby Town,8,2,1,5,9,13,-4,7,England - Northern league,0.25,0.38,-4,1.12,0.88,4.0,2.63,12
Matlock,8,1,3,4,8,12,-4,6,England - Northern league,0.12,0.5,-4,1.0,0.75,8.33,2.0,13
Lancaster City,8,1,1,6,7,15,-8,4,England - Northern league,0.12,0.25,-8,0.88,0.5,8.33,4.0,14
Hebburn Town,8,1,1,6,5,14,-9,4,England - Northern league,0.12,0.25,-9,0.62,0.5,8.33,4.0,14
Blyth Spartans,8,0,1,7,7,25,-18,1,England - Northern league,0.0,0.12,-18,0.88,0.12,0.0,8.33,15
Bedford Town,8,6,2,0,17,4,13,20,England - Southern Central,0.75,1.0,13,2.12,2.5,1.33,1.0,1
Halesowen Town,8,5,3,0,11,4,7,18,England - Southern Central,0.62,1.0,7,1.38,2.25,1.61,1.0,2
Stamford,8,5,2,1,10,7,3,17,England - Southern Central,0.62,0.88,3,1.25,2.12,1.61,1.14,3
Harborough Town,8,4,4,0,16,6,10,16,England - Southern Central,0.5,1.0,10,2.0,2.0,2.0,1.0,4
Telford Utd,8,4,4,0,15,7,8,16,England - Southern Central,0.5,1.0,8,1.88,2.0,2.0,1.0,4
Spalding United,8,5,1,2,16,11,5,16,England - Southern Central,0.62,0.75,5,2.0,2.0,1.61,1.33,4
Kettering Town,8,3,4,1,11,8,3,13,England - Southern Central,0.38,0.88,3,1.38,1.62,2.63,1.14,5
Barwell,8,4,1,3,17,15,2,13,England - Southern Central,0.5,0.62,2,2.12,1.62,2.0,1.61,5
Banbury Utd,8,3,3,2,10,9,1,12,England - Southern Central,0.38,0.75,1,1.25,1.5,2.63,1.33,6
Bromsgrove,8,3,2,3,13,10,3,11,England - Southern Central,0.38,0.62,3,1.62,1.38,2.63,1.61,7
B. Stortford,8,3,2,3,11,15,-4,11,England - Southern Central,0.38,0.62,-4,1.38,1.38,2.63,1.61,7
Stratford Town,8,2,4,2,8,8,0,10,England - Southern Central,0.25,0.75,0,1.0,1.25,4.0,1.33,8
AFC Sudbury,8,3,1,4,9,12,-3,10,England - Southern Central,0.38,0.5,-3,1.12,1.25,2.63,2.0,8
Royston,8,1,6,1,8,7,1,9,England - Southern Central,0.12,0.88,1,1.0,1.12,8.33,1.14,9
Stourbridge,8,2,3,3,7,10,-3,9,England - Southern Central,0.25,0.62,-3,0.88,1.12,4.0,1.61,9
Leiston,8,2,2,4,10,13,-3,8,England - Southern Central,0.25,0.5,-3,1.25,1.0,4.0,2.0,10
Alvechurch,8,2,2,4,5,8,-3,8,England - Southern Central,0.25,0.5,-3,0.62,1.0,4.0,2.0,10
St. Ives Town,8,1,4,3,12,15,-3,7,England - Southern Central,0.12,0.62,-3,1.5,0.88,8.33,1.61,11
Redditch Utd,8,1,3,4,4,8,-4,6,England - Southern Central,0.12,0.5,-4,0.5,0.75,8.33,2.0,12
Hitchin Town,8,0,4,4,12,16,-4,4,England - Southern Central,0.0,0.5,-4,1.5,0.5,0.0,2.0,13
Biggleswade,8,1,1,6,7,14,-7,4,England - Southern Central,0.12,0.25,-7,0.88,0.5,8.33,4.0,13
Lowestoft,8,0,3,5,7,20,-13,3,England - Southern Central,0.0,0.38,-13,0.88,0.38,0.0,2.63,14
Levadia,5,5,0,0,13,4,9,15,Estonia - Meistriliiga,1.0,1.0,9,2.6,3.0,1.0,1.0,1
Paide,5,4,0,1,12,2,10,12,Estonia - Meistriliiga,0.8,0.8,10,2.4,2.4,1.25,1.25,2
Flora,5,3,1,1,13,4,9,10,Estonia - Meistriliiga,0.6,0.8,9,2.6,2.0,1.67,1.25,3
Vaprus,5,2,1,2,8,6,2,7,Estonia - Meistriliiga,0.4,0.6,2,1.6,1.4,2.5,1.67,4
Narva Trans,5,2,1,2,6,5,1,7,Estonia - Meistriliiga,0.4,0.6,1,1.2,1.4,2.5,1.67,4
Harju JK,5,2,1,2,5,10,-5,7,Estonia - Meistriliiga,0.4,0.6,-5,1.0,1.4,2.5,1.67,4
Nomme Kalju,5,1,1,3,7,10,-3,4,Estonia - Meistriliiga,0.2,0.4,-3,1.4,0.8,5.0,2.5,5
Tammeka,5,1,1,3,6,12,-6,4,Estonia - Meistriliiga,0.2,0.4,-6,1.2,0.8,5.0,2.5,5
Kuressaare,5,1,0,4,5,13,-8,3,Estonia - Meistriliiga,0.2,0.2,-8,1.0,0.6,5.0,5.0,6
Tallinna Kalev,5,1,0,4,5,14,-9,3,Estonia - Meistriliiga,0.2,0.2,-9,1.0,0.6,5.0,5.0,6
Elva,5,4,1,0,13,7,6,13,Estonia - Esiliiga,0.8,1.0,6,2.6,2.6,1.25,1.0,1
Nomme Utd,5,4,0,1,8,3,5,12,Estonia - Esiliiga,0.8,0.8,5,1.6,2.4,1.25,1.25,2
Viimsi,5,3,1,1,12,6,6,10,Estonia - Esiliiga,0.6,0.8,6,2.4,2.0,1.67,1.25,3
Tartu Welco,5,3,1,1,9,7,2,10,Estonia - Esiliiga,0.6,0.8,2,1.8,2.0,1.67,1.25,3
Nomme Kalju B,5,3,0,2,6,9,-3,9,Estonia - Esiliiga,0.6,0.6,-3,1.2,1.8,1.67,1.67,4
Flora B,5,2,1,2,7,6,1,7,Estonia - Esiliiga,0.4,0.6,1,1.4,1.4,2.5,1.67,5
Levadia B,5,2,1,2,7,6,1,7,Estonia - Esiliiga,0.4,0.6,1,1.4,1.4,2.5,1.67,5
Tallinna K. B,5,0,2,3,5,10,-5,2,Estonia - Esiliiga,0.0,0.4,-5,1.0,0.4,0.0,2.5,6
FC Tallinn,5,0,1,4,4,11,-7,1,Estonia - Esiliiga,0.0,0.2,-7,0.8,0.2,0.0,5.0,7
Tammeka B,5,0,0,5,5,11,-6,0,Estonia - Esiliiga,0.0,0.0,-6,1.0,0.0,0.0,0.0,8
NSI Runavik,4,4,0,0,22,4,18,12,FaroeIslands - Premier League,1.0,1.0,18,5.5,3.0,1.0,1.0,1
HB Torshavn,4,4,0,0,12,3,9,12,FaroeIslands - Premier League,1.0,1.0,9,3.0,3.0,1.0,1.0,1
Klaksvik,4,4,0,0,10,3,7,12,FaroeIslands - Premier League,1.0,1.0,7,2.5,3.0,1.0,1.0,1
B36 Torshavn,4,2,0,2,6,7,-1,6,FaroeIslands - Premier League,0.5,0.5,-1,1.5,1.5,2.0,2.0,2
Streymur,4,1,1,2,5,7,-2,4,FaroeIslands - Premier League,0.25,0.5,-2,1.25,1.0,4.0,2.0,3
Suduroy,4,1,0,3,1,8,-7,3,FaroeIslands - Premier League,0.25,0.25,-7,0.25,0.75,4.0,4.0,4
B68 Toftir,4,1,0,3,4,16,-12,3,FaroeIslands - Premier League,0.25,0.25,-12,1.0,0.75,4.0,4.0,4
TB Tvoroyri,4,0,2,2,3,5,-2,2,FaroeIslands - Premier League,0.0,0.5,-2,0.75,0.5,0.0,2.0,5
Vikingur,4,0,2,2,1,5,-4,2,FaroeIslands - Premier League,0.0,0.5,-4,0.25,0.5,0.0,2.0,5
07 Vestur,4,0,1,3,3,9,-6,1,FaroeIslands - Premier League,0.0,0.25,-6,0.75,0.25,0.0,4.0,6
Skala,4,3,1,0,11,1,10,10,FaroeIslands - 1. Deild,0.75,1.0,10,2.75,2.5,1.33,1.0,1
Vikingur B,4,3,0,1,9,5,4,9,FaroeIslands - 1. Deild,0.75,0.75,4,2.25,2.25,1.33,1.33,2
B71 Sandur,4,3,0,1,6,3,3,9,FaroeIslands - 1. Deild,0.75,0.75,3,1.5,2.25,1.33,1.33,2
Streymur B,3,2,0,1,3,2,1,6,FaroeIslands - 1. Deild,0.67,0.67,1,1.0,2.0,1.49,1.49,3
AB Argir,3,1,2,0,4,2,2,5,FaroeIslands - 1. Deild,0.33,1.0,2,1.33,1.67,3.03,1.0,4
IF Fuglafjordur,4,1,2,1,6,7,-1,5,FaroeIslands - 1. Deild,0.25,0.75,-1,1.5,1.25,4.0,1.33,4
NSI Runavik B,4,1,1,2,8,8,0,4,FaroeIslands - 1. Deild,0.25,0.5,0,2.0,1.0,4.0,2.0,5
Klaksvik B,4,1,1,2,4,6,-2,4,FaroeIslands - 1. Deild,0.25,0.5,-2,1.0,1.0,4.0,2.0,5
B36 Torshavn B,4,0,1,3,3,11,-8,1,FaroeIslands - 1. Deild,0.0,0.25,-8,0.75,0.25,0.0,4.0,6
07 Vestur B,4,0,0,4,3,12,-9,0,FaroeIslands - 1. Deild,0.0,0.0,-9,0.75,0.0,0.0,0.0,7
Jaro,1,1,0,0,2,0,2,3,Finland - Veikkausliiga,1.0,1.0,2,2.0,3.0,1.0,1.0,1
VPS,1,1,0,0,4,3,1,3,Finland - Veikkausliiga,1.0,1.0,1,4.0,3.0,1.0,1.0,1
Haka,1,1,0,0,3,2,1,3,Finland - Veikkausliiga,1.0,1.0,1,3.0,3.0,1.0,1.0,1
Ilves,1,1,0,0,3,2,1,3,Finland - Veikkausliiga,1.0,1.0,1,3.0,3.0,1.0,1.0,1
SJK,1,1,0,0,1,0,1,3,Finland - Veikkausliiga,1.0,1.0,1,1.0,3.0,1.0,1.0,1
Inter Turku,1,0,1,0,1,1,0,1,Finland - Veikkausliiga,0.0,1.0,0,1.0,1.0,0.0,1.0,2
KuPS,1,0,1,0,1,1,0,1,Finland - Veikkausliiga,0.0,1.0,0,1.0,1.0,0.0,1.0,2
Oulu,1,0,0,1,3,4,-1,0,Finland - Veikkausliiga,0.0,0.0,-1,3.0,0.0,0.0,0.0,3
Gnistan,1,0,0,1,2,3,-1,0,Finland - Veikkausliiga,0.0,0.0,-1,2.0,0.0,0.0,0.0,3
HJK Helsinki,1,0,0,1,2,3,-1,0,Finland - Veikkausliiga,0.0,0.0,-1,2.0,0.0,0.0,0.0,3
KTP,1,0,0,1,0,1,-1,0,Finland - Veikkausliiga,0.0,0.0,-1,0.0,0.0,0.0,0.0,3
Mariehamn,1,0,0,1,0,2,-2,0,Finland - Veikkausliiga,0.0,0.0,-2,0.0,0.0,0.0,0.0,3
JaPS,8,5,1,2,17,13,4,16,Finland - Ykkosliga,0.62,0.75,4,2.12,2.0,1.61,1.33,1
JIPPO,8,5,0,3,17,9,8,15,Finland - Ykkosliga,0.62,0.62,8,2.12,1.88,1.61,1.61,2
PK-35,8,4,3,1,8,5,3,15,Finland - Ykkosliga,0.5,0.88,3,1.0,1.88,2.0,1.14,2
Jaro,8,5,0,3,15,14,1,15,Finland - Ykkosliga,0.62,0.62,1,1.88,1.88,1.61,1.61,2
KTP,8,4,2,2,26,14,12,14,Finland - Ykkosliga,0.5,0.75,12,3.25,1.75,2.0,1.33,3
KaPa,8,3,1,4,20,25,-5,10,Finland - Ykkosliga,0.38,0.5,-5,2.5,1.25,2.63,2.0,4
TPS,8,2,3,3,13,11,2,9,Finland - Ykkosliga,0.25,0.62,2,1.62,1.12,4.0,1.61,5
SalPa,8,2,1,5,8,18,-10,7,Finland - Ykkosliga,0.25,0.38,-10,1.0,0.88,4.0,2.63,6
SJK Akatemia,8,0,5,3,13,18,-5,5,Finland - Ykkosliga,0.0,0.62,-5,1.62,0.62,0.0,1.61,7
Mikkelin,8,1,2,5,9,19,-10,5,Finland - Ykkosliga,0.12,0.38,-10,1.12,0.62,8.33,2.63,7
KPV Kokkola,8,6,1,1,16,7,9,19,Finland - Ykkonen,0.75,0.88,9,2.0,2.38,1.33,1.14,1
Klubi-04,8,5,0,3,16,11,5,15,Finland - Ykkonen,0.62,0.62,5,2.0,1.88,1.61,1.61,2
JJK,8,5,0,3,14,15,-1,15,Finland - Ykkonen,0.62,0.62,-1,1.75,1.88,1.61,1.61,2
Atlantis,8,4,2,2,22,18,4,14,Finland - Ykkonen,0.5,0.75,4,2.75,1.75,2.0,1.33,3
OLS Oulu,8,4,2,2,21,19,2,14,Finland - Ykkonen,0.5,0.75,2,2.62,1.75,2.0,1.33,3
PKKU,8,4,1,3,24,18,6,13,Finland - Ykkonen,0.5,0.62,6,3.0,1.62,2.0,1.61,4
Rovaniemi,8,3,1,4,13,12,1,10,Finland - Ykkonen,0.38,0.5,1,1.62,1.25,2.63,2.0,5
VIFK,8,3,1,4,18,18,0,10,Finland - Ykkonen,0.38,0.5,0,2.25,1.25,2.63,2.0,5
Jazz Pori,8,3,1,4,18,20,-2,10,Finland - Ykkonen,0.38,0.5,-2,2.25,1.25,2.63,2.0,5
EPS,8,3,1,4,17,20,-3,10,Finland - Ykkonen,0.38,0.5,-3,2.12,1.25,2.63,2.0,5
KuPS Ak.,8,2,0,6,12,20,-8,6,Finland - Ykkonen,0.25,0.25,-8,1.5,0.75,4.0,4.0,6
Vaajakoski,8,0,2,6,10,23,-13,2,Finland - Ykkonen,0.0,0.25,-13,1.25,0.25,0.0,4.0,7
PEPO,8,4,4,0,15,9,6,16,Finland - Kakkonen Group A,0.5,1.0,6,1.88,2.0,2.0,1.0,1
Reipas,8,4,2,2,18,10,8,14,Finland - Kakkonen Group A,0.5,0.75,8,2.25,1.75,2.0,1.33,2
PPJ,8,4,1,3,17,12,5,13,Finland - Kakkonen Group A,0.5,0.62,5,2.12,1.62,2.0,1.61,3
NJS,8,3,4,1,16,12,4,13,Finland - Kakkonen Group A,0.38,0.88,4,2.0,1.62,2.63,1.14,3
Atlantis B,8,4,1,3,13,13,0,13,Finland - Kakkonen Group A,0.5,0.62,0,1.62,1.62,2.0,1.61,3
MYPA,8,3,3,2,13,13,0,12,Finland - Kakkonen Group A,0.38,0.75,0,1.62,1.5,2.63,1.33,4
Kiffen,8,3,2,3,12,9,3,11,Finland - Kakkonen Group A,0.38,0.62,3,1.5,1.38,2.63,1.61,5
JaPS B,8,2,1,5,11,19,-8,7,Finland - Kakkonen Group A,0.25,0.38,-8,1.38,0.88,4.0,2.63,6
GrIFK,8,1,3,4,9,15,-6,6,Finland - Kakkonen Group A,0.12,0.5,-6,1.12,0.75,8.33,2.0,7
Futura,8,1,1,6,7,19,-12,4,Finland - Kakkonen Group A,0.12,0.25,-12,0.88,0.5,8.33,4.0,8
Inter Turku B,8,7,1,0,30,7,23,22,Finland - Kakkonen Group B,0.88,1.0,23,3.75,2.75,1.14,1.0,1
HJS Akatemia,8,6,1,1,20,6,14,19,Finland - Kakkonen Group B,0.75,0.88,14,2.5,2.38,1.33,1.14,2
Tampere Utd,8,5,1,2,21,10,11,16,Finland - Kakkonen Group B,0.62,0.75,11,2.62,2.0,1.61,1.33,3
VJS,8,5,0,3,21,13,8,15,Finland - Kakkonen Group B,0.62,0.62,8,2.62,1.88,1.61,1.61,4
Ilves B,8,4,0,4,17,17,0,12,Finland - Kakkonen Group B,0.5,0.5,0,2.12,1.5,2.0,2.0,5
P-Iirot,8,4,0,4,11,11,0,12,Finland - Kakkonen Group B,0.5,0.5,0,1.38,1.5,2.0,2.0,5
TPV,8,2,3,3,16,19,-3,9,Finland - Kakkonen Group B,0.25,0.62,-3,2.0,1.12,4.0,1.61,6
Honka,8,2,3,3,14,17,-3,9,Finland - Kakkonen Group B,0.25,0.62,-3,1.75,1.12,4.0,1.61,6
Ilves-Kissat,8,2,1,5,17,30,-13,7,Finland - Kakkonen Group B,0.25,0.38,-13,2.12,0.88,4.0,2.63,7
Poxyt,8,1,0,7,10,22,-12,3,Finland - Kakkonen Group B,0.12,0.12,-12,1.25,0.38,8.33,8.33,8
EBK,8,0,0,8,8,35,-27,0,Finland - Kakkonen Group B,0.0,0.0,-27,1.0,0.0,0.0,0.0,9
TP-47,8,6,2,0,25,9,16,20,Finland - Kakkonen Group C,0.75,1.0,16,3.12,2.5,1.33,1.0,1
Narpes Kraft,8,6,0,2,26,15,11,18,Finland - Kakkonen Group C,0.75,0.75,11,3.25,2.25,1.33,1.33,2
GBK,8,5,0,3,15,13,2,15,Finland - Kakkonen Group C,0.62,0.62,2,1.88,1.88,1.61,1.61,3
JBK,8,4,2,2,14,10,4,14,Finland - Kakkonen Group C,0.5,0.75,4,1.75,1.75,2.0,1.33,4
Kuopion Elo,8,3,2,3,19,18,1,11,Finland - Kakkonen Group C,0.38,0.62,1,2.38,1.38,2.63,1.61,5
JS Hercules,8,3,2,3,18,18,0,11,Finland - Kakkonen Group C,0.38,0.62,0,2.25,1.38,2.63,1.61,5
SJK Akatemia B,8,2,1,5,16,21,-5,7,Finland - Kakkonen Group C,0.25,0.38,-5,2.0,0.88,4.0,2.63,6
OPS,8,2,1,5,14,23,-9,7,Finland - Kakkonen Group C,0.25,0.38,-9,1.75,0.88,4.0,2.63,6
JPS,8,1,3,4,19,17,2,6,Finland - Kakkonen Group C,0.12,0.5,2,2.38,0.75,8.33,2.0,7
OTP,8,1,0,7,12,33,-21,3,Finland - Kakkonen Group C,0.12,0.12,-21,1.5,0.38,8.33,8.33,8
Paris SG,8,8,0,0,26,7,19,24,France - Ligue 1,1.0,1.0,19,3.25,3.0,1.0,1.0,1
Strasbourg,8,7,1,0,13,3,10,22,France - Ligue 1,0.88,1.0,10,1.62,2.75,1.14,1.0,2
Lyon,8,6,0,2,22,12,10,18,France - Ligue 1,0.75,0.75,10,2.75,2.25,1.33,1.33,3
Brest,8,4,3,1,13,7,6,15,France - Ligue 1,0.5,0.88,6,1.62,1.88,2.0,1.14,4
Auxerre,8,4,3,1,12,6,6,15,France - Ligue 1,0.5,0.88,6,1.5,1.88,2.0,1.14,4
Monaco,8,4,1,3,18,11,7,13,France - Ligue 1,0.5,0.62,7,2.25,1.62,2.0,1.61,5
Nice,8,4,1,3,13,9,4,13,France - Ligue 1,0.5,0.62,4,1.62,1.62,2.0,1.61,5
Le Havre,8,4,1,3,16,18,-2,13,France - Ligue 1,0.5,0.62,-2,2.0,1.62,2.0,1.61,5
Rennes,8,4,0,4,11,8,3,12,France - Ligue 1,0.5,0.5,3,1.38,1.5,2.0,2.0,6
Marseille,8,4,0,4,14,13,1,12,France - Ligue 1,0.5,0.5,1,1.75,1.5,2.0,2.0,6
Lille,8,4,0,4,9,10,-1,12,France - Ligue 1,0.5,0.5,-1,1.12,1.5,2.0,2.0,6
Lens,8,3,0,5,7,12,-5,9,France - Ligue 1,0.38,0.38,-5,0.88,1.12,2.63,2.63,7
Nantes,8,3,0,5,9,17,-8,9,France - Ligue 1,0.38,0.38,-8,1.12,1.12,2.63,2.63,7
Toulouse,8,2,2,4,16,14,2,8,France - Ligue 1,0.25,0.5,2,2.0,1.0,4.0,2.0,8
Saint-Etienne,8,1,2,5,9,21,-12,5,France - Ligue 1,0.12,0.38,-12,1.12,0.62,8.33,2.63,9
Reims,8,1,1,6,3,13,-10,4,France - Ligue 1,0.12,0.25,-10,0.38,0.5,8.33,4.0,10
Angers,8,1,1,6,4,17,-13,4,France - Ligue 1,0.12,0.25,-13,0.5,0.5,8.33,4.0,10
Montpellier,8,0,0,8,1,18,-17,0,France - Ligue 1,0.0,0.0,-17,0.12,0.0,0.0,0.0,11
Metz,8,6,1,1,20,9,11,19,France - Ligue 2,0.75,0.88,11,2.5,2.38,1.33,1.14,1
Lorient,8,6,0,2,20,7,13,18,France - Ligue 2,0.75,0.75,13,2.5,2.25,1.33,1.33,2
Paris FC,8,6,0,2,16,11,5,18,France - Ligue 2,0.75,0.75,5,2.0,2.25,1.33,1.33,2
SC Bastia,8,4,2,2,8,8,0,14,France - Ligue 2,0.5,0.75,0,1.0,1.75,2.0,1.33,3
Guingamp,8,4,1,3,11,9,2,13,France - Ligue 2,0.5,0.62,2,1.38,1.62,2.0,1.61,4
AC Ajaccio,8,4,1,3,11,11,0,13,France - Ligue 2,0.5,0.62,0,1.38,1.62,2.0,1.61,4
Rodez Aveyron,8,3,3,2,15,9,6,12,France - Ligue 2,0.38,0.75,6,1.88,1.5,2.63,1.33,5
Red Star,8,3,3,2,10,7,3,12,France - Ligue 2,0.38,0.75,3,1.25,1.5,2.63,1.33,5
USL Dunkerque,8,4,0,4,11,12,-1,12,France - Ligue 2,0.5,0.5,-1,1.38,1.5,2.0,2.0,5
Grenoble,8,2,4,2,10,8,2,10,France - Ligue 2,0.25,0.75,2,1.25,1.25,4.0,1.33,6
Troyes,8,3,1,4,9,8,1,10,France - Ligue 2,0.38,0.5,1,1.12,1.25,2.63,2.0,6
Martigues,8,3,1,4,8,7,1,10,France - Ligue 2,0.38,0.5,1,1.0,1.25,2.63,2.0,6
Laval,8,3,0,5,6,9,-3,9,France - Ligue 2,0.38,0.38,-3,0.75,1.12,2.63,2.63,7
Annecy,8,2,2,4,7,13,-6,8,France - Ligue 2,0.25,0.5,-6,0.88,1.0,4.0,2.0,8
Pau FC,8,2,2,4,7,19,-12,8,France - Ligue 2,0.25,0.5,-12,0.88,1.0,4.0,2.0,8
Caen,8,1,2,5,8,14,-6,5,France - Ligue 2,0.12,0.38,-6,1.0,0.62,8.33,2.63,9
Amiens,8,1,2,5,8,16,-8,5,France - Ligue 2,0.12,0.38,-8,1.0,0.62,8.33,2.63,9
Clermont,8,0,3,5,4,14,-10,3,France - Ligue 2,0.0,0.38,-10,0.5,0.38,0.0,2.63,10
Le Mans,8,6,1,1,13,4,9,19,France - National,0.75,0.88,9,1.62,2.38,1.33,1.14,1
Boulogne,8,4,2,2,13,9,4,14,France - National,0.5,0.75,4,1.62,1.75,2.0,1.33,2
Bourg-en-Bresse,8,4,2,2,7,4,3,14,France - National,0.5,0.75,3,0.88,1.75,2.0,1.33,2
Nancy,8,4,1,3,10,8,2,13,France - National,0.5,0.62,2,1.25,1.62,2.0,1.61,3
Villefranche,8,3,3,2,12,10,2,12,France - National,0.38,0.75,2,1.5,1.5,2.63,1.33,4
Nimes,8,3,2,3,9,8,1,11,France - National,0.38,0.62,1,1.12,1.38,2.63,1.61,5
Versailles,8,2,5,1,11,11,0,11,France - National,0.25,0.88,0,1.38,1.38,4.0,1.14,5
Chateauroux,8,3,2,3,11,12,-1,11,France - National,0.38,0.62,-1,1.38,1.38,2.63,1.61,5
Orleans,8,2,4,2,11,11,0,10,France - National,0.25,0.75,0,1.38,1.25,4.0,1.33,6
Dijon,8,2,4,2,6,6,0,10,France - National,0.25,0.75,0,0.75,1.25,4.0,1.33,6
Valenciennes,8,2,3,3,7,7,0,9,France - National,0.25,0.62,0,0.88,1.12,4.0,1.61,7
Concarneau,8,2,3,3,11,13,-2,9,France - National,0.25,0.62,-2,1.38,1.12,4.0,1.61,7
Rouen,8,2,3,3,10,12,-2,9,France - National,0.25,0.62,-2,1.25,1.12,4.0,1.61,7
Aubagne,8,2,2,4,6,9,-3,8,France - National,0.25,0.5,-3,0.75,1.0,4.0,2.0,8
Quevilly Rouen,8,2,2,4,6,10,-4,8,France - National,0.25,0.5,-4,0.75,1.0,4.0,2.0,8
Paris 13 A.,8,1,3,4,6,10,-4,6,France - National,0.12,0.5,-4,0.75,0.75,8.33,2.0,9
Sochaux,8,1,3,4,6,10,-4,6,France - National,0.12,0.5,-4,0.75,0.75,8.33,2.0,9
Iberia,6,4,2,0,10,1,9,14,Georgia - Erovnuli Liga,0.67,1.0,9,1.67,2.33,1.49,1.0,1
Dinamo Batumi,6,3,3,0,6,3,3,12,Georgia - Erovnuli Liga,0.5,1.0,3,1.0,2.0,2.0,1.0,2
Dila Gori,6,3,2,1,11,5,6,11,Georgia - Erovnuli Liga,0.5,0.83,6,1.83,1.83,2.0,1.2,3
Dinamo Tbilisi,6,3,2,1,8,3,5,11,Georgia - Erovnuli Liga,0.5,0.83,5,1.33,1.83,2.0,1.2,3
Telavi,6,3,1,2,6,10,-4,10,Georgia - Erovnuli Liga,0.5,0.67,-4,1.0,1.67,2.0,1.49,4
Samgurali,6,2,2,2,7,5,2,8,Georgia - Erovnuli Liga,0.33,0.67,2,1.17,1.33,3.03,1.49,5
Torpedo Kutaisi,6,1,1,4,5,9,-4,4,Georgia - Erovnuli Liga,0.17,0.33,-4,0.83,0.67,5.88,3.03,6
Gareji Sagarejo,6,1,1,4,3,7,-4,4,Georgia - Erovnuli Liga,0.17,0.33,-4,0.5,0.67,5.88,3.03,6
Gagra,6,1,1,4,4,10,-6,4,Georgia - Erovnuli Liga,0.17,0.33,-6,0.67,0.67,5.88,3.03,6
Kolkheti Poti,6,1,1,4,1,8,-7,4,Georgia - Erovnuli Liga,0.17,0.33,-7,0.17,0.67,5.88,3.03,6
Spaeri,5,3,2,0,13,9,4,11,Georgia - Erovnuli Liga 2,0.6,1.0,4,2.6,2.2,1.67,1.0,1
Rustavi,5,3,2,0,9,5,4,11,Georgia - Erovnuli Liga 2,0.6,1.0,4,1.8,2.2,1.67,1.0,1
Merani Martvili,5,2,1,2,9,10,-1,7,Georgia - Erovnuli Liga 2,0.4,0.6,-1,1.8,1.4,2.5,1.67,2
Samtredia,5,1,3,1,5,5,0,6,Georgia - Erovnuli Liga 2,0.2,0.8,0,1.0,1.2,5.0,1.25,3
Meshakhte,5,1,3,1,4,6,-2,6,Georgia - Erovnuli Liga 2,0.2,0.8,-2,0.8,1.2,5.0,1.25,3
Bolnisi,5,1,2,2,5,4,1,5,Georgia - Erovnuli Liga 2,0.2,0.6,1,1.0,1.0,5.0,1.67,4
Iberia B,5,1,2,2,5,6,-1,5,Georgia - Erovnuli Liga 2,0.2,0.6,-1,1.0,1.0,5.0,1.67,4
Gonio,5,1,2,2,4,5,-1,5,Georgia - Erovnuli Liga 2,0.2,0.6,-1,0.8,1.0,5.0,1.67,4
L. Tbilisi,5,0,4,1,6,7,-1,4,Georgia - Erovnuli Liga 2,0.0,0.8,-1,1.2,0.8,0.0,1.25,5
D. Tbilisi B,5,0,3,2,6,9,-3,3,Georgia - Erovnuli Liga 2,0.0,0.6,-3,1.2,0.6,0.0,1.67,6
Bayern Munich,8,5,2,1,19,8,11,17,Germany - Bundesliga,0.62,0.88,11,2.38,2.12,1.61,1.14,1
Leverkusen,8,5,2,1,14,7,7,17,Germany - Bundesliga,0.62,0.88,7,1.75,2.12,1.61,1.14,1
FSV Mainz,8,4,3,1,13,8,5,15,Germany - Bundesliga,0.5,0.88,5,1.62,1.88,2.0,1.14,2
Monchengladbach,8,4,2,2,13,11,2,14,Germany - Bundesliga,0.5,0.75,2,1.62,1.75,2.0,1.33,3
FC Augsburg,8,3,4,1,7,4,3,13,Germany - Bundesliga,0.38,0.88,3,0.88,1.62,2.63,1.14,4
Union Berlin,8,4,1,3,11,12,-1,13,Germany - Bundesliga,0.5,0.62,-1,1.38,1.62,2.0,1.61,4
Dortmund,8,4,0,4,16,9,7,12,Germany - Bundesliga,0.5,0.5,7,2.0,1.5,2.0,2.0,5
RB Leipzig,8,3,3,2,10,6,4,12,Germany - Bundesliga,0.38,0.75,4,1.25,1.5,2.63,1.33,5
Freiburg,8,3,3,2,11,8,3,12,Germany - Bundesliga,0.38,0.75,3,1.38,1.5,2.63,1.33,5
E. Frankfurt,8,3,1,4,10,15,-5,10,Germany - Bundesliga,0.38,0.5,-5,1.25,1.25,2.63,2.0,6
Wolfsburg,8,2,3,3,6,7,-1,9,Germany - Bundesliga,0.25,0.62,-1,0.75,1.12,4.0,1.61,7
Hoffenheim,8,2,3,3,8,12,-4,9,Germany - Bundesliga,0.25,0.62,-4,1.0,1.12,4.0,1.61,7
Werder Bremen,8,3,0,5,11,17,-6,9,Germany - Bundesliga,0.38,0.38,-6,1.38,1.12,2.63,2.63,7
Stuttgart,8,2,2,4,14,14,0,8,Germany - Bundesliga,0.25,0.5,0,1.75,1.0,4.0,2.0,8
Heidenheim,8,2,2,4,7,11,-4,8,Germany - Bundesliga,0.25,0.5,-4,0.88,1.0,4.0,2.0,8
Bochum,8,2,2,4,10,16,-6,8,Germany - Bundesliga,0.25,0.5,-6,1.25,1.0,4.0,2.0,8
Holstein Kiel,8,1,3,4,8,16,-8,6,Germany - Bundesliga,0.12,0.5,-8,1.0,0.75,8.33,2.0,9
Sankt Pauli,8,1,2,5,5,12,-7,5,Germany - Bundesliga,0.12,0.38,-7,0.62,0.62,8.33,2.63,10
Hamburger SV,8,5,2,1,16,5,11,17,Germany - 2. Bundesliga,0.62,0.88,11,2.0,2.12,1.61,1.14,1
Elversberg,8,4,3,1,16,2,14,15,Germany - 2. Bundesliga,0.5,0.88,14,2.0,1.88,2.0,1.14,2
Paderborn,8,4,2,2,15,9,6,14,Germany - 2. Bundesliga,0.5,0.75,6,1.88,1.75,2.0,1.33,3
FC Nurnberg,8,4,1,3,12,10,2,13,Germany - 2. Bundesliga,0.5,0.62,2,1.5,1.62,2.0,1.61,4
Schalke 04,8,4,1,3,11,11,0,13,Germany - 2. Bundesliga,0.5,0.62,0,1.38,1.62,2.0,1.61,4
FC Koln,8,4,1,3,7,8,-1,13,Germany - 2. Bundesliga,0.5,0.62,-1,0.88,1.62,2.0,1.61,4
Braunschweig,8,3,3,2,10,13,-3,12,Germany - 2. Bundesliga,0.38,0.75,-3,1.25,1.5,2.63,1.33,5
Magdeburg,8,3,2,3,14,12,2,11,Germany - 2. Bundesliga,0.38,0.62,2,1.75,1.38,2.63,1.61,6
Hannover 96,8,2,5,1,7,6,1,11,Germany - 2. Bundesliga,0.25,0.88,1,0.88,1.38,4.0,1.14,6
Greuther Furth,8,3,2,3,11,12,-1,11,Germany - 2. Bundesliga,0.38,0.62,-1,1.38,1.38,2.63,1.61,6
Kaiserslautern,8,3,2,3,11,12,-1,11,Germany - 2. Bundesliga,0.38,0.62,-1,1.38,1.38,2.63,1.61,6
Dusseldorf,8,3,2,3,9,12,-3,11,Germany - 2. Bundesliga,0.38,0.62,-3,1.12,1.38,2.63,1.61,6
Hertha Berlin,8,3,1,4,11,11,0,10,Germany - 2. Bundesliga,0.38,0.5,0,1.38,1.25,2.63,2.0,7
Karlsruher SC,8,3,1,4,7,11,-4,10,Germany - 2. Bundesliga,0.38,0.5,-4,0.88,1.25,2.63,2.0,7
Darmstadt,8,3,0,5,9,12,-3,9,Germany - 2. Bundesliga,0.38,0.38,-3,1.12,1.12,2.63,2.63,8
Preuss. Munster,8,2,1,5,5,8,-3,7,Germany - 2. Bundesliga,0.25,0.38,-3,0.62,0.88,4.0,2.63,9
Ulm,8,1,3,4,4,9,-5,6,Germany - 2. Bundesliga,0.12,0.5,-5,0.5,0.75,8.33,2.0,10
Regensburg,8,1,2,5,4,16,-12,5,Germany - 2. Bundesliga,0.12,0.38,-12,0.5,0.62,8.33,2.63,11
Bielefeld,8,6,1,1,17,7,10,19,Germany - 3. Liga,0.75,0.88,10,2.12,2.38,1.33,1.14,1
Dynamo Dresden,8,5,2,1,15,6,9,17,Germany - 3. Liga,0.62,0.88,9,1.88,2.12,1.61,1.14,2
RW Essen,8,5,1,2,10,7,3,16,Germany - 3. Liga,0.62,0.75,3,1.25,2.0,1.61,1.33,3
Mannheim,8,4,3,1,14,7,7,15,Germany - 3. Liga,0.5,0.88,7,1.75,1.88,2.0,1.14,4
Osnabruck,8,4,2,2,12,7,5,14,Germany - 3. Liga,0.5,0.75,5,1.5,1.75,2.0,1.33,5
1860 Munchen,8,4,1,3,13,12,1,13,Germany - 3. Liga,0.5,0.62,1,1.62,1.62,2.0,1.61,6
VfB Stuttgart B,8,4,1,3,12,11,1,13,Germany - 3. Liga,0.5,0.62,1,1.5,1.62,2.0,1.61,6
Verl,8,4,1,3,12,12,0,13,Germany - 3. Liga,0.5,0.62,0,1.5,1.62,2.0,1.61,6
Erzgebirge Aue,8,4,0,4,9,10,-1,12,Germany - 3. Liga,0.5,0.5,-1,1.12,1.5,2.0,2.0,7
Viktoria Koln,8,3,2,3,12,11,1,11,Germany - 3. Liga,0.38,0.62,1,1.5,1.38,2.63,1.61,8
FC Ingolstadt,8,3,2,3,13,14,-1,11,Germany - 3. Liga,0.38,0.62,-1,1.62,1.38,2.63,1.61,8
Hansa Rostock,8,3,2,3,10,11,-1,11,Germany - 3. Liga,0.38,0.62,-1,1.25,1.38,2.63,1.61,8
Saarbrucken,8,3,2,3,10,11,-1,11,Germany - 3. Liga,0.38,0.62,-1,1.25,1.38,2.63,1.61,8
Alemannia A.,8,3,1,4,11,10,1,10,Germany - 3. Liga,0.38,0.5,1,1.38,1.25,2.63,2.0,9
Energie Cottbus,8,3,1,4,8,13,-5,10,Germany - 3. Liga,0.38,0.5,-5,1.0,1.25,2.63,2.0,9
Dortmund B,8,1,5,2,7,8,-1,8,Germany - 3. Liga,0.12,0.75,-1,0.88,1.0,8.33,1.33,10
Wehen Wiesbaden,8,2,2,4,7,12,-5,8,Germany - 3. Liga,0.25,0.5,-5,0.88,1.0,4.0,2.0,10
Unterhaching,8,1,2,5,8,13,-5,5,Germany - 3. Liga,0.12,0.38,-5,1.0,0.62,8.33,2.63,11
Hannover 96 B,8,1,2,5,13,23,-10,5,Germany - 3. Liga,0.12,0.38,-10,1.62,0.62,8.33,2.63,11
Sandhausen,8,0,1,7,7,15,-8,1,Germany - 3. Liga,0.0,0.12,-8,0.88,0.12,0.0,8.33,12
Dreams,8,6,2,0,10,3,7,20,Ghana - Premier League,0.75,1.0,7,1.25,2.5,1.33,1.0,1
Asante Kotoko,8,4,3,1,7,3,4,15,Ghana - Premier League,0.5,0.88,4,0.88,1.88,2.0,1.14,2
Aduana Stars,8,4,2,2,8,6,2,14,Ghana - Premier League,0.5,0.75,2,1.0,1.75,2.0,1.33,3
Samartex,8,3,4,1,9,6,3,13,Ghana - Premier League,0.38,0.88,3,1.12,1.62,2.63,1.14,4
Medeama,8,4,0,4,10,8,2,12,Ghana - Premier League,0.5,0.5,2,1.25,1.5,2.0,2.0,5
Young Apostles,8,3,3,2,6,6,0,12,Ghana - Premier League,0.38,0.75,0,0.75,1.5,2.63,1.33,5
Heart of Lions,8,3,2,3,10,8,2,11,Ghana - Premier League,0.38,0.62,2,1.25,1.38,2.63,1.61,6
Karela,8,3,2,3,7,6,1,11,Ghana - Premier League,0.38,0.62,1,0.88,1.38,2.63,1.61,6
Hearts of Oak,8,3,2,3,5,4,1,11,Ghana - Premier League,0.38,0.62,1,0.62,1.38,2.63,1.61,6
Bibiani GS,8,3,2,3,5,7,-2,11,Ghana - Premier League,0.38,0.62,-2,0.62,1.38,2.63,1.61,6
Berekum Chelsea,8,3,1,4,10,8,2,10,Ghana - Premier League,0.38,0.5,2,1.25,1.25,2.63,2.0,7
Bechem Utd,8,3,1,4,7,7,0,10,Ghana - Premier League,0.38,0.5,0,0.88,1.25,2.63,2.0,7
Accra Lions,8,3,1,4,8,9,-1,10,Ghana - Premier League,0.38,0.5,-1,1.0,1.25,2.63,2.0,7
Nations,8,3,1,4,5,7,-2,10,Ghana - Premier League,0.38,0.5,-2,0.62,1.25,2.63,2.0,7
Vision,8,2,3,3,7,9,-2,9,Ghana - Premier League,0.25,0.62,-2,0.88,1.12,4.0,1.61,8
Holy Stars,8,2,2,4,8,8,0,8,Ghana - Premier League,0.25,0.5,0,1.0,1.0,4.0,2.0,9
Legon Cities,8,2,2,4,5,9,-4,8,Ghana - Premier League,0.25,0.5,-4,0.62,1.0,4.0,2.0,9
Nsoatreman,8,2,0,6,2,14,-12,6,Ghana - Premier League,0.25,0.25,-12,0.25,0.75,4.0,4.0,10
St Josephs,8,7,1,0,26,6,20,22,Gibraltar - Premier Division,0.88,1.0,20,3.25,2.75,1.14,1.0,1
Lincoln RI,8,6,1,1,21,5,16,19,Gibraltar - Premier Division,0.75,0.88,16,2.62,2.38,1.33,1.14,2
Europa FC,8,5,1,2,18,8,10,16,Gibraltar - Premier Division,0.62,0.75,10,2.25,2.0,1.61,1.33,3
Lions FC,8,5,1,2,14,11,3,16,Gibraltar - Premier Division,0.62,0.75,3,1.75,2.0,1.61,1.33,3
Manchester 62,8,4,2,2,22,10,12,14,Gibraltar - Premier Division,0.5,0.75,12,2.75,1.75,2.0,1.33,4
Magpies,8,4,0,4,17,12,5,12,Gibraltar - Premier Division,0.5,0.5,5,2.12,1.5,2.0,2.0,5
College 1975,8,3,1,4,13,13,0,10,Gibraltar - Premier Division,0.38,0.5,0,1.62,1.25,2.63,2.0,6
Lynx,8,3,1,4,10,22,-12,10,Gibraltar - Premier Division,0.38,0.5,-12,1.25,1.25,2.63,2.0,6
Glacis Utd,8,2,0,6,13,24,-11,6,Gibraltar - Premier Division,0.25,0.25,-11,1.62,0.75,4.0,4.0,7
Europa Point,8,0,2,6,7,28,-21,2,Gibraltar - Premier Division,0.0,0.25,-21,0.88,0.25,0.0,4.0,8
Mons Calpe,8,0,1,7,7,25,-18,1,Gibraltar - Premier Division,0.0,0.12,-18,0.88,0.12,0.0,8.33,9
Olympiakos,8,6,1,1,15,6,9,19,Greece - Super League,0.75,0.88,9,1.88,2.38,1.33,1.14,1
Levadiakos,8,5,1,2,14,6,8,16,Greece - Super League,0.62,0.75,8,1.75,2.0,1.61,1.33,2
PAOK,8,5,0,3,22,9,13,15,Greece - Super League,0.62,0.62,13,2.75,1.88,1.61,1.61,3
Aris,8,4,3,1,9,6,3,15,Greece - Super League,0.5,0.88,3,1.12,1.88,2.0,1.14,3
AEK Athens,8,4,1,3,15,9,6,13,Greece - Super League,0.5,0.62,6,1.88,1.62,2.0,1.61,4
Atromitos,8,4,1,3,9,8,1,13,Greece - Super League,0.5,0.62,1,1.12,1.62,2.0,1.61,4
Panathinaikos,8,4,1,3,14,14,0,13,Greece - Super League,0.5,0.62,0,1.75,1.62,2.0,1.61,4
OFI Crete,8,4,0,4,13,14,-1,12,Greece - Super League,0.5,0.5,-1,1.62,1.5,2.0,2.0,5
A. Kallithea,8,3,1,4,9,11,-2,10,Greece - Super League,0.38,0.5,-2,1.12,1.25,2.63,2.0,6
Asteras T.,8,3,1,4,7,11,-4,10,Greece - Super League,0.38,0.5,-4,0.88,1.25,2.63,2.0,6
Panaitolikos,8,2,2,4,5,7,-2,8,Greece - Super League,0.25,0.5,-2,0.62,1.0,4.0,2.0,7
Panserraikos,8,2,2,4,6,17,-11,8,Greece - Super League,0.25,0.5,-11,0.75,1.0,4.0,2.0,7
Lamia,8,2,1,5,5,17,-12,7,Greece - Super League,0.25,0.38,-12,0.62,0.88,4.0,2.63,8
Volos,8,0,4,4,5,9,-4,4,Greece - Super League,0.0,0.5,-4,0.62,0.5,0.0,2.0,9
Malacateco,8,6,0,2,15,5,10,18,Guatemala - Liga Nacional - Apertura,0.75,0.75,10,1.88,2.25,1.33,1.33,1
Xelaju,8,5,2,1,16,5,11,17,Guatemala - Liga Nacional - Apertura,0.62,0.88,11,2.0,2.12,1.61,1.14,2
Municipal,8,4,2,2,13,13,0,14,Guatemala - Liga Nacional - Apertura,0.5,0.75,0,1.62,1.75,2.0,1.33,3
Coban Imperial,8,4,1,3,13,9,4,13,Guatemala - Liga Nacional - Apertura,0.5,0.62,4,1.62,1.62,2.0,1.61,4
Antigua GFC,8,3,3,2,14,11,3,12,Guatemala - Liga Nacional - Apertura,0.38,0.75,3,1.75,1.5,2.63,1.33,5
Xinabajul,8,3,2,3,15,14,1,11,Guatemala - Liga Nacional - Apertura,0.38,0.62,1,1.88,1.38,2.63,1.61,6
Comunicaciones,8,3,2,3,12,13,-1,11,Guatemala - Liga Nacional - Apertura,0.38,0.62,-1,1.5,1.38,2.63,1.61,6
Guastatoya,8,2,4,2,12,10,2,10,Guatemala - Liga Nacional - Apertura,0.25,0.75,2,1.5,1.25,4.0,1.33,7
Mixco,8,3,1,4,7,11,-4,10,Guatemala - Liga Nacional - Apertura,0.38,0.5,-4,0.88,1.25,2.63,2.0,7
Achuapa,8,2,3,3,6,10,-4,9,Guatemala - Liga Nacional - Apertura,0.25,0.62,-4,0.75,1.12,4.0,1.61,8
Marquense,8,0,3,5,4,16,-12,3,Guatemala - Liga Nacional - Apertura,0.0,0.38,-12,0.5,0.38,0.0,2.63,9
Zacapa Tellioz,8,0,2,6,3,14,-11,2,Guatemala - Liga Nacional - Apertura,0.0,0.25,-11,0.38,0.25,0.0,4.0,10
Olimpia,8,6,2,0,16,4,12,20,Honduras - Liga Nacional - Apertura,0.75,1.0,12,2.0,2.5,1.33,1.0,1
Genesis,8,4,3,1,16,8,8,15,Honduras - Liga Nacional - Apertura,0.5,0.88,8,2.0,1.88,2.0,1.14,2
Motagua,8,4,2,2,18,14,4,14,Honduras - Liga Nacional - Apertura,0.5,0.75,4,2.25,1.75,2.0,1.33,3
Olancho,8,3,4,1,15,10,5,13,Honduras - Liga Nacional - Apertura,0.38,0.88,5,1.88,1.62,2.63,1.14,4
Marathon,8,2,4,2,9,8,1,10,Honduras - Liga Nacional - Apertura,0.25,0.75,1,1.12,1.25,4.0,1.33,5
Juticalpa,8,2,2,4,7,14,-7,8,Honduras - Liga Nacional - Apertura,0.25,0.5,-7,0.88,1.0,4.0,2.0,6
UPNFM,8,2,2,4,6,16,-10,8,Honduras - Liga Nacional - Apertura,0.25,0.5,-10,0.75,1.0,4.0,2.0,6
Real Espana,8,1,4,3,6,7,-1,7,Honduras - Liga Nacional - Apertura,0.12,0.62,-1,0.75,0.88,8.33,1.61,7
Real Sociedad,8,1,3,4,10,17,-7,6,Honduras - Liga Nacional - Apertura,0.12,0.5,-7,1.25,0.75,8.33,2.0,8
Victoria,8,1,2,5,13,18,-5,5,Honduras - Liga Nacional - Apertura,0.12,0.38,-5,1.62,0.62,8.33,2.63,9
LM Warriors,8,6,1,1,20,16,4,19,Hong Kong - Premier League,0.75,0.88,4,2.5,2.38,1.33,1.14,1
Tai Po,8,6,0,2,26,14,12,18,Hong Kong - Premier League,0.75,0.75,12,3.25,2.25,1.33,1.33,2
Eastern,8,5,1,2,19,12,7,16,Hong Kong - Premier League,0.62,0.75,7,2.38,2.0,1.61,1.33,3
Kitchee,8,5,0,3,19,9,10,15,Hong Kong - Premier League,0.62,0.62,10,2.38,1.88,1.61,1.61,4
HK Rangers,8,3,1,4,12,12,0,10,Hong Kong - Premier League,0.38,0.5,0,1.5,1.25,2.63,2.0,5
North District,8,3,0,5,14,23,-9,9,Hong Kong - Premier League,0.38,0.38,-9,1.75,1.12,2.63,2.63,6
Southern D.,8,2,1,5,10,13,-3,7,Hong Kong - Premier League,0.25,0.38,-3,1.25,0.88,4.0,2.63,7
Kowloon City,8,2,1,5,15,24,-9,7,Hong Kong - Premier League,0.25,0.38,-9,1.88,0.88,4.0,2.63,7
Hong Kong FC,8,0,2,6,4,17,-13,2,Hong Kong - Premier League,0.0,0.25,-13,0.5,0.25,0.0,4.0,8
Paks,8,6,2,0,21,7,14,20,Hungary - NB I,0.75,1.0,14,2.62,2.5,1.33,1.0,1
Gyor,8,5,3,0,12,4,8,18,Hungary - NB I,0.62,1.0,8,1.5,2.25,1.61,1.0,2
Puskas A.,8,5,2,1,14,8,6,17,Hungary - NB I,0.62,0.88,6,1.75,2.12,1.61,1.14,3
Ferencvaros,8,4,2,2,13,7,6,14,Hungary - NB I,0.5,0.75,6,1.62,1.75,2.0,1.33,4
Zalaegerszegi,8,3,3,2,9,8,1,12,Hungary - NB I,0.38,0.75,1,1.12,1.5,2.63,1.33,5
MTK Budapest,8,3,2,3,15,12,3,11,Hungary - NB I,0.38,0.62,3,1.88,1.38,2.63,1.61,6
Debrecen,8,3,1,4,14,11,3,10,Hungary - NB I,0.38,0.5,3,1.75,1.25,2.63,2.0,7
Kecskemeti TE,8,1,4,3,13,16,-3,7,Hungary - NB I,0.12,0.62,-3,1.62,0.88,8.33,1.61,8
Fehervar,8,1,3,4,7,13,-6,6,Hungary - NB I,0.12,0.5,-6,0.88,0.75,8.33,2.0,9
Nyiregyhaza,8,1,3,4,2,9,-7,6,Hungary - NB I,0.12,0.5,-7,0.25,0.75,8.33,2.0,9
DVTK,8,1,2,5,6,16,-10,5,Hungary - NB I,0.12,0.38,-10,0.75,0.62,8.33,2.63,10
Ujpest,8,0,3,5,6,21,-15,3,Hungary - NB I,0.0,0.38,-15,0.75,0.38,0.0,2.63,11
Kisvarda,8,7,1,0,18,7,11,22,Hungary - NB II,0.88,1.0,11,2.25,2.75,1.14,1.0,1
Honved,8,5,0,3,17,11,6,15,Hungary - NB II,0.62,0.62,6,2.12,1.88,1.61,1.61,2
Szeged,8,4,3,1,10,6,4,15,Hungary - NB II,0.5,0.88,4,1.25,1.88,2.0,1.14,2
Szentlorinc,8,3,5,0,12,5,7,14,Hungary - NB II,0.38,1.0,7,1.5,1.75,2.63,1.0,3
Vasas,8,4,2,2,10,5,5,14,Hungary - NB II,0.5,0.75,5,1.25,1.75,2.0,1.33,3
Kazincbarcika,8,3,4,1,9,5,4,13,Hungary - NB II,0.38,0.88,4,1.12,1.62,2.63,1.14,4
Mezokovesd,8,3,2,3,9,7,2,11,Hungary - NB II,0.38,0.62,2,1.12,1.38,2.63,1.61,5
Csakvari,8,3,1,4,11,11,0,10,Hungary - NB II,0.38,0.5,0,1.38,1.25,2.63,2.0,6
Ajka,8,3,1,4,8,11,-3,10,Hungary - NB II,0.38,0.5,-3,1.0,1.25,2.63,2.0,6
Kozarmisleny,8,3,1,4,10,15,-5,10,Hungary - NB II,0.38,0.5,-5,1.25,1.25,2.63,2.0,6
Bekescsaba,8,2,3,3,8,10,-2,9,Hungary - NB II,0.25,0.62,-2,1.0,1.12,4.0,1.61,7
Gyirmot,8,1,5,2,8,9,-1,8,Hungary - NB II,0.12,0.75,-1,1.0,1.0,8.33,1.33,8
Tatabanya,8,2,1,5,7,15,-8,7,Hungary - NB II,0.25,0.38,-8,0.88,0.88,4.0,2.63,9
BVSC,8,1,3,4,7,11,-4,6,Hungary - NB II,0.12,0.5,-4,0.88,0.75,8.33,2.0,10
Soroksar,8,1,2,5,10,19,-9,5,Hungary - NB II,0.12,0.38,-9,1.25,0.62,8.33,2.63,11
Budafoki,8,1,0,7,9,18,-9,3,Hungary - NB II,0.12,0.12,-9,1.12,0.38,8.33,8.33,12
Breidablik,1,1,0,0,2,0,2,3,Iceland - Besta deild,1.0,1.0,2,2.0,3.0,1.0,1.0,1
IA Akranes,1,1,0,0,1,0,1,3,Iceland - Besta deild,1.0,1.0,1,1.0,3.0,1.0,1.0,1
KA Akureyri,1,0,1,0,2,2,0,1,Iceland - Besta deild,0.0,1.0,0,2.0,1.0,0.0,1.0,2
KR Reykjavik,1,0,1,0,2,2,0,1,Iceland - Besta deild,0.0,1.0,0,2.0,1.0,0.0,1.0,2
Valur,1,0,1,0,1,1,0,1,Iceland - Besta deild,0.0,1.0,0,1.0,1.0,0.0,1.0,2
Vestri,1,0,1,0,1,1,0,1,Iceland - Besta deild,0.0,1.0,0,1.0,1.0,0.0,1.0,2
Hafnarfjordur,0,0,0,0,0,0,0,0,Iceland - Besta deild,0.0,0.0,0,0.0,0.0,0.0,0.0,3
IBV,0,0,0,0,0,0,0,0,Iceland - Besta deild,0.0,0.0,0,0.0,0.0,0.0,0.0,3
Stjarnan,0,0,0,0,0,0,0,0,Iceland - Besta deild,0.0,0.0,0,0.0,0.0,0.0,0.0,3
Vikingur R.,0,0,0,0,0,0,0,0,Iceland - Besta deild,0.0,0.0,0,0.0,0.0,0.0,0.0,3
Fram,1,0,0,1,0,1,-1,0,Iceland - Besta deild,0.0,0.0,-1,0.0,0.0,0.0,0.0,3
Afturelding,1,0,0,1,0,2,-2,0,Iceland - Besta deild,0.0,0.0,-2,0.0,0.0,0.0,0.0,3
Afturelding,8,6,1,1,18,7,11,19,Iceland - 1. Deild,0.75,0.88,11,2.25,2.38,1.33,1.14,1
Keflavik,8,5,2,1,17,9,8,17,Iceland - 1. Deild,0.62,0.88,8,2.12,2.12,1.61,1.14,2
Leiknir R.,8,4,4,0,18,10,8,16,Iceland - 1. Deild,0.5,1.0,8,2.25,2.0,2.0,1.0,3
IBV,8,4,2,2,22,12,10,14,Iceland - 1. Deild,0.5,0.75,10,2.75,1.75,2.0,1.33,4
IR Reykjavik,8,3,4,1,10,10,0,13,Iceland - 1. Deild,0.38,0.88,0,1.25,1.62,2.63,1.14,5
Throttur R.,8,3,2,3,15,12,3,11,Iceland - 1. Deild,0.38,0.62,3,1.88,1.38,2.63,1.61,6
Grindavik,8,2,3,3,18,19,-1,9,Iceland - 1. Deild,0.25,0.62,-1,2.25,1.12,4.0,1.61,7
Thor Akureyri,8,2,3,3,11,16,-5,9,Iceland - 1. Deild,0.25,0.62,-5,1.38,1.12,4.0,1.61,7
Njardvik,8,1,5,2,8,11,-3,8,Iceland - 1. Deild,0.12,0.75,-3,1.0,1.0,8.33,1.33,8
Fjolnir,8,1,3,4,6,14,-8,6,Iceland - 1. Deild,0.12,0.5,-8,0.75,0.75,8.33,2.0,9
Dalvik / Reynir,8,1,1,6,10,25,-15,4,Iceland - 1. Deild,0.12,0.25,-15,1.25,0.5,8.33,4.0,10
Grotta,8,1,0,7,9,17,-8,3,Iceland - 1. Deild,0.12,0.12,-8,1.12,0.38,8.33,8.33,11
Throttur Vogar,8,6,2,0,29,7,22,20,Iceland - 2. Deild,0.75,1.0,22,3.62,2.5,1.33,1.0,1
Selfoss,8,6,1,1,22,12,10,19,Iceland - 2. Deild,0.75,0.88,10,2.75,2.38,1.33,1.14,2
Volsungur,8,5,3,0,21,7,14,18,Iceland - 2. Deild,0.62,1.0,14,2.62,2.25,1.61,1.0,3
V. Olafsvik,8,5,1,2,19,13,6,16,Iceland - 2. Deild,0.62,0.75,6,2.38,2.0,1.61,1.33,4
Haukar,8,3,1,4,16,14,2,10,Iceland - 2. Deild,0.38,0.5,2,2.0,1.25,2.63,2.0,5
Fjardabyggd/L.,8,3,1,4,23,24,-1,10,Iceland - 2. Deild,0.38,0.5,-1,2.88,1.25,2.63,2.0,5
AEggir,8,2,4,2,9,12,-3,10,Iceland - 2. Deild,0.25,0.75,-3,1.12,1.25,4.0,1.33,5
Hottur/Huginn,8,3,0,5,11,23,-12,9,Iceland - 2. Deild,0.38,0.38,-12,1.38,1.12,2.63,2.63,6
KFG,8,2,2,4,12,16,-4,8,Iceland - 2. Deild,0.25,0.5,-4,1.5,1.0,4.0,2.0,7
Reynir,8,2,1,5,11,16,-5,7,Iceland - 2. Deild,0.25,0.38,-5,1.38,0.88,4.0,2.63,8
Fjallabyggd,8,2,1,5,12,22,-10,7,Iceland - 2. Deild,0.25,0.38,-10,1.5,0.88,4.0,2.63,8
Kormakur/Hvot,8,0,1,7,5,24,-19,1,Iceland - 2. Deild,0.0,0.12,-19,0.62,0.12,0.0,8.33,9
Mohun Bagan,8,6,2,0,16,2,14,20,India - Super League,0.75,1.0,14,2.0,2.5,1.33,1.0,1
Goa,8,6,0,2,13,7,6,18,India - Super League,0.75,0.75,6,1.62,2.25,1.33,1.33,2
NorthEast Utd,8,4,2,2,15,7,8,14,India - Super League,0.5,0.75,8,1.88,1.75,2.0,1.33,3
East Bengal,8,4,2,2,11,11,0,14,India - Super League,0.5,0.75,0,1.38,1.75,2.0,1.33,3
Mumbai City,8,3,3,2,10,6,4,12,India - Super League,0.38,0.75,4,1.25,1.5,2.63,1.33,4
Odisha FC,8,3,3,2,13,11,2,12,India - Super League,0.38,0.75,2,1.62,1.5,2.63,1.33,4
Bengaluru,8,3,1,4,11,10,1,10,India - Super League,0.38,0.5,1,1.38,1.25,2.63,2.0,5
Chennaiyin,8,3,1,4,11,12,-1,10,India - Super League,0.38,0.5,-1,1.38,1.25,2.63,2.0,5
Jamshedpur,8,3,1,4,12,16,-4,10,India - Super League,0.38,0.5,-4,1.5,1.25,2.63,2.0,5
Kerala Blasters,8,2,3,3,7,10,-3,9,India - Super League,0.25,0.62,-3,0.88,1.12,4.0,1.61,6
Punjab,8,2,2,4,11,15,-4,8,India - Super League,0.25,0.5,-4,1.38,1.0,4.0,2.0,7
Hyderabad,8,2,2,4,10,16,-6,8,India - Super League,0.25,0.5,-6,1.25,1.0,4.0,2.0,7
Mohammedan,8,0,2,6,4,19,-15,2,India - Super League,0.0,0.25,-15,0.5,0.25,0.0,4.0,8
Gokulam,8,6,0,2,23,14,9,18,India - I-League,0.75,0.75,9,2.88,2.25,1.33,1.33,1
Inter Kashi,8,4,3,1,14,11,3,15,India - I-League,0.5,0.88,3,1.75,1.88,2.0,1.14,2
Churchill B.,8,3,5,0,18,9,9,14,India - I-League,0.38,1.0,9,2.25,1.75,2.63,1.0,3
Real Kashmir,8,4,2,2,12,12,0,14,India - I-League,0.5,0.75,0,1.5,1.75,2.0,1.33,3
Rajasthan,8,4,0,4,16,13,3,12,India - I-League,0.5,0.5,3,2.0,1.5,2.0,2.0,4
Sreenidi Deccan,8,3,3,2,11,10,1,12,India - I-League,0.38,0.75,1,1.38,1.5,2.63,1.33,4
Dempo,8,3,2,3,24,17,7,11,India - I-League,0.38,0.62,7,3.0,1.38,2.63,1.61,5
Aizawl,8,3,2,3,16,15,1,11,India - I-League,0.38,0.62,1,2.0,1.38,2.63,1.61,5
SC Bengaluru,8,2,2,4,11,18,-7,8,India - I-League,0.25,0.5,-7,1.38,1.0,4.0,2.0,6
Namdhari,8,2,1,5,8,14,-6,7,India - I-League,0.25,0.38,-6,1.0,0.88,4.0,2.63,7
Shillong Lajong,8,1,3,4,12,23,-11,6,India - I-League,0.12,0.5,-11,1.5,0.75,8.33,2.0,8
Delhi FC,8,1,1,6,7,16,-9,4,India - I-League,0.12,0.25,-9,0.88,0.5,8.33,4.0,9
Dewa Utd,8,6,0,2,20,9,11,18,Indonesia - Liga 1,0.75,0.75,11,2.5,2.25,1.33,1.33,1
Malut United,8,5,3,0,13,6,7,18,Indonesia - Liga 1,0.62,1.0,7,1.62,2.25,1.61,1.0,1
Persib,8,5,2,1,16,9,7,17,Indonesia - Liga 1,0.62,0.88,7,2.0,2.12,1.61,1.14,2
Madura Utd,8,4,3,1,10,6,4,15,Indonesia - Liga 1,0.5,0.88,4,1.25,1.88,2.0,1.14,3
Arema,8,4,2,2,19,13,6,14,Indonesia - Liga 1,0.5,0.75,6,2.38,1.75,2.0,1.33,4
Barito Putera,8,4,2,2,15,11,4,14,Indonesia - Liga 1,0.5,0.75,4,1.88,1.75,2.0,1.33,4
Persis Solo,8,3,4,1,13,10,3,13,Indonesia - Liga 1,0.38,0.88,3,1.62,1.62,2.63,1.14,5
Borneo,8,4,0,4,8,10,-2,12,Indonesia - Liga 1,0.5,0.5,-2,1.0,1.5,2.0,2.0,6
Persebaya S.,8,3,2,3,9,10,-1,11,Indonesia - Liga 1,0.38,0.62,-1,1.12,1.38,2.63,1.61,7
PSBS Biak N.,8,2,4,2,8,8,0,10,Indonesia - Liga 1,0.25,0.75,0,1.0,1.25,4.0,1.33,8
PSM,8,2,3,3,10,10,0,9,Indonesia - Liga 1,0.25,0.62,0,1.25,1.12,4.0,1.61,9
Bali Utd,8,2,3,3,10,13,-3,9,Indonesia - Liga 1,0.25,0.62,-3,1.25,1.12,4.0,1.61,9
Semen Padang,8,2,3,3,11,17,-6,9,Indonesia - Liga 1,0.25,0.62,-6,1.38,1.12,4.0,1.61,9
Persija,8,1,3,4,11,14,-3,6,Indonesia - Liga 1,0.12,0.5,-3,1.38,0.75,8.33,2.0,10
Persita,8,1,3,4,7,11,-4,6,Indonesia - Liga 1,0.12,0.5,-4,0.88,0.75,8.33,2.0,10
PSIS Semarang,8,1,3,4,9,14,-5,6,Indonesia - Liga 1,0.12,0.5,-5,1.12,0.75,8.33,2.0,10
Persik Kediri,8,0,4,4,7,13,-6,4,Indonesia - Liga 1,0.0,0.5,-6,0.88,0.5,0.0,2.0,11
PSS Sleman,8,1,0,7,9,21,-12,3,Indonesia - Liga 1,0.12,0.12,-12,1.12,0.38,8.33,8.33,12
Tractor Sazi,8,6,1,1,11,4,7,19,Iran - Pro League,0.75,0.88,7,1.38,2.38,1.33,1.14,1
Persepolis,8,4,3,1,10,6,4,15,Iran - Pro League,0.5,0.88,4,1.25,1.88,2.0,1.14,2
Malavan,8,4,1,3,8,7,1,13,Iran - Pro League,0.5,0.62,1,1.0,1.62,2.0,1.61,3
Sepahan,8,2,6,0,11,6,5,12,Iran - Pro League,0.25,1.0,5,1.38,1.5,4.0,1.0,4
Shams A. Qazvin,8,3,2,3,11,10,1,11,Iran - Pro League,0.38,0.62,1,1.38,1.38,2.63,1.61,5
K. Khorramabad,8,3,2,3,8,8,0,11,Iran - Pro League,0.38,0.62,0,1.0,1.38,2.63,1.61,5
Gol Gohar,8,3,2,3,7,7,0,11,Iran - Pro League,0.38,0.62,0,0.88,1.38,2.63,1.61,5
Foolad,8,3,2,3,10,11,-1,11,Iran - Pro League,0.38,0.62,-1,1.25,1.38,2.63,1.61,5
Esteghlal,8,2,4,2,7,6,1,10,Iran - Pro League,0.25,0.75,1,0.88,1.25,4.0,1.33,6
Chadormalu,8,3,1,4,6,6,0,10,Iran - Pro League,0.38,0.5,0,0.75,1.25,2.63,2.0,6
Havadar,8,3,1,4,8,13,-5,10,Iran - Pro League,0.38,0.5,-5,1.0,1.25,2.63,2.0,6
E. Khuzestan,8,2,3,3,5,8,-3,9,Iran - Pro League,0.25,0.62,-3,0.62,1.12,4.0,1.61,7
Zob Ahan,8,2,2,4,9,11,-2,8,Iran - Pro League,0.25,0.5,-2,1.12,1.0,4.0,2.0,8
Mes Rafsanjan,8,1,5,2,2,6,-4,8,Iran - Pro League,0.12,0.75,-4,0.25,1.0,8.33,1.33,8
Aluminium Arak,8,1,3,4,5,8,-3,6,Iran - Pro League,0.12,0.5,-3,0.62,0.75,8.33,2.0,9
N. Mazandaran,8,1,3,4,3,7,-4,6,Iran - Pro League,0.12,0.5,-4,0.38,0.75,8.33,2.0,9
Drogheda Utd,8,4,3,1,10,4,6,15,Ireland - Premier Division,0.5,0.88,6,1.25,1.88,2.0,1.14,1
St. Patricks,8,4,2,2,12,7,5,14,Ireland - Premier Division,0.5,0.75,5,1.5,1.75,2.0,1.33,2
Galway Utd,8,3,4,1,10,7,3,13,Ireland - Premier Division,0.38,0.88,3,1.25,1.62,2.63,1.14,3
Shelbourne,8,3,4,1,9,6,3,13,Ireland - Premier Division,0.38,0.88,3,1.12,1.62,2.63,1.14,3
Shamrock Rovers,7,3,2,2,6,5,1,11,Ireland - Premier Division,0.43,0.71,1,0.86,1.57,2.33,1.41,4
Derry City,8,3,2,3,7,9,-2,11,Ireland - Premier Division,0.38,0.62,-2,0.88,1.38,2.63,1.61,4
Bohemians,8,3,0,5,9,11,-2,9,Ireland - Premier Division,0.38,0.38,-2,1.12,1.12,2.63,2.63,5
Waterford,8,3,0,5,8,13,-5,9,Ireland - Premier Division,0.38,0.38,-5,1.0,1.12,2.63,2.63,5
Cork City,7,1,4,2,9,10,-1,7,Ireland - Premier Division,0.14,0.71,-1,1.29,1.0,7.14,1.41,6
Sligo Rovers,8,1,1,6,11,19,-8,4,Ireland - Premier Division,0.12,0.25,-8,1.38,0.5,8.33,4.0,7
Dundalk,8,7,1,0,14,4,10,22,Ireland - First Division,0.88,1.0,10,1.75,2.75,1.14,1.0,1
Bray Wanderers,8,5,0,3,7,11,-4,15,Ireland - First Division,0.62,0.62,-4,0.88,1.88,1.61,1.61,2
Cobh Ramblers,8,4,2,2,15,9,6,14,Ireland - First Division,0.5,0.75,6,1.88,1.75,2.0,1.33,3
Wexford,7,4,0,3,10,7,3,12,Ireland - First Division,0.57,0.57,3,1.43,1.71,1.75,1.75,4
Treaty Utd,8,3,2,3,15,9,6,11,Ireland - First Division,0.38,0.62,6,1.88,1.38,2.63,1.61,5
Finn Harps,8,2,2,4,10,10,0,8,Ireland - First Division,0.25,0.5,0,1.25,1.0,4.0,2.0,6
Longford Town,7,2,2,3,8,12,-4,8,Ireland - First Division,0.29,0.57,-4,1.14,1.14,3.45,1.75,6
Kerry,8,2,1,5,6,10,-4,7,Ireland - First Division,0.25,0.38,-4,0.75,0.88,4.0,2.63,7
Athlone Town,8,2,1,5,4,12,-8,7,Ireland - First Division,0.25,0.38,-8,0.5,0.88,4.0,2.63,7
UC Dublin,8,1,3,4,4,9,-5,6,Ireland - First Division,0.12,0.5,-5,0.5,0.75,8.33,2.0,8
M. Tel Aviv,8,7,0,1,20,7,13,21,Israel - Ligat HaAl,0.88,0.88,13,2.5,2.62,1.14,1.14,1
H. Beer Sheva,8,4,2,2,15,9,6,14,Israel - Ligat HaAl,0.5,0.75,6,1.88,1.75,2.0,1.33,2
H. Jerusalem,8,3,4,1,14,8,6,13,Israel - Ligat HaAl,0.38,0.88,6,1.75,1.62,2.63,1.14,3
Maccabi Haifa,8,3,4,1,17,13,4,13,Israel - Ligat HaAl,0.38,0.88,4,2.12,1.62,2.63,1.14,3
Hapoel Haifa,8,4,1,3,11,14,-3,13,Israel - Ligat HaAl,0.5,0.62,-3,1.38,1.62,2.0,1.61,3
Ashdod,8,3,3,2,11,9,2,12,Israel - Ligat HaAl,0.38,0.75,2,1.38,1.5,2.63,1.33,4
B. Jerusalem,8,2,4,2,10,10,0,10,Israel - Ligat HaAl,0.25,0.75,0,1.25,1.25,4.0,1.33,5
Kiryat Shmona,8,3,1,4,10,12,-2,10,Israel - Ligat HaAl,0.38,0.5,-2,1.25,1.25,2.63,2.0,5
M. Petah Tikva,8,3,0,5,10,10,0,9,Israel - Ligat HaAl,0.38,0.38,0,1.25,1.12,2.63,2.63,6
Ironi Tiberias,8,2,2,4,8,13,-5,8,Israel - Ligat HaAl,0.25,0.5,-5,1.0,1.0,4.0,2.0,7
Maccabi Netanya,8,2,2,4,6,11,-5,8,Israel - Ligat HaAl,0.25,0.5,-5,0.75,1.0,4.0,2.0,7
Hapoel Hadera,8,2,2,4,8,14,-6,8,Israel - Ligat HaAl,0.25,0.5,-6,1.0,1.0,4.0,2.0,7
M. Bnei Raina,8,2,1,5,7,12,-5,7,Israel - Ligat HaAl,0.25,0.38,-5,0.88,0.88,4.0,2.63,8
Sakhnin,8,2,0,6,7,14,-7,6,Israel - Ligat HaAl,0.25,0.25,-7,0.88,0.75,4.0,4.0,9
Hapoel Tel Aviv,8,8,0,0,20,2,18,24,Israel - Leumit League,1.0,1.0,18,2.5,3.0,1.0,1.0,1
H. Petah Tikva,8,7,1,0,15,2,13,22,Israel - Leumit League,0.88,1.0,13,1.88,2.75,1.14,1.0,2
Hapoel Akko,8,4,2,2,9,8,1,14,Israel - Leumit League,0.5,0.75,1,1.12,1.75,2.0,1.33,3
H. Ironi Rishon,8,4,1,3,14,11,3,13,Israel - Leumit League,0.5,0.62,3,1.75,1.62,2.0,1.61,4
Bnei Yehuda,8,4,1,3,9,8,1,13,Israel - Leumit League,0.5,0.62,1,1.12,1.62,2.0,1.61,4
Maccabi Jaffa,8,3,4,1,9,9,0,13,Israel - Leumit League,0.38,0.88,0,1.12,1.62,2.63,1.14,4
H. Kfar Shalem,8,4,0,4,13,10,3,12,Israel - Leumit League,0.5,0.5,3,1.62,1.5,2.0,2.0,5
Hapoel Raanana,8,3,3,2,6,5,1,12,Israel - Leumit League,0.38,0.75,1,0.75,1.5,2.63,1.33,5
H. Kfar Saba,8,3,1,4,8,9,-1,10,Israel - Leumit League,0.38,0.5,-1,1.0,1.25,2.63,2.0,6
M. Herziliya,8,3,1,4,7,12,-5,10,Israel - Leumit League,0.38,0.5,-5,0.88,1.25,2.63,2.0,6
H. Ramat Gan,8,2,3,3,13,7,6,9,Israel - Leumit League,0.25,0.62,6,1.62,1.12,4.0,1.61,7
H. Umm al-Fahm,8,2,3,3,9,12,-3,9,Israel - Leumit League,0.25,0.62,-3,1.12,1.12,4.0,1.61,7
Hapoel Afula,8,2,2,4,7,8,-1,8,Israel - Leumit League,0.25,0.5,-1,0.88,1.0,4.0,2.0,8
Kafr Qasim,8,2,2,4,7,9,-2,8,Israel - Leumit League,0.25,0.5,-2,0.88,1.0,4.0,2.0,8
H. Nof Hagalil,8,0,3,5,1,8,-7,3,Israel - Leumit League,0.0,0.38,-7,0.12,0.38,0.0,2.63,9
Ramat Hasharon,8,0,3,5,6,23,-17,3,Israel - Leumit League,0.0,0.38,-17,0.75,0.38,0.0,2.63,9
AS Roma,8,7,1,0,12,2,10,22,Italy - Serie A,0.88,1.0,10,1.5,2.75,1.14,1.0,1
Bologna,8,6,1,1,15,7,8,19,Italy - Serie A,0.75,0.88,8,1.88,2.38,1.33,1.14,2
Inter Milan,8,5,2,1,13,8,5,17,Italy - Serie A,0.62,0.88,5,1.62,2.12,1.61,1.14,3
Juventus,8,5,1,2,8,9,-1,16,Italy - Serie A,0.62,0.75,-1,1.0,2.0,1.61,1.33,4
Torino,8,3,4,1,12,9,3,13,Italy - Serie A,0.38,0.88,3,1.5,1.62,2.63,1.14,5
Lazio,8,3,4,1,12,11,1,13,Italy - Serie A,0.38,0.88,1,1.5,1.62,2.63,1.14,5
Genoa,8,3,3,2,8,6,2,12,Italy - Serie A,0.38,0.75,2,1.0,1.5,2.63,1.33,6
Atalanta,8,3,2,3,14,4,10,11,Italy - Serie A,0.38,0.62,10,1.75,1.38,2.63,1.61,7
Como,8,3,2,3,12,10,2,11,Italy - Serie A,0.38,0.62,2,1.5,1.38,2.63,1.61,7
Udinese,8,3,2,3,8,6,2,11,Italy - Serie A,0.38,0.62,2,1.0,1.38,2.63,1.61,7
Napoli,8,2,5,1,10,9,1,11,Italy - Serie A,0.25,0.88,1,1.25,1.38,4.0,1.14,7
Fiorentina,8,3,1,4,9,9,0,10,Italy - Serie A,0.38,0.5,0,1.12,1.25,2.63,2.0,8
AC Milan,8,3,1,4,12,13,-1,10,Italy - Serie A,0.38,0.5,-1,1.5,1.25,2.63,2.0,8
Cagliari,8,2,3,3,7,6,1,9,Italy - Serie A,0.25,0.62,1,0.88,1.12,4.0,1.61,9
Hellas Verona,8,2,2,4,4,11,-7,8,Italy - Serie A,0.25,0.5,-7,0.5,1.0,4.0,2.0,10
Parma,8,1,4,3,8,9,-1,7,Italy - Serie A,0.12,0.62,-1,1.0,0.88,8.33,1.61,11
Venezia,8,0,5,3,2,6,-4,5,Italy - Serie A,0.0,0.62,-4,0.25,0.62,0.0,1.61,12
Lecce,8,0,3,5,4,9,-5,3,Italy - Serie A,0.0,0.38,-5,0.5,0.38,0.0,2.63,13
Empoli,8,0,3,5,2,14,-12,3,Italy - Serie A,0.0,0.38,-12,0.25,0.38,0.0,2.63,13
Monza,8,0,2,6,5,21,-16,2,Italy - Serie A,0.0,0.25,-16,0.62,0.25,0.0,4.0,14
Sassuolo,8,5,2,1,17,8,9,17,Italy - Serie B,0.62,0.88,9,2.12,2.12,1.61,1.14,1
Frosinone,8,4,4,0,13,7,6,16,Italy - Serie B,0.5,1.0,6,1.62,2.0,2.0,1.0,2
Juve Stabia,8,5,1,2,13,8,5,16,Italy - Serie B,0.62,0.75,5,1.62,2.0,1.61,1.33,2
Cremonese,8,4,3,1,18,11,7,15,Italy - Serie B,0.5,0.88,7,2.25,1.88,2.0,1.14,3
Palermo,8,4,3,1,18,12,6,15,Italy - Serie B,0.5,0.88,6,2.25,1.88,2.0,1.14,3
Cesena,8,3,4,1,9,6,3,13,Italy - Serie B,0.38,0.88,3,1.12,1.62,2.63,1.14,4
Catanzaro,8,3,3,2,12,11,1,12,Italy - Serie B,0.38,0.75,1,1.5,1.5,2.63,1.33,5
Modena,8,3,2,3,9,8,1,11,Italy - Serie B,0.38,0.62,1,1.12,1.38,2.63,1.61,6
Pisa,8,3,1,4,13,10,3,10,Italy - Serie B,0.38,0.5,3,1.62,1.25,2.63,2.0,7
Sudtirol,8,2,4,2,12,11,1,10,Italy - Serie B,0.25,0.75,1,1.5,1.25,4.0,1.33,7
Spezia,8,2,4,2,9,8,1,10,Italy - Serie B,0.25,0.75,1,1.12,1.25,4.0,1.33,7
Carrarese,8,2,4,2,11,11,0,10,Italy - Serie B,0.25,0.75,0,1.38,1.25,4.0,1.33,7
Bari,8,1,5,2,9,11,-2,8,Italy - Serie B,0.12,0.75,-2,1.12,1.0,8.33,1.33,8
Mantova,8,2,2,4,9,13,-4,8,Italy - Serie B,0.25,0.5,-4,1.12,1.0,4.0,2.0,8
Cittadella,8,2,2,4,6,12,-6,8,Italy - Serie B,0.25,0.5,-6,0.75,1.0,4.0,2.0,8
Cosenza,8,2,2,4,5,16,-11,8,Italy - Serie B,0.25,0.5,-11,0.62,1.0,4.0,2.0,8
Sampdoria,8,1,4,3,6,11,-5,7,Italy - Serie B,0.12,0.62,-5,0.75,0.88,8.33,1.61,9
Salernitana,8,1,3,4,5,9,-4,6,Italy - Serie B,0.12,0.5,-4,0.62,0.75,8.33,2.0,10
Brescia,8,1,3,4,4,8,-4,6,Italy - Serie B,0.12,0.5,-4,0.5,0.75,8.33,2.0,10
Reggiana,8,0,4,4,8,15,-7,4,Italy - Serie B,0.0,0.5,-7,1.0,0.5,0.0,2.0,11
Vicenza,8,6,2,0,14,5,9,20,Italy - Serie C - Group A,0.75,1.0,9,1.75,2.5,1.33,1.0,1
FeralpiSalo,8,5,2,1,13,9,4,17,Italy - Serie C - Group A,0.62,0.88,4,1.62,2.12,1.61,1.14,2
Renate,8,5,1,2,12,8,4,16,Italy - Serie C - Group A,0.62,0.75,4,1.5,2.0,1.61,1.33,3
Giana Erminio,8,4,1,3,10,7,3,13,Italy - Serie C - Group A,0.5,0.62,3,1.25,1.62,2.0,1.61,4
Virtus Verona,8,3,3,2,10,8,2,12,Italy - Serie C - Group A,0.38,0.75,2,1.25,1.5,2.63,1.33,5
Trento,8,3,3,2,9,7,2,12,Italy - Serie C - Group A,0.38,0.75,2,1.12,1.5,2.63,1.33,5
AlbinoLeffe,8,3,3,2,10,11,-1,12,Italy - Serie C - Group A,0.38,0.75,-1,1.25,1.5,2.63,1.33,5
Padova,8,3,2,3,13,9,4,11,Italy - Serie C - Group A,0.38,0.62,4,1.62,1.38,2.63,1.61,6
Atalanta B,8,2,5,1,11,8,3,11,Italy - Serie C - Group A,0.25,0.88,3,1.38,1.38,4.0,1.14,6
Lecco,8,2,5,1,5,4,1,11,Italy - Serie C - Group A,0.25,0.88,1,0.62,1.38,4.0,1.14,6
Triestina,8,3,2,3,6,9,-3,11,Italy - Serie C - Group A,0.38,0.62,-3,0.75,1.38,2.63,1.61,6
Novara,8,3,1,4,6,8,-2,10,Italy - Serie C - Group A,0.38,0.5,-2,0.75,1.25,2.63,2.0,7
Alcione,8,2,3,3,6,6,0,9,Italy - Serie C - Group A,0.25,0.62,0,0.75,1.12,4.0,1.61,8
Pro Patria,8,2,3,3,4,5,-1,9,Italy - Serie C - Group A,0.25,0.62,-1,0.5,1.12,4.0,1.61,8
Arzignano,8,3,0,5,7,11,-4,9,Italy - Serie C - Group A,0.38,0.38,-4,0.88,1.12,2.63,2.63,8
Caldiero Terme,8,1,4,3,11,13,-2,7,Italy - Serie C - Group A,0.12,0.62,-2,1.38,0.88,8.33,1.61,9
Pergolettese,8,1,3,4,5,9,-4,6,Italy - Serie C - Group A,0.12,0.5,-4,0.62,0.75,8.33,2.0,10
Pro Vercelli,8,1,3,4,3,8,-5,6,Italy - Serie C - Group A,0.12,0.5,-5,0.38,0.75,8.33,2.0,10
Clodiense,8,2,0,6,9,15,-6,6,Italy - Serie C - Group A,0.25,0.25,-6,1.12,0.75,4.0,4.0,10
Lumezzane,8,0,4,4,5,11,-6,4,Italy - Serie C - Group A,0.0,0.5,-6,0.62,0.5,0.0,2.0,11
Entella,8,6,2,0,16,4,12,20,Italy - Serie C - Group B,0.75,1.0,12,2.0,2.5,1.33,1.0,1
Pineto,8,5,2,1,12,9,3,17,Italy - Serie C - Group B,0.62,0.88,3,1.5,2.12,1.61,1.14,2
Ternana,8,5,1,2,12,6,6,16,Italy - Serie C - Group B,0.62,0.75,6,1.5,2.0,1.61,1.33,3
Arezzo,8,5,0,3,8,3,5,15,Italy - Serie C - Group B,0.62,0.62,5,1.0,1.88,1.61,1.61,4
Perugia,8,4,2,2,8,5,3,14,Italy - Serie C - Group B,0.5,0.75,3,1.0,1.75,2.0,1.33,5
Rimini,8,4,0,4,10,10,0,12,Italy - Serie C - Group B,0.5,0.5,0,1.25,1.5,2.0,2.0,6
Pescara,8,3,2,3,15,12,3,11,Italy - Serie C - Group B,0.38,0.62,3,1.88,1.38,2.63,1.61,7
Pontedera,8,3,2,3,12,11,1,11,Italy - Serie C - Group B,0.38,0.62,1,1.5,1.38,2.63,1.61,7
Athletic Carpi,8,3,2,3,8,9,-1,11,Italy - Serie C - Group B,0.38,0.62,-1,1.0,1.38,2.63,1.61,7
Gubbio,8,3,2,3,6,8,-2,11,Italy - Serie C - Group B,0.38,0.62,-2,0.75,1.38,2.63,1.61,7
Lucchese,8,2,4,2,14,15,-1,10,Italy - Serie C - Group B,0.25,0.75,-1,1.75,1.25,4.0,1.33,8
Legnago Salus,8,2,3,3,9,10,-1,9,Italy - Serie C - Group B,0.25,0.62,-1,1.12,1.12,4.0,1.61,9
Torres,8,2,3,3,6,7,-1,9,Italy - Serie C - Group B,0.25,0.62,-1,0.75,1.12,4.0,1.61,9
Pianese,8,3,0,5,5,9,-4,9,Italy - Serie C - Group B,0.38,0.38,-4,0.62,1.12,2.63,2.63,9
Campobasso,8,3,0,5,9,14,-5,9,Italy - Serie C - Group B,0.38,0.38,-5,1.12,1.12,2.63,2.63,9
AC Milan B,8,2,2,4,10,12,-2,8,Italy - Serie C - Group B,0.25,0.5,-2,1.25,1.0,4.0,2.0,10
Vis Pesaro,8,1,4,3,8,9,-1,7,Italy - Serie C - Group B,0.12,0.62,-1,1.0,0.88,8.33,1.61,11
Sestri Levante,8,2,1,5,9,14,-5,7,Italy - Serie C - Group B,0.25,0.38,-5,1.12,0.88,4.0,2.63,11
SPAL,8,1,3,4,6,12,-6,6,Italy - Serie C - Group B,0.12,0.5,-6,0.75,0.75,8.33,2.0,12
Ascoli,8,1,3,4,3,9,-6,6,Italy - Serie C - Group B,0.12,0.5,-6,0.38,0.75,8.33,2.0,12
Avellino,8,8,0,0,14,5,9,24,Italy - Serie C - Group C,1.0,1.0,9,1.75,3.0,1.0,1.0,1
A. Cerignola,8,6,1,1,10,4,6,19,Italy - Serie C - Group C,0.75,0.88,6,1.25,2.38,1.33,1.14,2
Picerno,8,3,5,0,11,6,5,14,Italy - Serie C - Group C,0.38,1.0,5,1.38,1.75,2.63,1.0,3
Crotone,8,4,2,2,14,10,4,14,Italy - Serie C - Group C,0.5,0.75,4,1.75,1.75,2.0,1.33,3
Monopoli,8,4,2,2,8,6,2,14,Italy - Serie C - Group C,0.5,0.75,2,1.0,1.75,2.0,1.33,3
Catania,8,3,4,1,12,6,6,13,Italy - Serie C - Group C,0.38,0.88,6,1.5,1.62,2.63,1.14,4
Cavese,8,3,3,2,10,10,0,12,Italy - Serie C - Group C,0.38,0.75,0,1.25,1.5,2.63,1.33,5
Juventus U23,8,3,2,3,12,9,3,11,Italy - Serie C - Group C,0.38,0.62,3,1.5,1.38,2.63,1.61,6
Potenza,8,2,5,1,16,14,2,11,Italy - Serie C - Group C,0.25,0.88,2,2.0,1.38,4.0,1.14,6
Giugliano,8,3,2,3,16,15,1,11,Italy - Serie C - Group C,0.38,0.62,1,2.0,1.38,2.63,1.61,6
Altamura,8,2,3,3,10,12,-2,9,Italy - Serie C - Group C,0.25,0.62,-2,1.25,1.12,4.0,1.61,7
Casertana,8,2,2,4,11,8,3,8,Italy - Serie C - Group C,0.25,0.5,3,1.38,1.0,4.0,2.0,8
ACR Messina,8,2,1,5,11,13,-2,7,Italy - Serie C - Group C,0.25,0.38,-2,1.38,0.88,4.0,2.63,9
Foggia,8,2,1,5,9,16,-7,7,Italy - Serie C - Group C,0.25,0.38,-7,1.12,0.88,4.0,2.63,9
Benevento,8,0,6,2,5,8,-3,6,Italy - Serie C - Group C,0.0,0.75,-3,0.62,0.75,0.0,1.33,10
Trapani,8,2,0,6,5,11,-6,6,Italy - Serie C - Group C,0.25,0.25,-6,0.62,0.75,4.0,4.0,10
Latina,8,1,3,4,7,17,-10,6,Italy - Serie C - Group C,0.12,0.5,-10,0.88,0.75,8.33,2.0,10
Sorrento,8,1,2,5,5,13,-8,5,Italy - Serie C - Group C,0.12,0.38,-8,0.62,0.62,8.33,2.63,11
Taranto,0,0,0,0,0,0,0,0,Italy - Serie C - Group C,0.0,0.0,0,0.0,0.0,0.0,0.0,12
Turris,0,0,0,0,0,0,0,0,Italy - Serie C - Group C,0.0,0.0,0,0.0,0.0,0.0,0.0,12
NovaRomentin,8,6,1,1,20,7,13,19,Italy - Serie D - Group A,0.75,0.88,13,2.5,2.38,1.33,1.14,1
Lavagnese,8,5,2,1,11,4,7,17,Italy - Serie D - Group A,0.62,0.88,7,1.38,2.12,1.61,1.14,2
Vado,8,4,2,2,11,6,5,14,Italy - Serie D - Group A,0.5,0.75,5,1.38,1.75,2.0,1.33,3
Bra,8,4,2,2,12,9,3,14,Italy - Serie D - Group A,0.5,0.75,3,1.5,1.75,2.0,1.33,3
Ligorna,8,4,2,2,12,11,1,14,Italy - Serie D - Group A,0.5,0.75,1,1.5,1.75,2.0,1.33,3
Gozzano,8,3,4,1,10,7,3,13,Italy - Serie D - Group A,0.38,0.88,3,1.25,1.62,2.63,1.14,4
Derthona,8,4,1,3,9,7,2,13,Italy - Serie D - Group A,0.5,0.62,2,1.12,1.62,2.0,1.61,4
Saluzzo,8,3,3,2,9,6,3,12,Italy - Serie D - Group A,0.38,0.75,3,1.12,1.5,2.63,1.33,5
Vogherese,8,2,5,1,5,4,1,11,Italy - Serie D - Group A,0.25,0.88,1,0.62,1.38,4.0,1.14,6
Oltrepo,8,3,2,3,7,7,0,11,Italy - Serie D - Group A,0.38,0.62,0,0.88,1.38,2.63,1.61,6
Chieri,8,2,4,2,8,7,1,10,Italy - Serie D - Group A,0.25,0.75,1,1.0,1.25,4.0,1.33,7
Asti,8,2,4,2,7,7,0,10,Italy - Serie D - Group A,0.25,0.75,0,0.88,1.25,4.0,1.33,7
Sanremese,8,2,4,2,6,6,0,10,Italy - Serie D - Group A,0.25,0.75,0,0.75,1.25,4.0,1.33,7
Chisola,8,2,3,3,8,9,-1,9,Italy - Serie D - Group A,0.25,0.62,-1,1.0,1.12,4.0,1.61,8
Fossano,8,3,0,5,7,13,-6,9,Italy - Serie D - Group A,0.38,0.38,-6,0.88,1.12,2.63,2.63,8
Citta di Varese,8,2,2,4,7,10,-3,8,Italy - Serie D - Group A,0.25,0.5,-3,0.88,1.0,4.0,2.0,9
Cairese,8,1,2,5,5,9,-4,5,Italy - Serie D - Group A,0.12,0.38,-4,0.62,0.62,8.33,2.63,10
Pro Imperia,8,1,2,5,10,18,-8,5,Italy - Serie D - Group A,0.12,0.38,-8,1.25,0.62,8.33,2.63,10
Borgaro Nobis,8,1,1,6,6,17,-11,4,Italy - Serie D - Group A,0.12,0.25,-11,0.75,0.5,8.33,4.0,11
Albenga,0,0,0,0,0,0,0,0,Italy - Serie D - Group A,0.0,0.0,0,0.0,0.0,0.0,0.0,12
F. Caratese,8,5,2,1,17,8,9,17,Italy - Serie D - Group B,0.62,0.88,9,2.12,2.12,1.61,1.14,1
USD Casatese,8,5,2,1,15,6,9,17,Italy - Serie D - Group B,0.62,0.88,9,1.88,2.12,1.61,1.14,1
Varesina,8,5,2,1,15,8,7,17,Italy - Serie D - Group B,0.62,0.88,7,1.88,2.12,1.61,1.14,1
Pro Palazzolo,8,5,1,2,16,8,8,16,Italy - Serie D - Group B,0.62,0.75,8,2.0,2.0,1.61,1.33,2
Sondrio,8,4,2,2,11,7,4,14,Italy - Serie D - Group B,0.5,0.75,4,1.38,1.75,2.0,1.33,3
Ospitaletto,8,3,4,1,10,9,1,13,Italy - Serie D - Group B,0.38,0.88,1,1.25,1.62,2.63,1.14,4
Desenxano,8,3,2,3,9,7,2,11,Italy - Serie D - Group B,0.38,0.62,2,1.12,1.38,2.63,1.61,5
Vigasio,8,3,2,3,8,9,-1,11,Italy - Serie D - Group B,0.38,0.62,-1,1.0,1.38,2.63,1.61,5
Pro Sesto,8,3,2,3,7,8,-1,11,Italy - Serie D - Group B,0.38,0.62,-1,0.88,1.38,2.63,1.61,5
Club Milano,8,3,1,4,10,12,-2,10,Italy - Serie D - Group B,0.38,0.5,-2,1.25,1.25,2.63,2.0,6
Crema,8,2,3,3,15,15,0,9,Italy - Serie D - Group B,0.25,0.62,0,1.88,1.12,4.0,1.61,7
Castellanzese,8,1,6,1,12,13,-1,9,Italy - Serie D - Group B,0.12,0.88,-1,1.5,1.12,8.33,1.14,7
Breno,8,2,3,3,12,17,-5,9,Italy - Serie D - Group B,0.25,0.62,-5,1.5,1.12,4.0,1.61,7
Ciliverghe,8,3,0,5,12,21,-9,9,Italy - Serie D - Group B,0.38,0.38,-9,1.5,1.12,2.63,2.63,7
Magenta,8,2,2,4,10,14,-4,8,Italy - Serie D - Group B,0.25,0.5,-4,1.25,1.0,4.0,2.0,8
Sangiuliano C.,8,2,2,4,9,13,-4,8,Italy - Serie D - Group B,0.25,0.5,-4,1.12,1.0,4.0,2.0,8
SantAngelo,8,1,4,3,9,11,-2,7,Italy - Serie D - Group B,0.12,0.62,-2,1.12,0.88,8.33,1.61,9
Chievo,8,2,1,5,7,9,-2,7,Italy - Serie D - Group B,0.25,0.38,-2,0.88,0.88,4.0,2.63,9
Arconatese,8,1,4,3,6,10,-4,7,Italy - Serie D - Group B,0.12,0.62,-4,0.75,0.88,8.33,1.61,9
Fanfulla,8,1,3,4,5,10,-5,6,Italy - Serie D - Group B,0.12,0.5,-5,0.62,0.75,8.33,2.0,10
Mestre,8,5,2,1,9,4,5,17,Italy - Serie D - Group C,0.62,0.88,5,1.12,2.12,1.61,1.14,1
D. Bellunesi,8,4,3,1,12,8,4,15,Italy - Serie D - Group C,0.5,0.88,4,1.5,1.88,2.0,1.14,2
Luparense,8,4,3,1,11,7,4,15,Italy - Serie D - Group C,0.5,0.88,4,1.38,1.88,2.0,1.14,2
Brian Lignano,8,3,5,0,11,4,7,14,Italy - Serie D - Group C,0.38,1.0,7,1.38,1.75,2.63,1.0,3
Real Calepina,8,3,5,0,10,5,5,14,Italy - Serie D - Group C,0.38,1.0,5,1.25,1.75,2.63,1.0,3
Portogruaro,8,4,1,3,8,4,4,13,Italy - Serie D - Group C,0.5,0.62,4,1.0,1.62,2.0,1.61,4
Cjarlins Muzane,8,3,3,2,10,9,1,12,Italy - Serie D - Group C,0.38,0.75,1,1.25,1.5,2.63,1.33,5
Bassano Virtus,8,3,2,3,11,6,5,11,Italy - Serie D - Group C,0.38,0.62,5,1.38,1.38,2.63,1.61,6
Campodarsego,8,2,5,1,9,7,2,11,Italy - Serie D - Group C,0.25,0.88,2,1.12,1.38,4.0,1.14,6
Villa Alme,8,3,2,3,15,14,1,11,Italy - Serie D - Group C,0.38,0.62,1,1.88,1.38,2.63,1.61,6
Brusaporto,8,3,2,3,8,7,1,11,Italy - Serie D - Group C,0.38,0.62,1,1.0,1.38,2.63,1.61,6
Este,8,3,2,3,9,11,-2,11,Italy - Serie D - Group C,0.38,0.62,-2,1.12,1.38,2.63,1.61,6
Adriese,8,3,2,3,8,10,-2,11,Italy - Serie D - Group C,0.38,0.62,-2,1.0,1.38,2.63,1.61,6
Chions,8,2,4,2,8,8,0,10,Italy - Serie D - Group C,0.25,0.75,0,1.0,1.25,4.0,1.33,7
Calvi Noale,8,3,1,4,9,12,-3,10,Italy - Serie D - Group C,0.38,0.5,-3,1.12,1.25,2.63,2.0,7
Treviso,8,3,1,4,6,9,-3,10,Italy - Serie D - Group C,0.38,0.5,-3,0.75,1.25,2.63,2.0,7
Ciserano,8,1,5,2,4,6,-2,8,Italy - Serie D - Group C,0.12,0.75,-2,0.5,1.0,8.33,1.33,8
Montecchio M.,8,1,2,5,5,11,-6,5,Italy - Serie D - Group C,0.12,0.38,-6,0.62,0.62,8.33,2.63,9
Lavis,8,1,0,7,3,15,-12,3,Italy - Serie D - Group C,0.12,0.12,-12,0.38,0.38,8.33,8.33,10
Caravaggio,8,0,2,6,6,15,-9,2,Italy - Serie D - Group C,0.0,0.25,-9,0.75,0.25,0.0,4.0,11
Forli,8,8,0,0,18,4,14,24,Italy - Serie D - Group D,1.0,1.0,14,2.25,3.0,1.0,1.0,1
Ravenna,8,5,2,1,20,8,12,17,Italy - Serie D - Group D,0.62,0.88,12,2.5,2.12,1.61,1.14,2
Pistoiese,8,5,2,1,10,4,6,17,Italy - Serie D - Group D,0.62,0.88,6,1.25,2.12,1.61,1.14,2
Lentigione,8,4,2,2,15,8,7,14,Italy - Serie D - Group D,0.5,0.75,7,1.88,1.75,2.0,1.33,3
Zenith Prato,8,4,1,3,12,6,6,13,Italy - Serie D - Group D,0.5,0.62,6,1.5,1.62,2.0,1.61,4
Progresso,8,3,2,3,9,8,1,11,Italy - Serie D - Group D,0.38,0.62,1,1.12,1.38,2.63,1.61,5
Imolese,8,3,2,3,8,11,-3,11,Italy - Serie D - Group D,0.38,0.62,-3,1.0,1.38,2.63,1.61,5
Tau Altopascio,8,2,4,2,8,7,1,10,Italy - Serie D - Group D,0.25,0.75,1,1.0,1.25,4.0,1.33,6
Piacenza,8,2,4,2,6,6,0,10,Italy - Serie D - Group D,0.25,0.75,0,0.75,1.25,4.0,1.33,6
Sasso Marconi,8,3,1,4,10,12,-2,10,Italy - Serie D - Group D,0.38,0.5,-2,1.25,1.25,2.63,2.0,6
Prato,8,3,1,4,6,10,-4,10,Italy - Serie D - Group D,0.38,0.5,-4,0.75,1.25,2.63,2.0,6
Corticella,8,3,1,4,6,15,-9,10,Italy - Serie D - Group D,0.38,0.5,-9,0.75,1.25,2.63,2.0,6
San Marino C.,8,2,3,3,12,12,0,9,Italy - Serie D - Group D,0.25,0.62,0,1.5,1.12,4.0,1.61,7
Cittadella Vis,8,2,3,3,8,10,-2,9,Italy - Serie D - Group D,0.25,0.62,-2,1.0,1.12,4.0,1.61,7
Tuttocuoio,8,2,2,4,11,12,-1,8,Italy - Serie D - Group D,0.25,0.5,-1,1.38,1.0,4.0,2.0,8
Sammaurese,8,2,2,4,5,6,-1,8,Italy - Serie D - Group D,0.25,0.5,-1,0.62,1.0,4.0,2.0,8
Fiorenzuola,8,2,0,6,5,13,-8,6,Italy - Serie D - Group D,0.25,0.25,-8,0.62,0.75,4.0,4.0,9
United Riccione,8,1,0,7,2,19,-17,3,Italy - Serie D - Group D,0.12,0.12,-17,0.25,0.38,8.33,8.33,10
Flaminia,8,5,2,1,18,8,10,17,Italy - Serie D - Group E,0.62,0.88,10,2.25,2.12,1.61,1.14,1
Livorno,8,5,1,2,17,14,3,16,Italy - Serie D - Group E,0.62,0.75,3,2.12,2.0,1.61,1.33,2
Ghiviborgo,8,5,0,3,19,11,8,15,Italy - Serie D - Group E,0.62,0.62,8,2.38,1.88,1.61,1.61,3
Fulgens Foligno,8,3,3,2,15,11,4,12,Italy - Serie D - Group E,0.38,0.75,4,1.88,1.5,2.63,1.33,4
Ostia Mare,8,3,3,2,13,13,0,12,Italy - Serie D - Group E,0.38,0.75,0,1.62,1.5,2.63,1.33,4
Orvietana,8,3,3,2,11,11,0,12,Italy - Serie D - Group E,0.38,0.75,0,1.38,1.5,2.63,1.33,4
T. Traiana,8,2,5,1,7,6,1,11,Italy - Serie D - Group E,0.25,0.88,1,0.88,1.38,4.0,1.14,5
Gavorrano,8,2,5,1,8,8,0,11,Italy - Serie D - Group E,0.25,0.88,0,1.0,1.38,4.0,1.14,5
S. Trestina,8,3,2,3,7,12,-5,11,Italy - Serie D - Group E,0.38,0.62,-5,0.88,1.38,2.63,1.61,5
San Donato,8,3,1,4,6,7,-1,10,Italy - Serie D - Group E,0.38,0.5,-1,0.75,1.25,2.63,2.0,6
Seravezza,8,2,3,3,10,12,-2,9,Italy - Serie D - Group E,0.25,0.62,-2,1.25,1.12,4.0,1.61,7
Grosseto,8,2,3,3,8,10,-2,9,Italy - Serie D - Group E,0.25,0.62,-2,1.0,1.12,4.0,1.61,7
Figline,8,2,2,4,8,8,0,8,Italy - Serie D - Group E,0.25,0.5,0,1.0,1.0,4.0,2.0,8
Montevarchi,8,1,5,2,6,7,-1,8,Italy - Serie D - Group E,0.12,0.75,-1,0.75,1.0,8.33,1.33,8
Poggibonsi,8,2,2,4,3,7,-4,8,Italy - Serie D - Group E,0.25,0.5,-4,0.38,1.0,4.0,2.0,8
Fezzanese,8,1,4,3,7,11,-4,7,Italy - Serie D - Group E,0.12,0.62,-4,0.88,0.88,8.33,1.61,9
FC Siena,8,1,4,3,6,10,-4,7,Italy - Serie D - Group E,0.12,0.62,-4,0.75,0.88,8.33,1.61,9
Sangiovannese,8,1,3,4,9,13,-4,6,Italy - Serie D - Group E,0.12,0.5,-4,1.12,0.75,8.33,2.0,10
Teramo,8,6,0,2,14,7,7,18,Italy - Serie D - Group F,0.75,0.75,7,1.75,2.25,1.33,1.33,1
San Nicolo,8,5,1,2,11,7,4,16,Italy - Serie D - Group F,0.62,0.75,4,1.38,2.0,1.61,1.33,2
Chieti,8,4,2,2,12,10,2,14,Italy - Serie D - Group F,0.5,0.75,2,1.5,1.75,2.0,1.33,3
Fossombrone,8,3,4,1,11,7,4,13,Italy - Serie D - Group F,0.38,0.88,4,1.38,1.62,2.63,1.14,4
Sambenedettese,8,3,4,1,9,5,4,13,Italy - Serie D - Group F,0.38,0.88,4,1.12,1.62,2.63,1.14,4
Termoli Calcio,8,2,5,1,11,12,-1,11,Italy - Serie D - Group F,0.25,0.88,-1,1.38,1.38,4.0,1.14,5
Isernia,8,3,2,3,8,10,-2,11,Italy - Serie D - Group F,0.38,0.62,-2,1.0,1.38,2.63,1.61,5
V. Senigallia,8,3,2,3,7,9,-2,11,Italy - Serie D - Group F,0.38,0.62,-2,0.88,1.38,2.63,1.61,5
Civitanovese,8,2,4,2,9,7,2,10,Italy - Serie D - Group F,0.25,0.75,2,1.12,1.25,4.0,1.33,6
Atletico Ascoli,8,2,4,2,9,9,0,10,Italy - Serie D - Group F,0.25,0.75,0,1.12,1.25,4.0,1.33,6
Avezzano,8,2,4,2,9,12,-3,10,Italy - Serie D - Group F,0.25,0.75,-3,1.12,1.25,4.0,1.33,6
Castelfidardo,8,2,3,3,7,6,1,9,Italy - Serie D - Group F,0.25,0.62,1,0.88,1.12,4.0,1.61,7
Sora,8,2,3,3,8,8,0,9,Italy - Serie D - Group F,0.25,0.62,0,1.0,1.12,4.0,1.61,7
Recanatese,8,2,3,3,10,14,-4,9,Italy - Serie D - Group F,0.25,0.62,-4,1.25,1.12,4.0,1.61,7
LAquila,8,1,4,3,8,8,0,7,Italy - Serie D - Group F,0.12,0.62,0,1.0,0.88,8.33,1.61,8
Roma City,8,1,4,3,8,10,-2,7,Italy - Serie D - Group F,0.12,0.62,-2,1.0,0.88,8.33,1.61,8
Ancona 1905,8,1,3,4,7,12,-5,6,Italy - Serie D - Group F,0.12,0.5,-5,0.88,0.75,8.33,2.0,9
Fermana,8,1,2,5,7,12,-5,5,Italy - Serie D - Group F,0.12,0.38,-5,0.88,0.62,8.33,2.63,10
Savoia,8,6,2,0,16,4,12,20,Italy - Serie D - Group G,0.75,1.0,12,2.0,2.5,1.33,1.0,1
Guidonia,8,6,1,1,17,9,8,19,Italy - Serie D - Group G,0.75,0.88,8,2.12,2.38,1.33,1.14,2
Sarnese,8,5,3,0,18,8,10,18,Italy - Serie D - Group G,0.62,1.0,10,2.25,2.25,1.61,1.0,3
Gelbison,8,5,2,1,12,5,7,17,Italy - Serie D - Group G,0.62,0.88,7,1.5,2.12,1.61,1.14,4
Ilvamaddalena,8,5,1,2,15,5,10,16,Italy - Serie D - Group G,0.62,0.75,10,1.88,2.0,1.61,1.33,5
Paganese,8,5,1,2,13,7,6,16,Italy - Serie D - Group G,0.62,0.75,6,1.62,2.0,1.61,1.33,5
CynthiAlbalonga,8,5,0,3,13,10,3,15,Italy - Serie D - Group G,0.62,0.62,3,1.62,1.88,1.61,1.61,6
Olbia,8,4,2,2,11,5,6,14,Italy - Serie D - Group G,0.5,0.75,6,1.38,1.75,2.0,1.33,7
Cassino,8,3,2,3,8,7,1,11,Italy - Serie D - Group G,0.38,0.62,1,1.0,1.38,2.63,1.61,8
S. Ogliastra,8,3,2,3,14,16,-2,11,Italy - Serie D - Group G,0.38,0.62,-2,1.75,1.38,2.63,1.61,8
A. Lodigiani,8,2,3,3,12,12,0,9,Italy - Serie D - Group G,0.25,0.62,0,1.5,1.12,4.0,1.61,9
Trastevere,8,3,0,5,11,13,-2,9,Italy - Serie D - Group G,0.38,0.38,-2,1.38,1.12,2.63,2.63,9
R. Monterotondo,8,2,2,4,7,13,-6,8,Italy - Serie D - Group G,0.25,0.5,-6,0.88,1.0,4.0,2.0,10
Atletico Uri,8,2,1,5,9,12,-3,7,Italy - Serie D - Group G,0.25,0.38,-3,1.12,0.88,4.0,2.63,11
Puteolana,8,1,2,5,5,13,-8,5,Italy - Serie D - Group G,0.12,0.38,-8,0.62,0.62,8.33,2.63,12
Latte Dolce,8,1,1,6,6,17,-11,4,Italy - Serie D - Group G,0.12,0.25,-11,0.75,0.5,8.33,4.0,13
Anzio,8,0,2,6,6,22,-16,2,Italy - Serie D - Group G,0.0,0.25,-16,0.75,0.25,0.0,4.0,14
Terracina,8,0,1,7,7,22,-15,1,Italy - Serie D - Group G,0.0,0.12,-15,0.88,0.12,0.0,8.33,15
Casarano,8,6,2,0,22,7,15,20,Italy - Serie D - Group H,0.75,1.0,15,2.75,2.5,1.33,1.0,1
Francavilla,8,6,0,2,11,5,6,18,Italy - Serie D - Group H,0.75,0.75,6,1.38,2.25,1.33,1.33,2
Citta di Fasano,8,4,3,1,15,6,9,15,Italy - Serie D - Group H,0.5,0.88,9,1.88,1.88,2.0,1.14,3
Nocerina,8,3,4,1,10,6,4,13,Italy - Serie D - Group H,0.38,0.88,4,1.25,1.62,2.63,1.14,4
Brindisi,8,3,3,2,14,11,3,12,Italy - Serie D - Group H,0.38,0.75,3,1.75,1.5,2.63,1.33,5
Manfredonia,8,3,3,2,9,6,3,12,Italy - Serie D - Group H,0.38,0.75,3,1.12,1.5,2.63,1.33,5
USD Palmese,8,3,3,2,10,9,1,12,Italy - Serie D - Group H,0.38,0.75,1,1.25,1.5,2.63,1.33,5
V. Francavilla,8,2,5,1,12,7,5,11,Italy - Serie D - Group H,0.25,0.88,5,1.5,1.38,4.0,1.14,6
Fidelis Andria,8,3,2,3,7,7,0,11,Italy - Serie D - Group H,0.38,0.62,0,0.88,1.38,2.63,1.61,6
Ischia,8,2,4,2,6,6,0,10,Italy - Serie D - Group H,0.25,0.75,0,0.75,1.25,4.0,1.33,7
Martina Franca,8,2,4,2,6,8,-2,10,Italy - Serie D - Group H,0.25,0.75,-2,0.75,1.25,4.0,1.33,7
Nardo,8,2,2,4,5,8,-3,8,Italy - Serie D - Group H,0.25,0.5,-3,0.62,1.0,4.0,2.0,8
Angri Calcio,8,2,2,4,7,14,-7,8,Italy - Serie D - Group H,0.25,0.5,-7,0.88,1.0,4.0,2.0,8
Gravina,8,1,4,3,7,9,-2,7,Italy - Serie D - Group H,0.12,0.62,-2,0.88,0.88,8.33,1.61,9
Ugento,8,2,1,5,7,14,-7,7,Italy - Serie D - Group H,0.25,0.38,-7,0.88,0.88,4.0,2.63,9
Real Acerrana,8,1,3,4,6,12,-6,6,Italy - Serie D - Group H,0.12,0.5,-6,0.75,0.75,8.33,2.0,10
Matera,8,1,3,4,7,19,-12,6,Italy - Serie D - Group H,0.12,0.5,-12,0.88,0.75,8.33,2.0,10
Costa DAmalfi,8,1,2,5,6,13,-7,5,Italy - Serie D - Group H,0.12,0.38,-7,0.75,0.62,8.33,2.63,11
Siracusa,8,7,0,1,22,6,16,21,Italy - Serie D - Group I,0.88,0.88,16,2.75,2.62,1.14,1.14,1
Reggina,8,7,0,1,18,4,14,21,Italy - Serie D - Group I,0.88,0.88,14,2.25,2.62,1.14,1.14,1
Pompei,8,5,1,2,8,6,2,16,Italy - Serie D - Group I,0.62,0.75,2,1.0,2.0,1.61,1.33,2
Nissa,8,3,4,1,13,10,3,13,Italy - Serie D - Group I,0.38,0.88,3,1.62,1.62,2.63,1.14,3
Scafatese,8,4,1,3,10,8,2,13,Italy - Serie D - Group I,0.5,0.62,2,1.25,1.62,2.0,1.61,3
Ragusa,8,4,0,4,12,8,4,12,Italy - Serie D - Group I,0.5,0.5,4,1.5,1.5,2.0,2.0,4
Acireale,8,2,5,1,10,11,-1,11,Italy - Serie D - Group I,0.25,0.88,-1,1.25,1.38,4.0,1.14,5
Sancataldese,8,3,2,3,8,9,-1,11,Italy - Serie D - Group I,0.38,0.62,-1,1.0,1.38,2.63,1.61,5
CD S. Agata,8,2,4,2,13,12,1,10,Italy - Serie D - Group I,0.25,0.75,1,1.62,1.25,4.0,1.33,6
Igea Virtus,8,3,1,4,10,10,0,10,Italy - Serie D - Group I,0.38,0.5,0,1.25,1.25,2.63,2.0,6
Paterno,8,2,4,2,6,7,-1,10,Italy - Serie D - Group I,0.25,0.75,-1,0.75,1.25,4.0,1.33,6
Sambiase,8,2,2,4,6,8,-2,8,Italy - Serie D - Group I,0.25,0.5,-2,0.75,1.0,4.0,2.0,7
CastrumFavara,8,1,4,3,7,10,-3,7,Italy - Serie D - Group I,0.12,0.62,-3,0.88,0.88,8.33,1.61,8
Vibonese,8,2,1,5,7,11,-4,7,Italy - Serie D - Group I,0.25,0.38,-4,0.88,0.88,4.0,2.63,8
Licata,8,2,1,5,6,18,-12,7,Italy - Serie D - Group I,0.25,0.38,-12,0.75,0.88,4.0,2.63,8
Enna,8,1,3,4,3,9,-6,6,Italy - Serie D - Group I,0.12,0.5,-6,0.38,0.75,8.33,2.0,9
Locri 1909,8,1,1,6,6,18,-12,4,Italy - Serie D - Group I,0.12,0.25,-12,0.75,0.5,8.33,4.0,10
Akragas,0,0,0,0,0,0,0,0,Italy - Serie D - Group I,0.0,0.0,0,0.0,0.0,0.0,0.0,11
Juventus U20,8,7,0,1,22,13,9,21,Italy - Primavera 1,0.88,0.88,9,2.75,2.62,1.14,1.14,1
Roma U20,8,6,0,2,16,11,5,18,Italy - Primavera 1,0.75,0.75,5,2.0,2.25,1.33,1.33,2
Inter Milan U20,8,5,2,1,15,5,10,17,Italy - Primavera 1,0.62,0.88,10,1.88,2.12,1.61,1.14,3
Sassuolo U20,8,5,2,1,10,6,4,17,Italy - Primavera 1,0.62,0.88,4,1.25,2.12,1.61,1.14,3
H. Verona U20,8,5,1,2,16,5,11,16,Italy - Primavera 1,0.62,0.75,11,2.0,2.0,1.61,1.33,4
Lazio U20,8,5,1,2,12,9,3,16,Italy - Primavera 1,0.62,0.75,3,1.5,2.0,1.61,1.33,4
Cesena U20,8,4,2,2,18,14,4,14,Italy - Primavera 1,0.5,0.75,4,2.25,1.75,2.0,1.33,5
Genoa U20,8,4,0,4,14,11,3,12,Italy - Primavera 1,0.5,0.5,3,1.75,1.5,2.0,2.0,6
Cagliari U20,8,3,3,2,9,8,1,12,Italy - Primavera 1,0.38,0.75,1,1.12,1.5,2.63,1.33,6
Bologna U20,8,3,2,3,9,9,0,11,Italy - Primavera 1,0.38,0.62,0,1.12,1.38,2.63,1.61,7
Lecce U20,8,3,2,3,9,11,-2,11,Italy - Primavera 1,0.38,0.62,-2,1.12,1.38,2.63,1.61,7
Atalanta U20,8,3,0,5,12,10,2,9,Italy - Primavera 1,0.38,0.38,2,1.5,1.12,2.63,2.63,8
Cremonese U20,8,1,5,2,10,10,0,8,Italy - Primavera 1,0.12,0.75,0,1.25,1.0,8.33,1.33,9
Milan U20,8,2,2,4,8,13,-5,8,Italy - Primavera 1,0.25,0.5,-5,1.0,1.0,4.0,2.0,9
Fiorentina U20,8,2,1,5,11,14,-3,7,Italy - Primavera 1,0.25,0.38,-3,1.38,0.88,4.0,2.63,10
Monza U20,8,2,1,5,14,22,-8,7,Italy - Primavera 1,0.25,0.38,-8,1.75,0.88,4.0,2.63,10
Sampdoria U20,8,1,3,4,7,15,-8,6,Italy - Primavera 1,0.12,0.5,-8,0.88,0.75,8.33,2.0,11
Torino U20,8,1,2,5,10,15,-5,5,Italy - Primavera 1,0.12,0.38,-5,1.25,0.62,8.33,2.63,12
Empoli U20,8,1,2,5,8,15,-7,5,Italy - Primavera 1,0.12,0.38,-7,1.0,0.62,8.33,2.63,12
Udinese U20,8,1,1,6,6,20,-14,4,Italy - Primavera 1,0.12,0.25,-14,0.75,0.5,8.33,4.0,13
Mount Pleasant,8,5,2,1,12,2,10,17,Jamaica - Premier League,0.62,0.88,10,1.5,2.12,1.61,1.14,1
Portmore Utd,8,5,2,1,7,2,5,17,Jamaica - Premier League,0.62,0.88,5,0.88,2.12,1.61,1.14,1
Montego Bay,8,4,4,0,15,4,11,16,Jamaica - Premier League,0.5,1.0,11,1.88,2.0,2.0,1.0,2
Arnett Gardens,8,4,3,1,22,10,12,15,Jamaica - Premier League,0.5,0.88,12,2.75,1.88,2.0,1.14,3
Tivoli Gardens,8,4,3,1,15,9,6,15,Jamaica - Premier League,0.5,0.88,6,1.88,1.88,2.0,1.14,3
Racing United,8,4,3,1,11,5,6,15,Jamaica - Premier League,0.5,0.88,6,1.38,1.88,2.0,1.14,3
Cavalier,8,3,3,2,11,10,1,12,Jamaica - Premier League,0.38,0.75,1,1.38,1.5,2.63,1.33,4
Waterhouse,8,3,3,2,11,10,1,12,Jamaica - Premier League,0.38,0.75,1,1.38,1.5,2.63,1.33,4
Humble Lions,8,3,2,3,9,8,1,11,Jamaica - Premier League,0.38,0.62,1,1.12,1.38,2.63,1.61,5
Chapelton,8,3,2,3,6,12,-6,11,Jamaica - Premier League,0.38,0.62,-6,0.75,1.38,2.63,1.61,5
Harbour View,8,2,2,4,4,9,-5,8,Jamaica - Premier League,0.25,0.5,-5,0.5,1.0,4.0,2.0,6
Vere Utd,8,1,1,6,5,13,-8,4,Jamaica - Premier League,0.12,0.25,-8,0.62,0.5,8.33,4.0,7
Molynes Utd,8,0,3,5,2,16,-14,3,Jamaica - Premier League,0.0,0.38,-14,0.25,0.38,0.0,2.63,8
Dunbeholden,8,0,1,7,3,18,-15,1,Jamaica - Premier League,0.0,0.12,-15,0.38,0.12,0.0,8.33,9
Machida Zelvia,8,5,2,1,11,6,5,17,Japan - J1 League,0.62,0.88,5,1.38,2.12,1.61,1.14,1
S. Hiroshima,8,5,2,1,9,5,4,17,Japan - J1 League,0.62,0.88,4,1.12,2.12,1.61,1.14,1
Kashima Antlers,8,5,1,2,16,8,8,16,Japan - J1 League,0.62,0.75,8,2.0,2.0,1.61,1.33,2
Avispa Fukuoka,8,5,1,2,9,6,3,16,Japan - J1 League,0.62,0.75,3,1.12,2.0,1.61,1.33,2
K. Frontale,8,4,3,1,14,5,9,15,Japan - J1 League,0.5,0.88,9,1.75,1.88,2.0,1.14,3
Kyoto Sanga,8,4,3,1,11,8,3,15,Japan - J1 League,0.5,0.88,3,1.38,1.88,2.0,1.14,3
Kashiwa Reysol,8,3,4,1,9,7,2,13,Japan - J1 League,0.38,0.88,2,1.12,1.62,2.63,1.14,4
Fagiano Okayama,8,3,2,3,6,5,1,11,Japan - J1 League,0.38,0.62,1,0.75,1.38,2.63,1.61,5
Shonan Bellmare,8,3,2,3,8,11,-3,11,Japan - J1 League,0.38,0.62,-3,1.0,1.38,2.63,1.61,5
Yokohama FC,8,3,1,4,6,6,0,10,Japan - J1 League,0.38,0.5,0,0.75,1.25,2.63,2.0,6
Gamba Osaka,8,3,1,4,7,10,-3,10,Japan - J1 League,0.38,0.5,-3,0.88,1.25,2.63,2.0,6
Tokyo Verdy,8,2,4,2,7,10,-3,10,Japan - J1 League,0.25,0.75,-3,0.88,1.25,4.0,1.33,6
Vissel Kobe,8,2,3,3,6,7,-1,9,Japan - J1 League,0.25,0.62,-1,0.75,1.12,4.0,1.61,7
Urawa RD,8,2,3,3,7,9,-2,9,Japan - J1 League,0.25,0.62,-2,0.88,1.12,4.0,1.61,7
Shimizu S-Pulse,8,2,2,4,9,9,0,8,Japan - J1 League,0.25,0.5,0,1.12,1.0,4.0,2.0,8
Nagoya G.,8,2,2,4,11,13,-2,8,Japan - J1 League,0.25,0.5,-2,1.38,1.0,4.0,2.0,8
Yokohama M.,8,1,4,3,4,6,-2,7,Japan - J1 League,0.12,0.62,-2,0.5,0.88,8.33,1.61,9
Albirex Niigata,8,1,3,4,9,13,-4,6,Japan - J1 League,0.12,0.5,-4,1.12,0.75,8.33,2.0,10
Cerezo Osaka,8,1,3,4,9,13,-4,6,Japan - J1 League,0.12,0.5,-4,1.12,0.75,8.33,2.0,10
FC Tokyo,8,1,2,5,5,11,-6,5,Japan - J1 League,0.12,0.38,-6,0.62,0.62,8.33,2.63,11
JEF Utd Chiba,8,7,0,1,19,7,12,21,Japan - J2 League,0.88,0.88,12,2.38,2.62,1.14,1.14,1
Omiya Ardija,8,5,1,2,13,6,7,16,Japan - J2 League,0.62,0.75,7,1.62,2.0,1.61,1.33,2
Jubilo Iwata,8,5,1,2,11,9,2,16,Japan - J2 League,0.62,0.75,2,1.38,2.0,1.61,1.33,2
FC Imabari,8,4,3,1,14,7,7,15,Japan - J2 League,0.5,0.88,7,1.75,1.88,2.0,1.14,3
V-V. Nagasaki,8,4,2,2,16,13,3,14,Japan - J2 League,0.5,0.75,3,2.0,1.75,2.0,1.33,4
Vegalta Sendai,8,4,2,2,10,7,3,14,Japan - J2 League,0.5,0.75,3,1.25,1.75,2.0,1.33,4
Tokushima V.,8,3,3,2,5,3,2,12,Japan - J2 League,0.38,0.75,2,0.62,1.5,2.63,1.33,5
Fujieda MYFC,8,3,3,2,11,10,1,12,Japan - J2 League,0.38,0.75,1,1.38,1.5,2.63,1.33,5
Oita Trinita,8,2,5,1,7,6,1,11,Japan - J2 League,0.25,0.88,1,0.88,1.38,4.0,1.14,6
Kataller Toyama,8,3,2,3,6,5,1,11,Japan - J2 League,0.38,0.62,1,0.75,1.38,2.63,1.61,6
R. Kumamoto,8,3,2,3,10,11,-1,11,Japan - J2 League,0.38,0.62,-1,1.25,1.38,2.63,1.61,6
Ventforet Kofu,8,3,1,4,8,10,-2,10,Japan - J2 League,0.38,0.5,-2,1.0,1.25,2.63,2.0,7
Sagan Tosu,8,3,1,4,6,10,-4,10,Japan - J2 League,0.38,0.5,-4,0.75,1.25,2.63,2.0,7
M. Yamagata,8,2,3,3,12,11,1,9,Japan - J2 League,0.25,0.62,1,1.5,1.12,4.0,1.61,8
Mito Hollyhock,8,2,3,3,11,11,0,9,Japan - J2 League,0.25,0.62,0,1.38,1.12,4.0,1.61,8
C. Sapporo,8,3,0,5,7,13,-6,9,Japan - J2 League,0.38,0.38,-6,0.88,1.12,2.63,2.63,8
Blaublitz Akita,8,3,0,5,9,16,-7,9,Japan - J2 League,0.38,0.38,-7,1.12,1.12,2.63,2.63,8
R. Yamaguchi,8,1,3,4,7,9,-2,6,Japan - J2 League,0.12,0.5,-2,0.88,0.75,8.33,2.0,9
Iwaki,8,0,3,5,3,12,-9,3,Japan - J2 League,0.0,0.38,-9,0.38,0.38,0.0,2.63,10
Ehime FC,8,0,2,6,7,16,-9,2,Japan - J2 League,0.0,0.25,-9,0.88,0.25,0.0,4.0,11
Osaka,8,5,1,2,9,5,4,16,Japan - J3 League,0.62,0.75,4,1.12,2.0,1.61,1.33,1
Kagoshima Utd,8,4,3,1,16,9,7,15,Japan - J3 League,0.5,0.88,7,2.0,1.88,2.0,1.14,2
G. Kitakyushu,7,5,0,2,9,3,6,15,Japan - J3 League,0.71,0.71,6,1.29,2.14,1.41,1.41,2
Tochigi City,8,4,3,1,11,9,2,15,Japan - J3 League,0.5,0.88,2,1.38,1.88,2.0,1.14,2
Nara Club,8,3,4,1,12,10,2,13,Japan - J3 League,0.38,0.88,2,1.5,1.62,2.63,1.14,3
T. Miyazaki,8,3,3,2,9,7,2,12,Japan - J3 League,0.38,0.75,2,1.12,1.5,2.63,1.33,4
Z. Kanazawa,7,3,2,2,10,8,2,11,Japan - J3 League,0.43,0.71,2,1.43,1.57,2.33,1.41,5
Fukushima Utd,7,3,2,2,13,12,1,11,Japan - J3 League,0.43,0.71,1,1.86,1.57,2.33,1.41,5
V. Hachinohe,7,3,2,2,8,7,1,11,Japan - J3 League,0.43,0.71,1,1.14,1.57,2.33,1.41,5
Kamatamare S.,8,2,4,2,7,7,0,10,Japan - J3 League,0.25,0.75,0,0.88,1.25,4.0,1.33,6
Kochi United,8,2,3,3,13,10,3,9,Japan - J3 League,0.25,0.62,3,1.62,1.12,4.0,1.61,7
Nagano Parceiro,7,3,0,4,9,12,-3,9,Japan - J3 League,0.43,0.43,-3,1.29,1.29,2.33,2.33,7
FC Ryukyu,8,2,2,4,6,7,-1,8,Japan - J3 League,0.25,0.5,-1,0.75,1.0,4.0,2.0,8
Tochigi SC,8,2,2,4,5,7,-2,8,Japan - J3 League,0.25,0.5,-2,0.62,1.0,4.0,2.0,8
Kusatsu,8,2,2,4,9,13,-4,8,Japan - J3 League,0.25,0.5,-4,1.12,1.0,4.0,2.0,8
SC Sagamihara,8,2,2,4,6,11,-5,8,Japan - J3 League,0.25,0.5,-5,0.75,1.0,4.0,2.0,8
AC Numazu,7,1,4,2,6,6,0,7,Japan - J3 League,0.14,0.71,0,0.86,1.0,7.14,1.41,9
Matsumoto Y.,6,1,3,2,5,9,-4,6,Japan - J3 League,0.17,0.67,-4,0.83,1.0,5.88,1.49,10
Gifu,8,1,3,4,9,14,-5,6,Japan - J3 League,0.12,0.5,-5,1.12,0.75,8.33,2.0,10
Gainare Tottori,8,1,3,4,5,11,-6,6,Japan - J3 League,0.12,0.5,-6,0.62,0.75,8.33,2.0,10
Al Hussein,8,6,2,0,21,7,14,20,Jordan - Premier League,0.75,1.0,14,2.62,2.5,1.33,1.0,1
Al Wihdat,8,6,1,1,16,3,13,19,Jordan - Premier League,0.75,0.88,13,2.0,2.38,1.33,1.14,2
Al Jazeera,8,6,0,2,17,9,8,18,Jordan - Premier League,0.75,0.75,8,2.12,2.25,1.33,1.33,3
Al Faysali,8,4,4,0,13,6,7,16,Jordan - Premier League,0.5,1.0,7,1.62,2.0,2.0,1.0,4
Al Ramtha,8,4,2,2,8,9,-1,14,Jordan - Premier League,0.5,0.75,-1,1.0,1.75,2.0,1.33,5
Aqaba,8,3,3,2,7,8,-1,12,Jordan - Premier League,0.38,0.75,-1,0.88,1.5,2.63,1.33,6
Al Salt,8,3,2,3,11,8,3,11,Jordan - Premier League,0.38,0.62,3,1.38,1.38,2.63,1.61,7
Al Sareeh,8,2,2,4,7,12,-5,8,Jordan - Premier League,0.25,0.5,-5,0.88,1.0,4.0,2.0,8
Maan,8,2,1,5,8,18,-10,7,Jordan - Premier League,0.25,0.38,-10,1.0,0.88,4.0,2.63,9
Shabab Al Ordon,8,1,2,5,6,12,-6,5,Jordan - Premier League,0.12,0.38,-6,0.75,0.62,8.33,2.63,10
Al Ahli,8,0,3,5,2,10,-8,3,Jordan - Premier League,0.0,0.38,-8,0.25,0.38,0.0,2.63,11
Moghayer Al S.,8,0,1,7,3,16,-13,1,Jordan - Premier League,0.0,0.12,-13,0.38,0.12,0.0,8.33,12
Kairat Almaty,4,3,1,0,11,3,8,10,Kazakhstan - Premier League,0.75,1.0,8,2.75,2.5,1.33,1.0,1
FC Astana,4,3,1,0,8,2,6,10,Kazakhstan - Premier League,0.75,1.0,6,2.0,2.5,1.33,1.0,1
Tobol,4,2,2,0,4,1,3,8,Kazakhstan - Premier League,0.5,1.0,3,1.0,2.0,2.0,1.0,2
Aktobe,3,2,1,0,6,1,5,7,Kazakhstan - Premier League,0.67,1.0,5,2.0,2.33,1.49,1.0,3
Turan,4,2,0,2,7,6,1,6,Kazakhstan - Premier League,0.5,0.5,1,1.75,1.5,2.0,2.0,4
Yelimay Semey,3,1,1,1,4,3,1,4,Kazakhstan - Premier League,0.33,0.67,1,1.33,1.33,3.03,1.49,5
Zhenys,4,0,4,0,1,1,0,4,Kazakhstan - Premier League,0.0,1.0,0,0.25,1.0,0.0,1.0,5
Okzhetpes,4,1,1,2,4,6,-2,4,Kazakhstan - Premier League,0.25,0.5,-2,1.0,1.0,4.0,2.0,5
Zhetysu,4,0,3,1,1,4,-3,3,Kazakhstan - Premier League,0.0,0.75,-3,0.25,0.75,0.0,1.33,6
Atyrau,4,1,0,3,4,11,-7,3,Kazakhstan - Premier League,0.25,0.25,-7,1.0,0.75,4.0,4.0,6
Kaisar K.,3,0,2,1,2,4,-2,2,Kazakhstan - Premier League,0.0,0.67,-2,0.67,0.67,0.0,1.49,7
Ulytau,3,0,2,1,1,3,-2,2,Kazakhstan - Premier League,0.0,0.67,-2,0.33,0.67,0.0,1.49,7
Kyzylzhar,4,0,2,2,3,6,-3,2,Kazakhstan - Premier League,0.0,0.5,-3,0.75,0.5,0.0,2.0,7
Ordabasy,4,0,2,2,1,6,-5,2,Kazakhstan - Premier League,0.0,0.5,-5,0.25,0.5,0.0,2.0,7
Drita,8,5,2,1,14,6,8,17,Kosovo - Superliga,0.62,0.88,8,1.75,2.12,1.61,1.14,1
Ferizaj,8,5,0,3,14,11,3,15,Kosovo - Superliga,0.62,0.62,3,1.75,1.88,1.61,1.61,2
Gjilani,8,4,2,2,9,10,-1,14,Kosovo - Superliga,0.5,0.75,-1,1.12,1.75,2.0,1.33,3
Ballkani,8,4,1,3,11,9,2,13,Kosovo - Superliga,0.5,0.62,2,1.38,1.62,2.0,1.61,4
Llapi,8,3,3,2,7,3,4,12,Kosovo - Superliga,0.38,0.75,4,0.88,1.5,2.63,1.33,5
Malisheva,8,3,3,2,10,7,3,12,Kosovo - Superliga,0.38,0.75,3,1.25,1.5,2.63,1.33,5
Dukagjini,8,3,3,2,5,4,1,12,Kosovo - Superliga,0.38,0.75,1,0.62,1.5,2.63,1.33,5
Prishtina,8,0,6,2,7,9,-2,6,Kosovo - Superliga,0.0,0.75,-2,0.88,0.75,0.0,1.33,6
Suhareka,8,1,1,6,7,16,-9,4,Kosovo - Superliga,0.12,0.25,-9,0.88,0.5,8.33,4.0,7
Feronikeli,8,1,1,6,4,13,-9,4,Kosovo - Superliga,0.12,0.25,-9,0.5,0.5,8.33,4.0,7
Al Kuwait,8,6,2,0,24,4,20,20,Kuwait - Premier League,0.75,1.0,20,3.0,2.5,1.33,1.0,1
Al Arabi SC,8,4,4,0,12,6,6,16,Kuwait - Premier League,0.5,1.0,6,1.5,2.0,2.0,1.0,2
Al Qadsia,8,5,0,3,16,15,1,15,Kuwait - Premier League,0.62,0.62,1,2.0,1.88,1.61,1.61,3
Al Fahaheel,8,3,3,2,14,11,3,12,Kuwait - Premier League,0.38,0.75,3,1.75,1.5,2.63,1.33,4
Al Salmiyah,8,3,3,2,13,11,2,12,Kuwait - Premier League,0.38,0.75,2,1.62,1.5,2.63,1.33,4
Kazma,8,2,3,3,12,10,2,9,Kuwait - Premier League,0.25,0.62,2,1.5,1.12,4.0,1.61,5
Al Nasar,8,2,2,4,11,15,-4,8,Kuwait - Premier League,0.25,0.5,-4,1.38,1.0,4.0,2.0,6
Khaitan,8,1,3,4,5,8,-3,6,Kuwait - Premier League,0.12,0.5,-3,0.62,0.75,8.33,2.0,7
Al Tadhamon,8,2,0,6,5,18,-13,6,Kuwait - Premier League,0.25,0.25,-13,0.62,0.75,4.0,4.0,7
Yarmouk,8,0,3,5,4,20,-16,3,Kuwait - Premier League,0.0,0.38,-16,0.5,0.38,0.0,2.63,8
RFS,5,4,0,1,9,4,5,12,Latvia - Virsliga,0.8,0.8,5,1.8,2.4,1.25,1.25,1
Daugavpils,5,3,0,2,10,7,3,9,Latvia - Virsliga,0.6,0.6,3,2.0,1.8,1.67,1.67,2
Metta,5,3,0,2,8,12,-4,9,Latvia - Virsliga,0.6,0.6,-4,1.6,1.8,1.67,1.67,2
Riga FC,5,2,2,1,11,7,4,8,Latvia - Virsliga,0.4,0.8,4,2.2,1.6,2.5,1.25,3
Liepaja,5,2,1,2,11,10,1,7,Latvia - Virsliga,0.4,0.6,1,2.2,1.4,2.5,1.67,4
Auda,5,2,1,2,7,6,1,7,Latvia - Virsliga,0.4,0.6,1,1.4,1.4,2.5,1.67,4
Tukums,5,1,2,2,6,8,-2,5,Latvia - Virsliga,0.2,0.6,-2,1.2,1.0,5.0,1.67,5
FS Jelgava,5,1,2,2,4,6,-2,5,Latvia - Virsliga,0.2,0.6,-2,0.8,1.0,5.0,1.67,5
Super Nova,5,1,1,3,7,7,0,4,Latvia - Virsliga,0.2,0.4,0,1.4,0.8,5.0,2.5,6
Grobina,5,1,1,3,7,13,-6,4,Latvia - Virsliga,0.2,0.4,-6,1.4,0.8,5.0,2.5,6
Hegelmann L.,5,4,0,1,7,4,3,12,Lithuania - A Lyga,0.8,0.8,3,1.4,2.4,1.25,1.25,1
Suduva,5,4,0,1,7,5,2,12,Lithuania - A Lyga,0.8,0.8,2,1.4,2.4,1.25,1.25,1
Zalgiris,5,2,3,0,7,5,2,9,Lithuania - A Lyga,0.4,1.0,2,1.4,1.8,2.5,1.0,2
Kauno Zalgiris,5,2,2,1,7,5,2,8,Lithuania - A Lyga,0.4,0.8,2,1.4,1.6,2.5,1.25,3
Siauliai,5,2,1,2,9,8,1,7,Lithuania - A Lyga,0.4,0.6,1,1.8,1.4,2.5,1.67,4
Dziugas Telsiai,5,2,0,3,5,6,-1,6,Lithuania - A Lyga,0.4,0.4,-1,1.0,1.2,2.5,2.5,5
Riteriai,5,1,2,2,10,10,0,5,Lithuania - A Lyga,0.2,0.6,0,2.0,1.0,5.0,1.67,6
Banga,5,1,2,2,5,5,0,5,Lithuania - A Lyga,0.2,0.6,0,1.0,1.0,5.0,1.67,6
Panevezys,5,1,1,3,6,9,-3,4,Lithuania - A Lyga,0.2,0.4,-3,1.2,0.8,5.0,2.5,7
Dainava,5,0,1,4,3,9,-6,1,Lithuania - A Lyga,0.0,0.2,-6,0.6,0.2,0.0,5.0,8
TransINVEST,4,4,0,0,14,2,12,12,Lithuania - 1st League,1.0,1.0,12,3.5,3.0,1.0,1.0,1
BFA Vilnius,4,4,0,0,7,1,6,12,Lithuania - 1st League,1.0,1.0,6,1.75,3.0,1.0,1.0,1
Tauras,4,3,1,0,11,0,11,10,Lithuania - 1st League,0.75,1.0,11,2.75,2.5,1.33,1.0,2
Neptuna K.,4,3,0,1,11,4,7,9,Lithuania - 1st League,0.75,0.75,7,2.75,2.25,1.33,1.33,3
Atmosfera,4,2,1,1,5,6,-1,7,Lithuania - 1st League,0.5,0.75,-1,1.25,1.75,2.0,1.33,4
Babrungas,4,2,1,1,7,9,-2,7,Lithuania - 1st League,0.5,0.75,-2,1.75,1.75,2.0,1.33,4
Kauno Z. B,4,2,0,2,2,3,-1,6,Lithuania - 1st League,0.5,0.5,-1,0.5,1.5,2.0,2.0,5
Panevezys B,4,2,0,2,6,10,-4,6,Lithuania - 1st League,0.5,0.5,-4,1.5,1.5,2.0,2.0,5
Hegelmann B,4,1,2,1,5,5,0,5,Lithuania - 1st League,0.25,0.75,0,1.25,1.25,4.0,1.33,6
Nevezis,4,1,1,2,7,7,0,4,Lithuania - 1st League,0.25,0.5,0,1.75,1.0,4.0,2.0,7
Siauliai B,4,1,1,2,6,9,-3,4,Lithuania - 1st League,0.25,0.5,-3,1.5,1.0,4.0,2.0,7
Minija,4,1,0,3,2,9,-7,3,Lithuania - 1st League,0.25,0.25,-7,0.5,0.75,4.0,4.0,8
Zalgiris B,4,0,2,2,3,7,-4,2,Lithuania - 1st League,0.0,0.5,-4,0.75,0.5,0.0,2.0,9
Be1 NFA,4,0,2,2,2,7,-5,2,Lithuania - 1st League,0.0,0.5,-5,0.5,0.5,0.0,2.0,9
Jonava,4,0,1,3,0,3,-3,1,Lithuania - 1st League,0.0,0.25,-3,0.0,0.25,0.0,4.0,10
Ekranas,4,0,0,4,1,7,-6,0,Lithuania - 1st League,0.0,0.0,-6,0.25,0.0,0.0,0.0,11
Differdange,8,8,0,0,20,0,20,24,Luxembourg - National Division,1.0,1.0,20,2.5,3.0,1.0,1.0,1
Petange,8,5,2,1,12,3,9,17,Luxembourg - National Division,0.62,0.88,9,1.5,2.12,1.61,1.14,2
Hesperange,8,4,3,1,13,7,6,15,Luxembourg - National Division,0.5,0.88,6,1.62,1.88,2.0,1.14,3
UNA Strassen,8,4,2,2,15,9,6,14,Luxembourg - National Division,0.5,0.75,6,1.88,1.75,2.0,1.33,4
Dudelange,8,4,2,2,14,8,6,14,Luxembourg - National Division,0.5,0.75,6,1.75,1.75,2.0,1.33,4
Hostert,8,4,2,2,14,12,2,14,Luxembourg - National Division,0.5,0.75,2,1.75,1.75,2.0,1.33,4
Niedercorn,8,4,2,2,10,8,2,14,Luxembourg - National Division,0.5,0.75,2,1.25,1.75,2.0,1.33,4
Mondorf,8,4,1,3,12,10,2,13,Luxembourg - National Division,0.5,0.62,2,1.5,1.62,2.0,1.61,5
V. Rosport,8,2,5,1,8,9,-1,11,Luxembourg - National Division,0.25,0.88,-1,1.0,1.38,4.0,1.14,6
Jeunesse Esch,8,2,3,3,12,12,0,9,Luxembourg - National Division,0.25,0.62,0,1.5,1.12,4.0,1.61,7
Rodange,8,2,3,3,12,13,-1,9,Luxembourg - National Division,0.25,0.62,-1,1.5,1.12,4.0,1.61,7
Racing,8,2,1,5,6,8,-2,7,Luxembourg - National Division,0.25,0.38,-2,0.75,0.88,4.0,2.63,8
Bettembourg,8,2,0,6,9,16,-7,6,Luxembourg - National Division,0.25,0.25,-7,1.12,0.75,4.0,4.0,9
Wiltz,8,2,0,6,8,18,-10,6,Luxembourg - National Division,0.25,0.25,-10,1.0,0.75,4.0,4.0,9
Mondercange,8,1,2,5,5,15,-10,5,Luxembourg - National Division,0.12,0.38,-10,0.62,0.62,8.33,2.63,10
Fola Esch,8,0,0,8,3,25,-22,0,Luxembourg - National Division,0.0,0.0,-22,0.38,0.0,0.0,0.0,11
Johor Darul,8,8,0,0,26,2,24,24,Malaysia - Super League,1.0,1.0,24,3.25,3.0,1.0,1.0,1
Kuching,8,5,3,0,16,5,11,18,Malaysia - Super League,0.62,1.0,11,2.0,2.25,1.61,1.0,2
Selangor,8,5,2,1,15,4,11,17,Malaysia - Super League,0.62,0.88,11,1.88,2.12,1.61,1.14,3
Kuala Lumpur,8,4,2,2,12,10,2,14,Malaysia - Super League,0.5,0.75,2,1.5,1.75,2.0,1.33,4
Sabah,8,3,4,1,13,12,1,13,Malaysia - Super League,0.38,0.88,1,1.62,1.62,2.63,1.14,5
Pulau Pinang,8,3,3,2,15,10,5,12,Malaysia - Super League,0.38,0.75,5,1.88,1.5,2.63,1.33,6
Terengganu,8,3,2,3,14,10,4,11,Malaysia - Super League,0.38,0.62,4,1.75,1.38,2.63,1.61,7
Perak,8,2,4,2,15,10,5,10,Malaysia - Super League,0.25,0.75,5,1.88,1.25,4.0,1.33,8
Negeri Sembilan,8,2,1,5,7,11,-4,7,Malaysia - Super League,0.25,0.38,-4,0.88,0.88,4.0,2.63,9
PDRM,8,2,1,5,10,15,-5,7,Malaysia - Super League,0.25,0.38,-5,1.25,0.88,4.0,2.63,9
Kedah,8,2,1,5,6,16,-10,7,Malaysia - Super League,0.25,0.38,-10,0.75,0.88,4.0,2.63,9
Pahang,8,1,2,5,9,18,-9,5,Malaysia - Super League,0.12,0.38,-9,1.12,0.62,8.33,2.63,10
Kelantan United,8,0,0,8,3,35,-32,0,Malaysia - Super League,0.0,0.0,-32,0.38,0.0,0.0,0.0,11
Mosta,8,5,1,2,11,9,2,16,Malta - Premier League,0.62,0.75,2,1.38,2.0,1.61,1.33,1
Floriana,8,4,3,1,11,7,4,15,Malta - Premier League,0.5,0.88,4,1.38,1.88,2.0,1.14,2
Birkirkara,8,4,2,2,12,5,7,14,Malta - Premier League,0.5,0.75,7,1.5,1.75,2.0,1.33,3
Hibernians,8,4,2,2,13,12,1,14,Malta - Premier League,0.5,0.75,1,1.62,1.75,2.0,1.33,3
Marsaxlokk,8,4,1,3,13,6,7,13,Malta - Premier League,0.5,0.62,7,1.62,1.62,2.0,1.61,4
Sliema,8,4,0,4,13,12,1,12,Malta - Premier League,0.5,0.5,1,1.62,1.5,2.0,2.0,5
Hamrun Spartans,8,3,1,4,7,6,1,10,Malta - Premier League,0.38,0.5,1,0.88,1.25,2.63,2.0,6
Naxxar Lions,8,3,1,4,11,15,-4,10,Malta - Premier League,0.38,0.5,-4,1.38,1.25,2.63,2.0,6
Zabbar,8,2,2,4,10,9,1,8,Malta - Premier League,0.25,0.5,1,1.25,1.0,4.0,2.0,7
Gzira Utd,8,2,2,4,5,13,-8,8,Malta - Premier League,0.25,0.5,-8,0.62,1.0,4.0,2.0,7
Balzan,8,1,4,3,6,8,-2,7,Malta - Premier League,0.12,0.62,-2,0.75,0.88,8.33,1.61,8
Melita,8,1,3,4,10,20,-10,6,Malta - Premier League,0.12,0.5,-10,1.25,0.75,8.33,2.0,9
Cruz Azul,8,6,2,0,20,6,14,20,Mexico - Liga MX - Apertura,0.75,1.0,14,2.5,2.5,1.33,1.0,1
Toluca,8,5,2,1,21,7,14,17,Mexico - Liga MX - Apertura,0.62,0.88,14,2.62,2.12,1.61,1.14,2
A. San Luis,8,5,1,2,12,8,4,16,Mexico - Liga MX - Apertura,0.62,0.75,4,1.5,2.0,1.61,1.33,3
Pumas UNAM,8,4,3,1,8,3,5,15,Mexico - Liga MX - Apertura,0.5,0.88,5,1.0,1.88,2.0,1.14,4
Tijuana,8,4,3,1,10,9,1,15,Mexico - Liga MX - Apertura,0.5,0.88,1,1.25,1.88,2.0,1.14,4
CF America,8,4,2,2,15,10,5,14,Mexico - Liga MX - Apertura,0.5,0.75,5,1.88,1.75,2.0,1.33,5
Tigres,8,4,2,2,13,11,2,14,Mexico - Liga MX - Apertura,0.5,0.75,2,1.62,1.75,2.0,1.33,5
Juarez,8,4,1,3,13,15,-2,13,Mexico - Liga MX - Apertura,0.5,0.62,-2,1.62,1.62,2.0,1.61,6
Monterrey,8,3,3,2,12,7,5,12,Mexico - Liga MX - Apertura,0.38,0.75,5,1.5,1.5,2.63,1.33,7
Club Leon,8,2,5,1,13,9,4,11,Mexico - Liga MX - Apertura,0.25,0.88,4,1.62,1.38,4.0,1.14,8
Guadalajara,8,3,2,3,10,8,2,11,Mexico - Liga MX - Apertura,0.38,0.62,2,1.25,1.38,2.63,1.61,8
Queretaro,8,2,2,4,7,13,-6,8,Mexico - Liga MX - Apertura,0.25,0.5,-6,0.88,1.0,4.0,2.0,9
Atlas,8,1,5,2,6,12,-6,8,Mexico - Liga MX - Apertura,0.12,0.75,-6,0.75,1.0,8.33,1.33,9
Mazatlan,8,1,4,3,4,9,-5,7,Mexico - Liga MX - Apertura,0.12,0.62,-5,0.5,0.88,8.33,1.61,10
Pachuca,8,1,1,6,12,16,-4,4,Mexico - Liga MX - Apertura,0.12,0.25,-4,1.5,0.5,8.33,4.0,11
Necaxa,8,0,3,5,7,18,-11,3,Mexico - Liga MX - Apertura,0.0,0.38,-11,0.88,0.38,0.0,2.63,12
Puebla,8,1,0,7,7,18,-11,3,Mexico - Liga MX - Apertura,0.12,0.12,-11,0.88,0.38,8.33,8.33,12
Santos Laguna,8,0,2,6,4,16,-12,2,Mexico - Liga MX - Apertura,0.0,0.25,-12,0.5,0.25,0.0,4.0,13
Toluca,8,7,0,1,24,9,15,21,Mexico - Liga MX - Clausura,0.88,0.88,15,3.0,2.62,1.14,1.14,1
Necaxa,8,6,0,2,19,12,7,18,Mexico - Liga MX - Clausura,0.75,0.75,7,2.38,2.25,1.33,1.33,2
Cruz Azul,8,5,2,1,12,6,6,17,Mexico - Liga MX - Clausura,0.62,0.88,6,1.5,2.12,1.61,1.14,3
Monterrey,8,5,1,2,19,11,8,16,Mexico - Liga MX - Clausura,0.62,0.75,8,2.38,2.0,1.61,1.33,4
CF America,8,4,2,2,14,6,8,14,Mexico - Liga MX - Clausura,0.5,0.75,8,1.75,1.75,2.0,1.33,5
Pachuca,8,4,2,2,15,11,4,14,Mexico - Liga MX - Clausura,0.5,0.75,4,1.88,1.75,2.0,1.33,5
Tigres,8,4,1,3,8,7,1,13,Mexico - Liga MX - Clausura,0.5,0.62,1,1.0,1.62,2.0,1.61,6
Juarez,8,3,3,2,9,10,-1,12,Mexico - Liga MX - Clausura,0.38,0.75,-1,1.12,1.5,2.63,1.33,7
A. San Luis,8,4,0,4,12,15,-3,12,Mexico - Liga MX - Clausura,0.5,0.5,-3,1.5,1.5,2.0,2.0,7
Club Leon,8,3,2,3,10,10,0,11,Mexico - Liga MX - Clausura,0.38,0.62,0,1.25,1.38,2.63,1.61,8
Atlas,8,3,1,4,14,19,-5,10,Mexico - Liga MX - Clausura,0.38,0.5,-5,1.75,1.25,2.63,2.0,9
Mazatlan,8,2,3,3,9,11,-2,9,Mexico - Liga MX - Clausura,0.25,0.62,-2,1.12,1.12,4.0,1.61,10
Guadalajara,8,2,2,4,7,11,-4,8,Mexico - Liga MX - Clausura,0.25,0.5,-4,0.88,1.0,4.0,2.0,11
Santos Laguna,8,2,1,5,10,15,-5,7,Mexico - Liga MX - Clausura,0.25,0.38,-5,1.25,0.88,4.0,2.63,12
Queretaro,8,2,1,5,6,14,-8,7,Mexico - Liga MX - Clausura,0.25,0.38,-8,0.75,0.88,4.0,2.63,12
Tijuana,8,2,0,6,13,19,-6,6,Mexico - Liga MX - Clausura,0.25,0.25,-6,1.62,0.75,4.0,4.0,13
Pumas UNAM,8,2,0,6,11,17,-6,6,Mexico - Liga MX - Clausura,0.25,0.25,-6,1.38,0.75,4.0,4.0,13
Puebla,8,1,1,6,6,15,-9,4,Mexico - Liga MX - Clausura,0.12,0.25,-9,0.75,0.5,8.33,4.0,14
Buducnost,8,5,3,0,27,13,14,18,Montenegro - First League,0.62,1.0,14,3.38,2.25,1.61,1.0,1
Petrovac,8,4,4,0,15,6,9,16,Montenegro - First League,0.5,1.0,9,1.88,2.0,2.0,1.0,2
Sutjeska,8,5,1,2,11,8,3,16,Montenegro - First League,0.62,0.75,3,1.38,2.0,1.61,1.33,2
Jezero,8,3,1,4,13,13,0,10,Montenegro - First League,0.38,0.5,0,1.62,1.25,2.63,2.0,3
Decic,8,2,3,3,6,7,-1,9,Montenegro - First League,0.25,0.62,-1,0.75,1.12,4.0,1.61,4
Jedinstvo,8,2,3,3,10,12,-2,9,Montenegro - First League,0.25,0.62,-2,1.25,1.12,4.0,1.61,4
Otrant,8,3,0,5,11,14,-3,9,Montenegro - First League,0.38,0.38,-3,1.38,1.12,2.63,2.63,4
Mornar Bar,8,2,3,3,9,13,-4,9,Montenegro - First League,0.25,0.62,-4,1.12,1.12,4.0,1.61,4
Arsenal Tivat,8,3,0,5,6,13,-7,9,Montenegro - First League,0.38,0.38,-7,0.75,1.12,2.63,2.63,4
Bokelj,8,2,0,6,4,13,-9,6,Montenegro - First League,0.25,0.25,-9,0.5,0.75,4.0,4.0,5
Berkane,8,6,2,0,14,2,12,20,morocco,0.75,1.0,12,1.75,2.5,1.33,1.0,1
Wydad,8,4,4,0,14,5,9,16,morocco,0.5,1.0,9,1.75,2.0,2.0,1.0,2
FUS Rabat,8,4,2,2,13,8,5,14,morocco,0.5,0.75,5,1.62,1.75,2.0,1.33,3
FAR Rabat,8,4,2,2,11,9,2,14,morocco,0.5,0.75,2,1.38,1.75,2.0,1.33,3
Raja Casablanca,8,3,4,1,9,6,3,13,morocco,0.38,0.88,3,1.12,1.62,2.63,1.14,4
Union Touarga,8,3,3,2,10,8,2,12,morocco,0.38,0.75,2,1.25,1.5,2.63,1.33,5
Meknes,8,3,3,2,9,7,2,12,morocco,0.38,0.75,2,1.12,1.5,2.63,1.33,5
Difaa El Jadida,8,3,3,2,8,7,1,12,morocco,0.38,0.75,1,1.0,1.5,2.63,1.33,5
Olympic Safi,8,2,5,1,9,8,1,11,morocco,0.25,0.88,1,1.12,1.38,4.0,1.14,6
Maghreb de Fes,8,2,4,2,9,11,-2,10,morocco,0.25,0.75,-2,1.12,1.25,4.0,1.33,7
Ittihad Tanger,8,2,3,3,11,13,-2,9,morocco,0.25,0.62,-2,1.38,1.12,4.0,1.61,8
R. Zemamra,8,3,0,5,7,10,-3,9,morocco,0.38,0.38,-3,0.88,1.12,2.63,2.63,8
Hassania Agadir,8,1,3,4,9,11,-2,6,morocco,0.12,0.5,-2,1.12,0.75,8.33,2.0,9
Moghreb Tetouan,8,1,3,4,7,11,-4,6,morocco,0.12,0.5,-4,0.88,0.75,8.33,2.0,9
JS Sousalem,8,0,2,6,5,17,-12,2,morocco,0.0,0.25,-12,0.62,0.25,0.0,4.0,10
C. Mohammedia,8,0,1,7,4,18,-14,1,morocco,0.0,0.12,-14,0.5,0.12,0.0,8.33,11
Shan Utd,8,7,1,0,24,2,22,22,myanmar,0.88,1.0,22,3.0,2.75,1.14,1.0,1
Yangon Utd,8,5,2,1,21,6,15,17,myanmar,0.62,0.88,15,2.62,2.12,1.61,1.14,2
Sagaing Utd,8,4,2,2,16,13,3,14,myanmar,0.5,0.75,3,2.0,1.75,2.0,1.33,3
Thitsar Arman,8,4,1,3,15,12,3,13,myanmar,0.5,0.62,3,1.88,1.62,2.0,1.61,4
Yadanarbon,8,3,3,2,18,15,3,12,myanmar,0.38,0.75,3,2.25,1.5,2.63,1.33,5
Dagon,8,3,2,3,10,11,-1,11,myanmar,0.38,0.62,-1,1.25,1.38,2.63,1.61,6
Hantharwady,8,3,2,3,7,11,-4,11,myanmar,0.38,0.62,-4,0.88,1.38,2.63,1.61,6
Rakhine Utd,8,3,2,3,10,16,-6,11,myanmar,0.38,0.62,-6,1.25,1.38,2.63,1.61,6
Ayeyawady,8,2,0,6,9,16,-7,6,myanmar,0.25,0.25,-7,1.12,0.75,4.0,4.0,7
Ispe FC,8,1,3,4,4,14,-10,6,myanmar,0.12,0.5,-10,0.5,0.75,8.33,2.0,7
Dagon Port,8,1,2,5,12,21,-9,5,myanmar,0.12,0.38,-9,1.5,0.62,8.33,2.63,8
Myawady,8,1,2,5,11,20,-9,5,myanmar,0.12,0.38,-9,1.38,0.62,8.33,2.63,8
Ajax Amsterdam,8,7,1,0,17,3,14,22,netherlands,0.88,1.0,14,2.12,2.75,1.14,1.0,1
Feyenoord,8,6,2,0,19,6,13,20,netherlands,0.75,1.0,13,2.38,2.5,1.33,1.0,2
Sparta,8,4,2,2,12,6,6,14,netherlands,0.5,0.75,6,1.5,1.75,2.0,1.33,3
Go Ahead Eagles,8,4,1,3,14,15,-1,13,netherlands,0.5,0.62,-1,1.75,1.62,2.0,1.61,4
PSV Eindhoven,8,3,3,2,16,13,3,12,netherlands,0.38,0.75,3,2.0,1.5,2.63,1.33,5
AZ Alkmaar,8,3,3,2,13,11,2,12,netherlands,0.38,0.75,2,1.62,1.5,2.63,1.33,5
FC Utrecht,8,3,3,2,13,11,2,12,netherlands,0.38,0.75,2,1.62,1.5,2.63,1.33,5
FC Twente,8,3,3,2,13,13,0,12,netherlands,0.38,0.75,0,1.62,1.5,2.63,1.33,5
Heracles Almelo,8,3,3,2,12,12,0,12,netherlands,0.38,0.75,0,1.5,1.5,2.63,1.33,5
FC Groningen,8,3,2,3,10,12,-2,11,netherlands,0.38,0.62,-2,1.25,1.38,2.63,1.61,6
Heerenveen,8,2,4,2,14,13,1,10,netherlands,0.25,0.75,1,1.75,1.25,4.0,1.33,7
Almere City,8,2,3,3,9,9,0,9,netherlands,0.25,0.62,0,1.12,1.12,4.0,1.61,8
RKC Waalwijk,8,2,2,4,12,12,0,8,netherlands,0.25,0.5,0,1.5,1.0,4.0,2.0,9
Fortuna Sittard,8,2,2,4,6,11,-5,8,netherlands,0.25,0.5,-5,0.75,1.0,4.0,2.0,9
PEC Zwolle,8,1,4,3,11,14,-3,7,netherlands,0.12,0.62,-3,1.38,0.88,8.33,1.61,10
NEC Nijmegen,8,1,3,4,9,14,-5,6,netherlands,0.12,0.5,-5,1.12,0.75,8.33,2.0,11
NAC Breda,8,0,5,3,5,13,-8,5,netherlands,0.0,0.62,-8,0.62,0.62,0.0,1.61,12
Willem II,8,0,1,7,5,19,-14,1,netherlands,0.0,0.12,-14,0.62,0.12,0.0,8.33,13
FC Volendam,8,8,0,0,23,4,19,24,netherlands2,1.0,1.0,19,2.88,3.0,1.0,1.0,1
ADO Den Haag,8,7,0,1,13,7,6,21,netherlands2,0.88,0.88,6,1.62,2.62,1.14,1.14,2
FC Emmen,8,6,0,2,15,6,9,18,netherlands2,0.75,0.75,9,1.88,2.25,1.33,1.33,3
Excelsior,8,5,2,1,16,8,8,17,netherlands2,0.62,0.88,8,2.0,2.12,1.61,1.14,4
De Graafschap,8,5,1,2,15,8,7,16,netherlands2,0.62,0.75,7,1.88,2.0,1.61,1.33,5
Telstar,8,5,1,2,15,10,5,16,netherlands2,0.62,0.75,5,1.88,2.0,1.61,1.33,5
FC Dordrecht,8,5,0,3,15,10,5,15,netherlands2,0.62,0.62,5,1.88,1.88,1.61,1.61,6
Cambuur,8,4,2,2,14,11,3,14,netherlands2,0.5,0.75,3,1.75,1.75,2.0,1.33,7
Jong AZ,8,3,3,2,17,14,3,12,netherlands2,0.38,0.75,3,2.12,1.5,2.63,1.33,8
Vitesse Arnhem,8,3,2,3,10,10,0,11,netherlands2,0.38,0.62,0,1.25,1.38,2.63,1.61,9
Helmond Sport,8,2,3,3,16,13,3,9,netherlands2,0.25,0.62,3,2.0,1.12,4.0,1.61,10
FC Den Bosch,8,2,2,4,11,13,-2,8,netherlands2,0.25,0.5,-2,1.38,1.0,4.0,2.0,11
Roda JC,8,2,2,4,9,15,-6,8,netherlands2,0.25,0.5,-6,1.12,1.0,4.0,2.0,11
VVV,8,2,2,4,9,17,-8,8,netherlands2,0.25,0.5,-8,1.12,1.0,4.0,2.0,11
FC Eindhoven,8,1,4,3,13,15,-2,7,netherlands2,0.12,0.62,-2,1.62,0.88,8.33,1.61,12
TOP Oss,8,1,4,3,7,14,-7,7,netherlands2,0.12,0.62,-7,0.88,0.88,8.33,1.61,12
Jong Utrecht,8,1,2,5,5,16,-11,5,netherlands2,0.12,0.38,-11,0.62,0.62,8.33,2.63,13
MVV Maastricht,8,1,1,6,5,14,-9,4,netherlands2,0.12,0.25,-9,0.62,0.5,8.33,4.0,14
Jong Ajax,8,1,1,6,4,15,-11,4,netherlands2,0.12,0.25,-11,0.5,0.5,8.33,4.0,14
Jong PSV,8,0,2,6,9,21,-12,2,netherlands2,0.0,0.25,-12,1.12,0.25,0.0,4.0,15
Diriangen,8,7,1,0,29,1,28,22,nicaragua,0.88,1.0,28,3.62,2.75,1.14,1.0,1
Matagalpa,8,6,1,1,16,6,10,19,nicaragua,0.75,0.88,10,2.0,2.38,1.33,1.14,2
Real Esteli,8,4,3,1,13,9,4,15,nicaragua,0.5,0.88,4,1.62,1.88,2.0,1.14,3
Walter Ferreti,8,3,3,2,7,6,1,12,nicaragua,0.38,0.75,1,0.88,1.5,2.63,1.33,4
Managua FC,8,3,1,4,11,10,1,10,nicaragua,0.38,0.5,1,1.38,1.25,2.63,2.0,5
UNAN Managua,8,3,1,4,9,15,-6,10,nicaragua,0.38,0.5,-6,1.12,1.25,2.63,2.0,5
Jalapa,8,2,3,3,6,13,-7,9,nicaragua,0.25,0.62,-7,0.75,1.12,4.0,1.61,6
Export Sebaco,8,2,2,4,9,10,-1,8,nicaragua,0.25,0.5,-1,1.12,1.0,4.0,2.0,7
Rancho Santana,8,1,1,6,6,20,-14,4,nicaragua,0.12,0.25,-14,0.75,0.5,8.33,4.0,8
D. Ocotal,8,1,1,6,6,21,-15,4,nicaragua,0.12,0.25,-15,0.75,0.5,8.33,4.0,8
Real Esteli,8,7,1,0,23,7,16,22,nicaragua2,0.88,1.0,16,2.88,2.75,1.14,1.0,1
Managua FC,8,6,2,0,18,3,15,20,nicaragua2,0.75,1.0,15,2.25,2.5,1.33,1.0,2
Diriangen,8,4,1,3,16,14,2,13,nicaragua2,0.5,0.62,2,2.0,1.62,2.0,1.61,3
Matagalpa,8,3,3,2,19,16,3,12,nicaragua2,0.38,0.75,3,2.38,1.5,2.63,1.33,4
D. Ocotal,8,3,3,2,10,13,-3,12,nicaragua2,0.38,0.75,-3,1.25,1.5,2.63,1.33,4
CS Sebaco,8,3,2,3,9,11,-2,11,nicaragua2,0.38,0.62,-2,1.12,1.38,2.63,1.61,5
Walter Ferreti,8,2,3,3,6,6,0,9,nicaragua2,0.25,0.62,0,0.75,1.12,4.0,1.61,6
UNAN Managua,8,2,2,4,9,17,-8,8,nicaragua2,0.25,0.5,-8,1.12,1.0,4.0,2.0,7
Jalapa,8,1,2,5,8,15,-7,5,nicaragua2,0.12,0.38,-7,1.0,0.62,8.33,2.63,8
Rancho Santana,8,0,2,6,3,16,-13,2,nicaragua2,0.0,0.25,-13,0.38,0.25,0.0,4.0,9
Linfield,8,6,1,1,13,5,8,19,northernireland,0.75,0.88,8,1.62,2.38,1.33,1.14,1
Coleraine,8,5,2,1,11,5,6,17,northernireland,0.62,0.88,6,1.38,2.12,1.61,1.14,2
Crusaders,8,5,1,2,11,8,3,16,northernireland,0.62,0.75,3,1.38,2.0,1.61,1.33,3
Larne,8,4,2,2,11,7,4,14,northernireland,0.5,0.75,4,1.38,1.75,2.0,1.33,4
Cliftonville,8,3,2,3,13,10,3,11,northernireland,0.38,0.62,3,1.62,1.38,2.63,1.61,5
Dungannon,8,3,2,3,8,10,-2,11,northernireland,0.38,0.62,-2,1.0,1.38,2.63,1.61,5
Ballymena Utd,8,3,1,4,10,9,1,10,northernireland,0.38,0.5,1,1.25,1.25,2.63,2.0,6
Glentoran,8,2,4,2,9,10,-1,10,northernireland,0.25,0.75,-1,1.12,1.25,4.0,1.33,6
Portadown,8,2,3,3,7,9,-2,9,northernireland,0.25,0.62,-2,0.88,1.12,4.0,1.61,7
Glenavon,8,2,2,4,9,10,-1,8,northernireland,0.25,0.5,-1,1.12,1.0,4.0,2.0,8
Loughgall,8,1,2,5,5,12,-7,5,northernireland,0.12,0.38,-7,0.62,0.62,8.33,2.63,9
Carrick Rangers,8,1,2,5,2,11,-9,5,northernireland,0.12,0.38,-9,0.25,0.62,8.33,2.63,9
Annagh Utd,8,6,1,1,22,8,14,19,northernireland2,0.75,0.88,14,2.75,2.38,1.33,1.14,1
Bangor,8,4,3,1,18,9,9,15,northernireland2,0.5,0.88,9,2.25,1.88,2.0,1.14,2
Ards,8,4,2,2,14,13,1,14,northernireland2,0.5,0.75,1,1.75,1.75,2.0,1.33,3
HW Welders,8,4,1,3,16,11,5,13,northernireland2,0.5,0.62,5,2.0,1.62,2.0,1.61,4
Limavady,8,3,4,1,12,8,4,13,northernireland2,0.38,0.88,4,1.5,1.62,2.63,1.14,4
Newington,8,3,3,2,17,15,2,12,northernireland2,0.38,0.75,2,2.12,1.5,2.63,1.33,5
Institute,8,3,2,3,13,16,-3,11,northernireland2,0.38,0.62,-3,1.62,1.38,2.63,1.61,6
Newry City,8,2,4,2,12,12,0,10,northernireland2,0.25,0.75,0,1.5,1.25,4.0,1.33,7
Ballinamallard,8,3,1,4,7,7,0,10,northernireland2,0.38,0.5,0,0.88,1.25,2.63,2.0,7
Ballyclare,8,2,2,4,10,15,-5,8,northernireland2,0.25,0.5,-5,1.25,1.0,4.0,2.0,8
Dundela,8,1,3,4,8,13,-5,6,northernireland2,0.12,0.5,-5,1.0,0.75,8.33,2.0,9
Armagh City,8,1,1,6,10,25,-15,4,northernireland2,0.12,0.25,-15,1.25,0.5,8.33,4.0,10
Shkendija,8,6,1,1,12,8,4,19,northmacedonia,0.75,0.88,4,1.5,2.38,1.33,1.14,1
Sileks,8,4,3,1,17,9,8,15,northmacedonia,0.5,0.88,8,2.12,1.88,2.0,1.14,2
Vardar,8,4,3,1,12,5,7,15,northmacedonia,0.5,0.88,7,1.5,1.88,2.0,1.14,2
Rabotnicki,8,3,3,2,4,5,-1,12,northmacedonia,0.38,0.75,-1,0.5,1.5,2.63,1.33,3
Shkupi,8,3,2,3,9,7,2,11,northmacedonia,0.38,0.62,2,1.12,1.38,2.63,1.61,4
Besa,8,3,2,3,8,13,-5,11,northmacedonia,0.38,0.62,-5,1.0,1.38,2.63,1.61,4
Voska Sport,8,3,1,4,9,7,2,10,northmacedonia,0.38,0.5,2,1.12,1.25,2.63,2.0,5
Struga,8,3,1,4,11,10,1,10,northmacedonia,0.38,0.5,1,1.38,1.25,2.63,2.0,5
Pelister,8,3,1,4,7,12,-5,10,northmacedonia,0.38,0.5,-5,0.88,1.25,2.63,2.0,5
Gostivar,8,2,3,3,6,8,-2,9,northmacedonia,0.25,0.62,-2,0.75,1.12,4.0,1.61,6
Tikves,8,2,2,4,6,8,-2,8,northmacedonia,0.25,0.5,-2,0.75,1.0,4.0,2.0,7
Brera Strumica,8,0,2,6,5,14,-9,2,northmacedonia,0.0,0.25,-9,0.62,0.25,0.0,4.0,8
Bodo.Glimt,2,2,0,0,4,0,4,6,norway,1.0,1.0,4,2.0,3.0,1.0,1.0,1
Rosenborg,2,2,0,0,3,1,2,6,norway,1.0,1.0,2,1.5,3.0,1.0,1.0,1
Valerenga,2,1,1,0,4,2,2,4,norway,0.5,1.0,2,2.0,2.0,2.0,1.0,2
Sarpsborg 08,2,1,1,0,3,1,2,4,norway,0.5,1.0,2,1.5,2.0,2.0,1.0,2
Stromsgodset,2,1,0,1,6,2,4,3,norway,0.5,0.5,4,3.0,1.5,2.0,2.0,3
Fredrikstad,2,1,0,1,3,1,2,3,norway,0.5,0.5,2,1.5,1.5,2.0,2.0,3
Sandefjord,2,1,0,1,4,3,1,3,norway,0.5,0.5,1,2.0,1.5,2.0,2.0,3
KFUM Oslo,2,1,0,1,4,4,0,3,norway,0.5,0.5,0,2.0,1.5,2.0,2.0,3
Viking,2,1,0,1,4,4,0,3,norway,0.5,0.5,0,2.0,1.5,2.0,2.0,3
Kristiansund,2,1,0,1,3,3,0,3,norway,0.5,0.5,0,1.5,1.5,2.0,2.0,3
Brann,2,1,0,1,3,4,-1,3,norway,0.5,0.5,-1,1.5,1.5,2.0,2.0,3
Tromso,2,1,0,1,2,3,-1,3,norway,0.5,0.5,-1,1.0,1.5,2.0,2.0,3
HamKam,2,1,0,1,2,4,-2,3,norway,0.5,0.5,-2,1.0,1.5,2.0,2.0,3
Bryne,2,0,0,2,1,3,-2,0,norway,0.0,0.0,-2,0.5,0.0,0.0,0.0,4
Molde,2,0,0,2,0,5,-5,0,norway,0.0,0.0,-5,0.0,0.0,0.0,0.0,4
Haugesund,2,0,0,2,0,6,-6,0,norway,0.0,0.0,-6,0.0,0.0,0.0,0.0,4
Egersund,2,2,0,0,5,2,3,6,norway2,1.0,1.0,3,2.5,3.0,1.0,1.0,1
Start,2,2,0,0,5,2,3,6,norway2,1.0,1.0,3,2.5,3.0,1.0,1.0,1
Kongsvinger,2,1,1,0,3,1,2,4,norway2,0.5,1.0,2,1.5,2.0,2.0,1.0,2
Aalesund,2,1,1,0,6,5,1,4,norway2,0.5,1.0,1,3.0,2.0,2.0,1.0,2
Raufoss,2,1,1,0,4,3,1,4,norway2,0.5,1.0,1,2.0,2.0,2.0,1.0,2
Lillestrom,2,1,1,0,3,2,1,4,norway2,0.5,1.0,1,1.5,2.0,2.0,1.0,2
Stabaek,2,1,1,0,2,1,1,4,norway2,0.5,1.0,1,1.0,2.0,2.0,1.0,2
Lyn,2,1,0,1,3,1,2,3,norway2,0.5,0.5,2,1.5,1.5,2.0,2.0,3
Moss,2,1,0,1,4,3,1,3,norway2,0.5,0.5,1,2.0,1.5,2.0,2.0,3
Odd,2,1,0,1,2,2,0,3,norway2,0.5,0.5,0,1.0,1.5,2.0,2.0,3
Mjondalen,2,0,1,1,3,4,-1,1,norway2,0.0,0.5,-1,1.5,0.5,0.0,2.0,4
Asane,2,0,1,1,1,3,-2,1,norway2,0.0,0.5,-2,0.5,0.5,0.0,2.0,4
Hodd,2,0,1,1,1,3,-2,1,norway2,0.0,0.5,-2,0.5,0.5,0.0,2.0,4
Sogndal,2,0,0,2,4,6,-2,0,norway2,0.0,0.0,-2,2.0,0.0,0.0,0.0,5
Skeid,2,0,0,2,2,5,-3,0,norway2,0.0,0.0,-3,1.0,0.0,0.0,0.0,5
Ranheim,2,0,0,2,0,5,-5,0,norway2,0.0,0.0,-5,0.0,0.0,0.0,0.0,5
Brann B,2,2,0,0,8,6,2,6,norway3,1.0,1.0,2,4.0,3.0,1.0,1.0,1
Sotra,2,1,1,0,6,1,5,4,norway3,0.5,1.0,5,3.0,2.0,2.0,1.0,2
Sandnes Ulf,2,1,1,0,6,4,2,4,norway3,0.5,1.0,2,3.0,2.0,2.0,1.0,2
Jerv,2,1,1,0,3,2,1,4,norway3,0.5,1.0,1,1.5,2.0,2.0,1.0,2
Notodden,2,1,1,0,3,2,1,4,norway3,0.5,1.0,1,1.5,2.0,2.0,1.0,2
Brattvag,2,1,0,1,5,5,0,3,norway3,0.5,0.5,0,2.5,1.5,2.0,2.0,3
Sandviken,2,1,0,1,3,3,0,3,norway3,0.5,0.5,0,1.5,1.5,2.0,2.0,3
Arendal,2,0,2,0,4,4,0,2,norway3,0.0,1.0,0,2.0,1.0,0.0,1.0,4
Pors Grenland,2,0,2,0,2,2,0,2,norway3,0.0,1.0,0,1.0,1.0,0.0,1.0,4
Traef,2,0,1,1,4,5,-1,1,norway3,0.0,0.5,-1,2.0,0.5,0.0,2.0,5
Lysekloster,2,0,1,1,1,2,-1,1,norway3,0.0,0.5,-1,0.5,0.5,0.0,2.0,5
Eik Tonsberg,2,0,1,1,2,4,-2,1,norway3,0.0,0.5,-2,1.0,0.5,0.0,2.0,5
Flekkeroy,2,0,1,1,2,7,-5,1,norway3,0.0,0.5,-5,1.0,0.5,0.0,2.0,5
V. Haugesund,2,0,0,2,2,4,-2,0,norway3,0.0,0.0,-2,1.0,0.0,0.0,0.0,6
Strommen,2,2,0,0,6,2,4,6,norway4,1.0,1.0,4,3.0,3.0,1.0,1.0,1
Tromsdalen,2,1,1,0,4,1,3,4,norway4,0.5,1.0,3,2.0,2.0,2.0,1.0,2
Follo,2,1,1,0,4,3,1,4,norway4,0.5,1.0,1,2.0,2.0,2.0,1.0,2
Honefoss,2,1,0,1,3,1,2,3,norway4,0.5,0.5,2,1.5,1.5,2.0,2.0,3
Eidsvold,2,1,0,1,4,4,0,3,norway4,0.5,0.5,0,2.0,1.5,2.0,2.0,3
Kjelsas,2,1,0,1,3,3,0,3,norway4,0.5,0.5,0,1.5,1.5,2.0,2.0,3
Ull/Kisa,2,1,0,1,3,3,0,3,norway4,0.5,0.5,0,1.5,1.5,2.0,2.0,3
Alta,2,1,0,1,4,5,-1,3,norway4,0.5,0.5,-1,2.0,1.5,2.0,2.0,3
Rana,2,1,0,1,3,4,-1,3,norway4,0.5,0.5,-1,1.5,1.5,2.0,2.0,3
Grorud,2,1,0,1,2,4,-2,3,norway4,0.5,0.5,-2,1.0,1.5,2.0,2.0,3
Stjordals-Blink,2,1,0,1,2,4,-2,3,norway4,0.5,0.5,-2,1.0,1.5,2.0,2.0,3
Asker,2,0,2,0,3,3,0,2,norway4,0.0,1.0,0,1.5,1.0,0.0,1.0,4
Levanger,2,0,0,2,4,6,-2,0,norway4,0.0,0.0,-2,2.0,0.0,0.0,0.0,5
Strindheim,2,0,0,2,2,4,-2,0,norway4,0.0,0.0,-2,1.0,0.0,0.0,0.0,5
Floya,2,2,0,0,7,3,4,6,norway5,1.0,1.0,4,3.5,3.0,1.0,1.0,1
Junkeren,2,2,0,0,6,3,3,6,norway5,1.0,1.0,3,3.0,3.0,1.0,1.0,1
Gamle Oslo,2,1,1,0,7,2,5,4,norway5,0.5,1.0,5,3.5,2.0,2.0,1.0,2
Sortland,2,1,1,0,4,3,1,4,norway5,0.5,1.0,1,2.0,2.0,2.0,1.0,2
Ullern,2,1,0,1,5,3,2,3,norway5,0.5,0.5,2,2.5,1.5,2.0,2.0,3
Tromso B,2,1,0,1,6,5,1,3,norway5,0.5,0.5,1,3.0,1.5,2.0,2.0,3
Ulfstind,2,1,0,1,1,2,-1,3,norway5,0.5,0.5,-1,0.5,1.5,2.0,2.0,3
Harstad,2,1,0,1,5,7,-2,3,norway5,0.5,0.5,-2,2.5,1.5,2.0,2.0,3
Frigg,1,0,1,0,2,2,0,1,norway5,0.0,1.0,0,2.0,1.0,0.0,1.0,4
Funnefoss/V,2,0,1,1,5,7,-2,1,norway5,0.0,0.5,-2,2.5,0.5,0.0,2.0,4
Skjervoy,2,0,1,1,4,7,-3,1,norway5,0.0,0.5,-3,2.0,0.5,0.0,2.0,4
Alta B,2,0,1,1,2,6,-4,1,norway5,0.0,0.5,-4,1.0,0.5,0.0,2.0,4
KFUM B,1,0,0,1,3,5,-2,0,norway5,0.0,0.0,-2,3.0,0.0,0.0,0.0,5
Baerum,2,0,0,2,1,3,-2,0,norway5,0.0,0.0,-2,0.5,0.0,0.0,0.0,5
Melhus,2,2,0,0,8,0,8,6,norway6,1.0,1.0,8,4.0,3.0,1.0,1.0,1
Rosenborg B,2,2,0,0,3,0,3,6,norway6,1.0,1.0,3,1.5,3.0,1.0,1.0,1
Byasen,2,1,1,0,3,0,3,4,norway6,0.5,1.0,3,1.5,2.0,2.0,1.0,2
Nardo,2,1,1,0,5,3,2,4,norway6,0.5,1.0,2,2.5,2.0,2.0,1.0,2
Volda,2,1,1,0,3,1,2,4,norway6,0.5,1.0,2,1.5,2.0,2.0,1.0,2
Trygg/Lade,2,1,0,1,4,1,3,3,norway6,0.5,0.5,3,2.0,1.5,2.0,2.0,3
Spjelkavik,2,1,0,1,7,5,2,3,norway6,0.5,0.5,2,3.5,1.5,2.0,2.0,3
Aalesund B,2,1,0,1,5,5,0,3,norway6,0.5,0.5,0,2.5,1.5,2.0,2.0,3
Ranheim B,2,1,0,1,3,3,0,3,norway6,0.5,0.5,0,1.5,1.5,2.0,2.0,3
Tiller,2,0,2,0,1,1,0,2,norway6,0.0,1.0,0,0.5,1.0,0.0,1.0,4
Kristiansund B,2,0,1,1,1,2,-1,1,norway6,0.0,0.5,-1,0.5,0.5,0.0,2.0,5
Molde B,2,0,0,2,3,7,-4,0,norway6,0.0,0.0,-4,1.5,0.0,0.0,0.0,6
Kvik Trondheim,2,0,0,2,2,7,-5,0,norway6,0.0,0.0,-5,1.0,0.0,0.0,0.0,6
Surnadal,2,0,0,2,1,14,-13,0,norway6,0.0,0.0,-13,0.5,0.0,0.0,0.0,6
Skjetten,2,2,0,0,6,0,6,6,norway7,1.0,1.0,6,3.0,3.0,1.0,1.0,1
Lillehammer,2,1,1,0,8,3,5,4,norway7,0.5,1.0,5,4.0,2.0,2.0,1.0,2
Gjovik-Lyn,2,1,1,0,3,1,2,4,norway7,0.5,1.0,2,1.5,2.0,2.0,1.0,2
Kongsvinger B,2,1,1,0,4,3,1,4,norway7,0.5,1.0,1,2.0,2.0,2.0,1.0,2
Elverum,1,1,0,0,5,1,4,3,norway7,1.0,1.0,4,5.0,3.0,1.0,1.0,3
Lorenskog,2,1,0,1,7,4,3,3,norway7,0.5,0.5,3,3.5,1.5,2.0,2.0,3
Stromsgodset B,2,1,0,1,3,2,1,3,norway7,0.5,0.5,1,1.5,1.5,2.0,2.0,3
Skedsmo,2,1,0,1,6,6,0,3,norway7,0.5,0.5,0,3.0,1.5,2.0,2.0,3
Nordstrand,1,0,1,0,1,1,0,1,norway7,0.0,1.0,0,1.0,1.0,0.0,1.0,4
Assiden IF,2,0,1,1,2,4,-2,1,norway7,0.0,0.5,-2,1.0,0.5,0.0,2.0,4
Bjorkelangen,2,0,1,1,2,6,-4,1,norway7,0.0,0.5,-4,1.0,0.5,0.0,2.0,4
HamKam B,1,0,0,1,1,3,-2,0,norway7,0.0,0.0,-2,1.0,0.0,0.0,0.0,5
Lillestrom B,1,0,0,1,1,5,-4,0,norway7,0.0,0.0,-4,1.0,0.0,0.0,0.0,5
Ull/Kisa B,2,0,0,2,1,11,-10,0,norway7,0.0,0.0,-10,0.5,0.0,0.0,0.0,5
Lyn B,2,2,0,0,9,3,6,6,norway8,1.0,1.0,6,4.5,3.0,1.0,1.0,1
Forde,2,2,0,0,4,1,3,6,norway8,1.0,1.0,3,2.0,3.0,1.0,1.0,1
Fana,2,1,1,0,9,1,8,4,norway8,0.5,1.0,8,4.5,2.0,2.0,1.0,2
Gneist,2,1,1,0,4,3,1,4,norway8,0.5,1.0,1,2.0,2.0,2.0,1.0,2
Bjarg,1,1,0,0,5,0,5,3,norway8,1.0,1.0,5,5.0,3.0,1.0,1.0,3
Fyllingsdalen,2,1,0,1,5,4,1,3,norway8,0.5,0.5,1,2.5,1.5,2.0,2.0,3
Sandefjord B,1,1,0,0,4,3,1,3,norway8,1.0,1.0,1,4.0,3.0,1.0,1.0,3
Asane B,2,1,0,1,6,6,0,3,norway8,0.5,0.5,0,3.0,1.5,2.0,2.0,3
Askoy,2,1,0,1,1,5,-4,3,norway8,0.5,0.5,-4,0.5,1.5,2.0,2.0,3
Loddefjord,2,1,0,1,3,10,-7,3,norway8,0.5,0.5,-7,1.5,1.5,2.0,2.0,3
OS,2,0,0,2,3,5,-2,0,norway8,0.0,0.0,-2,1.5,0.0,0.0,0.0,4
Valerenga B,2,0,0,2,3,5,-2,0,norway8,0.0,0.0,-2,1.5,0.0,0.0,0.0,4
Lyngbo,2,0,0,2,1,4,-3,0,norway8,0.0,0.0,-3,0.5,0.0,0.0,0.0,4
Fjora,2,0,0,2,2,9,-7,0,norway8,0.0,0.0,-7,1.0,0.0,0.0,0.0,4
Vidar,2,2,0,0,4,1,3,6,norway9,1.0,1.0,3,2.0,3.0,1.0,1.0,1
Torvastad,2,1,1,0,6,2,4,4,norway9,0.5,1.0,4,3.0,2.0,2.0,1.0,2
Vindbjart,2,1,1,0,3,2,1,4,norway9,0.5,1.0,1,1.5,2.0,2.0,1.0,2
Sandnes Ulf B,1,1,0,0,5,2,3,3,norway9,1.0,1.0,3,5.0,3.0,1.0,1.0,3
Sola,1,1,0,0,4,1,3,3,norway9,1.0,1.0,3,4.0,3.0,1.0,1.0,3
Hinna,2,1,0,1,7,7,0,3,norway9,0.5,0.5,0,3.5,1.5,2.0,2.0,3
Brodd,2,1,0,1,3,3,0,3,norway9,0.5,0.5,0,1.5,1.5,2.0,2.0,3
Madla,2,0,2,0,2,2,0,2,norway9,0.0,1.0,0,1.0,1.0,0.0,1.0,4
Stord,2,0,2,0,2,2,0,2,norway9,0.0,1.0,0,1.0,1.0,0.0,1.0,4
Viking B,1,0,1,0,1,1,0,1,norway9,0.0,1.0,0,1.0,1.0,0.0,1.0,5
Staal Jorpeland,2,0,1,1,4,5,-1,1,norway9,0.0,0.5,-1,2.0,0.5,0.0,2.0,5
Haugesund B,2,0,0,2,2,6,-4,0,norway9,0.0,0.0,-4,1.0,0.0,0.0,0.0,6
Vag,1,0,0,1,0,4,-4,0,norway9,0.0,0.0,-4,0.0,0.0,0.0,0.0,6
Djerv,2,0,0,2,3,8,-5,0,norway9,0.0,0.0,-5,1.5,0.0,0.0,0.0,6
Stabaek B,2,2,0,0,6,2,4,6,norway10,1.0,1.0,4,3.0,3.0,1.0,1.0,1
Grei,2,1,1,0,3,2,1,4,norway10,0.5,1.0,1,1.5,2.0,2.0,1.0,2
Fram,2,1,0,1,6,3,3,3,norway10,0.5,0.5,3,3.0,1.5,2.0,2.0,3
Flint,2,1,0,1,5,3,2,3,norway10,0.5,0.5,2,2.5,1.5,2.0,2.0,3
Sarpsborg 08 B,1,1,0,0,2,1,1,3,norway10,1.0,1.0,1,2.0,3.0,1.0,1.0,3
Kvik Halden,2,1,0,1,4,4,0,3,norway10,0.5,0.5,0,2.0,1.5,2.0,2.0,3
Fredrikstad B,2,1,0,1,3,3,0,3,norway10,0.5,0.5,0,1.5,1.5,2.0,2.0,3
Oppsal,2,1,0,1,3,3,0,3,norway10,0.5,0.5,0,1.5,1.5,2.0,2.0,3
Pors Grenland B,2,1,0,1,3,3,0,3,norway10,0.5,0.5,0,1.5,1.5,2.0,2.0,3
Lokomotiv Oslo,2,1,0,1,2,5,-3,3,norway10,0.5,0.5,-3,1.0,1.5,2.0,2.0,3
Drobak-Frogn,1,0,1,0,1,1,0,1,norway10,0.0,1.0,0,1.0,1.0,0.0,1.0,4
Odd B,1,0,0,1,1,2,-1,0,norway10,0.0,0.0,-1,1.0,0.0,0.0,0.0,5
IF Ready,1,0,0,1,0,3,-3,0,norway10,0.0,0.0,-3,0.0,0.0,0.0,0.0,5
Orn Horten,2,0,0,2,1,5,-4,0,norway10,0.0,0.0,-4,0.5,0.0,0.0,0.0,5
Plaza Amador,8,5,3,0,15,6,9,18,panama,0.62,1.0,9,1.88,2.25,1.61,1.0,1
Universitario,8,5,2,1,9,5,4,17,panama,0.62,0.88,4,1.12,2.12,1.61,1.14,2
San Francisco,8,4,2,2,11,5,6,14,panama,0.5,0.75,6,1.38,1.75,2.0,1.33,3
Arabe Unido,8,3,3,2,7,6,1,12,panama,0.38,0.75,1,0.88,1.5,2.63,1.33,4
San Miguelito,8,3,2,3,7,9,-2,11,panama,0.38,0.62,-2,0.88,1.38,2.63,1.61,5
Independiente,8,2,4,2,8,5,3,10,panama,0.25,0.75,3,1.0,1.25,4.0,1.33,6
Tauro,8,2,3,3,11,10,1,9,panama,0.25,0.62,1,1.38,1.12,4.0,1.61,7
UMECIT,8,2,3,3,8,10,-2,9,panama,0.25,0.62,-2,1.0,1.12,4.0,1.61,7
Costa del Este,8,2,2,4,7,10,-3,8,panama,0.25,0.5,-3,0.88,1.0,4.0,2.0,8
Veraguas,8,2,2,4,8,15,-7,8,panama,0.25,0.5,-7,1.0,1.0,4.0,2.0,8
Alianza,8,1,4,3,9,12,-3,7,panama,0.12,0.62,-3,1.12,0.88,8.33,1.61,9
Herrera,8,1,3,4,5,10,-5,6,panama,0.12,0.5,-5,0.62,0.75,8.33,2.0,10
San Miguelito,8,5,2,1,8,4,4,17,panama2,0.62,0.88,4,1.0,2.12,1.61,1.14,1
Independiente,8,5,1,2,14,11,3,16,panama2,0.62,0.75,3,1.75,2.0,1.61,1.33,2
Plaza Amador,8,4,3,1,9,6,3,15,panama2,0.5,0.88,3,1.12,1.88,2.0,1.14,3
Tauro,8,4,3,1,9,6,3,15,panama2,0.5,0.88,3,1.12,1.88,2.0,1.14,3
Veraguas,8,3,3,2,11,7,4,12,panama2,0.38,0.75,4,1.38,1.5,2.63,1.33,4
Arabe Unido,8,2,5,1,7,6,1,11,panama2,0.25,0.88,1,0.88,1.38,4.0,1.14,5
Universitario,8,3,2,3,6,5,1,11,panama2,0.38,0.62,1,0.75,1.38,2.63,1.61,5
UMECIT,8,3,1,4,8,8,0,10,panama2,0.38,0.5,0,1.0,1.25,2.63,2.0,6
Costa del Este,8,2,3,3,10,15,-5,9,panama2,0.25,0.62,-5,1.25,1.12,4.0,1.61,7
Alianza,8,2,0,6,8,12,-4,6,panama2,0.25,0.25,-4,1.0,0.75,4.0,4.0,8
San Francisco,8,1,2,5,4,10,-6,5,panama2,0.12,0.38,-6,0.5,0.62,8.33,2.63,9
Herrera,8,1,1,6,4,8,-4,4,panama2,0.12,0.25,-4,0.5,0.5,8.33,4.0,10
Libertad,8,6,2,0,17,4,13,20,paraguay,0.75,1.0,13,2.12,2.5,1.33,1.0,1
Cerro Porteno,8,4,1,3,8,6,2,13,paraguay,0.5,0.62,2,1.0,1.62,2.0,1.61,2
Nacional,8,4,1,3,8,7,1,13,paraguay,0.5,0.62,1,1.0,1.62,2.0,1.61,2
Guarani,8,4,1,3,8,10,-2,13,paraguay,0.5,0.62,-2,1.0,1.62,2.0,1.61,2
D. Recoleta,8,3,3,2,13,10,3,12,paraguay,0.38,0.75,3,1.62,1.5,2.63,1.33,3
Olimpia,8,3,2,3,12,11,1,11,paraguay,0.38,0.62,1,1.5,1.38,2.63,1.61,4
S. Trinidense,8,2,5,1,10,9,1,11,paraguay,0.25,0.88,1,1.25,1.38,4.0,1.14,4
S. Luqueno,8,2,3,3,6,11,-5,9,paraguay,0.25,0.62,-5,0.75,1.12,4.0,1.61,5
S. Ameliano,8,2,2,4,7,10,-3,8,paraguay,0.25,0.5,-3,0.88,1.0,4.0,2.0,6
G. Caballero,8,2,2,4,6,11,-5,8,paraguay,0.25,0.5,-5,0.75,1.0,4.0,2.0,6
A. Tembetary,8,1,3,4,6,9,-3,6,paraguay,0.12,0.5,-3,0.75,0.75,8.33,2.0,7
2 de Mayo,8,0,5,3,5,8,-3,5,paraguay,0.0,0.62,-3,0.62,0.62,0.0,1.61,8
Olimpia,8,4,3,1,10,4,6,15,paraguay2,0.5,0.88,6,1.25,1.88,2.0,1.14,1
Guarani,8,3,5,0,10,7,3,14,paraguay2,0.38,1.0,3,1.25,1.75,2.63,1.0,2
S. Ameliano,8,4,1,3,7,6,1,13,paraguay2,0.5,0.62,1,0.88,1.62,2.0,1.61,3
Sol de America,8,3,3,2,12,9,3,12,paraguay2,0.38,0.75,3,1.5,1.5,2.63,1.33,4
S. Luqueno,8,3,3,2,10,8,2,12,paraguay2,0.38,0.75,2,1.25,1.5,2.63,1.33,4
S. Trinidense,8,3,3,2,10,9,1,12,paraguay2,0.38,0.75,1,1.25,1.5,2.63,1.33,4
2 de Mayo,8,2,4,2,7,5,2,10,paraguay2,0.25,0.75,2,0.88,1.25,4.0,1.33,5
G. Caballero,8,2,3,3,7,7,0,9,paraguay2,0.25,0.62,0,0.88,1.12,4.0,1.61,6
Nacional,8,1,5,2,8,9,-1,8,paraguay2,0.12,0.75,-1,1.0,1.0,8.33,1.33,7
Cerro Porteno,8,2,2,4,11,15,-4,8,paraguay2,0.25,0.5,-4,1.38,1.0,4.0,2.0,7
Libertad,8,2,1,5,8,12,-4,7,paraguay2,0.25,0.38,-4,1.0,0.88,4.0,2.63,8
Tacuary,8,1,3,4,5,14,-9,6,paraguay2,0.12,0.5,-9,0.62,0.75,8.33,2.0,9
FBC Melgar,6,6,0,0,14,3,11,18,peru,1.0,1.0,11,2.33,3.0,1.0,1.0,1
D. Garcilaso,7,5,2,0,16,5,11,17,peru,0.71,1.0,11,2.29,2.43,1.41,1.0,2
Universitario,6,4,2,0,14,5,9,14,peru,0.67,1.0,9,2.33,2.33,1.49,1.0,3
Alianza Lima,7,4,1,2,10,8,2,13,peru,0.57,0.71,2,1.43,1.86,1.75,1.41,4
ADT,7,3,2,2,15,15,0,11,peru,0.43,0.71,0,2.14,1.57,2.33,1.41,5
S. Cristal,7,3,1,3,12,10,2,10,peru,0.43,0.57,2,1.71,1.43,2.33,1.75,6
Cusco,6,3,1,2,11,10,1,10,peru,0.5,0.67,1,1.83,1.67,2.0,1.49,6
Sport Huancayo,7,3,1,3,7,10,-3,10,peru,0.43,0.57,-3,1.0,1.43,2.33,1.75,6
Atletico Grau,6,2,2,2,9,10,-1,8,peru,0.33,0.67,-1,1.5,1.33,3.03,1.49,7
Sport Boys,7,2,2,3,7,12,-5,8,peru,0.29,0.57,-5,1.0,1.14,3.45,1.75,7
Alianza A.,6,2,1,3,11,10,1,7,peru,0.33,0.5,1,1.83,1.17,3.03,2.0,8
Los Chankas,6,1,4,1,8,7,1,7,peru,0.17,0.83,1,1.33,1.17,5.88,1.2,8
Binacional,6,2,1,3,9,12,-3,7,peru,0.33,0.5,-3,1.5,1.17,3.03,2.0,8
Comerciantes U.,6,1,3,2,9,9,0,6,peru,0.17,0.67,0,1.5,1.0,5.88,1.49,9
Cienciano,6,1,3,2,10,11,-1,6,peru,0.17,0.67,-1,1.67,1.0,5.88,1.49,9
Ayacucho,7,1,2,4,8,12,-4,5,peru,0.14,0.43,-4,1.14,0.71,7.14,2.33,10
Cajamarca,6,1,2,3,7,13,-6,5,peru,0.17,0.5,-6,1.17,0.83,5.88,2.0,10
Juan Pablo II C,6,1,0,5,6,11,-5,3,peru,0.17,0.17,-5,1.0,0.5,5.88,5.88,11
A. Huanuco,7,0,2,5,7,17,-10,2,peru,0.0,0.29,-10,1.0,0.29,0.0,3.45,12
Manila Digger,8,6,1,1,25,4,21,19,philippines,0.75,0.88,21,3.12,2.38,1.33,1.14,1
Kaya FC,8,5,1,2,14,7,7,16,philippines,0.62,0.75,7,1.75,2.0,1.61,1.33,2
Davao Aguilas,8,4,2,2,11,3,8,14,philippines,0.5,0.75,8,1.38,1.75,2.0,1.33,3
One Taguig,8,4,2,2,13,7,6,14,philippines,0.5,0.75,6,1.62,1.75,2.0,1.33,3
DH Cebu,8,4,1,3,14,8,6,13,philippines,0.5,0.62,6,1.75,1.62,2.0,1.61,4
Stallion,8,3,2,3,16,12,4,11,philippines,0.38,0.62,4,2.0,1.38,2.63,1.61,5
Maharlika,8,2,1,5,7,13,-6,7,philippines,0.25,0.38,-6,0.88,0.88,4.0,2.63,6
PFF Development,8,1,3,4,9,22,-13,6,philippines,0.12,0.5,-13,1.12,0.75,8.33,2.0,7
Loyola,8,1,1,6,6,16,-10,4,philippines,0.12,0.25,-10,0.75,0.5,8.33,4.0,8
Mendiola,8,1,1,6,6,35,-29,4,philippines,0.12,0.25,-29,0.75,0.5,8.33,4.0,8
Rakow C.,8,6,1,1,14,5,9,19,poland,0.75,0.88,9,1.75,2.38,1.33,1.14,1
Pogon Szczecin,8,5,2,1,19,7,12,17,poland,0.62,0.88,12,2.38,2.12,1.61,1.14,2
Radomiak Radom,8,4,2,2,14,10,4,14,poland,0.5,0.75,4,1.75,1.75,2.0,1.33,3
Jagiellonia,8,4,2,2,11,7,4,14,poland,0.5,0.75,4,1.38,1.75,2.0,1.33,3
Korona Kielce,8,4,2,2,9,8,1,14,poland,0.5,0.75,1,1.12,1.75,2.0,1.33,3
Slask Wroclaw,8,3,3,2,14,10,4,12,poland,0.38,0.75,4,1.75,1.5,2.63,1.33,4
Lech Poznan,8,4,0,4,13,9,4,12,poland,0.5,0.5,4,1.62,1.5,2.0,2.0,4
Legia Warsaw,8,3,2,3,13,12,1,11,poland,0.38,0.62,1,1.62,1.38,2.63,1.61,5
Motor Lublin,8,3,2,3,12,15,-3,11,poland,0.38,0.62,-3,1.5,1.38,2.63,1.61,5
Widzew Lodz,8,3,2,3,7,10,-3,11,poland,0.38,0.62,-3,0.88,1.38,2.63,1.61,5
Cracovia Krakow,8,2,4,2,12,13,-1,10,poland,0.25,0.75,-1,1.5,1.25,4.0,1.33,6
Katowice,8,3,1,4,7,11,-4,10,poland,0.38,0.5,-4,0.88,1.25,2.63,2.0,6
Gornik Zabrze,8,3,0,5,11,12,-1,9,poland,0.38,0.38,-1,1.38,1.12,2.63,2.63,7
Lechia Gdansk,8,3,0,5,8,12,-4,9,poland,0.38,0.38,-4,1.0,1.12,2.63,2.63,7
Piast Gliwice,8,2,3,3,6,10,-4,9,poland,0.25,0.62,-4,0.75,1.12,4.0,1.61,7
Puszcza Niepolo,8,2,1,5,8,12,-4,7,poland,0.25,0.38,-4,1.0,0.88,4.0,2.63,8
Zaglebie Lubin,8,2,1,5,6,12,-6,7,poland,0.25,0.38,-6,0.75,0.88,4.0,2.63,8
Stal Mielec,8,1,2,5,9,18,-9,5,poland,0.12,0.38,-9,1.12,0.62,8.33,2.63,9
Tychy,8,7,0,1,21,6,15,21,poland2,0.88,0.88,15,2.62,2.62,1.14,1.14,1
Polonia Warszaw,8,6,2,0,16,8,8,20,poland2,0.75,1.0,8,2.0,2.5,1.33,1.0,2
Arka Gdynia,8,6,2,0,10,2,8,20,poland2,0.75,1.0,8,1.25,2.5,1.33,1.0,2
Wisla Plock,8,5,2,1,15,5,10,17,poland2,0.62,0.88,10,1.88,2.12,1.61,1.14,3
Wisla Krakow,8,4,2,2,13,7,6,14,poland2,0.5,0.75,6,1.62,1.75,2.0,1.33,4
T. Nieciecza,8,3,4,1,16,15,1,13,poland2,0.38,0.88,1,2.0,1.62,2.63,1.14,5
Znicz Pruszkow,8,3,2,3,9,9,0,11,poland2,0.38,0.62,0,1.12,1.38,2.63,1.61,6
Gornik Leczna,8,3,1,4,11,8,3,10,poland2,0.38,0.5,3,1.38,1.25,2.63,2.0,7
LKS Lodz,8,2,3,3,9,10,-1,9,poland2,0.25,0.62,-1,1.12,1.12,4.0,1.61,8
Chrobry Glogow,8,2,2,4,11,14,-3,8,poland2,0.25,0.5,-3,1.38,1.0,4.0,2.0,9
Miedz Legnica,8,2,2,4,10,14,-4,8,poland2,0.25,0.5,-4,1.25,1.0,4.0,2.0,9
Stal Rzeszow,8,2,2,4,9,15,-6,8,poland2,0.25,0.5,-6,1.12,1.0,4.0,2.0,9
Odra Opole,8,2,2,4,7,17,-10,8,poland2,0.25,0.5,-10,0.88,1.0,4.0,2.0,9
Pogon Siedlce,8,1,4,3,8,11,-3,7,poland2,0.12,0.62,-3,1.0,0.88,8.33,1.61,10
Ruch Chorzow,8,1,3,4,6,14,-8,6,poland2,0.12,0.5,-8,0.75,0.75,8.33,2.0,11
Stalowa Wola,8,0,5,3,5,10,-5,5,poland2,0.0,0.62,-5,0.62,0.62,0.0,1.61,12
K. Kolobrzeg,8,0,4,4,4,11,-7,4,poland2,0.0,0.5,-7,0.5,0.5,0.0,2.0,13
Warta Poznan,8,0,2,6,3,14,-11,2,poland2,0.0,0.25,-11,0.38,0.25,0.0,4.0,14
Pogon Grodzisk,8,6,0,2,13,7,6,18,poland3,0.75,0.75,6,1.62,2.25,1.33,1.33,1
Chojniczanka,8,6,0,2,12,6,6,18,poland3,0.75,0.75,6,1.5,2.25,1.33,1.33,1
Z. Sosnowiec,8,5,1,2,16,10,6,16,poland3,0.62,0.75,6,2.0,2.0,1.61,1.33,2
Wieczysta K.,8,5,0,3,17,9,8,15,poland3,0.62,0.62,8,2.12,1.88,1.61,1.61,3
Polonia Bytom,8,4,3,1,11,7,4,15,poland3,0.5,0.88,4,1.38,1.88,2.0,1.14,3
LKS Lodz B,8,4,2,2,14,9,5,14,poland3,0.5,0.75,5,1.75,1.75,2.0,1.33,4
Zaglebie L. B,8,4,0,4,15,12,3,12,poland3,0.5,0.5,3,1.88,1.5,2.0,2.0,5
Swit Skolwin,8,4,0,4,17,16,1,12,poland3,0.5,0.5,1,2.12,1.5,2.0,2.0,5
Podbeskidzie,8,3,2,3,8,9,-1,11,poland3,0.38,0.62,-1,1.0,1.38,2.63,1.61,6
O. Grudziadz,8,3,2,3,10,13,-3,11,poland3,0.38,0.62,-3,1.25,1.38,2.63,1.61,6
Kalisz,8,3,1,4,11,10,1,10,poland3,0.38,0.5,1,1.38,1.25,2.63,2.0,7
Jastrzebie,8,3,1,4,9,8,1,10,poland3,0.38,0.5,1,1.12,1.25,2.63,2.0,7
Rekord Bielsko,8,2,4,2,10,10,0,10,poland3,0.25,0.75,0,1.25,1.25,4.0,1.33,7
Hutnik Krakow,8,3,1,4,10,15,-5,10,poland3,0.38,0.5,-5,1.25,1.25,2.63,2.0,7
Resovia Rzeszow,8,2,2,4,13,16,-3,8,poland3,0.25,0.5,-3,1.62,1.0,4.0,2.0,8
Olimpia Elblag,8,2,1,5,7,10,-3,7,poland3,0.25,0.38,-3,0.88,0.88,4.0,2.63,9
SKRA Czestochow,8,2,1,5,5,11,-6,7,poland3,0.25,0.38,-6,0.62,0.88,4.0,2.63,9
Wisla Pulawy,8,1,1,6,6,22,-16,4,poland3,0.12,0.25,-16,0.75,0.5,8.33,4.0,10
Benfica,8,8,0,0,23,7,16,24,portugal,1.0,1.0,16,2.88,3.0,1.0,1.0,1
Sporting Braga,8,6,1,1,10,4,6,19,portugal,0.75,0.88,6,1.25,2.38,1.33,1.14,2
Sporting CP,8,5,3,0,20,9,11,18,portugal,0.62,1.0,11,2.5,2.25,1.61,1.0,3
Famalicao,8,5,1,2,13,7,6,16,portugal,0.62,0.75,6,1.62,2.0,1.61,1.33,4
Guimaraes,8,4,4,0,10,4,6,16,portugal,0.5,1.0,6,1.25,2.0,2.0,1.0,4
FC Porto,8,4,2,2,10,8,2,14,portugal,0.5,0.75,2,1.25,1.75,2.0,1.33,5
Estoril,8,3,3,2,14,12,2,12,portugal,0.38,0.75,2,1.75,1.5,2.63,1.33,6
Moreirense,8,3,3,2,11,11,0,12,portugal,0.38,0.75,0,1.38,1.5,2.63,1.33,6
Santa Clara,8,3,2,3,5,6,-1,11,portugal,0.38,0.62,-1,0.62,1.38,2.63,1.61,7
Nacional,8,3,1,4,9,10,-1,10,portugal,0.38,0.5,-1,1.12,1.25,2.63,2.0,8
Casa Pia,8,3,0,5,9,13,-4,9,portugal,0.38,0.38,-4,1.12,1.12,2.63,2.63,9
Estrela Amadora,8,2,3,3,4,8,-4,9,portugal,0.25,0.62,-4,0.5,1.12,4.0,1.61,9
Arouca,8,1,4,3,9,12,-3,7,portugal,0.12,0.62,-3,1.12,0.88,8.33,1.61,10
Rio Ave,8,1,3,4,10,13,-3,6,portugal,0.12,0.5,-3,1.25,0.75,8.33,2.0,11
AVS,8,1,2,5,6,15,-9,5,portugal,0.12,0.38,-9,0.75,0.62,8.33,2.63,12
Gil Vicente,8,1,1,6,4,12,-8,4,portugal,0.12,0.25,-8,0.5,0.5,8.33,4.0,13
Boavista,8,1,0,7,4,14,-10,3,portugal,0.12,0.12,-10,0.5,0.38,8.33,8.33,14
Farense,8,0,2,6,7,15,-8,2,portugal,0.0,0.25,-8,0.88,0.25,0.0,4.0,15
Vizela,8,7,1,0,21,7,14,22,portugal2,0.88,1.0,14,2.62,2.75,1.14,1.0,1
Tondela,8,5,2,1,12,7,5,17,portugal2,0.62,0.88,5,1.5,2.12,1.61,1.14,2
Uniao de Leiria,8,4,3,1,11,8,3,15,portugal2,0.5,0.88,3,1.38,1.88,2.0,1.14,3
Alverca,8,3,4,1,15,8,7,13,portugal2,0.38,0.88,7,1.88,1.62,2.63,1.14,4
Chaves,8,4,1,3,11,7,4,13,portugal2,0.5,0.62,4,1.38,1.62,2.0,1.61,4
Felgueiras,8,3,3,2,5,5,0,12,portugal2,0.38,0.75,0,0.62,1.5,2.63,1.33,5
Maritimo,8,3,3,2,7,9,-2,12,portugal2,0.38,0.75,-2,0.88,1.5,2.63,1.33,5
Feirense,8,4,0,4,9,12,-3,12,portugal2,0.5,0.5,-3,1.12,1.5,2.0,2.0,5
Oliveirense,8,4,0,4,11,16,-5,12,portugal2,0.5,0.5,-5,1.38,1.5,2.0,2.0,5
Academico Viseu,8,2,5,1,9,7,2,11,portugal2,0.25,0.88,2,1.12,1.38,4.0,1.14,6
Torreense,8,3,2,3,17,16,1,11,portugal2,0.38,0.62,1,2.12,1.38,2.63,1.61,6
FC Porto B,8,3,2,3,8,7,1,11,portugal2,0.38,0.62,1,1.0,1.38,2.63,1.61,6
Benfica B,8,2,3,3,6,7,-1,9,portugal2,0.25,0.62,-1,0.75,1.12,4.0,1.61,7
Pacos Ferreira,8,2,1,5,6,10,-4,7,portugal2,0.25,0.38,-4,0.75,0.88,4.0,2.63,8
Penafiel,8,2,0,6,9,11,-2,6,portugal2,0.25,0.25,-2,1.12,0.75,4.0,4.0,9
Leixoes,8,1,3,4,5,8,-3,6,portugal2,0.12,0.5,-3,0.62,0.75,8.33,2.0,9
Mafra,8,1,2,5,4,13,-9,5,portugal2,0.12,0.38,-9,0.5,0.62,8.33,2.63,10
Portimonense,8,1,1,6,8,16,-8,4,portugal2,0.12,0.25,-8,1.0,0.5,8.33,4.0,11
Al Sadd,8,7,0,1,20,3,17,21,qatar,0.88,0.88,17,2.5,2.62,1.14,1.14,1
Al Gharafa,8,5,1,2,14,12,2,16,qatar,0.62,0.75,2,1.75,2.0,1.61,1.33,2
Al Duhail,8,5,1,2,12,10,2,16,qatar,0.62,0.75,2,1.5,2.0,1.61,1.33,2
Al Shamal,8,4,1,3,16,6,10,13,qatar,0.5,0.62,10,2.0,1.62,2.0,1.61,3
Qatar SC,8,3,3,2,11,9,2,12,qatar,0.38,0.75,2,1.38,1.5,2.63,1.33,4
Al Shahaniya,8,4,0,4,11,17,-6,12,qatar,0.5,0.5,-6,1.38,1.5,2.0,2.0,4
Al Rayyan,8,3,2,3,15,9,6,11,qatar,0.38,0.62,6,1.88,1.38,2.63,1.61,5
Al Arabi,8,3,1,4,15,17,-2,10,qatar,0.38,0.5,-2,1.88,1.25,2.63,2.0,6
Al Ahli Doha,8,3,1,4,10,16,-6,10,qatar,0.38,0.5,-6,1.25,1.25,2.63,2.0,6
Al Wakrah,8,3,1,4,9,15,-6,10,qatar,0.38,0.5,-6,1.12,1.25,2.63,2.0,6
Al Khor,8,2,0,6,10,17,-7,6,qatar,0.25,0.25,-7,1.25,0.75,4.0,4.0,7
Umm Salal,8,0,1,7,5,17,-12,1,qatar,0.0,0.12,-12,0.62,0.12,0.0,8.33,8
CFR Cluj,8,5,3,0,19,5,14,18,romania,0.62,1.0,14,2.38,2.25,1.61,1.0,1
FCSB,8,5,3,0,10,2,8,18,romania,0.62,1.0,8,1.25,2.25,1.61,1.0,1
Univ. Craiova,8,5,1,2,11,6,5,16,romania,0.62,0.75,5,1.38,2.0,1.61,1.33,2
Din. Bucharest,8,4,2,2,10,6,4,14,romania,0.5,0.75,4,1.25,1.75,2.0,1.33,3
Rapid Bucharest,8,4,2,2,9,6,3,14,romania,0.5,0.75,3,1.12,1.75,2.0,1.33,3
Hermannstadt,8,4,2,2,9,7,2,14,romania,0.5,0.75,2,1.12,1.75,2.0,1.33,3
U. Cluj,8,3,3,2,9,8,1,12,romania,0.38,0.75,1,1.12,1.5,2.63,1.33,4
Botosani,8,3,3,2,8,7,1,12,romania,0.38,0.75,1,1.0,1.5,2.63,1.33,4
Sepsi OSK,8,3,2,3,8,9,-1,11,romania,0.38,0.62,-1,1.0,1.38,2.63,1.61,5
Farul Constanta,8,3,1,4,8,10,-2,10,romania,0.38,0.5,-2,1.0,1.25,2.63,2.0,6
P. Iasi,8,2,3,3,8,12,-4,9,romania,0.25,0.62,-4,1.0,1.12,4.0,1.61,7
Petrolul,8,2,2,4,6,8,-2,8,romania,0.25,0.5,-2,0.75,1.0,4.0,2.0,8
UTA Arad,8,2,2,4,5,10,-5,8,romania,0.25,0.5,-5,0.62,1.0,4.0,2.0,8
Otelul,8,2,1,5,7,11,-4,7,romania,0.25,0.38,-4,0.88,0.88,4.0,2.63,9
FC Buzau,8,1,1,6,6,16,-10,4,romania,0.12,0.25,-10,0.75,0.5,8.33,4.0,10
Unirea Slobozia,8,0,1,7,4,14,-10,1,romania,0.0,0.12,-10,0.5,0.12,0.0,8.33,11
Spartak Moscow,8,6,1,1,19,5,14,19,russia,0.75,0.88,14,2.38,2.38,1.33,1.14,1
CSKA Moscow,8,5,2,1,12,6,6,17,russia,0.62,0.88,6,1.5,2.12,1.61,1.14,2
Rostov,8,5,1,2,15,10,5,16,russia,0.62,0.75,5,1.88,2.0,1.61,1.33,3
FC Krasnodar,8,4,3,1,13,6,7,15,russia,0.5,0.88,7,1.62,1.88,2.0,1.14,4
Rubin Kazan,8,4,2,2,13,12,1,14,russia,0.5,0.75,1,1.62,1.75,2.0,1.33,5
Dinamo Moscow,8,3,3,2,18,10,8,12,russia,0.38,0.75,8,2.25,1.5,2.63,1.33,6
Zenit,8,3,2,3,12,8,4,11,russia,0.38,0.62,4,1.5,1.38,2.63,1.61,7
Akhmat Grozny,8,2,5,1,7,6,1,11,russia,0.25,0.88,1,0.88,1.38,4.0,1.14,7
Krylya Sovetov,8,3,2,3,13,15,-2,11,russia,0.38,0.62,-2,1.62,1.38,2.63,1.61,7
Khimki,8,3,2,3,11,13,-2,11,russia,0.38,0.62,-2,1.38,1.38,2.63,1.61,7
Makhachkala,8,2,3,3,11,11,0,9,russia,0.25,0.62,0,1.38,1.12,4.0,1.61,8
Akron,8,3,0,5,9,12,-3,9,russia,0.38,0.38,-3,1.12,1.12,2.63,2.63,8
Lokomotiv M.,8,1,4,3,9,17,-8,7,russia,0.12,0.62,-8,1.12,0.88,8.33,1.61,9
Orenburg,8,2,0,6,5,13,-8,6,russia,0.25,0.25,-8,0.62,0.75,4.0,4.0,10
Nizhny Novgorod,8,1,1,6,3,16,-13,4,russia,0.12,0.25,-13,0.38,0.5,8.33,4.0,11
Fakel Voronezh,8,0,3,5,1,11,-10,3,russia,0.0,0.38,-10,0.12,0.38,0.0,2.63,12
Baltika,8,6,2,0,18,2,16,20,russia2,0.75,1.0,16,2.25,2.5,1.33,1.0,1
Chernomorets,8,5,2,1,13,5,8,17,russia2,0.62,0.88,8,1.62,2.12,1.61,1.14,2
PFC Sochi,8,5,1,2,13,8,5,16,russia2,0.62,0.75,5,1.62,2.0,1.61,1.33,3
SKA Khabarovsk,8,5,1,2,6,3,3,16,russia2,0.62,0.75,3,0.75,2.0,1.61,1.33,3
Yenisey,8,4,2,2,7,5,2,14,russia2,0.5,0.75,2,0.88,1.75,2.0,1.33,4
Torpedo Moscow,8,4,2,2,5,4,1,14,russia2,0.5,0.75,1,0.62,1.75,2.0,1.33,4
Shinnik,8,3,4,1,7,5,2,13,russia2,0.38,0.88,2,0.88,1.62,2.63,1.14,5
Ural,8,3,4,1,6,4,2,13,russia2,0.38,0.88,2,0.75,1.62,2.63,1.14,5
Rodina Moskva,8,3,2,3,9,7,2,11,russia2,0.38,0.62,2,1.12,1.38,2.63,1.61,6
Tyumen,8,3,2,3,7,7,0,11,russia2,0.38,0.62,0,0.88,1.38,2.63,1.61,6
Neftekhimik,8,3,1,4,9,8,1,10,russia2,0.38,0.5,1,1.12,1.25,2.63,2.0,7
Rotor Volgograd,8,2,4,2,5,5,0,10,russia2,0.25,0.75,0,0.62,1.25,4.0,1.33,7
Kamaz,8,3,0,5,10,12,-2,9,russia2,0.38,0.38,-2,1.25,1.12,2.63,2.63,8
Arsenal Tula,8,1,3,4,3,7,-4,6,russia2,0.12,0.5,-4,0.38,0.75,8.33,2.0,9
A. Vladikavkaz,8,1,2,5,4,13,-9,5,russia2,0.12,0.38,-9,0.5,0.62,8.33,2.63,10
Chayka,8,0,4,4,4,13,-9,4,russia2,0.0,0.5,-9,0.5,0.5,0.0,2.0,11
Sokol Saratov,8,0,3,5,5,11,-6,3,russia2,0.0,0.38,-6,0.62,0.38,0.0,2.63,12
Ufa,8,0,3,5,5,17,-12,3,russia2,0.0,0.38,-12,0.62,0.38,0.0,2.63,12
Al Shabab,8,5,2,1,24,10,14,17,saudiarabia,0.62,0.88,14,3.0,2.12,1.61,1.14,1
Al Nassr,8,5,1,2,19,11,8,16,saudiarabia,0.62,0.75,8,2.38,2.0,1.61,1.33,2
Al Ittihad,8,4,4,0,17,9,8,16,saudiarabia,0.5,1.0,8,2.12,2.0,2.0,1.0,2
Al Ahli Jeddah,8,4,2,2,18,12,6,14,saudiarabia,0.5,0.75,6,2.25,1.75,2.0,1.33,3
Al Ittifaq,8,4,2,2,11,9,2,14,saudiarabia,0.5,0.75,2,1.38,1.75,2.0,1.33,3
Al Quadisiya,8,4,2,2,11,9,2,14,saudiarabia,0.5,0.75,2,1.38,1.75,2.0,1.33,3
Al Taawon,8,4,1,3,11,8,3,13,saudiarabia,0.5,0.62,3,1.38,1.62,2.0,1.61,4
Al Fateh,8,4,1,3,12,10,2,13,saudiarabia,0.5,0.62,2,1.5,1.62,2.0,1.61,4
Al Orubah,8,4,0,4,11,14,-3,12,saudiarabia,0.5,0.5,-3,1.38,1.5,2.0,2.0,5
Al Kholood,8,4,0,4,10,16,-6,12,saudiarabia,0.5,0.5,-6,1.25,1.5,2.0,2.0,5
Al Hilal,8,3,2,3,16,14,2,11,saudiarabia,0.38,0.62,2,2.0,1.38,2.63,1.61,6
Al Feiha,8,2,4,2,5,6,-1,10,saudiarabia,0.25,0.75,-1,0.62,1.25,4.0,1.33,7
Al Akhdoud,8,2,2,4,5,10,-5,8,saudiarabia,0.25,0.5,-5,0.62,1.0,4.0,2.0,8
Al Wahda,8,2,1,5,9,15,-6,7,saudiarabia,0.25,0.38,-6,1.12,0.88,4.0,2.63,9
Al Riyadh,8,1,3,4,6,10,-4,6,saudiarabia,0.12,0.5,-4,0.75,0.75,8.33,2.0,10
Al Khaleej,8,1,3,4,7,14,-7,6,saudiarabia,0.12,0.5,-7,0.88,0.75,8.33,2.0,10
Damak,8,1,3,4,4,11,-7,6,saudiarabia,0.12,0.5,-7,0.5,0.75,8.33,2.0,10
Al Raed,8,1,1,6,8,16,-8,4,saudiarabia,0.12,0.25,-8,1.0,0.5,8.33,4.0,11
Neom SC,8,7,1,0,17,4,13,22,saudiarabia2,0.88,1.0,13,2.12,2.75,1.14,1.0,1
Al Bukayriyah,8,5,3,0,15,3,12,18,saudiarabia2,0.62,1.0,12,1.88,2.25,1.61,1.0,2
Al Najma,8,5,2,1,14,7,7,17,saudiarabia2,0.62,0.88,7,1.75,2.12,1.61,1.14,3
Al Tai,8,4,2,2,12,9,3,14,saudiarabia2,0.5,0.75,3,1.5,1.75,2.0,1.33,4
Abha,8,3,4,1,14,10,4,13,saudiarabia2,0.38,0.88,4,1.75,1.62,2.63,1.14,5
Al Adalha,8,3,3,2,13,11,2,12,saudiarabia2,0.38,0.75,2,1.62,1.5,2.63,1.33,6
Al Jabalain,8,3,3,2,13,11,2,12,saudiarabia2,0.38,0.75,2,1.62,1.5,2.63,1.33,6
Al Hazm,8,3,3,2,12,10,2,12,saudiarabia2,0.38,0.75,2,1.5,1.5,2.63,1.33,6
Al Zulfi,8,3,3,2,8,6,2,12,saudiarabia2,0.38,0.75,2,1.0,1.5,2.63,1.33,6
Jeddah,8,3,2,3,7,7,0,11,saudiarabia2,0.38,0.62,0,0.88,1.38,2.63,1.61,7
Al Jandal,8,2,3,3,8,8,0,9,saudiarabia2,0.25,0.62,0,1.0,1.12,4.0,1.61,8
Ohod,8,2,1,5,9,12,-3,7,saudiarabia2,0.25,0.38,-3,1.12,0.88,4.0,2.63,9
Al Faisaly,8,1,4,3,6,11,-5,7,saudiarabia2,0.12,0.62,-5,0.75,0.88,8.33,1.61,9
Al Batin,8,1,3,4,6,10,-4,6,saudiarabia2,0.12,0.5,-4,0.75,0.75,8.33,2.0,10
Al Arabi,8,1,2,5,12,17,-5,5,saudiarabia2,0.12,0.38,-5,1.5,0.62,8.33,2.63,11
Al Jubail,8,0,5,3,8,15,-7,5,saudiarabia2,0.0,0.62,-7,1.0,0.62,0.0,1.61,11
Al Ain,8,1,2,5,8,19,-11,5,saudiarabia2,0.12,0.38,-11,1.0,0.62,8.33,2.63,11
Al Safa,8,0,1,7,3,20,-17,1,saudiarabia2,0.0,0.12,-17,0.38,0.12,0.0,8.33,12
Hibernian,8,6,2,0,15,4,11,20,scotland,0.75,1.0,11,1.88,2.5,1.33,1.0,1
Celtic,8,5,0,3,25,9,16,15,scotland,0.62,0.62,16,3.12,1.88,1.61,1.61,2
Rangers,8,5,0,3,19,14,5,15,scotland,0.62,0.62,5,2.38,1.88,1.61,1.61,2
Aberdeen,8,4,2,2,11,11,0,14,scotland,0.5,0.75,0,1.38,1.75,2.0,1.33,3
Hearts,8,4,0,4,15,11,4,12,scotland,0.5,0.5,4,1.88,1.5,2.0,2.0,4
St. Johnstone,8,3,2,3,6,9,-3,11,scotland,0.38,0.62,-3,0.75,1.38,2.63,1.61,5
Kilmarnock,8,3,1,4,10,13,-3,10,scotland,0.38,0.5,-3,1.25,1.25,2.63,2.0,6
Dundee Utd,8,3,1,4,8,13,-5,10,scotland,0.38,0.5,-5,1.0,1.25,2.63,2.0,6
Ross County,8,3,0,5,7,10,-3,9,scotland,0.38,0.38,-3,0.88,1.12,2.63,2.63,7
St. Mirren,8,2,2,4,12,14,-2,8,scotland,0.25,0.5,-2,1.5,1.0,4.0,2.0,8
Dundee FC,8,2,1,5,13,20,-7,7,scotland,0.25,0.38,-7,1.62,0.88,4.0,2.63,9
Motherwell,8,2,1,5,8,17,-9,7,scotland,0.25,0.38,-9,1.0,0.88,4.0,2.63,9
Falkirk,8,6,1,1,19,3,16,19,scotland2,0.75,0.88,16,2.38,2.38,1.33,1.14,1
Livingston,8,4,3,1,13,8,5,15,scotland2,0.5,0.88,5,1.62,1.88,2.0,1.14,2
Airdrieonians,8,4,1,3,14,14,0,13,scotland2,0.5,0.62,0,1.75,1.62,2.0,1.61,3
Raith Rovers,8,3,3,2,9,8,1,12,scotland2,0.38,0.75,1,1.12,1.5,2.63,1.33,4
Partick Thistle,8,3,3,2,8,7,1,12,scotland2,0.38,0.75,1,1.0,1.5,2.63,1.33,4
Ayr Utd,8,3,1,4,13,11,2,10,scotland2,0.38,0.5,2,1.62,1.25,2.63,2.0,5
Greenock Morton,8,3,1,4,12,16,-4,10,scotland2,0.38,0.5,-4,1.5,1.25,2.63,2.0,5
Hamilton,8,2,2,4,6,12,-6,8,scotland2,0.25,0.5,-6,0.75,1.0,4.0,2.0,6
Dunfermline,8,2,1,5,3,9,-6,7,scotland2,0.25,0.38,-6,0.38,0.88,4.0,2.63,7
Queens Park,8,1,1,6,7,19,-12,4,scotland2,0.12,0.25,-12,0.88,0.5,8.33,4.0,8
Arbroath,8,6,2,0,14,6,8,20,scotland3,0.75,1.0,8,1.75,2.5,1.33,1.0,1
Inverness,8,4,2,2,12,8,4,14,scotland3,0.5,0.75,4,1.5,1.75,2.0,1.33,2
Alloa Athletic,8,4,1,3,19,15,4,13,scotland3,0.5,0.62,4,2.38,1.62,2.0,1.61,3
Queen of South,8,4,1,3,13,10,3,13,scotland3,0.5,0.62,3,1.62,1.62,2.0,1.61,3
Montrose,8,3,3,2,12,12,0,12,scotland3,0.38,0.75,0,1.5,1.5,2.63,1.33,4
Cove Rangers,8,3,2,3,12,10,2,11,scotland3,0.38,0.62,2,1.5,1.38,2.63,1.61,5
Stenhousemuir,8,3,2,3,11,12,-1,11,scotland3,0.38,0.62,-1,1.38,1.38,2.63,1.61,5
Dumbarton,8,2,2,4,13,11,2,8,scotland3,0.25,0.5,2,1.62,1.0,4.0,2.0,6
Annan Athletic,8,2,0,6,8,18,-10,6,scotland3,0.25,0.25,-10,1.0,0.75,4.0,4.0,7
Kelty Hearts,8,1,3,4,4,15,-11,6,scotland3,0.12,0.5,-11,0.5,0.75,8.33,2.0,7
Peterhead,8,4,4,0,13,3,10,16,scotland4,0.5,1.0,10,1.62,2.0,2.0,1.0,1
Edinburgh City,8,5,0,3,16,9,7,15,scotland4,0.62,0.62,7,2.0,1.88,1.61,1.61,2
Spartans,8,4,2,2,13,9,4,14,scotland4,0.5,0.75,4,1.62,1.75,2.0,1.33,3
Stirling Albion,8,4,2,2,10,8,2,14,scotland4,0.5,0.75,2,1.25,1.75,2.0,1.33,3
Forfar Athletic,8,4,2,2,6,5,1,14,scotland4,0.5,0.75,1,0.75,1.75,2.0,1.33,3
Stranraer,8,3,1,4,10,7,3,10,scotland4,0.38,0.5,3,1.25,1.25,2.63,2.0,4
Clyde,8,3,1,4,10,12,-2,10,scotland4,0.38,0.5,-2,1.25,1.25,2.63,2.0,4
Elgin City,8,3,0,5,6,10,-4,9,scotland4,0.38,0.38,-4,0.75,1.12,2.63,2.63,5
East Fife,8,2,2,4,9,14,-5,8,scotland4,0.25,0.5,-5,1.12,1.0,4.0,2.0,6
Bonnyrigg Rose,8,0,2,6,4,17,-13,2,scotland4,0.0,0.25,-13,0.5,0.25,0.0,4.0,7
Red Star,8,7,1,0,27,9,18,22,serbia,0.88,1.0,18,3.38,2.75,1.14,1.0,1
Partizan,8,6,2,0,19,7,12,20,serbia,0.75,1.0,12,2.38,2.5,1.33,1.0,2
Novi Pazar,8,4,2,2,11,8,3,14,serbia,0.5,0.75,3,1.38,1.75,2.0,1.33,3
OFK Beograd,8,4,1,3,13,11,2,13,serbia,0.5,0.62,2,1.62,1.62,2.0,1.61,4
Cukaricki,8,3,2,3,8,8,0,11,serbia,0.38,0.62,0,1.0,1.38,2.63,1.61,5
S. Subotica,8,3,2,3,8,8,0,11,serbia,0.38,0.62,0,1.0,1.38,2.63,1.61,5
Radnicki 1923,8,3,2,3,8,9,-1,11,serbia,0.38,0.62,-1,1.0,1.38,2.63,1.61,5
IMT N. Beograd,8,3,2,3,8,11,-3,11,serbia,0.38,0.62,-3,1.0,1.38,2.63,1.61,5
Backa Topola,8,3,1,4,13,16,-3,10,serbia,0.38,0.5,-3,1.62,1.25,2.63,2.0,6
Tekstilac Odzac,8,3,1,4,9,13,-4,10,serbia,0.38,0.5,-4,1.12,1.25,2.63,2.0,6
Z. Pancevo,8,2,3,3,10,11,-1,9,serbia,0.25,0.62,-1,1.25,1.12,4.0,1.61,7
Mladost Lucani,8,2,3,3,7,9,-2,9,serbia,0.25,0.62,-2,0.88,1.12,4.0,1.61,7
Jedinstvo U.,8,2,2,4,10,10,0,8,serbia,0.25,0.5,0,1.25,1.0,4.0,2.0,8
Vojvodina,8,2,2,4,11,14,-3,8,serbia,0.25,0.5,-3,1.38,1.0,4.0,2.0,8
Napredak,8,2,2,4,6,13,-7,8,serbia,0.25,0.5,-7,0.75,1.0,4.0,2.0,8
Radnicki Nis,8,1,2,5,8,17,-9,5,serbia,0.12,0.38,-9,1.0,0.62,8.33,2.63,9
R. Surdulica,8,7,0,1,17,3,14,21,serbia2,0.88,0.88,14,2.12,2.62,1.14,1.14,1
Zemun,8,4,3,1,10,5,5,15,serbia2,0.5,0.88,5,1.25,1.88,2.0,1.14,2
Graficar,8,4,3,1,12,8,4,15,serbia2,0.5,0.88,4,1.5,1.88,2.0,1.14,2
Dubocica,8,4,1,3,14,9,5,13,serbia2,0.5,0.62,5,1.75,1.62,2.0,1.61,3
Sloven Ruma,8,3,4,1,12,9,3,13,serbia2,0.38,0.88,3,1.5,1.62,2.63,1.14,3
S. Mitrovica,8,3,3,2,6,6,0,12,serbia2,0.38,0.75,0,0.75,1.5,2.63,1.33,4
Vozdovac,8,2,5,1,7,6,1,11,serbia2,0.25,0.88,1,0.88,1.38,4.0,1.14,5
Macva Sabac,8,2,5,1,6,5,1,11,serbia2,0.25,0.88,1,0.75,1.38,4.0,1.14,5
Borac Cacak,8,3,2,3,8,9,-1,11,serbia2,0.38,0.62,-1,1.0,1.38,2.63,1.61,5
Trajal Krusevac,8,2,3,3,7,7,0,9,serbia2,0.25,0.62,0,0.88,1.12,4.0,1.61,6
Javor Ivanjica,8,2,3,3,6,9,-3,9,serbia2,0.25,0.62,-3,0.75,1.12,4.0,1.61,6
Smederevo,8,1,4,3,7,9,-2,7,serbia2,0.12,0.62,-2,0.88,0.88,8.33,1.61,7
Mladost,8,1,4,3,3,10,-7,7,serbia2,0.12,0.62,-7,0.38,0.88,8.33,1.61,7
Vrsac,8,1,3,4,2,8,-6,6,serbia2,0.12,0.5,-6,0.25,0.75,8.33,2.0,8
Sloboda Uzice,8,1,2,5,5,12,-7,5,serbia2,0.12,0.38,-7,0.62,0.62,8.33,2.63,9
Indija,8,1,1,6,6,13,-7,4,serbia2,0.12,0.25,-7,0.75,0.5,8.33,4.0,10
Lion City,8,7,1,0,31,6,25,22,singapore,0.88,1.0,25,3.88,2.75,1.14,1.0,1
Tampines Rovers,8,6,0,2,23,8,15,18,singapore,0.75,0.75,15,2.88,2.25,1.33,1.33,2
Hougang,8,4,2,2,21,12,9,14,singapore,0.5,0.75,9,2.62,1.75,2.0,1.33,3
Geylang,8,4,1,3,20,12,8,13,singapore,0.5,0.62,8,2.5,1.62,2.0,1.61,4
A. Niigata (S),8,3,1,4,10,16,-6,10,singapore,0.38,0.5,-6,1.25,1.25,2.63,2.0,5
DPMM FC,8,2,1,5,10,17,-7,7,singapore,0.25,0.38,-7,1.25,0.88,4.0,2.63,6
Khalsa,8,2,1,5,15,26,-11,7,singapore,0.25,0.38,-11,1.88,0.88,4.0,2.63,6
Young Lions,8,1,3,4,9,25,-16,6,singapore,0.12,0.5,-16,1.12,0.75,8.33,2.0,7
Tanjong Pagar,8,1,2,5,9,26,-17,5,singapore,0.12,0.38,-17,1.12,0.62,8.33,2.63,8
FC Kosice,8,5,1,2,17,10,7,16,slovakia,0.62,0.75,7,2.12,2.0,1.61,1.33,1
S. Bratislava,8,4,3,1,19,8,11,15,slovakia,0.5,0.88,11,2.38,1.88,2.0,1.14,2
DAC Streda,8,3,5,0,15,8,7,14,slovakia,0.38,1.0,7,1.88,1.75,2.63,1.0,3
Trencin,8,4,2,2,10,8,2,14,slovakia,0.5,0.75,2,1.25,1.75,2.0,1.33,3
Skalica,8,4,2,2,8,6,2,14,slovakia,0.5,0.75,2,1.0,1.75,2.0,1.33,3
Z. Michalovce,8,3,2,3,11,11,0,11,slovakia,0.38,0.62,0,1.38,1.38,2.63,1.61,4
Komarno,8,3,2,3,6,6,0,11,slovakia,0.38,0.62,0,0.75,1.38,2.63,1.61,4
Spartak Trnava,8,2,4,2,12,11,1,10,slovakia,0.25,0.75,1,1.5,1.25,4.0,1.33,5
Podbrezova,8,1,5,2,9,11,-2,8,slovakia,0.12,0.75,-2,1.12,1.0,8.33,1.33,6
Zilina,8,2,2,4,8,15,-7,8,slovakia,0.25,0.5,-7,1.0,1.0,4.0,2.0,6
Ruzomberok,8,2,0,6,8,17,-9,6,slovakia,0.25,0.25,-9,1.0,0.75,4.0,4.0,7
Banska Bystrica,8,1,0,7,7,19,-12,3,slovakia,0.12,0.12,-12,0.88,0.38,8.33,8.33,8
Presov,8,6,1,1,12,3,9,19,slovakia2,0.75,0.88,9,1.5,2.38,1.33,1.14,1
Zlate Moravce,8,5,2,1,12,4,8,17,slovakia2,0.62,0.88,8,1.5,2.12,1.61,1.14,2
Petrzalka,8,4,3,1,11,5,6,15,slovakia2,0.5,0.88,6,1.38,1.88,2.0,1.14,3
P. Bystrica,8,4,2,2,13,8,5,14,slovakia2,0.5,0.75,5,1.62,1.75,2.0,1.33,4
S. Bratislava B,8,4,2,2,13,10,3,14,slovakia2,0.5,0.75,3,1.62,1.75,2.0,1.33,4
L. Mikulas,8,3,3,2,13,10,3,12,slovakia2,0.38,0.75,3,1.62,1.5,2.63,1.33,5
Zilina B,8,4,0,4,12,12,0,12,slovakia2,0.5,0.5,0,1.5,1.5,2.0,2.0,5
Puchov,8,3,2,3,14,14,0,11,slovakia2,0.38,0.62,0,1.75,1.38,2.63,1.61,6
Zvolen,8,3,1,4,8,8,0,10,slovakia2,0.38,0.5,0,1.0,1.25,2.63,2.0,7
Samorin,8,3,1,4,10,14,-4,10,slovakia2,0.38,0.5,-4,1.25,1.25,2.63,2.0,7
Pohronie,8,3,0,5,9,17,-8,9,slovakia2,0.38,0.38,-8,1.12,1.12,2.63,2.63,8
S. Lubovna,8,2,1,5,8,9,-1,7,slovakia2,0.25,0.38,-1,1.0,0.88,4.0,2.63,9
Malzenice,8,1,1,6,6,14,-8,4,slovakia2,0.12,0.25,-8,0.75,0.5,8.33,4.0,10
Humenne,8,1,1,6,4,18,-14,4,slovakia2,0.12,0.25,-14,0.5,0.5,8.33,4.0,10
NK Olimpija,8,6,0,2,16,5,11,18,slovenia,0.75,0.75,11,2.0,2.25,1.33,1.33,1
Maribor,8,5,0,3,16,9,7,15,slovenia,0.62,0.62,7,2.0,1.88,1.61,1.61,2
NK Celje,8,4,2,2,18,10,8,14,slovenia,0.5,0.75,8,2.25,1.75,2.0,1.33,3
Nafta,8,3,3,2,14,14,0,12,slovenia,0.38,0.75,0,1.75,1.5,2.63,1.33,4
Koper,8,3,2,3,12,12,0,11,slovenia,0.38,0.62,0,1.5,1.38,2.63,1.61,5
Domzale,8,3,1,4,12,12,0,10,slovenia,0.38,0.5,0,1.5,1.25,2.63,2.0,6
Bravo,8,2,3,3,11,15,-4,9,slovenia,0.25,0.62,-4,1.38,1.12,4.0,1.61,7
Mura,8,2,2,4,9,11,-2,8,slovenia,0.25,0.5,-2,1.12,1.0,4.0,2.0,8
Primorje,8,1,4,3,9,13,-4,7,slovenia,0.12,0.62,-4,1.12,0.88,8.33,1.61,9
Radomlje,8,2,1,5,6,22,-16,7,slovenia,0.25,0.38,-16,0.75,0.88,4.0,2.63,9
Mamelodi S.,8,5,1,2,16,8,8,16,southafrica,0.62,0.75,8,2.0,2.0,1.61,1.33,1
Orlando Pirates,8,5,1,2,9,9,0,16,southafrica,0.62,0.75,0,1.12,2.0,1.61,1.33,1
Stellenbosch,8,4,3,1,10,7,3,15,southafrica,0.5,0.88,3,1.25,1.88,2.0,1.14,2
Magesi,8,5,0,3,6,6,0,15,southafrica,0.62,0.62,0,0.75,1.88,1.61,1.61,2
Sekhukhune,8,4,1,3,14,13,1,13,southafrica,0.5,0.62,1,1.75,1.62,2.0,1.61,3
Chippa Utd,8,3,2,3,6,4,2,11,southafrica,0.38,0.62,2,0.75,1.38,2.63,1.61,4
Richards Bay,8,3,2,3,8,7,1,11,southafrica,0.38,0.62,1,1.0,1.38,2.63,1.61,4
TS Galaxy,8,3,2,3,13,13,0,11,southafrica,0.38,0.62,0,1.62,1.38,2.63,1.61,4
Marumo G.,8,3,2,3,8,8,0,11,southafrica,0.38,0.62,0,1.0,1.38,2.63,1.61,4
AmaZulu,8,3,1,4,10,10,0,10,southafrica,0.38,0.5,0,1.25,1.25,2.63,2.0,5
Golden Arrows,8,2,3,3,5,10,-5,9,southafrica,0.25,0.62,-5,0.62,1.12,4.0,1.61,6
Kaizer Chiefs,8,2,2,4,5,10,-5,8,southafrica,0.25,0.5,-5,0.62,1.0,4.0,2.0,7
SuperSport Utd,8,1,4,3,7,10,-3,7,southafrica,0.12,0.62,-3,0.88,0.88,8.33,1.61,8
Royal AM,8,1,2,5,9,13,-4,5,southafrica,0.12,0.38,-4,1.12,0.62,8.33,2.63,9
Polokwane,8,1,2,5,4,9,-5,5,southafrica,0.12,0.38,-5,0.5,0.62,8.33,2.63,9
Cape Town City,8,0,3,5,3,10,-7,3,southafrica,0.0,0.38,-7,0.38,0.38,0.0,2.63,10
Kruger United,8,5,2,1,12,6,6,17,southafrica2,0.62,0.88,6,1.5,2.12,1.61,1.14,1
Casric Stars,8,4,3,1,14,7,7,15,southafrica2,0.5,0.88,7,1.75,1.88,2.0,1.14,2
Durban City,8,4,3,1,7,4,3,15,southafrica2,0.5,0.88,3,0.88,1.88,2.0,1.14,2
Black Leopards,8,3,3,2,12,9,3,12,southafrica2,0.38,0.75,3,1.5,1.5,2.63,1.33,3
Venda FC,8,3,2,3,10,5,5,11,southafrica2,0.38,0.62,5,1.25,1.38,2.63,1.61,4
Orbit College,8,2,5,1,7,6,1,11,southafrica2,0.25,0.88,1,0.88,1.38,4.0,1.14,4
Leruma United,8,2,5,1,6,6,0,11,southafrica2,0.25,0.88,0,0.75,1.38,4.0,1.14,4
Hungry Lions,8,3,1,4,9,8,1,10,southafrica2,0.38,0.5,1,1.12,1.25,2.63,2.0,5
Pretoria U.,8,2,4,2,7,7,0,10,southafrica2,0.25,0.75,0,0.88,1.25,4.0,1.33,5
Cape Town Spurs,8,2,4,2,9,10,-1,10,southafrica2,0.25,0.75,-1,1.12,1.25,4.0,1.33,5
Pretoria C.,8,3,1,4,7,9,-2,10,southafrica2,0.38,0.5,-2,0.88,1.25,2.63,2.0,5
Highbury,8,2,3,3,9,8,1,9,southafrica2,0.25,0.62,1,1.12,1.12,4.0,1.61,6
Baroka,8,2,3,3,9,15,-6,9,southafrica2,0.25,0.62,-6,1.12,1.12,4.0,1.61,6
Milford,8,2,2,4,9,15,-6,8,southafrica2,0.25,0.5,-6,1.12,1.0,4.0,2.0,7
Upington City,8,2,1,5,4,8,-4,7,southafrica2,0.25,0.38,-4,0.5,0.88,4.0,2.63,8
JDR Stars,8,1,4,3,8,13,-5,7,southafrica2,0.12,0.62,-5,1.0,0.88,8.33,1.61,8
Daejeon Citizen,8,5,1,2,13,9,4,16,southkorea,0.62,0.75,4,1.62,2.0,1.61,1.33,1
Gimcheon Sangmu,7,4,2,1,10,5,5,14,southkorea,0.57,0.86,5,1.43,2.0,1.75,1.16,2
Seoul,7,3,3,1,6,5,1,12,southkorea,0.43,0.86,1,0.86,1.71,2.33,1.16,3
Jeonbuk Motors,7,3,2,2,9,7,2,11,southkorea,0.43,0.71,2,1.29,1.57,2.33,1.41,4
Ulsan,8,3,2,3,8,6,2,11,southkorea,0.38,0.62,2,1.0,1.38,2.63,1.61,4
Gwangju,7,2,4,1,8,7,1,10,southkorea,0.29,0.86,1,1.14,1.43,3.45,1.16,5
Anyang,7,3,0,4,7,8,-1,9,southkorea,0.43,0.43,-1,1.0,1.29,2.33,2.33,6
Pohang Steelers,7,2,3,2,8,10,-2,9,southkorea,0.29,0.71,-2,1.14,1.29,3.45,1.41,6
Daegu,7,2,1,4,8,10,-2,7,southkorea,0.29,0.43,-2,1.14,1.0,3.45,2.33,7
Jeju Utd,7,2,1,4,6,9,-3,7,southkorea,0.29,0.43,-3,0.86,1.0,3.45,2.33,7
Gangwon,7,2,1,4,4,7,-3,7,southkorea,0.29,0.43,-3,0.57,1.0,3.45,2.33,7
Suwon City,7,0,4,3,3,7,-4,4,southkorea,0.0,0.57,-4,0.43,0.57,0.0,1.75,8
Seoul E-Land,6,4,1,1,13,7,6,13,southkorea2,0.67,0.83,6,2.17,2.17,1.49,1.2,1
Incheon Utd,6,4,1,1,8,3,5,13,southkorea2,0.67,0.83,5,1.33,2.17,1.49,1.2,1
Seongnam,6,3,3,0,7,3,4,12,southkorea2,0.5,1.0,4,1.17,2.0,2.0,1.0,2
Bucheon FC,6,4,0,2,12,9,3,12,southkorea2,0.67,0.67,3,2.0,2.0,1.49,1.49,2
Jeonnam,6,3,2,1,8,5,3,11,southkorea2,0.5,0.83,3,1.33,1.83,2.0,1.2,3
Suwon Bluewings,6,3,1,2,9,7,2,10,southkorea2,0.5,0.67,2,1.5,1.67,2.0,1.49,4
Gimpo,6,2,2,2,7,5,2,8,southkorea2,0.33,0.67,2,1.17,1.33,3.03,1.49,5
Busan IPark,6,2,2,2,5,4,1,8,southkorea2,0.33,0.67,1,0.83,1.33,3.03,1.49,5
Gyeongnam,6,2,2,2,7,9,-2,8,southkorea2,0.33,0.67,-2,1.17,1.33,3.03,1.49,5
Asan,6,1,3,2,6,6,0,6,southkorea2,0.17,0.67,0,1.0,1.0,5.88,1.49,6
Hwaseong,6,1,3,2,7,9,-2,6,southkorea2,0.17,0.67,-2,1.17,1.0,5.88,1.49,6
Cheongju,6,1,1,4,7,14,-7,4,southkorea2,0.17,0.33,-7,1.17,0.67,5.88,3.03,7
Cheonan City,6,1,0,5,3,11,-8,3,southkorea2,0.17,0.17,-8,0.5,0.5,5.88,5.88,8
Ansan Greeners,6,0,1,5,4,11,-7,1,southkorea2,0.0,0.17,-7,0.67,0.17,0.0,5.88,9
FC Barcelona,8,7,1,0,23,5,18,22,spain,0.88,1.0,18,2.88,2.75,1.14,1.0,1
Real Betis,8,6,1,1,16,9,7,19,spain,0.75,0.88,7,2.0,2.38,1.33,1.14,2
Celta Vigo,8,5,3,0,13,8,5,18,spain,0.62,1.0,5,1.62,2.25,1.61,1.0,3
Getafe,8,5,0,3,13,8,5,15,spain,0.62,0.62,5,1.62,1.88,1.61,1.61,4
Valencia,8,4,3,1,12,10,2,15,spain,0.5,0.88,2,1.5,1.88,2.0,1.14,4
Villarreal,8,4,2,2,12,7,5,14,spain,0.5,0.75,5,1.5,1.75,2.0,1.33,5
Real Madrid,8,4,2,2,13,10,3,14,spain,0.5,0.75,3,1.62,1.75,2.0,1.33,5
Athletic Bilbao,8,3,4,1,13,4,9,13,spain,0.38,0.88,9,1.62,1.62,2.63,1.14,6
Real Sociedad,8,4,1,3,12,13,-1,13,spain,0.5,0.62,-1,1.5,1.62,2.0,1.61,6
Espanyol,8,3,3,2,11,7,4,12,spain,0.38,0.75,4,1.38,1.5,2.63,1.33,7
Atletico Madrid,8,3,3,2,12,10,2,12,spain,0.38,0.75,2,1.5,1.5,2.63,1.33,7
Mallorca,8,2,4,2,10,9,1,10,spain,0.25,0.75,1,1.25,1.25,4.0,1.33,8
Alaves,8,2,3,3,8,10,-2,9,spain,0.25,0.62,-2,1.0,1.12,4.0,1.61,9
Sevilla FC,8,2,2,4,10,11,-1,8,spain,0.25,0.5,-1,1.25,1.0,4.0,2.0,10
Rayo Vallecano,8,2,2,4,7,11,-4,8,spain,0.25,0.5,-4,0.88,1.0,4.0,2.0,10
Osasuna,8,1,4,3,8,12,-4,7,spain,0.12,0.62,-4,1.0,0.88,8.33,1.61,11
Leganes,8,1,1,6,9,17,-8,4,spain,0.12,0.25,-8,1.12,0.5,8.33,4.0,12
Las Palmas,8,0,3,5,7,15,-8,3,spain,0.0,0.38,-8,0.88,0.38,0.0,2.63,13
Girona,8,0,3,5,6,16,-10,3,spain,0.0,0.38,-10,0.75,0.38,0.0,2.63,13
Valladolid,8,0,1,7,4,22,-18,1,spain,0.0,0.12,-18,0.5,0.12,0.0,8.33,14
Levante,8,6,1,1,14,6,8,19,spain2,0.75,0.88,8,1.75,2.38,1.33,1.14,1
Elche,8,5,2,1,13,7,6,17,spain2,0.62,0.88,6,1.62,2.12,1.61,1.14,2
Burgos,8,5,1,2,10,6,4,16,spain2,0.62,0.75,4,1.25,2.0,1.61,1.33,3
Cordoba,8,4,3,1,14,7,7,15,spain2,0.5,0.88,7,1.75,1.88,2.0,1.14,4
Eldense,8,4,2,2,11,8,3,14,spain2,0.5,0.75,3,1.38,1.75,2.0,1.33,5
Albacete,8,4,1,3,12,7,5,13,spain2,0.5,0.62,5,1.5,1.62,2.0,1.61,6
Mirandes,8,4,1,3,13,9,4,13,spain2,0.5,0.62,4,1.62,1.62,2.0,1.61,6
Eibar,8,3,4,1,8,6,2,13,spain2,0.38,0.88,2,1.0,1.62,2.63,1.14,6
Deportivo,8,3,4,1,9,8,1,13,spain2,0.38,0.88,1,1.12,1.62,2.63,1.14,6
Tenerife,8,4,0,4,12,11,1,12,spain2,0.5,0.5,1,1.5,1.5,2.0,2.0,7
Racing,8,3,2,3,13,12,1,11,spain2,0.38,0.62,1,1.62,1.38,2.63,1.61,8
Real Oviedo,8,3,2,3,8,8,0,11,spain2,0.38,0.62,0,1.0,1.38,2.63,1.61,8
Granada,8,3,2,3,11,12,-1,11,spain2,0.38,0.62,-1,1.38,1.38,2.63,1.61,8
Cadiz,8,3,2,3,7,8,-1,11,spain2,0.38,0.62,-1,0.88,1.38,2.63,1.61,8
Castellon,8,2,4,2,13,13,0,10,spain2,0.25,0.75,0,1.62,1.25,4.0,1.33,9
Malaga,8,3,1,4,7,9,-2,10,spain2,0.38,0.5,-2,0.88,1.25,2.63,2.0,9
Almeria,8,2,3,3,11,12,-1,9,spain2,0.25,0.62,-1,1.38,1.12,4.0,1.61,10
Huesca,8,2,2,4,10,12,-2,8,spain2,0.25,0.5,-2,1.25,1.0,4.0,2.0,11
Real Zaragoza,8,1,3,4,8,15,-7,6,spain2,0.12,0.5,-7,1.0,0.75,8.33,2.0,12
Sporting Gijon,8,0,5,3,7,12,-5,5,spain2,0.0,0.62,-5,0.88,0.62,0.0,1.61,13
Cartagena,8,0,2,6,5,14,-9,2,spain2,0.0,0.25,-9,0.62,0.25,0.0,4.0,14
Racing Ferrol,8,0,1,7,2,15,-13,1,spain2,0.0,0.12,-13,0.25,0.12,0.0,8.33,15
Ourense CF,8,6,0,2,10,5,5,18,spain3,0.75,0.75,5,1.25,2.25,1.33,1.33,1
FC Andorra,8,4,3,1,11,8,3,15,spain3,0.5,0.88,3,1.38,1.88,2.0,1.14,2
Zamora,8,4,2,2,8,6,2,14,spain3,0.5,0.75,2,1.0,1.75,2.0,1.33,3
Osasuna B,8,3,4,1,14,12,2,13,spain3,0.38,0.88,2,1.75,1.62,2.63,1.14,4
Ponferradina,8,4,1,3,13,11,2,13,spain3,0.5,0.62,2,1.62,1.62,2.0,1.61,4
Sestao River,8,3,3,2,13,10,3,12,spain3,0.38,0.75,3,1.62,1.5,2.63,1.33,5
Gimnastic T.,8,3,2,3,13,11,2,11,spain3,0.38,0.62,2,1.62,1.38,2.63,1.61,6
Athletic B. B,8,2,5,1,11,9,2,11,spain3,0.25,0.88,2,1.38,1.38,4.0,1.14,6
Leonesa,8,2,5,1,9,8,1,11,spain3,0.25,0.88,1,1.12,1.38,4.0,1.14,6
Celta Vigo B,8,3,2,3,9,10,-1,11,spain3,0.38,0.62,-1,1.12,1.38,2.63,1.61,6
Tarazona,8,2,4,2,8,7,1,10,spain3,0.25,0.75,1,1.0,1.25,4.0,1.33,7
Lugo,8,3,1,4,10,12,-2,10,spain3,0.38,0.5,-2,1.25,1.25,2.63,2.0,7
Unionistas,8,3,1,4,9,11,-2,10,spain3,0.38,0.5,-2,1.12,1.25,2.63,2.0,7
Barakaldo,8,2,3,3,10,10,0,9,spain3,0.25,0.62,0,1.25,1.12,4.0,1.61,8
Amorebieta,8,2,3,3,7,7,0,9,spain3,0.25,0.62,0,0.88,1.12,4.0,1.61,8
Real Sociedad B,8,2,3,3,7,8,-1,9,spain3,0.25,0.62,-1,0.88,1.12,4.0,1.61,8
Gimnastica,8,2,3,3,7,13,-6,9,spain3,0.25,0.62,-6,0.88,1.12,4.0,1.61,8
Arenteiro,8,1,3,4,8,11,-3,6,spain3,0.12,0.5,-3,1.0,0.75,8.33,2.0,9
FC Barcelona B,8,1,2,5,10,15,-5,5,spain3,0.12,0.38,-5,1.25,0.62,8.33,2.63,10
Real Union,8,1,2,5,4,9,-5,5,spain3,0.12,0.38,-5,0.5,0.62,8.33,2.63,10
Ceuta,8,4,4,0,12,5,7,16,spain4,0.5,1.0,7,1.5,2.0,2.0,1.0,1
Alcorcon,8,4,2,2,11,6,5,14,spain4,0.5,0.75,5,1.38,1.75,2.0,1.33,2
UD Ibiza,8,4,2,2,13,9,4,14,spain4,0.5,0.75,4,1.62,1.75,2.0,1.33,2
Real Murcia,8,4,1,3,12,8,4,13,spain4,0.5,0.62,4,1.5,1.62,2.0,1.61,3
Sevilla FC B,8,4,1,3,8,5,3,13,spain4,0.5,0.62,3,1.0,1.62,2.0,1.61,3
Merida,8,4,1,3,12,16,-4,13,spain4,0.5,0.62,-4,1.5,1.62,2.0,1.61,3
Atletico M. B,8,3,3,2,10,7,3,12,spain4,0.38,0.75,3,1.25,1.5,2.63,1.33,4
Algeciras,8,3,3,2,9,8,1,12,spain4,0.38,0.75,1,1.12,1.5,2.63,1.33,4
Hercules,8,3,2,3,12,12,0,11,spain4,0.38,0.62,0,1.5,1.38,2.63,1.61,5
Intercity,8,3,2,3,12,14,-2,11,spain4,0.38,0.62,-2,1.5,1.38,2.63,1.61,5
Villarreal B,8,3,1,4,10,8,2,10,spain4,0.38,0.5,2,1.25,1.25,2.63,2.0,6
Real Madrid B,8,1,7,0,6,5,1,10,spain4,0.12,1.0,1,0.75,1.25,8.33,1.0,6
Antequera,8,2,4,2,12,14,-2,10,spain4,0.25,0.75,-2,1.5,1.25,4.0,1.33,6
Recreativo H.,8,2,4,2,4,7,-3,10,spain4,0.25,0.75,-3,0.5,1.25,4.0,1.33,6
Sanluqueno,8,2,3,3,11,13,-2,9,spain4,0.25,0.62,-2,1.38,1.12,4.0,1.61,7
Marbella,8,2,3,3,8,10,-2,9,spain4,0.25,0.62,-2,1.0,1.12,4.0,1.61,7
Real Betis B,8,2,2,4,9,14,-5,8,spain4,0.25,0.5,-5,1.12,1.0,4.0,2.0,8
Yeclano,8,1,4,3,6,7,-1,7,spain4,0.12,0.62,-1,0.75,0.88,8.33,1.61,9
Fuenlabrada,8,1,3,4,7,9,-2,6,spain4,0.12,0.5,-2,0.88,0.75,8.33,2.0,10
Alcoyano,8,1,2,5,5,12,-7,5,spain4,0.12,0.38,-7,0.62,0.62,8.33,2.63,11
Bergantinos,8,6,1,1,13,6,7,19,spain5,0.75,0.88,7,1.62,2.38,1.33,1.14,1
Rayo Cantabria,8,5,2,1,11,7,4,17,spain5,0.62,0.88,4,1.38,2.12,1.61,1.14,2
Pontevedra,8,5,1,2,9,4,5,16,spain5,0.62,0.75,5,1.12,2.0,1.61,1.33,3
Real Aviles,8,3,5,0,10,5,5,14,spain5,0.38,1.0,5,1.25,1.75,2.63,1.0,4
D. Fabril,8,4,2,2,8,5,3,14,spain5,0.5,0.75,3,1.0,1.75,2.0,1.33,4
Real Avila,8,3,4,1,10,5,5,13,spain5,0.38,0.88,5,1.25,1.62,2.63,1.14,5
Llanera,8,3,4,1,11,8,3,13,spain5,0.38,0.88,3,1.38,1.62,2.63,1.14,5
Langreo,8,3,2,3,8,8,0,11,spain5,0.38,0.62,0,1.0,1.38,2.63,1.61,6
Valladolid B,8,3,1,4,14,12,2,10,spain5,0.38,0.5,2,1.75,1.25,2.63,2.0,7
Coruxo,8,2,3,3,8,8,0,9,spain5,0.25,0.62,0,1.0,1.12,4.0,1.61,8
Escobedo,8,2,3,3,4,5,-1,9,spain5,0.25,0.62,-1,0.5,1.12,4.0,1.61,8
Marino de L.,8,2,3,3,4,6,-2,9,spain5,0.25,0.62,-2,0.5,1.12,4.0,1.61,8
Numancia,8,2,2,4,7,6,1,8,spain5,0.25,0.5,1,0.88,1.0,4.0,2.0,9
Salamanca CF,8,2,1,5,9,11,-2,7,spain5,0.25,0.38,-2,1.12,0.88,4.0,2.63,10
Torrelavega,8,1,4,3,8,11,-3,7,spain5,0.12,0.62,-3,1.0,0.88,8.33,1.61,10
Guijuelo,8,2,1,5,5,14,-9,7,spain5,0.25,0.38,-9,0.62,0.88,4.0,2.63,10
Laredo,8,1,3,4,4,11,-7,6,spain5,0.12,0.5,-7,0.5,0.75,8.33,2.0,11
Compostela,8,1,2,5,4,12,-8,5,spain5,0.12,0.38,-8,0.5,0.62,8.33,2.63,12
SD Logrones,8,6,2,0,16,5,11,20,spain6,0.75,1.0,11,2.0,2.5,1.33,1.0,1
Teruel,8,6,2,0,14,3,11,20,spain6,0.75,1.0,11,1.75,2.5,1.33,1.0,1
Arenas Club,8,5,2,1,11,4,7,17,spain6,0.62,0.88,7,1.38,2.12,1.61,1.14,2
Alaves B,8,5,2,1,10,6,4,17,spain6,0.62,0.88,4,1.25,2.12,1.61,1.14,2
Eibar B,8,4,3,1,13,4,9,15,spain6,0.5,0.88,9,1.62,1.88,2.0,1.14,3
Utebo,8,4,3,1,11,5,6,15,spain6,0.5,0.88,6,1.38,1.88,2.0,1.14,3
Ejea,8,2,5,1,12,9,3,11,spain6,0.25,0.88,3,1.5,1.38,4.0,1.14,4
Calahorra,8,3,2,3,6,9,-3,11,spain6,0.38,0.62,-3,0.75,1.38,2.63,1.61,4
Barbastro,8,3,1,4,7,7,0,10,spain6,0.38,0.5,0,0.88,1.25,2.63,2.0,5
Gernika,8,3,1,4,8,15,-7,10,spain6,0.38,0.5,-7,1.0,1.25,2.63,2.0,5
Tudelano,8,2,3,3,8,9,-1,9,spain6,0.25,0.62,-1,1.0,1.12,4.0,1.61,6
Subiza,8,3,0,5,9,11,-2,9,spain6,0.38,0.38,-2,1.12,1.12,2.63,2.63,6
Real Sociedad C,8,3,0,5,9,12,-3,9,spain6,0.38,0.38,-3,1.12,1.12,2.63,2.63,6
Alfaro,8,2,2,4,4,10,-6,8,spain6,0.25,0.5,-6,0.5,1.0,4.0,2.0,7
Real Zaragoza B,8,2,1,5,6,11,-5,7,spain6,0.25,0.38,-5,0.75,0.88,4.0,2.63,8
UD Logrones,8,1,3,4,5,8,-3,6,spain6,0.12,0.5,-3,0.62,0.75,8.33,2.0,9
Izarra,8,1,0,7,5,12,-7,3,spain6,0.12,0.12,-7,0.62,0.38,8.33,8.33,10
Anguiano,8,1,0,7,6,20,-14,3,spain6,0.12,0.12,-14,0.75,0.38,8.33,8.33,10
A. Baleares,8,6,2,0,12,3,9,20,spain7,0.75,1.0,9,1.5,2.5,1.33,1.0,1
SD Ibiza,8,6,1,1,16,8,8,19,spain7,0.75,0.88,8,2.0,2.38,1.33,1.14,2
Andratx,8,6,0,2,11,10,1,18,spain7,0.75,0.75,1,1.38,2.25,1.33,1.33,3
Europa,8,5,2,1,11,7,4,17,spain7,0.62,0.88,4,1.38,2.12,1.61,1.14,4
Sant Andreu,8,4,3,1,16,7,9,15,spain7,0.5,0.88,9,2.0,1.88,2.0,1.14,5
Olot,8,4,2,2,7,7,0,14,spain7,0.5,0.75,0,0.88,1.75,2.0,1.33,6
Elche B,8,4,1,3,14,9,5,13,spain7,0.5,0.62,5,1.75,1.62,2.0,1.61,7
Sabadell,8,4,1,3,15,11,4,13,spain7,0.5,0.62,4,1.88,1.62,2.0,1.61,7
Valencia B,8,4,1,3,9,6,3,13,spain7,0.5,0.62,3,1.12,1.62,2.0,1.61,7
Espanyol B,8,3,2,3,11,10,1,11,spain7,0.38,0.62,1,1.38,1.38,2.63,1.61,8
Torrent,8,2,4,2,9,8,1,10,spain7,0.25,0.75,1,1.12,1.25,4.0,1.33,9
Lleida,8,2,4,2,6,6,0,10,spain7,0.25,0.75,0,0.75,1.25,4.0,1.33,9
Terrassa,8,3,1,4,6,6,0,10,spain7,0.38,0.5,0,0.75,1.25,2.63,2.0,9
Cornella,8,2,2,4,13,14,-1,8,spain7,0.25,0.5,-1,1.62,1.0,4.0,2.0,10
Pena Deportiva,8,0,4,4,8,15,-7,4,spain7,0.0,0.5,-7,1.0,0.5,0.0,2.0,11
Alzira,8,0,2,6,6,19,-13,2,spain7,0.0,0.25,-13,0.75,0.25,0.0,4.0,12
Mallorca B,8,0,1,7,6,17,-11,1,spain7,0.0,0.12,-11,0.75,0.12,0.0,8.33,13
Badalona,8,0,1,7,2,15,-13,1,spain7,0.0,0.12,-13,0.25,0.12,0.0,8.33,13
La Union,8,6,2,0,10,2,8,20,spain8,0.75,1.0,8,1.25,2.5,1.33,1.0,1
Torremolinos,8,6,1,1,12,5,7,19,spain8,0.75,0.88,7,1.5,2.38,1.33,1.14,2
Antoniano,8,5,1,2,10,8,2,16,spain8,0.62,0.75,2,1.25,2.0,1.61,1.33,3
CD Estepona,8,4,3,1,10,7,3,15,spain8,0.5,0.88,3,1.25,1.88,2.0,1.14,4
Orihuela,8,4,2,2,7,5,2,14,spain8,0.5,0.75,2,0.88,1.75,2.0,1.33,5
Xerez D. FC,8,4,2,2,8,8,0,14,spain8,0.5,0.75,0,1.0,1.75,2.0,1.33,5
Xerez CD,8,4,1,3,10,6,4,13,spain8,0.5,0.62,4,1.25,1.62,2.0,1.61,6
Linares,8,3,2,3,11,8,3,11,spain8,0.38,0.62,3,1.38,1.38,2.63,1.61,7
UCAM Murcia,8,3,2,3,8,5,3,11,spain8,0.38,0.62,3,1.0,1.38,2.63,1.61,7
Almeria B,8,3,2,3,7,8,-1,11,spain8,0.38,0.62,-1,0.88,1.38,2.63,1.61,7
Aguilas CF,8,3,2,3,7,9,-2,11,spain8,0.38,0.62,-2,0.88,1.38,2.63,1.61,7
Villanovense,8,3,1,4,5,6,-1,10,spain8,0.38,0.5,-1,0.62,1.25,2.63,2.0,8
Cadiz B,8,2,3,3,8,8,0,9,spain8,0.25,0.62,0,1.0,1.12,4.0,1.61,9
San Fernando,8,1,4,3,4,6,-2,7,spain8,0.12,0.62,-2,0.5,0.88,8.33,1.61,10
D. Minera,8,2,0,6,10,15,-5,6,spain8,0.25,0.25,-5,1.25,0.75,4.0,4.0,11
Don Benito,8,1,2,5,5,10,-5,5,spain8,0.12,0.38,-5,0.62,0.62,8.33,2.63,12
Granada B,8,1,2,5,6,12,-6,5,spain8,0.12,0.38,-6,0.75,0.62,8.33,2.63,12
Linense,8,0,2,6,2,12,-10,2,spain8,0.0,0.25,-10,0.25,0.25,0.0,4.0,13
Cacereno,8,6,2,0,17,7,10,20,spain9,0.75,1.0,10,2.12,2.5,1.33,1.0,1
Guadalajara,8,5,3,0,10,3,7,18,spain9,0.62,1.0,7,1.25,2.25,1.61,1.0,2
Navalcarnero,8,6,0,2,12,6,6,18,spain9,0.75,0.75,6,1.5,2.25,1.33,1.33,2
CD Coria,8,4,3,1,12,6,6,15,spain9,0.5,0.88,6,1.5,1.88,2.0,1.14,3
Conquense,8,5,0,3,9,7,2,15,spain9,0.62,0.62,2,1.12,1.88,1.61,1.61,3
S. Sebastian R.,8,5,0,3,10,9,1,15,spain9,0.62,0.62,1,1.25,1.88,1.61,1.61,3
Talavera CF,8,3,3,2,12,5,7,12,spain9,0.38,0.75,7,1.5,1.5,2.63,1.33,4
CD Mostoles,8,4,0,4,12,10,2,12,spain9,0.5,0.5,2,1.5,1.5,2.0,2.0,4
Real Madrid C,8,3,3,2,8,7,1,12,spain9,0.38,0.75,1,1.0,1.5,2.63,1.33,4
R. Majadahonda,8,2,3,3,6,7,-1,9,spain9,0.25,0.62,-1,0.75,1.12,4.0,1.61,5
Atletico Paso,8,1,5,2,7,8,-1,8,spain9,0.12,0.75,-1,0.88,1.0,8.33,1.33,6
Melilla,8,2,2,4,5,7,-2,8,spain9,0.25,0.5,-2,0.62,1.0,4.0,2.0,6
Union Adarve,8,2,2,4,3,5,-2,8,spain9,0.25,0.5,-2,0.38,1.0,4.0,2.0,6
Getafe B,8,2,2,4,8,13,-5,8,spain9,0.25,0.5,-5,1.0,1.0,4.0,2.0,6
Yaiza,8,1,3,4,4,11,-7,6,spain9,0.12,0.5,-7,0.5,0.75,8.33,2.0,7
Tenerife B,8,1,2,5,7,14,-7,5,spain9,0.12,0.38,-7,0.88,0.62,8.33,2.63,8
Colonia M.,8,1,2,5,4,14,-10,5,spain9,0.12,0.38,-10,0.5,0.62,8.33,2.63,8
Illescas,8,1,1,6,5,12,-7,4,spain9,0.12,0.25,-7,0.62,0.5,8.33,4.0,9
Degerfors,2,2,0,0,6,0,6,6,sweden,1.0,1.0,6,3.0,3.0,1.0,1.0,1
Hammarby,2,2,0,0,6,0,6,6,sweden,1.0,1.0,6,3.0,3.0,1.0,1.0,1
AIK,2,2,0,0,5,3,2,6,sweden,1.0,1.0,2,2.5,3.0,1.0,1.0,1
Oster,2,1,0,1,5,4,1,3,sweden,0.5,0.5,1,2.5,1.5,2.0,2.0,2
Malmo FF,1,1,0,0,1,0,1,3,sweden,1.0,1.0,1,1.0,3.0,1.0,1.0,2
Norrkoping,2,1,0,1,7,7,0,3,sweden,0.5,0.5,0,3.5,1.5,2.0,2.0,2
Hacken,2,1,0,1,2,2,0,3,sweden,0.5,0.5,0,1.0,1.5,2.0,2.0,2
Sirius,2,1,0,1,2,2,0,3,sweden,0.5,0.5,0,1.0,1.5,2.0,2.0,2
Djurgarden,2,1,0,1,1,1,0,3,sweden,0.5,0.5,0,0.5,1.5,2.0,2.0,2
IFK Goteborg,2,1,0,1,1,4,-3,3,sweden,0.5,0.5,-3,0.5,1.5,2.0,2.0,2
Mjallby,2,0,2,0,3,3,0,2,sweden,0.0,1.0,0,1.5,1.0,0.0,1.0,3
Elfsborg,1,0,1,0,2,2,0,1,sweden,0.0,1.0,0,2.0,1.0,0.0,1.0,4
GAIS,2,0,1,1,1,2,-1,1,sweden,0.0,0.5,-1,0.5,0.5,0.0,2.0,4
Varnamo,2,0,0,2,1,3,-2,0,sweden,0.0,0.0,-2,0.5,0.0,0.0,0.0,5
Brommapojkarna,2,0,0,2,0,4,-4,0,sweden,0.0,0.0,-4,0.0,0.0,0.0,0.0,5
Halmstad,2,0,0,2,0,6,-6,0,sweden,0.0,0.0,-6,0.0,0.0,0.0,0.0,5
Oddevold,2,2,0,0,3,0,3,6,sweden2,1.0,1.0,3,1.5,3.0,1.0,1.0,1
Ostersunds,2,1,1,0,4,3,1,4,sweden2,0.5,1.0,1,2.0,2.0,2.0,1.0,2
Sandviken,2,1,1,0,2,1,1,4,sweden2,0.5,1.0,1,1.0,2.0,2.0,1.0,2
Kalmar,2,1,1,0,1,0,1,4,sweden2,0.5,1.0,1,0.5,2.0,2.0,1.0,2
Vasteras,1,1,0,0,2,0,2,3,sweden2,1.0,1.0,2,2.0,3.0,1.0,1.0,3
GIF Sundsvall,2,1,0,1,2,1,1,3,sweden2,0.5,0.5,1,1.0,1.5,2.0,2.0,3
Orgryte,1,1,0,0,2,1,1,3,sweden2,1.0,1.0,1,2.0,3.0,1.0,1.0,3
Trelleborg,2,1,0,1,1,1,0,3,sweden2,0.5,0.5,0,0.5,1.5,2.0,2.0,3
Landskrona,2,0,2,0,5,5,0,2,sweden2,0.0,1.0,0,2.5,1.0,0.0,1.0,4
Brage,1,0,1,0,2,2,0,1,sweden2,0.0,1.0,0,2.0,1.0,0.0,1.0,5
Falkenberg,1,0,1,0,2,2,0,1,sweden2,0.0,1.0,0,2.0,1.0,0.0,1.0,5
Varberg BoIS,1,0,1,0,2,2,0,1,sweden2,0.0,1.0,0,2.0,1.0,0.0,1.0,5
Orebro,1,0,0,1,0,2,-2,0,sweden2,0.0,0.0,-2,0.0,0.0,0.0,0.0,6
Umea,2,0,0,2,0,2,-2,0,sweden2,0.0,0.0,-2,0.0,0.0,0.0,0.0,6
Helsingborg,2,0,0,2,1,4,-3,0,sweden2,0.0,0.0,-3,0.5,0.0,0.0,0.0,6
Utsikten,2,0,0,2,1,4,-3,0,sweden2,0.0,0.0,-3,0.5,0.0,0.0,0.0,6
BSC Young Boys,8,5,1,2,9,4,5,16,switzerland,0.62,0.75,5,1.12,2.0,1.61,1.33,1
FC Basel,8,4,3,1,13,7,6,15,switzerland,0.5,0.88,6,1.62,1.88,2.0,1.14,2
Servette,8,5,0,3,13,8,5,15,switzerland,0.62,0.62,5,1.62,1.88,1.61,1.61,2
FC Zurich,8,4,2,2,14,11,3,14,switzerland,0.5,0.75,3,1.75,1.75,2.0,1.33,3
Yverdon,8,3,3,2,11,11,0,12,switzerland,0.38,0.75,0,1.38,1.5,2.63,1.33,4
Winterthur,8,3,1,4,10,10,0,10,switzerland,0.38,0.5,0,1.25,1.25,2.63,2.0,5
Luzern,8,2,3,3,13,14,-1,9,switzerland,0.25,0.62,-1,1.62,1.12,4.0,1.61,6
Lausanne Sport,8,2,3,3,10,13,-3,9,switzerland,0.25,0.62,-3,1.25,1.12,4.0,1.61,6
Lugano,8,3,0,5,7,11,-4,9,switzerland,0.38,0.38,-4,0.88,1.12,2.63,2.63,6
Grasshopper,8,2,2,4,11,13,-2,8,switzerland,0.25,0.5,-2,1.38,1.0,4.0,2.0,7
Sion,8,2,2,4,8,12,-4,8,switzerland,0.25,0.5,-4,1.0,1.0,4.0,2.0,7
St. Gallen,8,2,2,4,7,12,-5,8,switzerland,0.25,0.5,-5,0.88,1.0,4.0,2.0,7
Etoile Carouge,8,4,4,0,17,5,12,16,switzerland2,0.5,1.0,12,2.12,2.0,2.0,1.0,1
Aarau,8,4,4,0,14,7,7,16,switzerland2,0.5,1.0,7,1.75,2.0,2.0,1.0,1
Thun,8,4,2,2,12,10,2,14,switzerland2,0.5,0.75,2,1.5,1.75,2.0,1.33,2
Wil,8,4,1,3,15,12,3,13,switzerland2,0.5,0.62,3,1.88,1.62,2.0,1.61,3
Lausanne Ouchy,8,4,1,3,10,9,1,13,switzerland2,0.5,0.62,1,1.25,1.62,2.0,1.61,3
Neuchatel Xamax,8,3,2,3,17,11,6,11,switzerland2,0.38,0.62,6,2.12,1.38,2.63,1.61,4
Vaduz,8,3,2,3,11,8,3,11,switzerland2,0.38,0.62,3,1.38,1.38,2.63,1.61,4
Stade Nyonnais,8,2,1,5,10,15,-5,7,switzerland2,0.25,0.38,-5,1.25,0.88,4.0,2.63,5
Schaffhausen,8,1,2,5,7,20,-13,5,switzerland2,0.12,0.38,-13,0.88,0.62,8.33,2.63,6
Bellinzona,8,0,3,5,3,19,-16,3,switzerland2,0.0,0.38,-16,0.38,0.38,0.0,2.63,7
Bangkok Utd,8,6,2,0,18,7,11,20,thailand,0.75,1.0,11,2.25,2.5,1.33,1.0,1
Pathum Utd,8,6,2,0,12,3,9,20,thailand,0.75,1.0,9,1.5,2.5,1.33,1.0,1
Buriram Utd,8,6,1,1,16,6,10,19,thailand,0.75,0.88,10,2.0,2.38,1.33,1.14,2
Ratchaburi,8,5,1,2,22,12,10,16,thailand,0.62,0.75,10,2.75,2.0,1.61,1.33,3
Lamphun Warrior,8,4,1,3,10,9,1,13,thailand,0.5,0.62,1,1.25,1.62,2.0,1.61,4
Prachuap,8,4,0,4,16,11,5,12,thailand,0.5,0.5,5,2.0,1.5,2.0,2.0,5
Port FC,8,3,3,2,13,11,2,12,thailand,0.38,0.75,2,1.62,1.5,2.63,1.33,5
Chiangrai Utd,8,4,0,4,11,9,2,12,thailand,0.5,0.5,2,1.38,1.5,2.0,2.0,5
Uthai Thani,8,2,4,2,8,5,3,10,thailand,0.25,0.75,3,1.0,1.25,4.0,1.33,6
Rayong,8,2,2,4,11,15,-4,8,thailand,0.25,0.5,-4,1.38,1.0,4.0,2.0,7
Nakhon Pathom,8,2,1,5,7,15,-8,7,thailand,0.25,0.38,-8,0.88,0.88,4.0,2.63,8
Sukhothai,8,1,3,4,8,12,-4,6,thailand,0.12,0.5,-4,1.0,0.75,8.33,2.0,9
N. Bua Pitchaya,8,1,3,4,5,13,-8,6,thailand,0.12,0.5,-8,0.62,0.75,8.33,2.0,9
Muang Thong Utd,8,2,0,6,10,19,-9,6,thailand,0.25,0.25,-9,1.25,0.75,4.0,4.0,9
N. Ratchasima,8,1,3,4,10,19,-9,6,thailand,0.12,0.5,-9,1.25,0.75,8.33,2.0,9
Khon Kaen Utd,8,1,2,5,8,19,-11,5,thailand,0.12,0.38,-11,1.0,0.62,8.33,2.63,10
Chonburi,8,6,0,2,18,9,9,18,thailand2,0.75,0.75,9,2.25,2.25,1.33,1.33,1
Kanchanaburi,8,5,2,1,19,10,9,17,thailand2,0.62,0.88,9,2.38,2.12,1.61,1.14,2
Chanthaburi,8,4,2,2,11,9,2,14,thailand2,0.5,0.75,2,1.38,1.75,2.0,1.33,3
Ayutthaya Utd,8,4,1,3,16,9,7,13,thailand2,0.5,0.62,7,2.0,1.62,2.0,1.61,4
Mahasarakham,8,3,4,1,9,5,4,13,thailand2,0.38,0.88,4,1.12,1.62,2.63,1.14,4
Police Tero,8,4,1,3,12,12,0,13,thailand2,0.5,0.62,0,1.5,1.62,2.0,1.61,4
Phrae Utd,8,3,2,3,17,15,2,11,thailand2,0.38,0.62,2,2.12,1.38,2.63,1.61,5
Kasetsart,8,3,2,3,9,8,1,11,thailand2,0.38,0.62,1,1.12,1.38,2.63,1.61,5
Chainat,8,3,2,3,7,7,0,11,thailand2,0.38,0.62,0,0.88,1.38,2.63,1.61,5
Nakhon Si,8,3,2,3,13,15,-2,11,thailand2,0.38,0.62,-2,1.62,1.38,2.63,1.61,5
Lampang,8,3,1,4,11,12,-1,10,thailand2,0.38,0.5,-1,1.38,1.25,2.63,2.0,6
Chiangmai Utd,8,3,1,4,13,16,-3,10,thailand2,0.38,0.5,-3,1.62,1.25,2.63,2.0,6
Suphanburi,8,1,4,3,13,18,-5,7,thailand2,0.12,0.62,-5,1.62,0.88,8.33,1.61,7
Sisaket Utd,8,2,1,5,7,15,-8,7,thailand2,0.25,0.38,-8,0.88,0.88,4.0,2.63,7
Bangkok FC,8,1,3,4,9,13,-4,6,thailand2,0.12,0.5,-4,1.12,0.75,8.33,2.0,8
Pattaya United,8,1,2,5,5,18,-13,5,thailand2,0.12,0.38,-13,0.62,0.62,8.33,2.63,9
Trat FC,8,1,1,6,8,16,-8,4,thailand2,0.12,0.25,-8,1.0,0.5,8.33,4.0,10
Samut Prakan,0,0,0,0,0,0,0,0,thailand2,0.0,0.0,0,0.0,0.0,0.0,0.0,11
Fenerbahce,8,6,2,0,19,6,13,20,turkey,0.75,1.0,13,2.38,2.5,1.33,1.0,1
Galatasaray,8,5,2,1,16,7,9,17,turkey,0.62,0.88,9,2.0,2.12,1.61,1.14,2
Bodrumspor,8,5,2,1,8,4,4,17,turkey,0.62,0.88,4,1.0,2.12,1.61,1.14,2
Kayserispor,8,5,1,2,15,7,8,16,turkey,0.62,0.75,8,1.88,2.0,1.61,1.33,3
Besiktas,8,5,1,2,13,7,6,16,turkey,0.62,0.75,6,1.62,2.0,1.61,1.33,3
Antalyaspor,8,4,2,2,9,12,-3,14,turkey,0.5,0.75,-3,1.12,1.75,2.0,1.33,4
Kasimpasa,8,4,1,3,17,15,2,13,turkey,0.5,0.62,2,2.12,1.62,2.0,1.61,5
Basaksehir,8,4,1,3,10,8,2,13,turkey,0.5,0.62,2,1.25,1.62,2.0,1.61,5
Gaziantep,8,4,0,4,11,10,1,12,turkey,0.5,0.5,1,1.38,1.5,2.0,2.0,6
Samsunspor,8,3,2,3,11,11,0,11,turkey,0.38,0.62,0,1.38,1.38,2.63,1.61,7
Trabzonspor,8,3,1,4,11,12,-1,10,turkey,0.38,0.5,-1,1.38,1.25,2.63,2.0,8
Konyaspor,8,3,1,4,7,8,-1,10,turkey,0.38,0.5,-1,0.88,1.25,2.63,2.0,8
Hatayspor,8,3,0,5,8,15,-7,9,turkey,0.38,0.38,-7,1.0,1.12,2.63,2.63,9
Sivasspor,8,2,2,4,13,12,1,8,turkey,0.25,0.5,1,1.62,1.0,4.0,2.0,10
Eyupspor,8,2,2,4,8,13,-5,8,turkey,0.25,0.5,-5,1.0,1.0,4.0,2.0,10
Rizespor,8,2,1,5,13,16,-3,7,turkey,0.25,0.38,-3,1.62,0.88,4.0,2.63,11
Goztepe,8,0,4,4,7,12,-5,4,turkey,0.0,0.5,-5,0.88,0.5,0.0,2.0,12
Alanyaspor,8,1,0,7,7,15,-8,3,turkey,0.12,0.12,-8,0.88,0.38,8.33,8.33,13
Adana Demirspor,8,0,2,6,9,22,-13,2,turkey,0.0,0.25,-13,1.12,0.25,0.0,4.0,14
Istanbulspor,8,5,1,2,18,3,15,16,turkey2,0.62,0.75,15,2.25,2.0,1.61,1.33,1
Igdir,8,4,4,0,11,2,9,16,turkey2,0.5,1.0,9,1.38,2.0,2.0,1.0,1
Bandirmaspor,8,4,3,1,10,9,1,15,turkey2,0.5,0.88,1,1.25,1.88,2.0,1.14,2
Genclerbirligi,8,4,2,2,15,11,4,14,turkey2,0.5,0.75,4,1.88,1.75,2.0,1.33,3
F. Karagumruk,8,4,2,2,11,8,3,14,turkey2,0.5,0.75,3,1.38,1.75,2.0,1.33,3
Erzurum BB,8,4,2,2,10,8,2,14,turkey2,0.5,0.75,2,1.25,1.75,2.0,1.33,3
Amed SK,8,3,4,1,10,5,5,13,turkey2,0.38,0.88,5,1.25,1.62,2.63,1.14,4
Kocaelispor,8,2,6,0,11,7,4,12,turkey2,0.25,1.0,4,1.38,1.5,4.0,1.0,5
Boluspor,8,3,3,2,7,4,3,12,turkey2,0.38,0.75,3,0.88,1.5,2.63,1.33,5
Umraniyespor,8,2,5,1,8,4,4,11,turkey2,0.25,0.88,4,1.0,1.38,4.0,1.14,6
Erokspor,8,2,5,1,15,12,3,11,turkey2,0.25,0.88,3,1.88,1.38,4.0,1.14,6
Sanliurfaspor,8,2,3,3,11,11,0,9,turkey2,0.25,0.62,0,1.38,1.12,4.0,1.61,7
Sakaryaspor,8,2,3,3,13,14,-1,9,turkey2,0.25,0.62,-1,1.62,1.12,4.0,1.61,7
Corum,8,2,3,3,11,14,-3,9,turkey2,0.25,0.62,-3,1.38,1.12,4.0,1.61,7
Adanaspor,8,2,2,4,8,10,-2,8,turkey2,0.25,0.5,-2,1.0,1.0,4.0,2.0,8
Keciorengucu,8,2,2,4,13,17,-4,8,turkey2,0.25,0.5,-4,1.62,1.0,4.0,2.0,8
Ankaragucu,8,2,2,4,11,15,-4,8,turkey2,0.25,0.5,-4,1.38,1.0,4.0,2.0,8
Manisa BB,8,2,1,5,10,10,0,7,turkey2,0.25,0.38,0,1.25,0.88,4.0,2.63,9
Pendikspor,8,1,3,4,8,14,-6,6,turkey2,0.12,0.5,-6,1.0,0.75,8.33,2.0,10
Y. Malatyaspor,8,0,0,8,1,34,-33,0,turkey2,0.0,0.0,-33,0.12,0.0,0.0,0.0,11
B. Petrolspor,8,7,1,0,13,2,11,22,turkey3,0.88,1.0,11,1.62,2.75,1.14,1.0,1
Sariyer,8,6,1,1,22,7,15,19,turkey3,0.75,0.88,15,2.75,2.38,1.33,1.14,2
Trabzon FK,8,5,2,1,11,3,8,17,turkey3,0.62,0.88,8,1.38,2.12,1.61,1.14,3
Ankaraspor,8,5,1,2,20,6,14,16,turkey3,0.62,0.75,14,2.5,2.0,1.61,1.33,4
Kastamonuspor,8,4,4,0,12,4,8,16,turkey3,0.5,1.0,8,1.5,2.0,2.0,1.0,4
B. Anadolu,8,4,3,1,13,12,1,15,turkey3,0.5,0.88,1,1.62,1.88,2.0,1.14,5
Adana,8,4,2,2,10,6,4,14,turkey3,0.5,0.75,4,1.25,1.75,2.0,1.33,6
Iskenderun,8,3,2,3,14,13,1,11,turkey3,0.38,0.62,1,1.75,1.38,2.63,1.61,7
Kirklarelispor,8,3,2,3,11,11,0,11,turkey3,0.38,0.62,0,1.38,1.38,2.63,1.61,7
Altinordu,8,3,2,3,9,10,-1,11,turkey3,0.38,0.62,-1,1.12,1.38,2.63,1.61,7
Fethiyespor,8,3,2,3,7,9,-2,11,turkey3,0.38,0.62,-2,0.88,1.38,2.63,1.61,7
Inegolspor,8,2,3,3,12,17,-5,9,turkey3,0.25,0.62,-5,1.5,1.12,4.0,1.61,8
Altay,8,2,1,5,7,15,-8,7,turkey3,0.25,0.38,-8,0.88,0.88,4.0,2.63,9
Isparta Davrazs,8,1,2,5,8,15,-7,5,turkey3,0.12,0.38,-7,1.0,0.62,8.33,2.63,10
Kepez Belediyes,8,1,2,5,7,14,-7,5,turkey3,0.12,0.38,-7,0.88,0.62,8.33,2.63,10
Karakopru,8,1,1,6,6,11,-5,4,turkey3,0.12,0.25,-5,0.75,0.5,8.33,4.0,11
24 Erzincanspor,8,0,2,6,8,21,-13,2,turkey3,0.0,0.25,-13,1.0,0.25,0.0,4.0,12
Afyonspor,8,0,0,8,0,24,-24,0,turkey3,0.0,0.0,-24,0.0,0.0,0.0,0.0,13
Menemen B.,8,5,2,1,14,7,7,17,turkey4,0.62,0.88,7,1.75,2.12,1.61,1.14,1
Beyoglu Yeni C.,8,5,1,2,14,8,6,16,turkey4,0.62,0.75,6,1.75,2.0,1.61,1.33,2
Karacabey,8,5,1,2,14,8,6,16,turkey4,0.62,0.75,6,1.75,2.0,1.61,1.33,2
Yeni Mersin,8,4,3,1,13,4,9,15,turkey4,0.5,0.88,9,1.62,1.88,2.0,1.14,3
Elazigspor,8,5,0,3,16,8,8,15,turkey4,0.62,0.62,8,2.0,1.88,1.61,1.61,3
Van Spor,8,4,3,1,16,11,5,15,turkey4,0.5,0.88,5,2.0,1.88,2.0,1.14,3
Erbaaspor,8,5,0,3,16,12,4,15,turkey4,0.62,0.62,4,2.0,1.88,1.61,1.61,3
Serik Belediyes,8,4,2,2,21,11,10,14,turkey4,0.5,0.75,10,2.62,1.75,2.0,1.33,4
Aksaray B.,8,4,2,2,15,12,3,14,turkey4,0.5,0.75,3,1.88,1.75,2.0,1.33,4
Bucaspor,8,4,1,3,12,13,-1,13,turkey4,0.5,0.62,-1,1.5,1.62,2.0,1.61,5
A. Demirspor,8,2,4,2,12,11,1,10,turkey4,0.25,0.75,1,1.5,1.25,4.0,1.33,6
Arnavutkoy B.,8,3,1,4,12,16,-4,10,turkey4,0.38,0.5,-4,1.5,1.25,2.63,2.0,6
Karaman,8,1,6,1,10,9,1,9,turkey4,0.12,0.88,1,1.25,1.12,8.33,1.14,7
Diyarbekirspor,8,3,0,5,6,11,-5,9,turkey4,0.38,0.38,-5,0.75,1.12,2.63,2.63,7
Somaspor,8,2,1,5,6,7,-1,7,turkey4,0.25,0.38,-1,0.75,0.88,4.0,2.63,8
Derince,8,2,1,5,7,18,-11,7,turkey4,0.25,0.38,-11,0.88,0.88,4.0,2.63,8
Giresunspor,8,0,0,8,6,25,-19,0,turkey4,0.0,0.0,-19,0.75,0.0,0.0,0.0,9
Nazillispor,8,0,0,8,4,23,-19,0,turkey4,0.0,0.0,-19,0.5,0.0,0.0,0.0,9
Karsiyaka,8,6,1,1,21,7,14,19,turkey5,0.75,0.88,14,2.62,2.38,1.33,1.14,1
Musspor,8,6,1,1,17,6,11,19,turkey5,0.75,0.88,11,2.12,2.38,1.33,1.14,1
Bursaspor,8,5,2,1,19,7,12,17,turkey5,0.62,0.88,12,2.38,2.12,1.61,1.14,2
Silifke,8,5,1,2,13,7,6,16,turkey5,0.62,0.75,6,1.62,2.0,1.61,1.33,3
Kutahyaspor,8,5,1,2,15,10,5,16,turkey5,0.62,0.75,5,1.88,2.0,1.61,1.33,3
K. Bulvarspor,8,5,1,2,16,15,1,16,turkey5,0.62,0.75,1,2.0,2.0,1.61,1.33,3
Artvin Hopaspor,8,4,2,2,6,5,1,14,turkey5,0.5,0.75,1,0.75,1.75,2.0,1.33,4
Duzcespor,8,4,1,3,8,9,-1,13,turkey5,0.5,0.62,-1,1.0,1.62,2.0,1.61,5
Anadolu U.,8,4,1,3,10,13,-3,13,turkey5,0.5,0.62,-3,1.25,1.62,2.0,1.61,5
Ergene Velimese,8,3,1,4,6,11,-5,10,turkey5,0.38,0.5,-5,0.75,1.25,2.63,2.0,6
Kahramanmar.,8,2,1,5,10,11,-1,7,turkey5,0.25,0.38,-1,1.25,0.88,4.0,2.63,7
Tokat,8,2,1,5,9,10,-1,7,turkey5,0.25,0.38,-1,1.12,0.88,4.0,2.63,7
Kirsehir B.,8,1,2,5,5,15,-10,5,turkey5,0.12,0.38,-10,0.62,0.62,8.33,2.63,8
Elaziz K.,8,1,1,6,5,11,-6,4,turkey5,0.12,0.25,-6,0.62,0.5,8.33,4.0,9
Kusadasispor,8,1,1,6,4,17,-13,4,turkey5,0.12,0.25,-13,0.5,0.5,8.33,4.0,9
Viven Bornova,8,0,2,6,5,15,-10,2,turkey5,0.0,0.25,-10,0.62,0.25,0.0,4.0,10
Muglaspor,8,6,1,1,15,3,12,19,turkey6,0.75,0.88,12,1.88,2.38,1.33,1.14,1
Tire 2021 FK,8,5,3,0,13,3,10,18,turkey6,0.62,1.0,10,1.62,2.25,1.61,1.0,2
Silivrispor,8,4,3,1,15,6,9,15,turkey6,0.5,0.88,9,1.88,1.88,2.0,1.14,3
Usakspor,8,3,5,0,14,5,9,14,turkey6,0.38,1.0,9,1.75,1.75,2.63,1.0,4
Balikesirspor,8,4,1,3,13,8,5,13,turkey6,0.5,0.62,5,1.62,1.62,2.0,1.61,5
Turk Metal 1963,8,3,3,2,13,11,2,12,turkey6,0.38,0.75,2,1.62,1.5,2.63,1.33,6
Cayelispor,8,2,5,1,6,2,4,11,turkey6,0.25,0.88,4,0.75,1.38,4.0,1.14,7
Beykoz Ishaklis,8,3,2,3,11,11,0,11,turkey6,0.38,0.62,0,1.38,1.38,2.63,1.61,7
Mazidagi,8,2,4,2,8,8,0,10,turkey6,0.25,0.75,0,1.0,1.25,4.0,1.33,8
Kelkit,8,2,3,3,9,10,-1,9,turkey6,0.25,0.62,-1,1.12,1.12,4.0,1.61,9
Inegol Kafkas,8,2,3,3,7,8,-1,9,turkey6,0.25,0.62,-1,0.88,1.12,4.0,1.61,9
Amasyaspor,8,2,2,4,12,11,1,8,turkey6,0.25,0.5,1,1.5,1.0,4.0,2.0,10
Fatsa B.,8,2,2,4,5,12,-7,8,turkey6,0.25,0.5,-7,0.62,1.0,4.0,2.0,10
Etimesgut,8,1,4,3,5,10,-5,7,turkey6,0.12,0.62,-5,0.62,0.88,8.33,1.61,11
Nevsehirspor,8,0,3,5,5,20,-15,3,turkey6,0.0,0.38,-15,0.62,0.38,0.0,2.63,12
Adiyaman,8,0,0,8,0,25,-25,0,turkey6,0.0,0.0,-25,0.0,0.0,0.0,0.0,13
Aliaga FAS,8,7,1,0,16,4,12,22,turkey7,0.88,1.0,12,2.0,2.75,1.14,1.0,1
Ayvalikgucu,8,6,2,0,13,5,8,20,turkey7,0.75,1.0,8,1.62,2.5,1.33,1.0,2
Corluspor,8,5,1,2,16,8,8,16,turkey7,0.62,0.75,8,2.0,2.0,1.61,1.33,3
Yozgat Bld Bozo,8,5,0,3,16,13,3,15,turkey7,0.62,0.62,3,2.0,1.88,1.61,1.61,4
Orduspor,8,4,2,2,18,7,11,14,turkey7,0.5,0.75,11,2.25,1.75,2.0,1.33,5
Kucukcekmece,8,3,3,2,12,10,2,12,turkey7,0.38,0.75,2,1.5,1.5,2.63,1.33,6
Alanya 1221,8,3,2,3,8,6,2,11,turkey7,0.38,0.62,2,1.0,1.38,2.63,1.61,7
Osmaniyespor,8,3,2,3,11,14,-3,11,turkey7,0.38,0.62,-3,1.38,1.38,2.63,1.61,7
1923 M.,8,2,4,2,11,11,0,10,turkey7,0.25,0.75,0,1.38,1.25,4.0,1.33,8
Efeler 09,8,2,3,3,6,10,-4,9,turkey7,0.25,0.62,-4,0.75,1.12,4.0,1.61,9
Viransehir,8,3,0,5,6,10,-4,9,turkey7,0.38,0.38,-4,0.75,1.12,2.63,2.63,9
Cankaya FK,8,2,2,4,12,24,-12,8,turkey7,0.25,0.5,-12,1.5,1.0,4.0,2.0,10
Pazarspor,8,2,1,5,11,12,-1,7,turkey7,0.25,0.38,-1,1.38,0.88,4.0,2.63,11
Bayburt,8,1,3,4,5,12,-7,6,turkey7,0.12,0.5,-7,0.62,0.75,8.33,2.0,12
K. Idmanyurdu,8,1,2,5,7,12,-5,5,turkey7,0.12,0.38,-5,0.88,0.62,8.33,2.63,13
1922 Konyaspor,8,0,2,6,6,16,-10,2,turkey7,0.0,0.25,-10,0.75,0.25,0.0,4.0,14
Agri 1970,8,5,3,0,9,4,5,18,turkey8,0.62,1.0,5,1.12,2.25,1.61,1.0,1
Mardin BB,8,5,2,1,17,7,10,17,turkey8,0.62,0.88,10,2.12,2.12,1.61,1.14,2
Sebat G.,8,5,1,2,22,10,12,16,turkey8,0.62,0.75,12,2.75,2.0,1.61,1.33,3
Kirikkale B.,8,5,1,2,15,12,3,16,turkey8,0.62,0.75,3,1.88,2.0,1.61,1.33,3
Nilufer B.,8,4,2,2,10,6,4,14,turkey8,0.5,0.75,4,1.25,1.75,2.0,1.33,4
Erciyes,8,4,1,3,14,14,0,13,turkey8,0.5,0.62,0,1.75,1.62,2.0,1.61,5
K. Istiklalspor,8,3,2,3,13,11,2,11,turkey8,0.38,0.62,2,1.62,1.38,2.63,1.61,6
Polatli B.,8,3,2,3,8,8,0,11,turkey8,0.38,0.62,0,1.0,1.38,2.63,1.61,6
Z. Komurspor,8,3,2,3,9,14,-5,11,turkey8,0.38,0.62,-5,1.12,1.38,2.63,1.61,6
Denizlispor,8,1,6,1,12,10,2,9,turkey8,0.12,0.88,2,1.5,1.12,8.33,1.14,7
Tepecik,8,2,3,3,9,14,-5,9,turkey8,0.25,0.62,-5,1.12,1.12,4.0,1.61,7
Nigde Belediyes,8,2,2,4,8,9,-1,8,turkey8,0.25,0.5,-1,1.0,1.0,4.0,2.0,8
Edirnespor,8,2,2,4,11,17,-6,8,turkey8,0.25,0.5,-6,1.38,1.0,4.0,2.0,8
Turgutluspor,8,1,2,5,8,14,-6,5,turkey8,0.12,0.38,-6,1.0,0.62,8.33,2.63,9
Orduspor 1967,8,1,2,5,7,13,-6,5,turkey8,0.12,0.38,-6,0.88,0.62,8.33,2.63,9
Coruhlu,8,0,3,5,10,19,-9,3,turkey8,0.0,0.38,-9,1.25,0.38,0.0,2.63,10
Shabab Al Ahli,8,7,1,0,16,3,13,22,uae,0.88,1.0,13,2.0,2.75,1.14,1.0,1
Khorfakkan,8,5,1,2,11,8,3,16,uae,0.62,0.75,3,1.38,2.0,1.61,1.33,2
Al Wahda,8,4,2,2,14,10,4,14,uae,0.5,0.75,4,1.75,1.75,2.0,1.33,3
Al Wasl,8,4,2,2,9,6,3,14,uae,0.5,0.75,3,1.12,1.75,2.0,1.33,3
Al Sharjah,8,4,2,2,5,3,2,14,uae,0.5,0.75,2,0.62,1.75,2.0,1.33,3
Bani Yas,8,4,2,2,7,8,-1,14,uae,0.5,0.75,-1,0.88,1.75,2.0,1.33,3
Al Jazira,8,4,1,3,13,10,3,13,uae,0.5,0.62,3,1.62,1.62,2.0,1.61,4
Ajman,8,4,1,3,13,13,0,13,uae,0.5,0.62,0,1.62,1.62,2.0,1.61,4
Al Bataeh,8,3,3,2,9,8,1,12,uae,0.38,0.75,1,1.12,1.5,2.63,1.33,5
Al Ain,8,3,1,4,16,15,1,10,uae,0.38,0.5,1,2.0,1.25,2.63,2.0,6
Ittihad Kalba,8,1,2,5,5,10,-5,5,uae,0.12,0.38,-5,0.62,0.62,8.33,2.63,7
Al Nasr,8,1,2,5,8,14,-6,5,uae,0.12,0.38,-6,1.0,0.62,8.33,2.63,7
Dibba Al Hisn,8,1,1,6,7,14,-7,4,uae,0.12,0.25,-7,0.88,0.5,8.33,4.0,8
Al Urooba,8,1,0,7,9,18,-9,3,uae,0.12,0.12,-9,1.12,0.38,8.33,8.33,9
Dynamo Kyiv,8,6,2,0,15,4,11,20,ukraine,0.75,1.0,11,1.88,2.5,1.33,1.0,1
Shakhtar,8,5,2,1,13,3,10,17,ukraine,0.62,0.88,10,1.62,2.12,1.61,1.14,2
Zorya Luhansk,8,5,1,2,13,11,2,16,ukraine,0.62,0.75,2,1.62,2.0,1.61,1.33,3
Oleksandria,8,5,1,2,10,8,2,16,ukraine,0.62,0.75,2,1.25,2.0,1.61,1.33,3
Polessya,8,4,2,2,8,8,0,14,ukraine,0.5,0.75,0,1.0,1.75,2.0,1.33,4
Livyi Bereh,8,4,1,3,8,6,2,13,ukraine,0.5,0.62,2,1.0,1.62,2.0,1.61,5
Kryvbas KR,8,4,1,3,10,9,1,13,ukraine,0.5,0.62,1,1.25,1.62,2.0,1.61,5
Karpaty Lviv,8,3,2,3,11,6,5,11,ukraine,0.38,0.62,5,1.38,1.38,2.63,1.61,6
Obolon,8,3,2,3,6,9,-3,11,ukraine,0.38,0.62,-3,0.75,1.38,2.63,1.61,6
Inhulets,8,3,1,4,6,5,1,10,ukraine,0.38,0.5,1,0.75,1.25,2.63,2.0,7
Veres,8,3,1,4,10,13,-3,10,ukraine,0.38,0.5,-3,1.25,1.25,2.63,2.0,7
Rukh Lviv,8,3,0,5,4,9,-5,9,ukraine,0.38,0.38,-5,0.5,1.12,2.63,2.63,8
Kolos Kovalivka,8,2,1,5,7,8,-1,7,ukraine,0.25,0.38,-1,0.88,0.88,4.0,2.63,9
LNZ Cherkasy,8,2,1,5,6,9,-3,7,ukraine,0.25,0.38,-3,0.75,0.88,4.0,2.63,9
Chornomorets,8,2,0,6,6,15,-9,6,ukraine,0.25,0.25,-9,0.75,0.75,4.0,4.0,10
Vorskla Poltava,8,1,2,5,4,9,-5,5,ukraine,0.12,0.38,-5,0.5,0.62,8.33,2.63,11
Dnipro-1,0,0,0,0,0,0,0,0,ukraine,0.0,0.0,0,0.0,0.0,0.0,0.0,12
Liverpool M.,8,5,3,0,14,5,9,18,uruguay,0.62,1.0,9,1.75,2.25,1.61,1.0,1
Juventud,8,6,0,2,16,10,6,18,uruguay,0.75,0.75,6,2.0,2.25,1.33,1.33,1
Racing CM,8,6,0,2,11,5,6,18,uruguay,0.75,0.75,6,1.38,2.25,1.33,1.33,1
Nacional,8,4,3,1,20,11,9,15,uruguay,0.5,0.88,9,2.5,1.88,2.0,1.14,2
Defensor S.,8,4,2,2,9,5,4,14,uruguay,0.5,0.75,4,1.12,1.75,2.0,1.33,3
Plaza Colonia,8,3,2,3,7,7,0,11,uruguay,0.38,0.62,0,0.88,1.38,2.63,1.61,4
Cerro,8,2,4,2,7,7,0,10,uruguay,0.25,0.75,0,0.88,1.25,4.0,1.33,5
Cerro Largo,8,2,4,2,6,10,-4,10,uruguay,0.25,0.75,-4,0.75,1.25,4.0,1.33,5
Montevideo City,8,2,3,3,10,15,-5,9,uruguay,0.25,0.62,-5,1.25,1.12,4.0,1.61,6
Miramar Misione,8,2,2,4,8,11,-3,8,uruguay,0.25,0.5,-3,1.0,1.0,4.0,2.0,7
Boston River,8,2,2,4,10,14,-4,8,uruguay,0.25,0.5,-4,1.25,1.0,4.0,2.0,7
Progreso,8,1,5,2,8,12,-4,8,uruguay,0.12,0.75,-4,1.0,1.0,8.33,1.33,7
Penarol,8,2,2,4,5,10,-5,8,uruguay,0.25,0.5,-5,0.62,1.0,4.0,2.0,7
Wanderers,8,1,3,4,9,11,-2,6,uruguay,0.12,0.5,-2,1.12,0.75,8.33,2.0,8
Danubio,8,0,6,2,6,8,-2,6,uruguay,0.0,0.75,-2,0.75,0.75,0.0,1.33,8
River Plate,8,0,3,5,7,13,-6,3,uruguay,0.0,0.38,-6,0.88,0.38,0.0,2.63,9
Nacional,7,5,1,1,18,5,13,16,uruguay2,0.71,0.86,13,2.57,2.29,1.41,1.16,1
Penarol,7,4,2,1,10,5,5,14,uruguay2,0.57,0.86,5,1.43,2.0,1.75,1.16,2
Danubio,7,4,2,1,11,11,0,14,uruguay2,0.57,0.86,0,1.57,2.0,1.75,1.16,2
Wanderers,7,4,1,2,11,9,2,13,uruguay2,0.57,0.71,2,1.57,1.86,1.75,1.41,3
Defensor S.,7,3,2,2,7,5,2,11,uruguay2,0.43,0.71,2,1.0,1.57,2.33,1.41,4
Cerro Largo,7,3,2,2,6,7,-1,11,uruguay2,0.43,0.71,-1,0.86,1.57,2.33,1.41,4
Cerro,7,3,1,3,8,5,3,10,uruguay2,0.43,0.57,3,1.14,1.43,2.33,1.75,5
Fenix,7,3,1,3,10,9,1,10,uruguay2,0.43,0.57,1,1.43,1.43,2.33,1.75,5
Miramar Misione,7,3,1,3,7,10,-3,10,uruguay2,0.43,0.57,-3,1.0,1.43,2.33,1.75,5
River Plate,7,2,2,3,8,9,-1,8,uruguay2,0.29,0.57,-1,1.14,1.14,3.45,1.75,6
Progreso,7,2,2,3,8,11,-3,8,uruguay2,0.29,0.57,-3,1.14,1.14,3.45,1.75,6
Rampla Juniors,7,2,2,3,8,12,-4,8,uruguay2,0.29,0.57,-4,1.14,1.14,3.45,1.75,6
Boston River,7,2,1,4,6,8,-2,7,uruguay2,0.29,0.43,-2,0.86,1.0,3.45,2.33,7
Racing CM,7,1,3,3,8,10,-2,6,uruguay2,0.14,0.57,-2,1.14,0.86,7.14,1.75,8
D. Maldonado,7,1,3,3,5,9,-4,6,uruguay2,0.14,0.57,-4,0.71,0.86,7.14,1.75,8
Liverpool M.,7,1,0,6,4,10,-6,3,uruguay2,0.14,0.14,-6,0.57,0.43,7.14,7.14,9
Vancouver,7,5,1,1,12,5,7,16,usa,0.71,0.86,7,1.71,2.29,1.41,1.16,1
Columbus Crew,7,4,3,0,10,5,5,15,usa,0.57,1.0,5,1.43,2.14,1.75,1.0,2
San Diego,7,4,2,1,13,6,7,14,usa,0.57,0.86,7,1.86,2.0,1.75,1.16,3
Inter Miami,6,4,2,0,12,6,6,14,usa,0.67,1.0,6,2.0,2.33,1.49,1.0,3
Minnesota Utd,7,4,2,1,11,7,4,14,usa,0.57,0.86,4,1.57,2.0,1.75,1.16,3
Philadelphia,7,4,1,2,13,8,5,13,usa,0.57,0.71,5,1.86,1.86,1.75,1.41,4
Charlotte,7,4,1,2,12,7,5,13,usa,0.57,0.71,5,1.71,1.86,1.75,1.41,4
Austin,7,4,1,2,5,3,2,13,usa,0.57,0.71,2,0.71,1.86,1.75,1.41,4
Cincinnati,7,4,1,2,9,9,0,13,usa,0.57,0.71,0,1.29,1.86,1.75,1.41,4
Orlando City,7,3,2,2,15,12,3,11,usa,0.43,0.71,3,2.14,1.57,2.33,1.41,5
Chicago Fire,7,3,2,2,14,12,2,11,usa,0.43,0.71,2,2.0,1.57,2.33,1.41,5
New York RB,7,3,2,2,9,7,2,11,usa,0.43,0.71,2,1.29,1.57,2.33,1.41,5
Portland,7,3,2,2,9,8,1,11,usa,0.43,0.71,1,1.29,1.57,2.33,1.41,5
Dallas,7,3,2,2,10,10,0,11,usa,0.43,0.71,0,1.43,1.57,2.33,1.41,5
Colorado Rapids,7,3,2,2,8,9,-1,11,usa,0.43,0.71,-1,1.14,1.57,2.33,1.41,5
SJ Earthquakes,7,3,1,3,15,10,5,10,usa,0.43,0.57,5,2.14,1.43,2.33,1.75,6
Nashville SC,7,3,1,3,10,7,3,10,usa,0.43,0.57,3,1.43,1.43,2.33,1.75,6
Atlanta Utd,7,2,3,2,11,12,-1,9,usa,0.29,0.71,-1,1.57,1.29,3.45,1.41,7
Los Angeles FC,7,3,0,4,8,10,-2,9,usa,0.43,0.43,-2,1.14,1.29,2.33,2.33,7
Real Salt Lake,7,3,0,4,7,11,-4,9,usa,0.43,0.43,-4,1.0,1.29,2.33,2.33,7
St. Louis City,7,2,2,3,4,4,0,8,usa,0.29,0.57,0,0.57,1.14,3.45,1.75,8
New York City,7,2,2,3,10,11,-1,8,usa,0.29,0.57,-1,1.43,1.14,3.45,1.75,8
Seattle,7,1,3,3,8,11,-3,6,usa,0.14,0.57,-3,1.14,0.86,7.14,1.75,9
DC United,7,1,3,3,9,17,-8,6,usa,0.14,0.57,-8,1.29,0.86,7.14,1.75,9
Houston Dynamo,7,1,2,4,5,11,-6,5,usa,0.14,0.43,-6,0.71,0.71,7.14,2.33,10
Sporting KC,7,1,1,5,8,12,-4,4,usa,0.14,0.29,-4,1.14,0.57,7.14,3.45,11
New England,6,1,1,4,3,7,-4,4,usa,0.17,0.33,-4,0.5,0.67,5.88,3.03,11
Toronto,7,0,3,4,7,13,-6,3,usa,0.0,0.43,-6,1.0,0.43,0.0,2.33,12
CF Montreal,7,0,2,5,4,12,-8,2,usa,0.0,0.29,-8,0.57,0.29,0.0,3.45,13
Loudoun Utd,5,4,0,1,9,4,5,12,usa2,0.8,0.8,5,1.8,2.4,1.25,1.25,1
San Antonio,5,4,0,1,9,5,4,12,usa2,0.8,0.8,4,1.8,2.4,1.25,1.25,1
Louisville City,5,3,2,0,8,3,5,11,usa2,0.6,1.0,5,1.6,2.2,1.67,1.0,2
Monterey Bay,5,3,1,1,9,4,5,10,usa2,0.6,0.8,5,1.8,2.0,1.67,1.25,3
New Mexico,4,3,0,1,6,4,2,9,usa2,0.75,0.75,2,1.5,2.25,1.33,1.33,4
FC Tulsa,4,3,0,1,3,1,2,9,usa2,0.75,0.75,2,0.75,2.25,1.33,1.33,4
El Paso,5,2,2,1,10,9,1,8,usa2,0.4,0.8,1,2.0,1.6,2.5,1.25,5
North Carolina,5,2,2,1,7,6,1,8,usa2,0.4,0.8,1,1.4,1.6,2.5,1.25,5
Detroit City,5,2,2,1,6,5,1,8,usa2,0.4,0.8,1,1.2,1.6,2.5,1.25,5
Las Vegas L.,4,2,1,1,4,3,1,7,usa2,0.5,0.75,1,1.0,1.75,2.0,1.33,6
Pittsburgh,4,2,1,1,4,3,1,7,usa2,0.5,0.75,1,1.0,1.75,2.0,1.33,6
Charleston,4,2,0,2,6,5,1,6,usa2,0.5,0.5,1,1.5,1.5,2.0,2.0,7
Indy Eleven,4,1,2,1,8,7,1,5,usa2,0.25,0.75,1,2.0,1.25,4.0,1.33,8
Colorado S.,4,1,2,1,8,8,0,5,usa2,0.25,0.75,0,2.0,1.25,4.0,1.33,8
Lexington,5,1,2,2,8,8,0,5,usa2,0.2,0.6,0,1.6,1.0,5.0,1.67,8
Sacramento R.,4,1,2,1,5,5,0,5,usa2,0.25,0.75,0,1.25,1.25,4.0,1.33,8
Phoenix Rising,5,1,2,2,9,11,-2,5,usa2,0.2,0.6,-2,1.8,1.0,5.0,1.67,8
Rhode Island,4,1,1,2,5,6,-1,4,usa2,0.25,0.5,-1,1.25,1.0,4.0,2.0,9
Orange County,4,1,1,2,6,8,-2,4,usa2,0.25,0.5,-2,1.5,1.0,4.0,2.0,9
Tampa Bay,4,1,0,3,3,5,-2,3,usa2,0.25,0.25,-2,0.75,0.75,4.0,4.0,10
Birmingham L.,4,0,2,2,4,8,-4,2,usa2,0.0,0.5,-4,1.0,0.5,0.0,2.0,11
Oakland Roots,5,0,1,4,5,12,-7,1,usa2,0.0,0.2,-7,1.0,0.2,0.0,5.0,12
Miami FC,4,0,0,4,2,8,-6,0,usa2,0.0,0.0,-6,0.5,0.0,0.0,0.0,13
Hartford A.,4,0,0,4,1,7,-6,0,usa2,0.0,0.0,-6,0.25,0.0,0.0,0.0,13
Naples,5,3,2,0,7,1,6,11,usa3,0.6,1.0,6,1.4,2.2,1.67,1.0,1
Greenville,4,2,1,1,5,5,0,7,usa3,0.5,0.75,0,1.25,1.75,2.0,1.33,2
Richmond K.,4,2,0,2,8,6,2,6,usa3,0.5,0.5,2,2.0,1.5,2.0,2.0,3
Spokane V.,4,1,2,1,6,3,3,5,usa3,0.25,0.75,3,1.5,1.25,4.0,1.33,4
One Knoxville,2,1,1,0,4,2,2,4,usa3,0.5,1.0,2,2.0,2.0,2.0,1.0,5
Westchester SC,3,1,1,1,4,4,0,4,usa3,0.33,0.67,0,1.33,1.33,3.03,1.49,5
Charlotte I.,3,1,1,1,1,1,0,4,usa3,0.33,0.67,0,0.33,1.33,3.03,1.49,5
Tormenta,4,1,1,2,7,9,-2,4,usa3,0.25,0.5,-2,1.75,1.0,4.0,2.0,5
Chattanooga RW,3,0,3,0,3,3,0,3,usa3,0.0,1.0,0,1.0,1.0,0.0,1.0,6
Union Omaha,2,1,0,1,3,4,-1,3,usa3,0.5,0.5,-1,1.5,1.5,2.0,2.0,6
Forward Madison,2,1,0,1,2,3,-1,3,usa3,0.5,0.5,-1,1.0,1.5,2.0,2.0,6
Alta,3,1,0,2,3,5,-2,3,usa3,0.33,0.33,-2,1.0,1.0,3.03,3.03,6
Portland Hearts,2,0,2,0,0,0,0,2,usa3,0.0,1.0,0,0.0,1.0,0.0,1.0,7
Texoma,3,0,0,3,1,8,-7,0,usa3,0.0,0.0,-7,0.33,0.0,0.0,0.0,8
D. La Guaira,8,5,2,1,13,6,7,17,venezuela,0.62,0.88,7,1.62,2.12,1.61,1.14,1
UCV,8,5,2,1,8,3,5,17,venezuela,0.62,0.88,5,1.0,2.12,1.61,1.14,1
Carabobo,8,5,2,1,10,7,3,17,venezuela,0.62,0.88,3,1.25,2.12,1.61,1.14,1
D. Tachira,8,4,3,1,9,6,3,15,venezuela,0.5,0.88,3,1.12,1.88,2.0,1.14,2
Rayo Zuliano,8,4,1,3,7,4,3,13,venezuela,0.5,0.62,3,0.88,1.62,2.0,1.61,3
Puerto Cabello,8,3,3,2,5,4,1,12,venezuela,0.38,0.75,1,0.62,1.5,2.63,1.33,4
A. Anzoategui,8,2,4,2,8,7,1,10,venezuela,0.25,0.75,1,1.0,1.25,4.0,1.33,5
Metropolitanos,8,2,4,2,10,11,-1,10,venezuela,0.25,0.75,-1,1.25,1.25,4.0,1.33,5
Caracas,8,2,3,3,6,6,0,9,venezuela,0.25,0.62,0,0.75,1.12,4.0,1.61,6
Portuguesa,8,2,2,4,6,9,-3,8,venezuela,0.25,0.5,-3,0.75,1.0,4.0,2.0,7
Monagas,8,2,2,4,6,10,-4,8,venezuela,0.25,0.5,-4,0.75,1.0,4.0,2.0,7
E. Merida,8,2,1,5,11,13,-2,7,venezuela,0.25,0.38,-2,1.38,0.88,4.0,2.63,8
Yaracuyanos,8,0,5,3,9,14,-5,5,venezuela,0.0,0.62,-5,1.12,0.62,0.0,1.61,9
Zamora,8,0,2,6,4,12,-8,2,venezuela,0.0,0.25,-8,0.5,0.25,0.0,4.0,10
Bunyodkor,4,3,1,0,9,3,6,10,uzbekistan,0.75,1.0,6,2.25,2.5,1.33,1.0,1
AGMK,4,3,1,0,7,2,5,10,uzbekistan,0.75,1.0,5,1.75,2.5,1.33,1.0,1
Nasaf Qarshi,4,2,2,0,6,2,4,8,uzbekistan,0.5,1.0,4,1.5,2.0,2.0,1.0,2
D. Samarqand,4,2,2,0,2,0,2,8,uzbekistan,0.5,1.0,2,0.5,2.0,2.0,1.0,2
Buxoro,4,2,0,2,7,5,2,6,uzbekistan,0.5,0.5,2,1.75,1.5,2.0,2.0,3
Andijan,4,1,3,0,5,4,1,6,uzbekistan,0.25,1.0,1,1.25,1.5,4.0,1.0,3
Neftchi,4,1,3,0,5,4,1,6,uzbekistan,0.25,1.0,1,1.25,1.5,4.0,1.0,3
Xorazm,3,2,0,1,5,4,1,6,uzbekistan,0.67,0.67,1,1.67,2.0,1.49,1.49,3
Navbahor,4,1,2,1,7,7,0,5,uzbekistan,0.25,0.75,0,1.75,1.25,4.0,1.33,4
Pakhtakor,4,1,0,3,5,5,0,3,uzbekistan,0.25,0.25,0,1.25,0.75,4.0,4.0,5
Sogdiana,4,1,0,3,4,5,-1,3,uzbekistan,0.25,0.25,-1,1.0,0.75,4.0,4.0,5
Qizilqum,3,1,0,2,3,5,-2,3,uzbekistan,0.33,0.33,-2,1.0,1.0,3.03,3.03,5
Kokand-1912,4,0,3,1,2,4,-2,3,uzbekistan,0.0,0.75,-2,0.5,0.75,0.0,1.33,5
Termez Surkhon,4,1,0,3,4,8,-4,3,uzbekistan,0.25,0.25,-4,1.0,0.75,4.0,4.0,5
Mashal,4,1,0,3,1,7,-6,3,uzbekistan,0.25,0.25,-6,0.25,0.75,4.0,4.0,5
Shurtan,4,0,1,3,1,8,-7,1,uzbekistan,0.0,0.25,-7,0.25,0.25,0.0,4.0,6
Ha Noi,8,5,1,2,16,7,9,16,vietnam,0.62,0.75,9,2.0,2.0,1.61,1.33,1
Nam Dinh,8,4,3,1,11,5,6,15,vietnam,0.5,0.88,6,1.38,1.88,2.0,1.14,2
Viettel,8,4,2,2,11,10,1,14,vietnam,0.5,0.75,1,1.38,1.75,2.0,1.33,3
Hai Phong,8,4,1,3,7,6,1,13,vietnam,0.5,0.62,1,0.88,1.62,2.0,1.61,4
Binh Duong,8,4,1,3,10,12,-2,13,vietnam,0.5,0.62,-2,1.25,1.62,2.0,1.61,4
Quang Nam,8,3,3,2,14,12,2,12,vietnam,0.38,0.75,2,1.75,1.5,2.63,1.33,5
Song Lam Nghe,8,3,3,2,7,8,-1,12,vietnam,0.38,0.75,-1,0.88,1.5,2.63,1.33,5
Cong An Nhan,8,2,5,1,12,11,1,11,vietnam,0.25,0.88,1,1.5,1.38,4.0,1.14,6
Ho Chi Minh,8,2,4,2,9,11,-2,10,vietnam,0.25,0.75,-2,1.12,1.25,4.0,1.33,7
Gia Lai,8,2,3,3,11,11,0,9,vietnam,0.25,0.62,0,1.38,1.12,4.0,1.61,8
Hong Linh Ha T.,8,1,6,1,6,6,0,9,vietnam,0.12,0.88,0,0.75,1.12,8.33,1.14,8
Thanh Hoa,8,0,6,2,8,11,-3,6,vietnam,0.0,0.75,-3,1.0,0.75,0.0,1.33,9
Da Nang,8,1,2,5,7,12,-5,5,vietnam,0.12,0.38,-5,0.88,0.62,8.33,2.63,10
Binh Dinh,8,0,2,6,4,11,-7,2,vietnam,0.0,0.25,-7,0.5,0.25,0.0,4.0,11
Phu Dong,8,8,0,0,18,0,18,24,vietnam2,1.0,1.0,18,2.25,3.0,1.0,1.0,1
Binh Phuoc,8,5,2,1,12,5,7,17,vietnam2,0.62,0.88,7,1.5,2.12,1.61,1.14,2
PVF-CAND,8,5,1,2,11,8,3,16,vietnam2,0.62,0.75,3,1.38,2.0,1.61,1.33,3
S. Khanh Hoa,8,2,4,2,7,7,0,10,vietnam2,0.25,0.75,0,0.88,1.25,4.0,1.33,4
Ba Ria Vung Tau,8,3,1,4,6,13,-7,10,vietnam2,0.38,0.5,-7,0.75,1.25,2.63,2.0,4
Long An,8,2,3,3,5,7,-2,9,vietnam2,0.25,0.62,-2,0.62,1.12,4.0,1.61,5
Ho Chi Minh B,8,2,3,3,6,9,-3,9,vietnam2,0.25,0.62,-3,0.75,1.12,4.0,1.61,5
Hoa Binh,8,1,5,2,2,4,-2,8,vietnam2,0.12,0.75,-2,0.25,1.0,8.33,1.33,6
Dong Thap,8,1,3,4,2,4,-2,6,vietnam2,0.12,0.5,-2,0.25,0.75,8.33,2.0,7
Dong Nai,8,0,5,3,1,4,-3,5,vietnam2,0.0,0.62,-3,0.12,0.62,0.0,1.61,8
Hue,8,1,1,6,6,15,-9,4,vietnam2,0.12,0.25,-9,0.75,0.5,8.33,4.0,9
The New Saints,8,7,0,1,23,3,20,21,wales,0.88,0.88,20,2.88,2.62,1.14,1.14,1
Barry,8,5,1,2,16,13,3,16,wales,0.62,0.75,3,2.0,2.0,1.61,1.33,2
Flint,8,5,1,2,15,14,1,16,wales,0.62,0.75,1,1.88,2.0,1.61,1.33,2
Connahs Quay,8,5,0,3,14,6,8,15,wales,0.62,0.62,8,1.75,1.88,1.61,1.61,3
Caernarfon,8,3,2,3,15,12,3,11,wales,0.38,0.62,3,1.88,1.38,2.63,1.61,4
Briton Ferry,8,3,2,3,12,13,-1,11,wales,0.38,0.62,-1,1.5,1.38,2.63,1.61,4
Penybont,8,3,2,3,9,12,-3,11,wales,0.38,0.62,-3,1.12,1.38,2.63,1.61,4
Cardiff MU,8,3,2,3,9,14,-5,11,wales,0.38,0.62,-5,1.12,1.38,2.63,1.61,4
Haverfordwest,8,2,4,2,8,11,-3,10,wales,0.25,0.75,-3,1.0,1.25,4.0,1.33,5
Newtown,8,1,4,3,10,12,-2,7,wales,0.12,0.62,-2,1.25,0.88,8.33,1.61,6
Aberystwyth,8,1,0,7,6,15,-9,3,wales,0.12,0.12,-9,0.75,0.38,8.33,8.33,7
Bala Town,8,0,2,6,6,18,-12,2,wales,0.0,0.25,-12,0.75,0.25,0.0,4.0,8
